match_id_hash,r_num_damage,r_num_damage_taken,r_damage,r_damage_taken,r_damage_net,d_num_damage,d_num_damage_taken,d_damage,d_damage_taken,d_damage_net
30cc2d778dca82f2edb568ce9b585caa,6,4,719,281,438,4,6,281,719,-438
70e5ba30f367cea48793b9003fab9d38,133,105,202097,51640,150457,89,61,158548,49375,109173
4d9ef74d3a2025d79e9423105fd73d41,104,74,194334,36872,157462,72,51,92908,45559,47349
2bb79e0c1eaac1608e5a09c8e0c6a555,35,29,55006,20125,34881,39,37,51161,25619,25542
bec17f099b01d67edc82dfb5ce735a43,121,103,303702,71293,232409,130,105,290040,64887,225153
038acbb47d9eb54c11962d07cce8d829,121,104,304090,104315,199775,152,114,420415,66479,353936
b891f03bb2a86d78b84043437fc95e04,110,82,168292,38440,129852,77,64,96350,55845,40505
ff898afdb5bb5c7163bde45a009503f7,142,120,361666,57950,303716,161,111,448307,106224,342083
72e6b1c31c718c0806f9aaeb8b7290a9,81,65,145742,54521,91221,94,75,147558,26813,120745
abd97ab60ceca3ae6f00a28baea8a43c,165,106,395971,61170,334801,153,112,287784,73492,214292
d46d5407bd08b42245e1bf2de86da403,112,91,257575,97524,160051,138,98,311116,72951,238165
a176147b06a337304ab179cd3b432015,111,86,302775,86030,216745,167,132,451444,74072,377372
f4e59a3443f4d1e55b8639651dca3a4d,46,40,48328,34553,13775,70,51,114322,32058,82264
2b8263ce33e0320e9d8b2775f65c3eef,22,20,3270,2144,1126,18,20,3295,3286,9
2d0803ecc11a376020a41da9aa255e23,124,89,178795,42978,135817,87,69,94184,60904,33280
4e043d36d488c88b73afec997ea4fb76,92,65,163481,25831,137650,59,48,58419,27929,30490
30f5b5e14622068c186b6f4e937bd6b9,31,25,24414,9137,15277,31,26,26682,8914,17768
44ef19f09cec7868270e5e62aba4a3ff,92,70,185295,44487,140808,94,59,155179,33964,121215
47b462bb8974dbe082357e8b1ddececd,82,60,86537,21026,65511,69,73,99918,20768,79150
41e32d96134ca0a52c1a1be7faefd752,46,31,63506,15974,47532,41,37,53384,22775,30609
a25a6fc067bc963af369f45d655db098,39,27,47976,15092,32884,32,26,45682,15643,30039
f9bf94520433bc98d287e01ae84090eb,140,107,335774,53669,282105,117,91,220032,70126,149906
3c83af081c79a7bcce2f47c038ccb360,5,5,613,586,27,5,4,872,386,486
e6955d1c0b810cc5dc9197cc7d404831,66,58,93999,20158,73841,50,36,62722,19143,43579
f53297cb268acd155dc0ba92765067d3,61,54,77519,38837,38682,67,47,97890,38967,58923
021cefc286d907c7b8ad4156f06067f2,0,3,0,361,-361,3,0,361,0,361
6b8377392b416087a5486b667159e942,152,109,370337,87624,282713,155,121,378630,112111,266519
17d1e4a72ebca9d7e5bb04595219d7f4,129,101,408562,66376,342186,116,88,341061,59747,281314
d020af84fd2a439bc9019dc681bc2325,188,132,790488,123777,666711,185,157,941464,125716,815748
525559396be62ae36be7fa72246b9ffa,26,19,7660,4588,3072,22,23,7934,4082,3852
39b35584d8fcca44bbb35b0d9ffaa8a3,145,130,414542,80543,333999,177,135,497187,113688,383499
5d8b85ca1307b58f511f8794b22229c0,133,96,583670,115910,467760,184,133,599259,113651,485608
3224dbf29a3f7a75b5a5c37dcab6b8f8,58,55,122898,44542,78356,83,58,183871,41128,142743
0cd98aadfef4ca31d2b352124757cc16,58,47,104627,23432,81195,71,49,83876,25180,58696
0e395c12a6af074b1cf20abca3662327,96,90,230884,43614,187270,107,77,166525,36748,129777
05fa1a5bf98ada8025535261b3fcdc6f,31,19,24768,8345,16423,29,25,25110,11053,14057
7d52952f47f56913ab634914f3904143,190,160,759353,149071,610282,176,129,484515,130557,353958
3a559937038a24655a3add1da523c998,182,109,449585,82350,367235,124,93,290031,119958,170073
a8531ace02ae32c1594ba5688ac535f4,164,95,328210,60969,267241,154,117,390497,79234,311263
1d55f15af571223402e59daa58ef8267,101,70,188406,57147,131259,123,84,237723,44476,193247
ee290a51ad00351c9db6e1cbad3fe7e1,116,95,251044,68740,182304,150,117,383222,48598,334624
8ec5c5e629b71a73e213dc216a931c36,52,33,55176,14623,40553,45,30,52456,17472,34984
c28f4b3a278a0dee272e1e887c677e76,96,66,177540,46248,131292,118,96,174164,46225,127939
9bf0626a279d053668fa8659c5ec6a0f,55,49,68638,24636,44002,76,62,101485,23917,77568
82649fc7c67eee0badd74c3a92486050,257,195,1615525,422804,1192721,268,162,1549279,196329,1352950
462140e734deb14ac27a2ffd6107968d,39,31,25377,7482,17895,36,23,21735,8581,13154
a6ea4996c5e6d25d12e2d230e09802e0,89,82,162241,35372,126869,79,58,120038,37439,82599
0ff573184e4c5c719bb3d63336bf4a19,49,36,62327,23860,38467,48,45,76777,22318,54459
8f7f06608f179231a81365b92355655d,44,34,47651,20472,27179,46,38,54614,16823,37791
829b44e368af73ca3fd4c87e8b217814,128,110,271478,57875,213603,104,80,252608,42255,210353
e1834129bfe64831575572d2dfb9289b,31,23,24707,6709,17998,31,28,18976,9620,9356
f3c661070c79ef6a88852dbb6a54ad22,142,106,342724,73817,268907,123,93,275311,71576,203735
bd7809aeeb5900478b8a06a7bedfae29,90,64,170643,47187,123456,70,60,151195,54959,96236
766d15ad4a340bff48ff37f5d173844d,182,144,665639,124802,540837,170,129,803068,122587,680481
15f619b1a28186c4164b0c206d931bbe,119,93,319545,54004,265541,167,98,306684,76603,230081
a73b39d09b3e5eaae81873e71cd467b7,94,70,217455,51422,166033,108,95,232700,62667,170033
39d0ba15f7a177c1a77cf9d2fbc3ae83,116,70,204038,47661,156377,86,66,147121,45443,101678
60353ee1ce84365ffee170457063f12d,154,116,408507,54359,354148,127,109,360335,91252,269083
41d5c8eaa020b58cc2a6398539b28eda,48,37,41644,7861,33783,43,37,45654,13386,32268
f05fcbd307f44f4ab1140eca9d1ba8d6,54,38,52524,13416,39108,61,42,56905,23352,33553
33ce8c7dafa35d022a8e431895a4e969,101,83,137739,34867,102872,96,63,124599,29942,94657
8009066aac44afe3c8aff74c6b41b75e,59,42,87809,20575,67234,64,51,84318,28499,55819
495eb2eeb331fc066cc33e28b8d937ef,81,65,132546,42444,90102,109,80,234593,19976,214617
6e93839278a01c8a18b6bc37a6a4304f,100,83,236782,58547,178235,73,62,208447,73430,135017
f6ec14644b6efe664531b1a775454bea,124,106,278128,71585,206543,151,116,318232,64159,254073
4dad0ce7aa3a691f2ced03c444874b71,162,136,442931,82173,360758,150,122,324730,83210,241520
4df5976fc62308f97f8eba3de32f4447,153,125,422555,100019,322536,189,148,556609,105036,451573
ce1447113933873d4e60ef986ab5e0a7,150,127,446989,80997,365992,133,97,427122,79777,347345
3f2e0f2a6608c910a2d69217209dc73e,207,154,751458,138795,612663,165,114,633231,170408,462823
edf2020b7d9c4d57749c7f3eb4d976e2,166,101,418602,101896,316706,198,157,640871,88182,552689
9933efa7dc6aebbd599e5663696ed314,46,34,37494,7623,29871,42,28,29163,6607,22556
f03ce7a080562784208d03920f8ed9a8,69,48,71377,34915,36462,74,57,91461,33621,57840
9bc9c1115610c3cd052c9fb1e32cd6a3,120,82,214026,82347,131679,108,97,251969,79247,172722
fca6f4a09a6e8ffe0e7b3726b2458ec5,133,98,323664,59822,263842,158,115,392811,65693,327118
e727c947fd12638260bf60fa0bd58ac4,51,37,61911,19850,42061,59,49,62842,22658,40184
a7988c80f80a92d1d00ec55b001e0531,79,68,151648,48384,103264,87,62,146546,34786,111760
73b4ac2c4b6c4c2203d8445aa5371d9c,63,47,74999,15797,59202,46,39,41501,19251,22250
036fa099bd5f9ed2bba6b253f11c0646,84,63,90425,31976,58449,69,61,96522,31251,65271
78afe765c255b1dbb4eef7bc6bef2ea2,47,38,67714,20912,46802,65,45,63204,24568,38636
ade6b775f2c15529c69e761693833b64,139,104,436389,131344,305045,173,124,394708,154876,239832
c4af2ef35e9b5c648d6e290560acae9e,76,63,100939,21150,79789,55,39,43528,15759,27769
42c66acd16752d83c132928436e2e0ab,139,106,392722,101353,291369,126,108,481081,94940,386141
b8491947accfed83d0a554a99ce8e38f,84,55,107676,28201,79475,101,74,171447,32704,138743
54a887a4c905a4579439fce4ff01719e,23,13,4352,1647,2705,23,15,4513,1702,2811
b6e68f2983bf76d505fe1067f2f84deb,71,64,118723,44404,74319,87,59,157717,34877,122840
253ae549ee3c10b2a64902adc8102d50,67,45,89100,26323,62777,69,53,99256,28167,71089
2d35af56639997118786d6eadba53e52,113,92,192358,39226,153132,118,99,250333,50042,200291
a2903da10946d1a751afec3d69ca5906,131,116,368485,114530,253955,136,110,400089,92111,307978
52951bcf6e52b8ac5e4c05ebc14c053b,42,30,43682,12220,31462,48,46,48914,17091,31823
39e27dbbd6d8fc50da949716010609a2,63,49,61774,17614,44160,58,49,65276,18200,47076
5c170ea7a477b123256754a4330e445f,102,82,249417,78927,170490,143,108,265117,87328,177789
b30f8d475edeb9e4067c94a5dad61745,120,86,253480,44671,208809,138,109,317096,58311,258785
274a537210fb94ccc97378e9550a6b1f,172,120,413704,85512,328192,190,142,527664,78099,449565
804621c88b9fb4d6961a8b879fb6d4e8,138,89,469625,90450,379175,121,95,364416,117927,246489
72821e849a6ad51e0c3831e8afee4e1d,117,91,222724,51606,171118,120,88,179133,41143,137990
40a1d084ce70a1f3dbaed42fb3972e90,21,16,6326,2634,3692,19,18,6712,3296,3416
aba5de27ee767c8ff0504ffcc88840c1,3,1,212,110,102,1,2,110,171,-61
73cbf76bbc4c90021252a9e100fa176d,73,54,109393,24649,84744,89,69,126332,25667,100665
75a7cf2ed1a3b2c6cd4c2676600af95f,160,119,406394,62274,344120,123,106,338584,63654,274930
a8273c207a85333263a715c92824d4c5,117,104,225474,60291,165183,136,96,280970,43823,237147
eaefb3e1caf992544319b50e52560729,90,74,271459,70711,200748,123,87,304613,50143,254470
ddb777d093a1a8f907364777fb04828c,69,57,128156,43543,84613,66,46,99989,33775,66214
ace3a47615b4ff4884732dc0f09cae72,27,22,9596,5933,3663,27,23,10405,4992,5413
dcf60d2b0d734f24a8d645b04d7c6b2c,66,56,114171,32695,81476,47,39,62925,21586,41339
b825903caed5dae1f2a096f4d9b725f2,170,128,446427,101869,344558,118,93,300591,102939,197652
2be8820ce1b4d74e16cf9e6a8cf92bc2,210,136,907427,177088,730339,184,127,1065088,172374,892714
16017bfd32c10318b28481022503eca6,16,13,6472,1835,4637,20,11,7150,1599,5551
9b1a5b963900d7217c526a488243fe3a,149,106,301147,46058,255089,110,92,167661,80657,87004
12780f9e434211f2cb75927e202fd1a9,37,32,17474,10338,7136,43,37,23744,6710,17034
cab3143fb59af69757706940b616799e,134,116,356699,81266,275433,96,83,261582,68398,193184
4509a5d8d23b966184a57ed75d7b36a0,60,46,59319,13624,45695,62,46,63909,16209,47700
19f1f13ff866be52b70abf4e77a59dd5,64,46,80360,18458,61902,48,34,31160,16267,14893
b5bb0c17d09bf40c28b599007d28aa1a,107,78,203653,58134,145519,98,79,164347,57551,106796
f53fd5b695022ed025b550865af03367,31,24,18375,7865,10510,27,19,19993,6187,13806
f00fa18fa9c75981ec7119e969a52f54,27,20,17670,5809,11861,35,31,19675,6512,13163
6523ed0ac8460e8f6338982a3126e826,109,95,177659,61154,116505,98,79,191770,53268,138502
880d3364cc3d469cf368b3c06f9ad729,127,99,239956,36617,203339,118,102,176362,58117,118245
d741178c3c6c16cf5ee83cda24718346,150,106,500535,151811,348724,163,126,637866,221264,416602
775e98b3529d03c2d8853281ac5b7eb6,46,33,28396,11070,17326,47,41,34508,9940,24568
40f95c10a23ff0a05a738fda12701b9d,16,17,3925,1212,2713,17,14,3100,1925,1175
a0c81e20bcd8afe281c6c2e100cca948,5,4,389,461,-72,3,4,378,298,80
058f0214f2484eb2b791ea5b116d443d,14,8,8386,1260,7126,16,7,8881,1553,7328
a3e9755c49ba36882a4cdb30b237925c,101,76,261613,52934,208679,138,114,298795,60578,238217
d383a1b73f22b1f88661506103d1ad28,31,22,8658,3834,4824,26,26,8348,5429,2919
279037ec318026190faed9c04510cb08,103,86,201195,47481,153714,130,88,276358,37717,238641
854a5f2de20eda094ca030750c3227ce,47,39,82623,25095,57528,50,48,73727,31732,41995
839b93ce45b29ba974f7a514eeae6fdf,47,35,46737,17428,29309,60,50,52760,19722,33038
b458533bf651b78a82df23020567b02d,41,29,31164,11015,20149,38,31,31183,12162,19021
4812dc6b2c1b843cfb26d8ccca75e3f3,174,133,428643,120354,308289,124,98,538967,70489,468478
44b39da92370301fe4778b773dde2f90,69,64,136565,39560,97005,60,45,101478,39426,62052
abddf3edd5aabb1114dcfdf9a9fd208f,88,58,124028,25146,98882,93,65,96443,40725,55718
362d4127aa4c6a187825e9b1b8b1314d,203,152,603176,160381,442795,191,131,701336,162611,538725
80075e16c8646647dacb9453e090e421,37,32,27881,8745,19136,32,31,21132,11584,9548
9663befb3126614a519da4c29ebfd121,128,107,565352,133054,432298,117,104,416902,124365,292537
a2634b94eb04ee73d1946088ffa711f1,86,70,142380,42278,100102,76,60,122618,43914,78704
ba24597e56fa6e4b9db0328e5bbc08cf,130,106,341279,65790,275489,152,129,355919,81689,274230
92a099a90b25a0bdcc4ac2bb8811b79f,163,125,507585,143691,363894,131,91,378594,110923,267671
ac4c63f11c9a59af2cb54001d25d18a1,99,66,210441,50960,159481,148,121,325831,63027,262804
7d7e90529d277c609266e8fcfc91bb5f,163,133,534890,97139,437751,115,86,307571,103183,204388
a52b16014ad43e8353f285aced6385f4,85,76,122440,39936,82504,72,56,108171,27043,81128
8713283449d8fa345a42617734af28f1,91,63,109198,27902,81296,82,64,104728,26842,77886
1bc4baa7f0864395298db819a203c865,130,102,454392,82295,372097,155,139,539872,103642,436230
9fac12ba6f629babe09b0b6b2667de57,181,118,346484,113028,233456,151,112,377201,98911,278290
5ee87d4baea9394c42dd8d55a40bdbb3,54,46,42941,13997,28944,52,38,42181,14143,28038
2549437466db071c461d652ecb20eb2c,171,107,1175346,152159,1023187,224,168,836032,190951,645081
767393fb9a3464261d107a6437842769,34,31,29111,15352,13759,43,31,52033,11311,40722
a9f97a892972dc10b8dffb4d808e67e1,125,93,274767,54810,219957,132,119,330458,61088,269370
1ad4b1384f217d83924b8474555c5ef9,114,102,225573,52742,172831,109,78,194624,40297,154327
e998f6699fe7fbb96d927ccd9ad59eff,108,80,245175,75678,169497,136,90,263651,72274,191377
552e43c7cb0ad23ac5ec6b198752e2fd,19,16,8454,2858,5596,20,16,4788,3592,1196
98518854b3be5aa25f746adfba86a24d,68,59,76430,30466,45964,53,46,78764,32598,46166
a8e4a409e67b62b3083c7de1eb1639d0,42,23,28696,7081,21615,40,36,25450,9426,16024
019163a00e91aeace40225e49013a995,82,68,174758,42094,132664,86,65,160335,36750,123585
65b25f7e86c5ab8b3ddc846b32076449,81,60,165673,42637,123036,113,93,251633,66000,185633
919291dd34c7a854aa5375021d970220,128,94,241263,56930,184333,122,97,299896,53824,246072
7a8a2c12b6bedead99b7ba318676b420,94,72,127874,35737,92137,96,66,189199,26669,162530
8695ef0f6dcd6183d62c488d510e223c,42,19,40841,6648,34193,33,28,23837,11899,11938
1e45081e96020c6b41f0d759a5a85494,98,70,199287,35341,163946,98,72,152820,35220,117600
e71dd42d9065d9c50221492bcf370c85,154,109,314061,71792,242269,141,116,346348,74352,271996
b4222ddfc5bc0427c489c2cea6817255,169,122,403700,86536,317164,136,91,352892,79008,273884
84c7163d5f4b27e3c834bdbc9da3f887,110,65,162558,39441,123117,97,83,224205,39745,184460
ada44aab7f812d2f040f3e93e17b1cb0,111,96,218376,47361,171015,111,88,198782,50837,147945
59695b5fbe69fbe7f64e88c0c58f99f8,25,22,6091,3136,2955,24,23,7260,3460,3800
03231e77b6f878ce2b557e5ab6889eea,128,99,284249,63665,220584,151,133,412434,67845,344589
32543f6901b47213b9ffdf4037da15a8,232,172,797133,145442,651691,166,125,650236,135193,515043
31217b63471e98e7d985cdd621ad8189,146,94,317503,58438,259065,97,70,236587,54628,181959
09c6e1d6f6997fd88e333659a921d05c,173,153,691970,156467,535503,202,150,690393,195759,494634
ddbf921fc86aec89848ad213c21b3eba,132,114,363067,67040,296027,117,98,279220,86917,192303
9cebcc8d28928ad5f61f082093132078,168,131,602316,87375,514941,147,117,476073,114592,361481
612cb3fd521a67a246508480c3ceb98a,97,78,283785,63113,220672,103,78,216681,74222,142459
d76f45cd1c3e8c6a505b2afcaadc89f3,65,41,121315,16962,104353,87,61,149664,23849,125815
1ff80ae3bc51fb975bbbc537b81f7fd4,70,56,101322,29401,71921,67,49,88150,29593,58557
7a9a4b9cf808a03ea99529b9d3f1e46e,131,115,375959,104395,271564,175,140,484387,96459,387928
427d56cb2d61e52206010a2c7a4b1ab9,46,34,63268,24697,38571,60,42,75360,22750,52610
e9fb2ed0904bf0ca058e28a4103efdf0,129,105,376346,102748,273598,159,123,488685,85431,403254
2fe69f818e1ee788b2a77a5e04d0cfb2,65,52,110058,28998,81060,57,49,71196,25775,45421
941f894e4099f77d901fc3f60a334e8a,98,76,182419,58233,124186,112,90,254214,59279,194935
532f33219f620c5a1c33d8e8e82e8b21,25,22,12909,5389,7520,22,18,11871,4053,7818
cb8a3f9fbdf9234191d8b6a657dc6e82,187,132,804951,178775,626176,211,157,993722,176981,816741
a67770c7587808e145bf7a4fd1f3ebc7,97,81,166260,62504,103756,123,79,229646,43784,185862
590832ad014e184634b91ba29722cf55,170,109,368548,65128,303420,118,83,247565,63981,183584
8b09b974a2139d681bbf04d0c6b1691f,30,22,17334,4138,13196,33,26,18583,4562,14021
83cee1ec54c46b0d46fb6034f72fc071,93,76,189497,77473,112024,127,90,267788,62726,205062
59cce49f9c9aaa004fcdc4fca23e8a75,13,10,2922,1815,1107,15,8,4155,697,3458
3ef8c798232eae195c04f8ff589b2542,188,155,706441,99070,607371,169,139,642833,86030,556803
81e186b5d66c653a7285dedf8f5b27a3,65,36,75269,16324,58945,56,52,57059,27067,29992
f3b69607f8421ccafaa13c35658e5185,54,43,64153,22750,41403,47,34,71092,19291,51801
8dad2f0c07c4386d7e53527a632570f0,108,79,218111,76228,141883,143,126,404076,91134,312942
6413f29e0288cb1d087fa204aeff13e5,25,19,17932,5249,12683,32,26,12271,6281,5990
9c080c22628b7561c40accd73941f471,81,73,158893,51293,107600,93,62,242924,41923,201001
5d4f4f8892d1d98e9f3bb726ec743164,36,29,31228,12028,19200,34,31,36541,11149,25392
cfc4f1321fbb9b3131e644630547339b,25,19,8635,3391,5244,25,22,6838,3827,3011
d2bbbaf2b4ff972bec92b5a8ef7a0877,85,67,151836,20697,131139,84,60,98104,24570,73534
0b80802958c6d22c120da9b92c57f3f6,45,25,62289,16141,46148,47,41,67187,16946,50241
3d09a3f34b9e9423aa87c0e402f7d482,115,105,263970,58925,205045,105,93,266179,43609,222570
145ec8608bba6a5af69ae3b3015f5b7f,74,66,153451,47637,105814,111,80,161550,52816,108734
eaf5d29ab213f97073899b90752e520f,69,57,96776,20221,76555,45,42,65325,26735,38590
4230a80cc02f5695d79862ba07e10a2d,111,78,276832,52355,224477,123,87,267537,51228,216309
c6731d71b549fd640b5ec444e1ebe238,110,69,200223,71785,128438,100,88,243213,71335,171878
bb276b32977ae66cdeab34d9b0e881a5,33,30,30042,11649,18393,39,28,29465,11917,17548
ed162e903c252f559f89101e259dcdcb,52,33,35135,16346,18789,44,34,38769,10637,28132
c9ecb8c7ff227da81b011a6014505226,46,44,98256,27314,70942,47,42,92953,32212,60741
625e1a4c032992218dd2b7d7154263d9,219,110,620892,86830,534062,176,127,561169,139974,421195
3d34fac1b03b613430609a0001f15c39,79,78,120088,62819,57269,87,69,171985,49188,122797
2b5d425c70df918388b1b5bc93b69b0a,174,133,848572,252387,596185,185,153,669048,213382,455666
0751c04c30e6c34a98146dd08dac720d,30,28,22163,5147,17016,39,26,15473,6672,8801
5414d12f85a2ba879ef2a9731d8481a1,30,20,12512,6336,6176,32,27,19360,3864,15496
59e82b36a498ddce3a5acba5f2919062,11,6,2033,781,1252,10,10,1295,1689,-394
458f83a861be13d4a86e5ec2d216844b,123,103,290341,55287,235054,136,105,321478,57548,263930
56ec6d3e78ee2cc2a8d926a50cdeef2b,39,34,37144,22784,14360,48,33,58346,19569,38777
029942b1fb888c0f6f991b7980ce3481,148,99,335636,89237,246399,153,124,384519,80867,303652
8e668a2e3f1c1fcc223c86e5f887b12b,178,117,479687,68859,410828,135,110,536380,74082,462298
96634002da4b2d50d30ac49c068d27bf,79,67,137216,23494,113722,56,44,77104,32204,44900
f2ff9c985944653c754980c6fa81a090,27,21,9136,3743,5393,28,21,14097,3644,10453
f6bedbbbafda7df41d413fb21f7ae8ea,69,53,78037,28599,49438,54,48,57369,29540,27829
ab4ba033b5b112507d16ef22fed5f37b,45,40,48231,21738,26493,45,40,57673,18411,39262
411eee1196c65f88fc253e59a61cdc71,149,81,271089,58097,212992,167,89,242006,64500,177506
b1166aa998afd4f9cf83e6f2635ec0be,163,123,420161,119327,300834,138,100,406717,109958,296759
e644e8cd2b1aff8e84a4d08e6576265c,20,17,12592,5120,7472,30,19,12808,4228,8580
0dcdf8f390cf1f0095e2095f0feaa723,57,41,53775,10876,42899,41,30,36904,12105,24799
5e1b8879958e4f64c0c131c99f4a5703,166,138,621368,148878,472490,197,151,737458,124446,613012
15e566c94ec4a6f7db356f8ab60c6b48,161,114,405284,71155,334129,123,92,308754,66472,242282
ae02722a4b4b60809a9e85b58b4b36c4,167,127,397839,79059,318780,155,130,328702,101680,227022
be704ef4890636f3007528ae715112b2,63,52,71500,44733,26767,60,52,110601,41303,69298
d1a86841b5d105350505e4c0507f6c4e,121,95,297632,90216,207416,115,90,276626,99700,176926
278704fec6c7cceecbdecbc994b1d74a,186,142,963450,313816,649634,218,160,1073796,239004,834792
1a359b8073aaa5fdf918212c1e5ab608,16,11,2070,1127,943,15,13,1933,694,1239
e99770ec500bd775514b261ccf99284b,105,83,312681,91236,221445,143,101,417656,104761,312895
7fb9b166d5fbd5dbed61c63003c8999f,198,135,758594,160373,598221,208,168,832342,134995,697347
bc21e8c8133919d1f301db4bf4011006,49,42,88345,31281,57064,53,37,97079,22025,75054
4f27f96136a57e27412a0805038bd58a,53,36,74381,18920,55461,75,70,109177,27277,81900
4a3bd8287989618304c243e63a861342,186,141,615240,104562,510678,209,134,475649,128014,347635
158ea370bf0dd093f58da5613e4f8909,203,152,655163,124251,530912,116,80,495431,130203,365228
f5b3b8620167faeb0e884d3b9d32d129,37,25,32367,10429,21938,35,24,23637,8624,15013
2b5a18342b965557bc7ec688b7f7f707,74,60,133017,37002,96015,90,78,204202,38449,165753
a21483d0b89a248e8f698d832e880dc0,81,58,142344,44171,98173,72,62,133811,41170,92641
16fe2fa89f6abca991f7bcf5a74a9150,199,131,477636,110901,366735,179,99,404204,95127,309077
9cff8a5036f95316b30e934364ebfab2,79,50,100767,35789,64978,84,60,128229,38637,89592
6b5d53b23021b2ba0e27dcf53ab0a227,99,76,251809,51495,200314,104,82,267886,57160,210726
38d91f3162742d4debc844c4e5b16d01,86,43,144743,37756,106987,85,63,167683,38603,129080
f20a9fcb451be82374775e9599d6b8bf,2,2,453,456,-3,3,3,556,553,3
aa9d66081aecb26f53284489c22ace99,150,102,491441,90556,400885,129,94,388902,118561,270341
393b6804f8e9f4a7174ff4cd9c7418a1,209,162,925263,188464,736799,208,134,822065,123780,698285
7674fd9457e4ed448a4cbc179fc95c7e,32,33,26990,12470,14520,37,24,25956,9540,16416
75df17c0eeb94c48792fceb27ceb37b2,145,106,214209,41594,172615,91,75,132706,39692,93014
bf9c4fc96715c8e10d345ab94556accd,105,91,200186,38032,162154,70,56,139909,42282,97627
80830d9d185f7a29050713b645049730,126,80,248375,70286,178089,115,83,231807,60381,171426
e09be15af5d35dc3089bd24fb61662f5,164,142,540084,135046,405038,162,128,572676,114492,458184
935451773793dfe455e32d09b1cb3ebb,54,45,47211,13921,33290,52,42,39237,14136,25101
3b86264001f0e2e9a1ee95b832069fa1,102,87,213877,54984,158893,98,77,198634,44920,153714
884de062e1a02137e3cc87087a8c47be,130,103,304442,71442,233000,112,87,273264,61745,211519
327409037dc188a9fee75f9bd43e8942,159,130,544789,168347,376442,172,132,642725,133193,509532
966e4816509e314769a6fc8992ede85a,89,72,177443,39084,138359,119,94,247948,36373,211575
8205fce811ec874762ccef2d295df8f4,97,69,146405,32595,113810,92,77,133004,45036,87968
939a404bcbad5532c847a7afd2d48c5d,20,18,4836,3042,1794,25,18,7336,2752,4584
faaadaaf828ed2f5247f1a4c50ff52a1,141,99,243344,30683,212661,106,97,208823,53674,155149
23017d83753191821e4b42505fce5668,99,75,140170,33293,106877,91,76,178569,28082,150487
a9360649afe09d71ad6c6d779b0c71d3,16,8,3138,915,2223,9,7,1318,1272,46
f6df069a4f1c6f95639bbc1f13b71e19,92,69,144509,28985,115524,83,65,95898,38949,56949
4916a2f6f2606f8d3afa42af1090e4ec,91,79,154466,42612,111854,85,74,147282,42398,104884
47f52049311f1e576769e19430dbc59a,97,70,202478,34676,167802,96,94,163307,47441,115866
96a5f4ca1196e2d1f8732d865cd38efc,29,22,18352,7541,10811,40,30,26906,8537,18369
bd33aea7a48d7f4a87accd024d837646,164,137,458979,90305,368674,118,91,314821,74515,240306
8f7e47fb1c67c01973a64f9bd3e36068,45,30,42848,10015,32833,50,47,38622,16048,22574
f849d3234e3e1c950c4323f84cf0d363,48,46,59346,26918,32428,64,57,87418,24698,62720
2017e88c09ce37f4c6b840e2e1489462,78,66,133618,38800,94818,66,56,100945,35119,65826
365d40d5ffa3646789fd1ec9890c0efa,18,14,4677,1695,2982,16,14,5074,1892,3182
c6dccda01ba6537aaa1dfdb18f16a5a8,17,16,3263,2551,712,14,17,2553,2981,-428
35f84d8afd1074e29eba3173035502e9,145,93,275681,49159,226522,94,63,180754,55551,125203
fa0cb3f9ac93b32d34ba78a586ef1588,46,36,45047,10492,34555,47,35,29662,15380,14282
ca5432429307931e4469405904e06d92,95,69,165808,35736,130072,97,69,146074,46139,99935
095eb258cd732614104948e02d28cd5e,135,98,372456,116925,255531,187,158,538398,104844,433554
113c60fd078a973899ed46f5fb37e51a,178,132,544907,57463,487444,135,105,362740,79603,283137
e05b8d21a49a73e6e2f4d993dd8582d7,100,59,187464,55990,131474,87,64,180201,55462,124739
97c49f7230aba6f4b09c5ab706cedad1,148,111,410453,70194,340259,192,143,485314,78324,406990
f0060bf0964ec830148f113881276fcd,143,113,577314,99012,478302,140,107,439571,94014,345557
39f13aab4917e9e92050848a33465099,102,78,158409,40080,118329,100,82,159187,49099,110088
b81e2647dd392d41665ae7fe92354033,182,133,440526,68876,371650,122,93,248179,76567,171612
0fc75058355eac9350708d3323f7145f,123,91,234364,43542,190822,98,79,167397,67531,99866
1cc733931bcf65279772cad992fc175f,97,91,209722,61021,148701,98,67,165862,50550,115312
ef4b9cb227fc7bafeba5add50bf03707,79,63,123393,34832,88561,74,47,104358,27651,76707
09b813f233c46b8a033c0649ce3c18bd,43,31,36712,14348,22364,62,51,60053,13690,46363
0d58d73c51b9961ea0fbfb3e2c6889ba,44,28,47088,15092,31996,39,26,40345,12562,27783
7e81ef8334a2c1c7cce9674f9263aac2,33,24,17616,7523,10093,26,25,14885,6392,8493
eb40f0d55b2fe921f4df378d5e10d724,77,58,128511,19086,109425,90,61,115020,26046,88974
16921203c6f6a660fbebf325bf7ca51f,25,21,13408,5113,8295,33,22,16467,6216,10251
5b3da9dc7ea2470f209b0798128f91ab,39,35,28265,13728,14537,51,34,45310,13340,31970
7791d8447975b04e076cc5323dc4892a,143,109,445796,182507,263289,177,117,587138,129165,457973
444dc8645581af7cba6cc15ec7b12f5d,33,26,17246,5926,11320,29,24,18093,7122,10971
6ddaf2c068386e41254ff010cfa5d64c,135,104,358568,66169,292399,111,95,252691,86052,166639
ce39c1fa7db3d1a19231a280f53555bf,181,152,680886,184013,496873,206,138,881405,134666,746739
801d2c939939c4b37d8cfcc8f9ff00de,36,28,26323,8318,18005,44,32,27780,9603,18177
3f580f1d7b24337f3f9e4ac4e18f1a34,102,76,208667,34261,174406,90,74,156631,34547,122084
ce1c21d8adc580da3402f1129af5b491,156,126,444321,81968,362353,171,101,418888,72404,346484
e7b6aee545a925291fa364eb6eb85f62,101,73,263114,70132,192982,149,112,465076,82822,382254
1b89a36fca0efce2396c5d45e44cc371,117,93,252680,62467,190213,131,108,290447,45657,244790
edb85c2b6eed7fabdcaa3615ab63e19c,3,5,536,525,11,5,3,525,536,-11
25ef3031e05b58046224891daba7e2fe,138,111,364568,66909,297659,124,103,381817,53595,328222
274886da51e62448e6ba76a76b44e509,164,121,571676,131405,440271,222,139,528391,125956,402435
db24590569841f7ef0434aa7b48062ea,43,38,52097,18717,33380,44,33,44043,15869,28174
f2b1739262bcaa0e514406b3a983e95c,166,136,757850,127916,629934,166,152,822324,124153,698171
ba3f6443835befddb820f5a49027d2ae,78,63,89229,24485,64744,72,43,104654,18135,86519
21df3b2459f95046304201a34d57d082,115,91,230561,76496,154065,133,103,303619,65383,238236
3e7f8c25b435d0352ee63466ecee743e,42,33,40827,20548,20279,48,29,42280,19252,23028
2cec497f5e724358b6094277aabf61a0,87,55,124792,36877,87915,97,75,126924,35313,91611
ab8dba998dfff8aab8fcd14fca3c587b,109,66,191940,42789,149151,105,84,176581,49072,127509
8f0b0b4b56e303df4e014fcc7ed17da8,139,116,474468,85635,388833,155,114,599432,100464,498968
15368b5d1cd06e5ad966908c99efe48b,39,26,27587,10553,17034,41,31,29783,8675,21108
17f6f632ae7ca16bb213b0015e304900,84,54,108801,33134,75667,63,50,130597,38056,92541
0911b3114d78ca7cb49a43b89adb19ce,74,52,78392,22124,56268,71,70,109634,18676,90958
41f858e2026af0225153db74f68cdb56,63,51,97235,26647,70588,71,52,85046,26384,58662
7568f9c3913e2039fcf68899acc1cb8b,13,15,2228,2384,-156,23,15,4891,1684,3207
f98bc9c968864479a044207fe78eac78,76,72,143244,40572,102672,66,34,119555,22909,96646
46e471eea342dc2c9c6ca23d69af2280,178,118,306071,99867,206204,149,100,388949,74223,314726
cf3ae6ed4fe7407118ffda18a26afc12,84,72,109205,29318,79887,59,51,99735,20802,78933
0bd83e94a90800701f0ecba850e09e7c,90,76,175046,55744,119302,83,77,196944,33751,163193
66b8207a2f4129d1e9e2cd3b8c08f1e2,67,49,65461,21709,43752,77,65,109310,24693,84617
d84bbd5636e2550915e2345f2692993b,17,11,3288,871,2417,20,17,2321,1351,970
ad0b9c4b047cd11c48a3e2dd6ea5843e,10,10,1851,1047,804,11,9,1959,1318,641
a9d7eb8910450f3f6b1a3b54f3731a8b,123,102,262928,67656,195272,144,107,320800,58539,262261
38fa5ea39b7de03a5ef1e2840df35312,106,86,225083,47371,177712,106,85,229314,33423,195891
54ffe9decae1bb70466bd4d4c516395e,174,122,426632,127994,298638,160,131,516557,112049,404508
2f1f829f1b3c94bbef671d9d970afcde,67,54,88795,26524,62271,62,58,97560,29671,67889
31249f6bca2ccb3250a3ca1ac932be6a,98,67,200081,35564,164517,66,42,94073,29325,64748
46b33d1a57bfdedf5daabf812ca97387,94,69,143981,52005,91976,90,63,143533,40761,102772
d2a680837cc160b15e3421f265c6c904,205,143,610407,156561,453846,168,112,1079763,136958,942805
c6903907dc364c11a7b52e7a702743a9,130,112,347425,73244,274181,127,107,459121,78975,380146
925800c2010aacec9542d70a185c5f4b,79,59,147243,33765,113478,99,81,167894,40028,127866
9792614bfde7acae9417326e8b95a934,97,60,166877,34155,132722,88,69,169926,36435,133491
ec4e2a08cf6db19ed557847dfe8df9f3,89,71,195637,70033,125604,121,97,284248,66077,218171
39a5c0d97c3c68d8f960ce86d0069616,35,23,26823,10551,16272,39,28,24629,9790,14839
c0b2038be3c90945223520dd1f20dbd3,116,69,182473,46239,136234,106,78,163851,47780,116071
004802e5ec172f6d37c799a0db3732b8,121,78,267999,79105,188894,163,137,360676,111878,248798
5e3731fa3e2d013e957065fd905548d2,25,20,7382,4646,2736,24,19,6669,3137,3532
b6c00da985fc19a33d692cc7ee840f62,114,85,217997,35361,182636,124,111,231797,68791,163006
e0efdcdbb832c9a355692a0862632d5a,173,143,747140,202326,544814,199,142,709954,144110,565844
b26456d8a32ae944153bb54bdab2e907,66,56,76224,13856,62368,75,59,79075,17177,61898
15b7a95234763bc61fb948db2d2ddffa,0,1,0,101,-101,1,0,101,0,101
a22b0731b516c33e7ebd03111182e1ab,99,80,224942,48372,176570,144,104,323950,55540,268410
bb9f7656e0bf0de8414f9a2f78673e6c,82,65,152871,30464,122407,72,57,114729,30933,83796
140f3f0fead5c2f44c0d329c8bed22fc,110,88,169645,48990,120655,115,82,211544,28564,182980
79ee9107b3ad99253c39c7d76bd8b394,106,76,226680,83442,143238,95,79,225055,71241,153814
2fb739a16fdd884e9430954cf70b777d,77,57,193159,36925,156234,109,73,195346,38107,157239
55e48206cd9250c29a855dac47d94905,187,135,711133,113220,597913,187,148,665199,94061,571138
0f52f7a5cb732fddbabc535dfe22594b,82,68,182250,44205,138045,98,75,187859,39854,148005
e8e34e3993075860a97295561f526a7e,175,127,495466,99558,395908,148,109,414861,88423,326438
28b2bda641400537a1911cfbfffc07fc,45,38,75587,17391,58196,74,53,95788,28642,67146
162939af31e8e62725a5bda2b929dafd,62,47,87237,23962,63275,83,49,106483,25344,81139
cacc96a02facc3743f8ed95751e192ca,236,169,1330182,268022,1062160,237,135,1160536,262346,898190
deba8ad59fee9d750ebf2654e6e4a7ee,185,126,601846,129305,472541,154,135,552914,146961,405953
29b4624d222d3c47bbb230847a39f462,55,43,52875,17549,35326,49,37,51198,21417,29781
cf5ca0402c7ffb149e805b39392ce36f,167,134,352848,84800,268048,110,93,349008,71206,277802
198a361b1b4bb250731394030d4bfbdd,53,33,50296,10707,39589,42,32,42036,12114,29922
c089bb9ff76b8b43fbb3975224f7cffb,41,39,66866,19781,47085,44,35,54691,16123,38568
79fc18663fb61fc99247110b86262b07,64,43,89344,19163,70181,44,32,41671,15306,26365
04ef843896a1fce076a0810a8694db23,158,116,398534,60699,337835,112,83,262646,75512,187134
23b4e35acbedd3c639db8ed1a3d0407f,161,95,560615,105331,455284,113,88,335443,100213,235230
cff803362f795c7b35d43551d8323ae9,84,61,128606,39416,89190,83,69,137998,34843,103155
db833e5d872c8b05afdd6c348f689b48,97,80,188787,58851,129936,97,83,175594,45267,130327
ec40c9fd94e402fd4d14720e0a9836f1,99,84,153538,43901,109637,107,90,205543,42774,162769
a2e850613cd428c0c9b41c90669452fb,123,88,366809,89281,277528,125,105,368473,93186,275287
bf3c06d76dc87eef175c3f8a35c38d13,27,23,16857,8031,8826,29,20,18770,6293,12477
4e392e0c6682ee4de638c50276f8b18c,92,71,210679,80759,129920,131,88,280595,71380,209215
be497765e10cd07e337a6f72b01519a3,79,65,156606,27035,129571,82,62,102031,35630,66401
b8cc827bdafcc2856be5b5e6c6f0e62f,45,39,57034,21235,35799,53,41,92610,18482,74128
ed7dbf650f63084a5ac4741ce9602c05,47,39,58753,16825,41928,35,25,42259,15459,26800
0f5c1ef547010ac8b65d21d8d8fac95f,38,29,47747,24311,23436,43,39,66204,20790,45414
d1dfb163e99e097f2eafd2515f5f0224,77,68,120369,33684,86685,73,61,94098,43868,50230
af88891ff3969e531c8f02be7dd3eb77,57,37,54156,17622,36534,63,57,84924,17934,66990
dce1ee89e2c753562a07d974935ed223,139,115,453180,82945,370235,171,142,441569,95312,346257
3e8a5813ecdf8fedf456ee2e4b736971,204,171,1042918,250985,791933,213,170,1031033,147636,883397
c3c01e9e2a5a5dc3b2a6d23d81b743f2,38,31,21370,8918,12452,40,27,25855,9813,16042
852a6c6e072c4c5cadf08bcc7e4a4c63,21,18,2547,2397,150,17,18,5274,1435,3839
d1c16aaa813742b1077e3c9c9bb18c2f,96,74,194305,40067,154238,85,64,133278,26839,106439
ad8148eaa6f45bd4a7c3e24fb6618b89,138,117,512951,121119,391832,199,145,637955,112092,525863
025bb7dd7bbc1b5b07a64b57172d5e56,169,108,482128,84808,397320,128,104,314650,113070,201580
434295c38c44f01f3505c2ddc73691fd,66,54,64240,24421,39819,53,34,59681,13074,46607
2c1a25266a6e6affff02d62b5d104947,0,0,0,0,0,0,0,0,0,0
63b85cec33df057374545329a12e017d,39,28,36152,9321,26831,44,29,41609,15139,26470
5e14e2f2a7d8b60a8dcf7728d1f2b60b,140,111,341716,81489,260227,93,70,225478,78152,147326
c6c590a5a5f0454acfbbf4e926336b54,18,14,8319,2495,5824,23,15,6855,2567,4288
ef1fece0d8ff1989a2ae92ab6bda1882,108,70,133349,32300,101049,60,41,104102,29859,74243
5d927e68bbc71b4ee4884ee786812f22,186,135,858370,192538,665832,204,151,1001421,183656,817765
ca5e4d8346cf12f7850e982b78f55138,160,132,471646,86948,384698,124,104,370181,93410,276771
83eb31521115ddcdcafabbabc7d715f2,74,63,124562,36769,87793,55,51,94483,41948,52535
50de287d16b3cfbd5466cee5ebbc6cf1,135,100,284951,106999,177952,87,69,238638,102068,136570
d8229e39e32c67b07610c24ed74310b6,170,93,543625,68765,474860,123,99,311267,71861,239406
78a4ea09faf0b11c288a5d26c2f9b6a0,94,74,210038,43220,166818,118,88,254435,58931,195504
dcbcf55f706b3814facf0df5a3322234,10,9,2449,1943,506,10,11,2308,2013,295
db1e07b8d47337ab8d56dbd1367d2f54,154,100,686568,192765,493803,171,108,536856,175308,361548
180ad779efd912a96d4ec4272b275aaf,178,132,704401,158763,545638,223,146,722961,120400,602561
9b5e7fd13c2cf237013751a357154c4c,116,89,183841,62987,120854,93,72,185129,40641,144488
fb2230522fe13ebb40077f07b63f6459,104,83,295742,53580,242162,105,71,236585,64428,172157
e5f89d8de9f4b1a1747689dc2dda1361,153,133,505525,80603,424922,136,104,371930,98141,273789
e9149e271a489e9c1b882738fa16f837,35,30,27402,12194,15208,37,27,28780,11863,16917
9c3b50df702b35e562650c47125a1471,41,28,39662,12881,26781,38,26,29617,13341,16276
02a7e40cb917c10b65d2728d96595758,55,50,136174,53205,82969,69,67,175823,71177,104646
a92c4a28f7b4688f285dff80dcd143f1,124,99,220100,48943,171157,72,55,121210,49950,71260
1b4f9aeef84ead3877933c70ddce780e,54,48,54687,22064,32623,50,37,45835,16665,29170
df8a107494dee59952404907bd0138b2,27,18,7645,3746,3899,27,25,9919,5010,4909
c7ecbf02645d7b9275d8c195a2530c64,44,33,65341,18646,46695,56,34,46468,20153,26315
c90447d0940ce19669e7802478dc99a1,21,22,6951,4435,2516,25,18,10424,4007,6417
342deb4d1a19d80c5adf896ffaebcd43,16,15,3897,3208,689,16,14,4897,2061,2836
5d5fcda6ecce93edd3e83245a0e51f27,166,112,929499,177342,752157,192,125,1066571,151861,914710
f70ebe502d78a58b6fe7513fe14fa65b,147,98,370109,84568,285541,161,113,368293,122602,245691
0908b33393b5a17c72811c9220b9829a,62,46,54591,21185,33406,58,45,53748,22297,31451
e6e455d677a62de1ca7d60b8c4f8409e,103,74,206580,52306,154274,149,129,413610,69981,343629
4ff0c77fb6b82a73658d1f125df2359b,72,61,86630,37025,49605,54,49,79026,30880,48146
2250967ef92214992e8ad58229d72db6,43,37,71004,22117,48887,43,35,62325,19698,42627
25c0122b0a17751538602d1d63310611,86,74,147324,42203,105121,67,45,108324,24331,83993
f65ef5da42967e41f8b4fe309fe69108,31,21,32809,11939,20870,39,32,45868,11503,34365
d4d0fd7b19540992cbd61385f601f426,63,44,125391,33914,91477,56,44,104581,36483,68098
e72e75f2c6f8b2e486ad4dc68319f0f9,85,78,123574,36785,86789,81,63,143099,30259,112840
f563e859d0e7d411ad8eb51e81a20ba1,118,71,182530,54680,127850,105,71,206997,41158,165839
0b4e06b9cc279d826ca37c0272af3151,25,22,22360,9032,13328,31,21,26731,7231,19500
35616a15b9963ecf7444674faa7185eb,103,83,186048,56044,130004,135,95,231189,32974,198215
ebbe123ed3ef4a9acde70b2326a9acfa,54,51,77663,20027,57636,44,34,65327,20151,45176
a8e7abfc918d78e2cd06ad214b56eed9,94,51,163328,37403,125925,106,79,254794,42652,212142
d66f194d3fa821a92603ea9ceda08537,51,38,55145,17231,37914,37,28,43880,10221,33659
e0b892ec023aa7e5bf23881a96d33259,116,93,315082,81131,233951,139,114,395300,114402,280898
fd79c87cf4057c2905c2093d3d85db9c,34,31,50339,21104,29235,55,40,51664,14774,36890
648bc3ee35dadcdf73c79306a9df6791,44,29,32908,8544,24364,42,40,31851,9016,22835
483fcf0d5bb6890a2f3c638a47fb2eb4,158,114,432388,101529,330859,193,130,548609,68402,480207
3c64bda7b1ceae710b23f85ea25de04c,42,30,46362,12765,33597,39,28,39146,11314,27832
67099d3fe96dd2f5690f3dde071e5418,22,18,6136,3703,2433,22,15,8363,3222,5141
3eaf4e793782e8d1e3520206838d2bc5,75,49,114830,20702,94128,69,50,71257,32750,38507
1dc725f6aaf5cfb73de12a8b1097237c,30,14,11891,4004,7887,20,21,10046,5705,4341
033441e7fb2c4cad5e366cc923f7d8fd,38,31,41866,15562,26304,40,31,33125,13434,19691
34d736b0ab5be165901cfc566e494b6e,28,19,16469,4066,12403,27,23,14570,4741,9829
dfe86f8f9c9dab3025065ee9896fd0d1,37,25,17160,5325,11835,27,20,17830,5175,12655
e3ff536ff3390eb5903d6d2a169f6213,234,164,741743,204714,537029,174,101,997019,190404,806615
ebc2ef2f20dd2af54281bbd0017b0e18,100,77,171183,46942,124241,105,84,167581,42820,124761
5b3880ab915b162b47fb94496314916e,126,99,299591,69414,230177,124,102,384813,69443,315370
c36f9e281a4922abadba04412a70a81c,95,55,109674,28699,80975,62,43,81080,25224,55856
de1f9f5a0476a13114c0e4f9d590712d,143,99,307055,110809,196246,147,120,351626,123554,228072
65be4202c824b2515bb39e36c8ae33d5,125,100,270884,68618,202266,123,105,327729,68454,259275
ead13949eab0b9b68629e45544b814f0,149,103,468802,82464,386338,167,107,469594,69087,400507
f7412f8becfa7329066fb9c3d4e084b3,110,86,233911,43616,190295,124,87,191522,44760,146762
71bbb6162ede25b1b15b027ef07e4608,71,57,154583,42221,112362,97,92,189492,33282,156210
74f439a18363c4b51a664b8b70f2286a,91,84,165999,71616,94383,125,81,227799,40129,187670
4c9f97de6f81b12e5aba735db47cdc47,93,67,197906,49153,148753,99,90,186096,63734,122362
a93341efaf7994851c55e00c39b5cb0b,62,46,107267,30021,77246,62,43,74341,32336,42005
5cdaf0659e016030c8edbfc200e16011,196,125,458555,129074,329481,155,132,502908,102330,400578
4960f3692782f83089a62e00a4c81829,111,73,264754,82134,182620,133,116,434241,70571,363670
77e500a42b2b3446854f1318f183eb2f,132,114,407817,81923,325894,146,110,437196,108415,328781
fd078f3b85edaa924f426efccaff8cca,158,103,388591,97436,291155,115,93,287150,129410,157740
f28bb170b3c7c4243bfe07c8b58d65d3,117,95,283855,112308,171547,184,106,416165,92976,323189
4a52fe3517f96857850735e3f0f85042,166,108,481312,89602,391710,176,147,458915,118431,340484
9eb1752323c5eca883eb358c31bc7ebc,87,69,270788,67166,203622,111,79,208368,60600,147768
fff9ad8d5da1c205f808e5ec938e0caa,131,113,373446,73244,300202,111,83,347074,66278,280796
d9ea512dcf77de17fcc1415b0b93d83c,134,99,274503,73121,201382,151,127,388989,68284,320705
118a0c9d138722c94c8dafc3b2c8f648,92,77,170242,43885,126357,69,51,115575,47246,68329
3ba983de9404beb719f05cbba6c3bfee,65,60,114629,47626,67003,103,86,254451,50601,203850
e9471d1af41ca30c468033b38f9b226f,146,112,461630,78764,382866,139,114,377713,77283,300430
433b0a6b50bc166dc6b1e829078ec24e,160,115,623962,125184,498778,170,118,737315,107535,629780
06111837877e36b42aa5d51c770cca38,50,36,44110,11043,33067,54,43,38706,13570,25136
c73b7960acf09dd97a17e75e3f83f1a6,144,112,329480,86864,242616,126,101,285453,78085,207368
9db0d51e33a5a26053b1b2fa6972db8a,127,98,239722,46277,193445,59,42,80925,39682,41243
988a685dc0aa8461b423f176c4d948b2,102,75,227671,65376,162295,126,79,258193,62097,196096
e9cebd2012413164099aeaada1d68b58,105,59,138149,24032,114117,95,70,138901,29021,109880
fbf5da0bbce7cc965eae30b834f21503,2,1,203,90,113,1,2,90,203,-113
f5be1cface2ade55f9df3a0412eedea8,72,61,82361,19086,63275,49,43,48202,23798,24404
8b45dd01c5b0f6a41a94bd8665047eea,173,125,496076,71578,424498,128,105,364434,95313,269121
c90adefe9dae6075983fbcf20f82b5b7,21,17,6984,2694,4290,24,18,6437,3291,3146
328975ea68b21bd60344bba020ef1d6e,165,125,467980,130219,337761,198,156,603212,125506,477706
c7b180543ea9acefcb666270fc52b96f,18,13,3433,2927,506,19,14,4876,1434,3442
14e5f3c6e64492a6dd31d51807c8639b,64,46,113018,37355,75663,87,69,175457,37547,137910
d63e6b66ab7868da00eb1887171488e5,44,29,37011,13464,23547,40,30,52668,9305,43363
991159684781feb32d5d9179fe9e50c7,120,97,288184,80929,207255,129,119,370944,70213,300731
43470699f841dd00441e6c3d2566129f,51,44,68166,16451,51715,68,55,89626,15881,73745
24a9f77bfac7c6a9390686d6d8ded45a,48,41,45632,14615,31017,42,39,38441,13899,24542
68ef3ce63733264fc7bcfaeed2abf46f,60,39,113883,25741,88142,52,40,82360,23861,58499
2007cfe0c226d49945ad7495fa9f40f2,39,31,54861,18071,36790,46,33,55634,21387,34247
5584e0acf4bd36dfc27837c9db6f100a,76,59,123461,25265,98196,84,55,82532,30642,51890
57280aaab2474e989756ae658cdd7f4d,55,42,75861,21757,54104,77,59,86361,25444,60917
6ea397d88b1aeab09a38dccc585265eb,132,104,302458,60815,241643,112,88,226290,73614,152676
626180c7cff20b3c2be83fc797ba863d,105,80,188717,98998,89719,135,91,325700,83657,242043
665df0a6d19e78b8347818d56fa5feb1,151,109,454292,96254,358038,112,78,367511,74463,293048
f4f449c5b0204724b1d9130271a9afc8,119,85,357135,114672,242463,200,128,484449,111519,372930
0634e6ba76d56502fb1aeb510b57c326,91,76,186637,76678,109959,162,120,356864,92093,264771
ff70e6894e94faaa54dd9f31249fb88a,182,148,735164,131732,603432,153,115,570934,136228,434706
4b1eca80f8be82de2af785327db75809,213,139,554516,112623,441893,186,120,726979,163803,563176
5d7661db9bf49f9490f1e9dc2a459a40,176,153,992566,162933,829633,190,135,1054607,227043,827564
bd1e00da5ed8c56ff39be1ddf6872e18,34,25,18947,3285,15662,18,16,8447,2871,5576
9cd623d5536fc57a314a7d7abb7685cc,50,35,42776,15871,26905,54,42,52170,11579,40591
2363be681c95ddef54ecd2152f022cb7,23,20,7194,5849,1345,21,18,9822,5570,4252
5efd38b28c3ea39199906ec188b6ca95,54,38,54244,28004,26240,63,50,75554,28774,46780
8660ba281f8ff33c8470d27a56842e41,63,54,92384,25040,67344,51,36,84482,21013,63469
7001c091d27f31a42c70e011a317d02f,112,92,278655,34491,244164,125,105,286308,53503,232805
6e896e620752092670352083fa1ce52f,160,105,268921,48310,220611,128,96,233091,59337,173754
565513a1c0f9439a7ef9ea0da96624c7,111,74,266439,57639,208800,189,143,405508,99282,306226
041bf8ce618d13160d8064605616322a,180,120,670791,127405,543386,197,130,653745,163842,489903
e0ab2f41659f9207d78cbfc3b13d3de3,82,72,215705,88605,127100,143,112,306252,85914,220338
d35c84f496c461067bf291b98e08a4e4,125,98,293254,91788,201466,119,95,256830,86119,170711
5203c6cd50db9205eaebaf9ea7040b5f,179,131,524354,96969,427385,156,97,416151,99730,316421
7fbd746e8575f090f2c7c0e7d28baefd,227,137,836942,183909,653033,220,145,926960,243324,683636
117a751df5acbe346181dbd280ad8f7d,137,109,235246,49440,185806,127,87,202304,46139,156165
b3683562db85e0de71bcf741290c150f,170,132,677554,101058,576496,175,133,588904,107902,481002
f6cfb28b34c9f380e6b58560d01030df,17,11,1855,1293,562,13,12,2848,1103,1745
deaa2a116210f1b1aa9ed9f96eb23ab6,162,112,418588,70689,347899,136,81,291221,64622,226599
0fa7742adde4031e36a0242b9682181a,29,25,23217,9722,13495,27,23,20142,10095,10047
5ba773dd8944a130cbc2e0d4f646a669,24,18,9028,2892,6136,18,15,5695,2648,3047
6b1217447b5aec8f09e6728aaf54b24f,53,49,58729,22071,36658,45,36,49265,25524,23741
490fda396085273bcb583dfa2ed78206,42,26,63377,11916,51461,30,23,34754,17392,17362
03787b00db3d688d40715c11c5612cdc,47,27,55229,8542,46687,32,27,25587,13242,12345
a44740cd9e64878ba7786514f9ef698a,92,62,130181,43000,87181,115,84,190998,45016,145982
4567e47802d003117bd8f81d87ca8c1c,177,135,578136,89382,488754,146,114,382263,115992,266271
2e9c1eb768a09dd3780181142e6ae89a,84,61,122942,45147,77795,80,64,158887,39750,119137
71384298ecec741fc2f9b9eda8a4f7eb,103,88,206659,49752,156907,144,111,287936,50635,237301
5f6a94c53cc3c9c07d20b320d979338a,161,103,425623,124653,300970,189,123,584810,107550,477260
c0e3c54b2e6e704cb0f3a4a423c07d51,106,84,226100,44141,181959,124,101,301863,58570,243293
d58016cd46e192474ac49ffd214cffa4,152,100,660940,111796,549144,171,120,392553,122631,269922
c6c5b4540d1f5f2aa7881e1a94ba84be,110,76,215393,74982,140411,165,105,375904,64447,311457
d009463213e27b526b302b6bfde5654d,82,50,114835,29455,85380,91,69,134109,20448,113661
f7c4f11f31caaff04c18bd4277656b1d,136,100,257541,67897,189644,79,58,236869,54175,182694
8db1ca8c323db6fac348468bea30926f,109,95,288785,95627,193158,124,124,311259,108542,202717
5966eb850f3bde9c01e71a647a660f9e,34,29,36458,13490,22968,40,26,36318,11635,24683
98ffc212d08951bd650e6bfe00088e47,171,107,502168,96651,405517,170,128,548104,113762,434342
cab517beb034909513979772397f358e,59,47,88832,25102,63730,77,59,126864,22085,104779
dabb4ab27274a51793a350af07353d6e,102,86,226108,68834,157274,144,127,400344,68562,331782
7d9ec7a328c2170ab227b00cfd0a92de,63,53,63219,23783,39436,76,54,75623,18670,56953
2f8f169b37103d36bed4b7d7a9ee4d37,169,124,532573,120069,412504,159,127,632869,114408,518461
9d76f22dad73215497079d68fa64bce8,25,11,5743,1113,4630,22,19,6130,1688,4442
3c10f7b1b0ce1a02e61441346ac147c4,119,112,270177,56728,213449,117,107,202628,59101,143527
7377196f168f796b03d873dd7d975a1f,45,37,39814,15032,24782,49,38,29433,18238,11195
61696d2318b492703bac5d5967af83e8,38,28,24448,7143,17305,42,41,39415,10674,28741
7be1ce40562b9e521295c53e251db43f,128,115,319951,75153,244798,106,79,340113,69889,270224
20f4ec24e157285967ef67852c79fe5d,54,42,41487,18901,22586,46,42,45509,17939,27570
784a5e2a49e9bc165d67b512859dc045,37,25,22864,6776,16088,45,21,17308,8104,9204
8783062b3526c98ead9bacb53c146d4a,173,126,783133,147306,635827,185,133,607591,131340,476251
fec26f2432f0d1fc4cea82fbcf655859,126,102,277141,60715,216426,89,71,231836,65118,166718
5736e9e42b1f0326d220beabdbeee0d5,33,26,14866,4581,10285,26,23,13126,4391,8735
d23fb39d93d83283110788a526551ff1,58,51,81480,14100,67380,51,38,58000,15340,42660
86b23767f4fa0d313c0962be61cd75a8,181,130,412036,86562,325474,144,107,309893,79524,230369
fbd2b3e308065ca0a9cf25ba44501f62,49,44,55352,18648,36704,49,38,47143,22090,25053
10435dac2a5a10da63ae93a5f9afb937,95,78,171524,43716,127808,102,82,170040,39944,130096
adf71def106c6a1956d69fb68b7131f3,206,102,640181,70444,569737,165,117,539506,113208,426298
baef1d04e656b61c44c1a23aaa9cb66e,128,86,327172,71906,255266,162,84,316744,98732,218012
5e7ea00c12619e1aac124849fab9b6fd,5,6,563,435,128,6,2,586,300,286
e1952239d10a656f1b42da1b7b42c515,92,69,176517,61626,114891,102,63,175594,44744,130850
94e84566857e78f02d16e87bc4a2b42e,121,89,236505,51844,184661,80,62,169116,31864,137252
b326b79b4b4d169d6683e684e071075a,114,89,283390,65996,217394,159,111,454276,82210,372066
f47d57e00ac6eb03d6796f66270f3359,53,39,65521,15733,49788,48,48,50684,20569,30115
f45516ae60bbc3e45de4f143d7a3e2ac,112,84,242920,63825,179095,102,72,213091,58404,154687
f73fc46bca4383470c57bc36958c1028,68,48,69540,16037,53503,40,29,54877,12488,42389
46c9bf5d6fc3aa0596997105e7943cc8,121,101,303421,55740,247681,125,96,238205,48205,190000
8fc03dc1a9286dca25fc6212f58ae947,116,102,254929,67989,186940,120,100,220669,76263,144406
f7dcd39aed4d8ad68bcd00c43a310bf3,43,34,32265,13748,18517,40,31,32833,12137,20696
5d75e01f5c41a5e296cd8d155f975290,57,46,53308,23109,30199,83,55,70296,16918,53378
ba3455a2641a396c22af9d4260680424,57,53,69934,24237,45697,59,44,54938,23833,31105
e475a132c3746819deb80cdb05495c92,81,74,197561,53490,144071,96,79,227148,63127,164021
01a09d0f8c2c140a99134528df845577,34,27,37975,17562,20413,34,30,42253,13146,29107
caf16e7d644638d883b5d4386dac4cec,21,21,20837,8841,11996,34,25,22005,8697,13308
5499d99e7eb4e84def60db964d762379,72,46,106399,31203,75196,54,35,70573,24415,46158
9f89103742ee4a37112dac8cbd1e5101,175,135,589413,105585,483828,163,107,521844,96182,425662
1211fbd23b78b88283fe74200e5e360a,105,84,242785,78923,163862,140,105,231888,56176,175712
cdcbe237c0fc6237989b2a3489603ff0,52,47,66755,19933,46822,50,33,48882,12337,36545
0c94457346381dc7df17cba90fbd7f58,87,60,132844,27445,105399,72,52,78278,23957,54321
c6f2bce444a1d35bb9de5e8b12305a1d,83,64,132080,31055,101025,69,59,92464,33561,58903
3e7d79c2e866c5004790182c0b3b9fcf,44,33,51408,18395,33013,41,43,54286,23254,31032
4a3c5859d67f92b97f75d6fab5d06769,57,49,82510,29867,52643,54,40,70177,26177,44000
ec822e43178fd9f6fda7ff4a7ac4264c,137,116,298512,56032,242480,130,91,258130,47614,210516
48ba824c0f7fab8832039d1574d4efa0,77,62,168079,51402,116677,70,62,132270,59644,72626
05dcac56318bc6e5d65b0683d4c4cd96,77,55,115580,26047,89533,38,32,42879,17236,25643
3fcffce8a1766240a8a207d1f8b5df9f,29,22,16550,6703,9847,32,26,24000,7072,16928
bfb164b8c64a517ef09c1ab616c0a1ed,80,73,139830,71747,68083,120,97,298691,89432,209259
a8795b9d3ce18572123ca092d0308196,119,85,198165,39142,159023,94,78,163970,38331,125639
cbfece17b6b863b04aa7838049fe0a82,116,97,252317,65641,186676,141,101,256420,70165,186255
017154ee48f5f490aad8b583bb4ea80a,24,21,19986,7233,12753,22,20,10759,7553,3206
d4811e42c231d364571c5af8768b6bdf,135,108,270306,53435,216871,95,79,137725,51026,86699
321a4afb16bfc9386fe3e644ce603571,63,55,63765,26489,37276,70,65,80318,26632,53686
e86fc02490489b6477f4ad0fdf78bfe6,103,77,372397,82399,289998,159,146,475926,81787,394139
e6dc1757f5300e2d43437c3e70c3560b,176,125,486007,82573,403434,218,153,567158,93262,473896
c1ec6179d99a18a43b6e74a24b1f4901,108,72,281263,81858,199405,195,148,664693,90524,574169
90c24d4069fe87d681226790645182f6,75,54,159374,39521,119853,113,101,199104,74717,124387
e1211892ef286b4e741dfd3c0b96f756,117,85,205480,36524,168956,110,96,179129,49334,129795
b28bcc08d9ac94ac9674577401060401,37,32,46171,12748,33423,44,31,42795,13484,29311
1d039cf8eb3bf58ee0b0995108f246f7,22,17,6351,3474,2877,21,21,6464,3401,3063
04129b117d16237734bf2abf3cb1dd07,148,116,447463,93818,353645,127,92,350684,115122,235562
5b47cbbf274262309dd06a55644c9e02,150,120,297874,62800,235074,109,82,201765,62782,138983
d4a87c4c7fca0f4f029ce9727779eb57,38,29,38818,11862,26956,36,24,33958,11242,22716
c0cec8d8e81ff9752e56407b40493163,0,0,0,0,0,0,0,0,0,0
b7b82b3af0154b76d856ccc3c7af7dde,35,32,28467,10105,18362,45,38,26501,13516,12985
347ea9f778d720ff4a3ca021e6d06f4b,31,27,18640,9487,9153,27,21,16381,10313,6068
94ca44000268b8feb95da388780cd526,93,74,135637,36646,98991,109,99,185862,32176,153686
eca9b3f0195076cd00f89eb08cddd736,142,109,413481,147260,266221,118,66,424385,111795,312590
d09df5d9e693eaa8875962440493e215,95,84,186368,53721,132647,63,55,227993,33547,194446
1dabcf688ec13eb2b6df59216d93503a,69,51,135645,37846,97799,101,71,187182,30099,157083
c6cd2d88dc23b5e150b172e434d96997,68,59,81714,26400,55314,58,51,73707,30911,42796
a4b1177b6cb568fc2f14b185f20a1ec2,113,88,341624,107944,233680,151,112,439730,87460,352270
c3598f564e2b5eaa8eeb73cc233d79d6,29,18,6445,2816,3629,22,17,7365,3245,4120
bf40c3e8596fc31295e1fa8d67dbd77b,129,97,331299,57122,274177,142,95,280700,53448,227252
4355c5da364868897fb21ca3f2170907,157,127,495018,88475,406543,144,122,498815,104555,394260
2b8d224ef5f4e5a1b74b7ac44e9e3a5f,95,67,141392,47047,94345,86,67,199671,51956,147715
e105ffe1abdb16d00de8e2505265aee0,84,70,172317,62370,109947,119,95,260349,69516,190833
e74a17874b60f8077b6645721c7359f2,33,34,21128,8342,12786,39,25,17031,8772,8259
8ea71028de00148e021047e59bc68213,31,26,48194,9610,38584,33,30,31534,12946,18588
4dc2a59da9219b2d001e3007a002257c,159,124,315218,62373,252845,118,96,260688,58898,201790
50ef2d3c1c4dd847a118910f88d3157f,63,49,94282,30550,63732,93,82,180014,32310,147704
1b25e511c10a06e006635ec6ca34e3fa,155,127,460624,105286,355338,142,109,353781,98626,255155
8f0a25e64da7799681462eb660a080b3,28,20,22814,5799,17015,24,22,21772,11434,10338
1bf4bb288f0b10d8d49693b60219d5b4,19,14,4199,3043,1156,23,20,9272,2948,6324
fe30b2756421b90157367411dc9a5c11,84,66,217687,48050,169637,87,67,122227,47330,74897
47f4e4ebb85d30bd33858197527a1a05,91,83,156652,35083,121569,92,82,139712,41497,98215
3b4a3b327a412a8d8f55332eaa26eada,122,110,345722,114758,230964,142,112,479921,92149,387772
78d1222b95db45f65e647e548273a7a4,161,133,459281,113418,345863,132,105,480750,148158,332592
2ab3a3e395ba1caf7555616e946d3fa3,150,106,641051,92737,548314,141,113,476000,94574,381426
705818f689eb6f1d8f1cb9759f183407,21,16,5237,1968,3269,19,17,5951,2773,3178
c1ca5f84a29701fbdbf988ee763dfd26,138,98,269604,52308,217296,140,94,240639,44384,196255
c8ba555a1993ef8942c7dd2943f2cf89,63,44,101988,26538,75450,67,55,108957,37195,71762
6cd2ae24c998a09252153e091c7d694b,29,23,11539,5751,5788,23,18,9334,3638,5696
88a89d6eebb55497b30189d252723044,123,90,196486,54497,141989,124,96,262869,48055,214814
9075af45c9526fb6ad788d820259af8f,20,17,7364,2768,4596,24,16,7157,2780,4377
281a40a47831fbdacf6e6c5d72195ee5,106,86,180404,30578,149826,87,75,111196,38061,73135
f68b2d3c13dc8dc38c74553e9ed5483a,63,39,52292,12942,39350,64,45,58892,13720,45172
2207b36c94d93e59f6d80d0c011fe292,121,88,204036,34282,169754,72,48,98214,25397,72817
0c41e2d0eac8a1d26344972815354cd0,174,112,760136,117240,642896,196,157,654971,192511,462460
4aa2ed87e90d22a741c4006733c9f50f,173,117,483126,150825,332301,194,139,634453,122090,512363
37599dc1be24c712cb71c242af0d039a,177,142,505461,126070,379391,114,90,346118,104506,241612
5a90c03cba8ca8ca3ab7c37acfcca83b,27,22,7009,4746,2263,22,15,5375,4646,729
4b33fd337b8b3bfb51cd26a47c5f0ea5,242,163,1120986,188162,932824,242,164,1155849,192759,963090
6193148d8c824c0bcf5e6e5578ddda91,64,55,120698,36929,83769,91,62,131918,32575,99343
ba74b9c3a1d2bbf05f8950b9d0741cdd,153,133,563311,156419,406892,186,149,588012,92779,495233
be45d46b6712e23a3a4d5f9c5e863eb2,189,146,539483,92933,446550,180,153,546656,120738,425918
443c56257a90742a0b5a70acf3f89427,75,59,123486,33914,89572,97,71,115904,40205,75699
c7409c63f73d9364bdde537ddce1104b,15,13,2185,1344,841,12,13,1569,1575,-6
be95aedb2d91e861a7dd02e98195079d,92,85,277206,83783,193423,104,65,298287,58487,239800
6da84ade10e345af7a81688d86ec4d4a,158,125,541428,152717,388711,178,137,598156,116238,481918
5b17cd583675c17a911e725fd77e4b31,65,58,79185,41369,37816,90,82,154876,31274,123602
c8a7b53c1607e2e21b5ae834f236e117,250,169,1275565,226527,1049038,200,160,1152771,338083,814688
1821a3269b42c464ac2b7bc433dbc186,98,73,230627,51628,178999,121,97,254385,73074,181311
8ef84a3a0b528c7e2a18eb55ecf6ade6,60,57,90607,28270,62337,60,45,83982,20776,63206
d480e5556dbe553f9d0f2ea7592f967f,40,29,34457,17291,17166,38,36,33002,13223,19779
74e50f37ce1362c6e2f99a66aa879e0c,50,38,47129,12868,34261,45,40,41666,14624,27042
dd22f2f936915a348413cd0646dbab33,14,11,2715,1528,1187,17,6,2486,787,1699
013efec6963066b1793c1a5d9783796e,71,54,102906,38641,64265,93,76,144070,37885,106185
8dc20ed3d7148b93b4383e6a4b800370,143,104,405738,63073,342665,180,162,515580,69467,446113
507daadf461e4ad5eac7900ca44ba8f9,30,22,26190,4303,21887,32,20,19531,5920,13611
afffa3421eecd810a2e927ec0348824d,217,152,868257,166111,702146,182,141,1038689,174546,864143
7e08cf97b89ce016d29b2078d8b5f699,196,154,781836,144685,637151,170,134,741164,193960,547204
986293617ddbf373cef66d48adf3b0ad,176,139,720881,118293,602588,139,108,423483,93018,330465
b117262e178c47732132f92c116ed021,36,24,34357,8262,26095,39,34,30908,12081,18827
67fbaf3fe7a721f6b4e49a857829e9de,192,142,838262,183474,654788,221,142,1098134,136312,961822
36a47562cd61cc78a3f9680fd4fcf2e9,23,22,10219,4039,6180,26,22,11636,4836,6800
748d48d465c2b9f16400a7127380c632,40,35,47903,17774,30129,55,39,51589,19503,32086
ec54bcd56fcf84cfefa25f7662cfd834,53,36,46379,14542,31837,53,43,44629,16696,27933
d8f450dc7d426368e7157c076538a8a5,69,56,96923,28091,68832,49,45,72797,28186,44611
f39583a920cb00a65bacad8db7ea8d92,39,40,57524,18050,39474,37,35,32983,11354,21629
41f8a1b7f3a3f21014cc504ba8fbf563,35,33,37308,10555,26753,33,25,24446,10921,13525
9e090f7c53d30981c6fe62cb7d4c9a00,52,42,58479,24063,34416,74,68,102480,29281,73199
5dded68720214daacb4028784ad649a3,73,53,90315,17421,72894,53,49,61242,15315,45927
1b6323a3d46b48f84e8f8bea72b2778a,106,67,179242,23533,155709,67,52,97950,34887,63063
a53be9dd676bebe3dcf3325fd53106c1,38,25,25074,4749,20325,39,28,23118,7167,15951
acc6eeedc277ebd3c35b96246403aa92,61,55,132503,38155,94348,92,79,165810,40218,125592
2c938c2b4c67befb961b9a51d02c6b6e,92,87,168862,52296,116566,87,71,174537,37541,136996
6123e0252ab95e92bb5cce2ae1139b2f,30,22,14724,4931,9793,28,18,11258,5098,6160
1e57ac5a810b3832b9e87df20929f070,138,118,469595,92644,376951,175,125,469498,103763,365735
dfe120f2ff510d74172a7fcfba5877a0,41,29,40741,14434,26307,49,48,46736,19145,27591
82d384da730c38f83b3db2ebfb6001e0,106,77,160842,39377,121465,96,62,94599,24350,70249
2b1457b6314f419a727d36d83c0284b7,91,78,190755,45709,145046,122,96,249640,75671,173969
a896457c84009856efae3fab178a72a0,98,76,177039,53741,123298,98,74,153057,52574,100483
7e9e51f562a3ae6985ba8799912f7db0,97,65,215989,42487,173502,93,79,198144,70881,127263
8c5be9f43ea07cf74a49f2c615b3c132,40,30,43235,8718,34517,34,31,19121,10995,8126
7bb94312939621f9d28efad9680f9af7,170,116,524988,135945,389043,157,121,500469,159380,341089
86cd6f8f480a151115ce8d08312f12eb,90,71,159140,34799,124341,62,51,97642,42109,55533
2dbd9d4c4ca1bee9be2afc6cc39d3ee5,16,16,5276,2063,3213,19,16,4632,2827,1805
01a14e3c8bf42ba26155c41d97abfdae,28,24,16011,8237,7774,38,33,22840,8069,14771
1a7a331f1b622d6e677e2e8ed6919b5f,8,7,828,316,512,10,1,797,53,744
072008a48ba917aef4003415eb229e56,101,67,211814,47510,164304,102,81,262372,54942,207430
4f949c5930aa4b810d7173627317e277,34,24,32639,8021,24618,45,39,41133,12560,28573
c2c22994dec7653ca392286caae46c3e,156,115,475936,135247,340689,144,128,533700,113648,420052
d0dd47374162936811d8f443f7f4ba1d,116,94,158439,24801,133638,76,58,106842,20784,86058
e0ef9220a1a7388437028437887262c1,155,86,281770,84436,197334,144,102,275086,83828,191258
c591210fc13e6f25be7dd05e5c6ef158,95,74,159979,43411,116568,107,77,200412,33910,166502
c2b8cfb06f3eb6b1042b69bf77ef9c43,91,64,168526,35233,133293,116,88,181513,40367,141146
70f6f31f55850318607bf71788ac1cf9,173,129,604943,119329,485614,152,109,571309,111752,459557
bada5e7d49048571d938b44e9e64f00d,64,50,84593,33143,51450,101,77,146101,31915,114186
f3ac9e58ecdaad726c4414e8105b9787,94,68,181099,41559,139540,109,82,192527,44206,148321
179d283c652a86d7169e422e79cdf0db,25,25,13776,5302,8474,31,24,17917,6888,11029
73921b0b222dfcd2b651499abc418ffd,163,128,489005,114271,374734,204,144,768646,100484,668162
17aaef7f96b5893197ef0d3af9bbf87f,23,17,4843,2774,2069,19,15,7728,2338,5390
98a477fbab8dc3db7ae2854ed3b83de6,137,99,274907,66906,208001,172,122,365489,90546,274943
1cc45831177eb920b6eb22423e687455,80,63,142635,34559,108076,64,61,106180,37366,68814
38afc22f0cbbec72094b8a15070f56c2,135,95,252009,65817,186192,133,94,207105,66750,140355
8056f38473af92aea8039436cb026f26,66,44,101016,24372,76644,63,51,80115,30706,49409
129d20371432165e6a970c3495d9c28a,212,136,502709,115013,387696,160,113,591223,78467,512756
01edb49ea44a06d1a6da61ae37afdb5c,97,84,228018,44738,183280,97,55,212392,37596,174796
b6d1cb9c24be803ecdcd1161f176757f,97,77,224078,42848,181230,103,76,191977,34430,157547
5d9ffc315cbb0c5a0226a259ef08d353,84,76,197804,45496,152308,102,89,171503,52936,118567
2c35ac8c4560eb428c9c17bbdd8e8a50,99,86,169030,38624,130406,101,72,145332,50769,94563
d3d9d523b0655bb1e205e09cc4e7dd01,24,18,7903,4795,3108,22,21,8262,4209,4053
37804d2ff4fc790c7d381c07521b85a1,65,61,112029,51842,60187,144,114,274513,42360,232153
9b79b795b37da7ef996f44ff6bdae54a,35,25,25219,12404,12815,44,29,36792,11362,25430
5ebc3460f66e86bb15f144db2ff52f98,107,76,267823,59968,207855,117,104,311894,62453,249441
cf7322395376db4b8587a6aacafce6fb,125,81,519528,126041,393487,203,158,830610,126761,703849
39329f137fe551fb803efdd91306a22b,78,72,100666,30876,69790,80,59,91810,27670,64140
c7b70b8fb52f7c4e2792a744ef8d72fc,199,135,688836,131563,557273,169,125,705340,148909,556431
23fc11f9c19b1c5fb24c87e6a00a1bbd,66,49,110139,33248,76891,44,46,84954,40429,44525
24e3d4e2e880be067999861975813dfb,195,149,1043527,124558,918969,236,178,1219429,173786,1045643
9a57b177d2f66918a0934b7b9802bf76,21,20,10174,6335,3839,29,19,11248,6363,4885
a8f307b126f51aac11238e598c5c8432,25,18,13614,5343,8271,23,21,16458,5766,10692
3829f0095f8eaef14deeb0b33e47f165,18,12,2323,1103,1220,19,16,3838,1003,2835
e2cbcfd73d806ae0eaaaa347489f6b46,214,131,851437,202881,648556,165,129,611442,183573,427869
15d619407f221182e0a20ee21d902b8b,98,75,174895,48815,126080,93,54,142038,35902,106136
2e4353891df791c8f073aeef2e290ea1,23,17,6557,3894,2663,23,20,6497,4220,2277
8b14c9f96de26aabbd8af7c10b003886,100,82,214228,69199,145029,104,83,243821,63297,180524
3eb69756ae7dbdadc34f5db84ee4484f,97,71,192440,50504,141936,147,138,347635,68855,278780
1fbdccbe0396a503cc29b6a8c48baf7e,141,104,426775,157119,269656,175,145,702821,116453,586368
a06aa7281638f6919c91a5a2354a60cc,126,95,251728,74076,177652,114,83,220334,55689,164645
037dcb9457b253fa043ce322667f5456,124,92,281545,74360,207185,92,66,193599,62117,131482
7f03bb17f8edbe047a80a497bc7bd47e,105,78,163598,59428,104170,115,91,210615,46476,164139
713271f89a3f85014382890851d4e9d1,24,19,8734,4518,4216,24,22,8144,4073,4071
654b64fe1d2e2bcd03709f6168bad356,92,72,164479,69306,95173,90,71,189086,52750,136336
17e748dd9cd8605628e54df76d973e35,106,89,151781,78849,72932,150,103,251244,63914,187330
e821d0655fc841c9a21352e7fa22f094,108,85,187510,31344,156166,125,103,236620,53128,183492
8a2408af8c2fdaf39d070f8c0474e057,126,84,249413,76745,172668,155,97,353902,81009,272893
ff028afe84839643d308f5a772c346e0,132,106,294210,62366,231844,130,98,239706,55066,184640
7013b62901b0b2bc9058978a52dd4d2a,162,126,504041,140026,364015,157,119,518222,102220,416002
ca1fe3c272114394ec19ab660aa77afc,155,118,536546,102354,434192,130,96,365101,85998,279103
981734aa86343cab843c7e7e00f75489,95,75,194808,46333,148475,80,57,142123,30315,111808
56e65d0f0ee4667406daab8abb0e6f3a,153,99,324825,61580,263245,128,106,310299,81347,228952
359448cfb765010b496e425b0841ce79,100,92,259172,59336,199836,89,69,177572,39708,137864
3701f43d6a843c41b8f95de4098472da,45,38,61295,11817,49478,29,25,29372,13404,15968
9b1b8908d0141adb960bc349775e4829,234,147,1031113,185317,845796,197,162,987734,263745,723989
4cd3c944d2c78f6bbd415ec954753aad,74,55,175330,60783,114547,73,66,163003,68469,94534
d26a8aff4d0ec4c079df359eb7c58bd2,97,81,140435,34148,106287,71,56,79225,27018,52207
8e2b8936430ff21b19892b9374fd303c,69,53,77989,24522,53467,73,70,88267,39239,49028
5e6ac1ba9bd60ed8e152692a2d3766a3,106,94,269268,66240,203028,127,93,281921,74487,207434
252a2e8ea3fd90d597393280f971d8e7,63,51,91933,29545,62388,60,41,110735,19718,91017
aef80807d7d48c4ee9b102f67fb770ec,23,21,14129,5928,8201,29,18,11715,8739,2976
eb6c6f3513555219d83d7c0128473abc,149,128,541051,106567,434484,112,89,362965,108581,254384
cf60413acd61ebfd339e402092e63252,105,85,365262,114820,250442,160,121,504651,108061,396590
5108bdf66b264e4b230b234a05ac0d31,120,94,286918,70546,216372,157,109,340799,84424,256375
68714099074bec45b4cb2546ead4e0c3,172,116,422570,64536,358034,149,110,435205,90662,344543
427f1f4f54c35533337e0bebc0a4fc40,50,41,56012,22261,33751,48,46,51635,25025,26610
8f51b9a51897f38c0e2b8bbdd0843730,98,78,300170,58190,241980,149,115,363254,69941,293313
49fbc38edaf6dcc8cac80236406be4dc,178,107,447388,63689,383699,143,112,400714,101250,299464
b1e0405db00b2516308104980eb7d7a0,34,23,18181,6887,11294,25,22,18925,7475,11450
fa561e9a3f3b3073ae34d1801260eab2,166,87,365434,83854,281580,112,95,260855,82090,178765
b6809b0ef4eba02e3c4bd6ac8423fa85,32,21,14254,7237,7017,26,20,15844,6779,9065
10f8c86b74227b13ab1880890db155b9,77,58,104592,22952,81640,60,55,100914,23054,77860
2d985244167882c523780bb05b47613b,89,69,179360,43770,135590,110,75,193093,54853,138240
7f40230e06fa1d61e2d0ba985444bdbb,8,8,1412,336,1076,9,8,537,498,39
47ce49ca0587d628294d65bcb9995752,118,91,295626,86942,208684,132,109,335182,86238,248944
1fa53aec0db0618e1416dde7fd4b0b6f,50,39,57301,24967,32334,52,44,54614,26744,27870
15a407f8dffe9d4e19dd0ba8685ce77c,82,64,91069,25632,65437,57,49,56106,25410,30696
4f3c5b4f2ded9dfc63e6d9167814460d,20,14,6091,2767,3324,22,19,9305,2927,6378
e093f79ac1617f8edacb2df1463b6751,84,65,130130,34555,95575,135,101,201817,26738,175079
36c0776f71831bbd39b5c57022b8cc3a,170,126,415431,103798,311633,163,132,513821,77669,436152
629bc65cf2f0136123346d5bc1151bf1,45,36,59419,23006,36413,56,47,64132,19521,44611
b44494b5483fd6e5e29877a2a81c3bad,106,85,214173,60726,153447,114,89,252886,69772,183114
8c832e200ddce19d5398cf227eb08603,80,73,106365,24495,81870,81,78,117011,28494,88517
c84d9f7d5ab9907a528d43cedfb35e49,65,47,128184,35939,92245,63,54,104444,41157,63287
e498dc4e7c48ff9059e4d6f9af2bfe39,35,26,14036,7570,6466,29,24,17493,6957,10536
7ad1be440129d1f7281d292cda4b98b6,181,124,588489,155652,432837,165,118,555153,151950,403203
c62ea1268f2510cef9e002f8905096d7,84,56,121644,26667,94977,99,85,162998,37558,125440
566a0f68320968e219d3a2fe10c613c6,10,4,1836,561,1275,8,8,842,1444,-602
398a87c3711f0a5cd4dcb38f6aabc9c8,133,103,576490,122638,453852,151,124,558653,149320,409333
e9e788b1d8780cb59a218c919c6e3ea9,54,51,72507,21889,50618,63,53,83035,26480,56555
b560c2c7598145610877d1b838698f4d,140,116,715490,131021,584469,181,144,878497,127320,751177
a33c5f38ee843b51943738ee89a3ad9c,137,122,353194,62386,290808,153,122,392823,60125,332698
6e7be0d1fcafca200e2dde34d5007446,203,112,498638,103682,394956,171,125,537874,84271,453603
ac5cc60e31bb92e24bfd4ad9d870af24,192,131,486092,119162,366930,143,113,489217,107679,381538
d84fef05c8dcd40658f0c7e73fe4a16b,108,93,246334,73046,173288,125,91,286948,76590,210358
91f204e6c5d8326f133365dde11b9a26,8,5,795,359,436,10,6,965,607,358
926d8fadaee934256161c85a398b396f,8,7,655,816,-161,13,11,1312,382,930
55bacdeb9ad0f84f40353aa1761cee9a,172,123,542281,109225,433056,121,86,292284,97057,195227
6012b83e609b1be6b4a7f718c8c7a096,24,24,14870,7684,7186,33,27,23617,9157,14460
e5eb7936eb4578ba4549928a9e10f240,125,106,557313,126031,431282,137,101,431844,108354,323490
955a44b4b5c6a92ebf5243a3bc0d3471,18,13,3076,2491,585,19,20,5261,2785,2476
304a46bbb29058131c0241b33e2e961f,83,53,98266,35849,62417,70,44,115261,29949,85312
34cfd61b3395b04eafb3f46de020b0a3,35,27,26771,9170,17601,37,27,23165,9647,13518
cad561b26845a72d1e6ccfaa7d522a64,51,51,58213,20752,37461,74,55,65147,21243,43904
0b60288522dec4885ae90fd434eac122,78,63,160494,39084,121410,140,98,233411,38001,195410
5c31cd15e3e2e48e2bd2a359029088d8,25,15,12727,4753,7974,38,32,34157,4495,29662
6e83e7327d5bf0dc0d63c13a6b5b230f,90,89,162111,45020,117091,115,86,221530,39177,182353
530c81fe43b2118b100a7e5c82169886,104,83,156895,21153,135742,107,73,124601,28680,95921
5873e2e53d033dd5571c9f571a2f52a5,38,28,41658,18200,23458,46,31,69304,14038,55266
f304674befac9e552a07d41026db4132,120,94,235313,29296,206017,101,70,188960,29397,159563
80f057d6b1e4bb1458c71a0ad249093a,41,33,68325,25419,42906,67,55,99503,29476,70027
02293e67021be2ab3ef6bc9e9c572702,59,41,81742,18865,62877,60,49,60415,22217,38198
a8af46b9a4eabb31bd7406f89e3f702b,76,56,94586,23580,71006,66,50,85817,21226,64591
1a7a49be80951d0c3d7316bf83ce441a,45,31,42847,11444,31403,54,48,46524,19603,26921
2bfb85d6716cc04803b550406210ac59,182,135,518460,94975,423485,163,122,442899,90539,352360
8cd7bfd660823e5d83749bdcd0fbc0ca,116,83,210204,57930,152274,102,72,147805,65677,82128
2502917b9698603d22cf511ce8fc2ec0,61,54,60783,20435,40348,39,36,48967,18623,30344
8d9f71e5d6917c8bf536a71a457ef611,139,110,512110,175733,336377,177,136,506050,118722,387328
3f8ebd321721e42ab972be2fefe0db1b,164,128,616841,142044,474797,167,105,556236,108806,447430
220ecebbb233bf2c479201d72fc253e7,173,135,371336,81466,289870,122,85,268431,98179,170252
a19ad7f1c3c61f8a69b8e1261f312a32,124,81,161275,39623,121652,162,111,271210,34904,236306
09645d3dae401d88f4534cbcdd7914ba,71,54,107815,34135,73680,109,94,186632,47976,138656
35ab4162728306512f5d0d16f96451ff,150,122,363302,71773,291529,115,84,262365,70912,191453
6294b9ce3fa567fa7fb72b387229d495,72,66,132532,39910,92622,75,61,116759,39489,77270
d445fccdce7e6534e68e0812f50bba62,195,155,374210,93510,280700,150,117,450125,99862,350263
e949161650d288a627042cf24a773b75,78,58,97807,40583,57224,85,56,127857,28491,99366
cde2fd3fb9c797d0bc1ac813d4d2752c,99,80,243052,70724,172328,117,95,297997,74763,223234
36f4692d4853c89241f8aad5b202db9f,80,59,119211,31412,87799,88,81,146194,43265,102929
e16aa9f0f4d0b3e95217bb97c2ab0d40,77,71,172075,55111,116964,89,69,194453,47821,146632
8cb385c08ac926b69fac9cf9f23643a7,134,100,395587,106412,289175,102,94,411793,106972,304821
f328e656469a4944748a8b77ff1f2d9d,182,149,1411690,336665,1075025,214,167,1291665,224317,1067348
499fc8f4cb30e461261ae11ad3cbddc2,47,38,37453,16634,20819,40,32,36784,11062,25722
8c8a167db46cd53e11a584bc306adb29,145,99,395721,110679,285042,204,163,621532,118497,503035
d0336045e253ed2853c32007893ab7d4,35,26,40468,15598,24870,32,28,44413,17521,26892
45e0ef9378a2626d64e4b23c4ef3a3ad,140,89,420508,71677,348831,94,80,224893,71659,153234
ff20add219574382256cf665829a71db,114,98,309042,70891,238151,98,73,227714,68871,158843
664e44347444eb7d0ba4a15d59ce36f4,57,38,94547,44727,49820,96,59,146034,37568,108466
ddb057b5207a7da4e4f0ad426178e9f7,177,120,415337,93132,322205,141,96,350228,73274,276954
798cd6efe8243db52aa1392c4e4d3dae,50,37,94921,23487,71434,60,44,89678,26678,63000
820c7cf7bce4a2fa6d0b9c96a5299046,174,135,611474,127236,484238,180,140,608010,113800,494210
ce402d52de6ba2ebdbe49203b13885e3,168,120,423482,61949,361533,152,128,366276,69735,296541
8f8c73f6805ff3a9c6c737d135857eb9,135,122,364498,119404,245094,168,122,425396,99769,325627
063aa3c205cc4fbf6b7c9808dd0d74f0,16,17,9280,4576,4704,28,17,11962,4349,7613
1d371d79ed3d3f77c6e64990553952ad,64,46,70922,19405,51517,53,40,48953,18582,30371
daa52981c20f95fdf425574d994e1783,115,105,363173,98436,264737,158,122,510970,91299,419671
a31c5b507e1f0ba56b19f44308bdfacd,40,28,35320,10571,24749,37,30,23145,10192,12953
d477fcfdac5cc3b3340663fcb2b79365,100,65,299275,34318,264957,132,97,258226,43312,214914
19342ae7fede4691c8190ac6e8082505,136,104,333933,57149,276784,100,70,173665,47896,125769
04a6ff6ef47a26feedb9eb12f7ea4b2b,131,100,291656,101568,190088,133,106,327697,94322,233375
31350e8367be5c38ebda461c0336e16f,141,100,282484,57276,225208,140,93,297488,40675,256813
2f9b5ff645987ba1daa3826392a654c2,120,66,237654,44700,192954,149,121,326374,78977,247397
012efd45e91998cb93e974c42c4fcbc2,41,28,42152,10842,31310,44,35,34709,15612,19097
0f07280f621f74a264dcdd90886608cf,181,138,532562,102676,429886,150,109,497134,101392,395742
574a23d781e72dcf57df031343c4b431,119,85,265299,82394,182905,137,117,377496,94590,282906
595d535eb5c692549417864b9d398ada,56,49,66675,23969,42706,52,40,75074,22929,52145
6c69392cd3bfc65df6596a70e5c366dd,114,85,203833,41389,162444,106,84,185054,43592,141462
2eba25bb802102e93d2fe959ae5f5620,29,21,24922,6709,18213,35,18,40594,7723,32871
f6cef91491b84d91c64d40b4917d7d94,106,88,252381,43097,209284,146,116,279721,56987,222734
7ea7263f342ddd29ba5d09f4cdf20964,36,28,33054,11430,21624,32,25,34422,10197,24225
ee2a28b07c8128023da73b5c15a0b7f0,97,71,111761,28781,82980,56,53,74323,30612,43711
dfb8bd8832a59a569924f004e80a30b1,30,22,17512,7182,10330,28,22,14849,7638,7211
1ef0ae4f10fd7fcb3fdc8c3b42d6c0e2,18,14,4192,2377,1815,19,13,4960,1883,3077
a41c5443b4caa34e7996424c68f8fe65,29,26,19000,5992,13008,26,19,11902,7061,4841
bc94ecf86c6f62f4a84e99041f5b0006,94,79,151253,50702,100551,72,57,155632,37778,117854
fd320d41f85321786580addafce0971b,139,76,306920,47419,259501,125,95,304748,65655,239093
b6147245461af400509acab5888fe88d,137,95,379896,108708,271188,167,131,501532,113686,387846
32243ad8d6d8d7dff5f1d15a90c41f03,75,63,125769,93808,31961,129,90,258832,58367,200465
878e72b00970fe3dbff7d064a2982d03,85,49,91548,19872,71676,61,46,64763,29827,34936
01d17e321912e480d1aed9cd94157c92,4,1,508,59,449,2,3,110,468,-358
6f283d1e94a47f9589aeeac7c2fe4a0f,105,92,276917,78636,198281,156,132,377746,92823,284923
fded0c55671d842e021c1aade8985735,26,19,14293,4279,10014,27,18,11074,5977,5097
497748dd21155e8befee54913ef6e2fe,34,21,12505,5641,6864,24,22,12754,5038,7716
6be8d8d3cb107d6f094a2b9584d448c5,148,126,351201,72278,278923,147,120,361294,72747,288547
592291994bf2400aa090d52327c2bff4,191,121,1064964,173378,891586,189,157,1009329,174881,834448
0b1121d38829c19174f2cde5ee23b9d1,54,47,65308,33522,31786,79,67,99587,43806,55781
72e0d00293a914429107775d58e5966e,122,93,289334,103985,185349,143,102,407127,78133,328994
20e06c3a9db409a485dc2d50a873d257,78,63,81062,50216,30846,90,74,172251,47732,124519
d3815c15034c70115dea8323e494e3c8,3,2,301,163,138,2,3,163,301,-138
17fdc92017a82d8434188ce829fd2b61,137,109,343267,111387,231880,126,63,379303,83985,295318
2750c8af09ddc15c52cf61e5e2c046cf,80,53,99162,17499,81663,75,57,94096,22604,71492
4dbcd38e71f353bbab9b8a28e6cea1a0,23,19,7516,3455,4061,22,18,5733,3631,2102
5d9dacd5517063a87813a32a5c31c450,132,112,717499,191264,526235,194,152,710006,193207,516799
00b299c30156fd8439b8d0c269bc4c79,119,97,202316,45396,156920,95,76,158477,55621,102856
ca3796c0c6ac666711c3c771b9e72ef8,182,121,495768,86752,409016,153,132,542088,114839,427249
5f9a54fa644ce04ec471dc187ef69a6a,199,133,738714,212209,526505,184,106,796181,177079,619102
f7ad73ae0fe451b7f8be4bc877f59e54,211,155,683269,213575,469694,199,130,653136,132240,520896
74dfcfde862256b9897451e02151dc02,20,15,3570,1846,1724,15,16,2641,2001,640
c3c2bcf5a7774821b4055c996ecdc654,44,40,38231,14708,23523,44,32,40929,13279,27650
0e6ec789a29e811ba88881bb3ab59587,0,0,0,0,0,0,0,0,0,0
e63f4fcb8e41a64cfa35f8f3cc3c84fa,17,12,4577,3000,1577,16,19,4637,3084,1553
ee859312046f6e34e3dbf125be70c2d6,114,78,209079,54441,154638,91,70,150054,63688,86366
366c5d9497407f30740b1f9cc041935d,106,76,233231,55278,177953,88,73,143632,68564,75068
4b65795fb473438cd0a35f982b56e21d,52,45,55981,17273,38708,55,40,41273,19922,21351
88ec54bc379e442f90073d856f5abdda,61,45,80589,41268,39321,64,45,99207,36969,62238
5687c9ece51fbac830770dca190d278c,157,124,545165,134529,410636,137,100,439950,142776,297174
0dc104a4e792bf65aecfe69deebecf6e,111,91,280246,65408,214838,92,67,216632,51378,165254
017b2cda53376c7fbd3975a29cc39cda,198,131,565972,109027,456945,160,98,443395,89005,354390
0de3201e8d4440b8f76b88eee0fab9df,31,26,59388,13374,46014,30,24,41360,16710,24650
909120db2bfdf94e69c0620977f89327,73,57,149684,35741,113943,66,46,106514,28182,78332
c918daab7ca70cb23743f78809c9f9e2,161,119,360676,62070,298606,136,107,360588,65622,294966
7b134a1642c9b0a7664114d3fe1ada9a,144,129,430535,97786,332749,161,126,456835,91404,365431
95eebf060e67bc5624eb7eec840735e6,110,89,248524,50475,198049,115,87,212263,56009,156254
f68913ab26db3df1c56751578d5f3bdc,64,44,82154,25021,57133,79,66,76877,28826,48051
3ebf68d12e8002a6cc01ba32cd9f10b0,50,50,62356,26520,35836,56,38,88899,19532,69367
45ac231cc60c1f1fbda98bc0dff67fe5,120,87,270489,57678,212811,106,90,231246,63501,167745
d1595e15cbf9b537d0fb4d3a74d07de8,45,53,49224,18303,30921,61,54,64551,23009,41542
1962b2fec05aea7b85206c945f62544a,115,76,289779,81701,208078,173,113,393639,85786,307853
c6e17640b180c4792ca8431972776387,154,125,525898,130625,395273,161,131,506178,90477,415701
12b650fe9891f42de8910171dc89cd46,133,105,258262,56490,201772,98,69,123155,44211,78944
b7031730b8dd17024cad9555393d7fe3,72,55,115275,32403,82872,56,48,81272,32166,49106
748be258a2ae8c8afa9bdbe2845302d9,15,16,6464,2852,3612,16,13,4594,2136,2458
571253a4b9770943129f0d4473bd8244,134,96,396741,109599,287142,152,122,501476,117044,384432
7d9c85cb936467e50b6eb9918a17775f,28,29,23895,12399,11496,34,24,27231,8888,18343
0488a560012a6a4c8cf7b1bd608ffb27,0,3,0,313,-313,3,0,313,0,313
2333413b87f72597bf6baf73b22328f2,49,47,39647,20132,19515,43,35,38607,12579,26028
64e717ba9beefba80143561b9d7f3129,21,14,7773,3269,4504,29,19,9818,3373,6445
1a0a22298d5c688b49dcc5652cec6451,132,107,394677,113593,281084,145,110,413680,112684,300996
8430aadd34882ff7a51f7b2be3097e18,32,28,17341,6779,10562,24,17,12272,4155,8117
6e3ec7c3fd2b49b7b1c4a671db61ae93,107,62,145709,41032,104677,121,81,157170,34416,122754
914b8994eabd6abac99aa12e48b1b830,121,82,240432,46712,193720,102,94,275507,52860,222647
d4b8c5cd162b95646b56741d795cf2de,245,163,1207317,189813,1017504,246,154,1101145,161632,939513
6f5f8d7aa01cfd2065da66d2b3d26cd5,169,138,583673,136314,447359,173,129,573565,129650,443915
df6e5e34ecec3b4d236772d2047792fd,142,107,501837,110347,391490,139,95,427544,63296,364248
76669cacef5f0ad78401bf403e5a7a19,154,134,618471,132430,486041,161,118,533692,107572,426120
bc82f294190b8394159a9cb26d26cce0,26,25,6825,5198,1627,25,20,12379,4943,7436
97a157ae0508e293a79f51a171183bc5,124,88,372191,91950,280241,142,134,442351,95066,347285
96be8593a602a19b8fc85cae115d265b,139,100,357323,68702,288621,133,102,355169,74522,280647
e173eebbcaa69c051bf52f01c4dd48f1,79,60,118696,35563,83133,67,64,95986,28876,67110
a936e9ae4a43fd9601714e069f26411f,128,99,216652,44882,171770,71,63,124068,44196,79872
e4eb6143633e83baffdd3c2f983c8f59,11,4,759,163,596,3,6,180,218,-38
6ff22c4cdf9e1a64412a787c978bcc93,35,35,22352,9171,13181,37,29,23709,8086,15623
09aca0050d1d2b5bd65c8d6191996326,170,139,452473,86956,365517,129,114,399620,70617,329003
b5db479a26cbada5dcba1772e59bbcda,107,77,238545,49979,188566,126,94,251158,65812,185346
979ac0e0a59e9197cf9eda90fe0fda22,61,44,50938,12763,38175,52,47,42120,14100,28020
22b3a2fa95629d1a3a8dae0e5c73c231,39,24,36987,5972,31015,29,21,16175,6870,9305
d0b527211a508db46ebab1eee97dd45e,113,94,217275,40555,176720,93,80,185118,45561,139557
197dc515f4696e57dea4297b5d7b83c8,85,75,110209,31151,79058,105,83,157717,34385,123332
d8021e597db05d6f198a8e0ecbf67f99,30,14,13694,1991,11703,28,21,15369,3895,11474
6b1e87e626108994113245e4c419f815,57,39,41987,8549,33438,46,33,35050,11233,23817
2d1ac8396d80c36130b75ace023dba05,115,94,231098,51958,179140,119,102,248206,82206,166000
8b8180508647025edbca60f566766430,164,120,537895,135674,402221,155,129,470183,96876,373307
406f5338df9140e405dcdfdd1f061297,38,26,24545,7286,17259,39,34,33672,14208,19464
e07a9c574d7cc140211b77a82d2fa69d,81,61,155917,41388,114529,81,51,89228,44408,44820
c223b4a5f4ab6fd9dab9c374e6821945,131,102,356306,67789,288517,156,132,514869,73404,441465
83cda6308c535c22fd700e01e79c02b9,146,93,380004,77524,302480,147,97,320445,86380,234065
fd29f7e136e864d69220579600e9bdd0,177,126,467858,120933,346925,130,79,508989,116974,392015
e4b354ad6455e94cd9f23f34c28927af,53,40,36613,25914,10699,48,38,67859,19610,48249
fa785d1dd73e313ec8d428006215fdd9,67,48,83123,23452,59671,57,47,66118,24989,41129
7ec3655dc8b5aa832c146d8a4803bc5c,29,25,11489,3441,8048,30,16,9458,3727,5731
c03108f0a53901d609fe111e25001a13,135,110,491228,71952,419276,131,96,432331,85503,346828
7eb875acbb76e2f54eb321ee91e498cd,115,90,275023,65939,209084,112,90,248354,58713,189641
d38a501cef98d881cc7098e42e177ff3,54,36,73938,14263,59675,45,34,45710,24324,21386
fbe9a5f9d8fdaa79c4d12f1c8909f2a3,86,75,168863,49167,119696,106,86,253690,67584,186106
104682c11f42f774948d1c1729a32059,2,2,80,764,-684,2,1,764,34,730
e7b8fe7862aa072e5d592e3ad4bc372e,60,51,102290,31443,70847,74,64,140347,37670,102677
163edf0688223266f31d43e71a3b0a7b,202,143,628219,102122,526097,173,142,645286,125185,520101
0fc7c9f45722b3c6f348218ae5b5b3f1,118,79,262414,80272,182142,142,111,486838,85571,401267
d32315c63dc8ebba705b3a060bf9aa23,154,140,484293,81534,402759,134,106,452187,81335,370852
0d1d2aba35e725adca80caad4c8b22b7,119,91,176316,44736,131580,121,104,263957,59953,204004
d671151be0b47fa13334810f7d413421,48,39,73299,20460,52839,42,31,44340,23388,20952
12be01cf74b233eb3a50aaa94ca680b2,155,122,621399,125880,495519,186,155,770909,141731,629178
ac828437745c79d2b95d70be46f43c8e,132,105,499735,110435,389300,172,115,589502,104904,484598
909af8cd2a97d6b0c0bf60cf85bde2ec,138,103,279553,71816,207737,158,114,385023,70408,314615
a66c135b71536baecc1cdff4585eeec3,122,104,468810,93119,375691,171,147,564069,124318,439751
51fba9d186e7b5926e58d8a39f127431,83,62,170013,34350,135663,83,66,126403,42639,83764
4df2c90455ec23117a1dbbb75f2456f0,38,33,49143,17624,31519,47,32,50477,18452,32025
85c481e08f27ce9190dc0a08fa9aced8,149,119,420022,48787,371235,157,130,453433,58896,394537
ebd23439a8d975a8316ce7bae1f9421e,50,41,58349,18238,40111,45,38,41999,22047,19952
46ebba0cd5d779d790deb17dd192985b,46,39,52822,15233,37589,41,31,53799,11104,42695
06d3ad96cc0f79263fcb5d687e64d22f,76,68,106240,37942,68298,90,64,156907,34950,121957
2955c3102161f04077fe3b0d63349206,153,128,526318,91404,434914,159,99,391266,76561,314705
11060cc5a25ed84f21a7349c7f5fb10f,146,122,354793,79499,275294,129,98,335407,65347,270060
a7466415ab983858413142d258477cd8,170,118,742072,144890,597182,172,117,952142,124701,827441
6d6942db13106d90c92232d025b93868,21,15,2895,1787,1108,22,20,3995,2352,1643
51d1c0b4e2492aec83e2697d4e3767d2,124,104,235630,65468,170162,93,69,147131,52122,95009
bd55b2b22409480b53b06ad0f1e21b28,143,98,431457,110523,320934,179,124,673727,120539,553188
b31a65d4377ad1c497dcfc6d2a9f8681,106,83,234086,61264,172822,123,106,290211,65165,225046
096adc6c3ce0f55f3d2c2a7b329703c7,65,61,73763,26058,47705,68,52,102613,30867,71746
23881e10067cdcff1b7335690747216d,93,62,213521,37730,175791,83,68,154694,49092,105602
35987aec2d2fbbb92b7595266e4425de,41,39,64452,17736,46716,36,25,36358,15737,20621
c619af3bab0d8d97a88f0a5a4a24cfa4,60,46,83657,21032,62625,61,43,73828,19587,54241
7c43e6005e7d7029ab53c01d838cb689,62,58,77786,26088,51698,79,68,90426,23066,67360
785abdb0f7382df724a8fbc0bc531ba1,86,60,96372,24662,71710,64,64,62422,27936,34486
41d64ad535068dbe844f25ac222e343f,185,131,582228,109313,472915,157,117,536621,85792,450829
b9b1f2fa9b95a0a9ce241d69ef77ddbd,130,104,401621,94184,307437,170,109,470473,103599,366874
6087819780bd4d876a15cdf71abf09ad,104,82,194801,68762,126039,118,75,282125,46520,235605
29b12cd65d12252ed2c4c32072b068ca,146,113,337439,91201,246238,139,118,331874,79787,252087
13f0d9760627cc4053237144ff534ded,115,101,313663,68999,244664,165,115,348845,70479,278366
bd4bad0add33aab79005ea1f7e2f25a3,26,26,14545,7084,7461,33,26,16604,6106,10498
cac4ca4c68979ee57fdb70468d3b40b8,133,119,376356,76943,299413,130,107,346838,90716,256122
6dadd85b92d10acb4559e457e4f63244,2,1,88,44,44,0,1,0,44,-44
4d91529e477e2a92198982fc34f25e80,107,86,232940,71119,161821,121,104,342927,82152,260775
6ccc00a551b04842a28186f59675f82d,88,61,270348,62364,207984,157,84,375608,63707,311901
65214bd17417a3108eceea929af28ed5,209,153,1066298,182098,884200,221,160,963350,198023,765327
2bee3c079ecc5d873720d6741712c8db,48,40,93557,32995,60562,61,40,97484,28359,69125
bd9a137d7945c3d0db361fac9e067b6f,133,105,431298,134189,297109,170,119,546217,143797,402420
0f8a4d5c80306125ecb9371066749f5a,114,106,236519,60623,175896,117,99,242470,79279,163191
3e25f29b2ce4f007f4541b7f8b48313e,34,31,21109,9164,11945,30,34,30092,8635,21457
c22f2778a263c4ecc70df1d5e5a48527,101,83,161765,45614,116151,122,85,280067,54604,225463
7e802cba4e5df418f282f66ca71b2b03,199,136,529698,34420,495278,92,77,182665,50638,132027
37855ec4bcf97acec91e42187cb169bf,96,80,246568,53552,193016,94,85,225590,58731,166859
aa7746821452bd02f40cae41b912cdd3,130,108,219460,48812,170648,113,92,197118,46768,150350
649fb86a23bf141db449a1098e37124a,118,105,226388,80509,145879,64,56,116909,45945,70964
80aad419ee4e550bbe1bef32757e85a0,116,78,187432,25867,161565,99,84,141995,27744,114251
ce28461adb6ed5ddbb8b340db009b10c,133,77,388051,70068,317983,172,107,533609,61553,472056
074c5e29ebfa1ca0ab338fe8a4bb7ba9,73,53,140064,49498,90566,90,70,196096,41804,154292
9274f8b2358e7384847030b07c635ae1,19,13,6585,3113,3472,22,16,5728,3294,2434
f54bd271612f0b6385bea55b0284ae58,157,93,297839,67674,230165,119,92,252238,76648,175590
f88042d15d3a769a5b8be7a3f8d7dfd4,86,64,100720,35729,64991,82,71,129467,49313,80154
bee2c63113686b0354abf4ad7ffacb5a,123,83,195543,45504,150039,106,78,209113,38138,170975
a04eddaa118282264c550bb881bc6d06,60,46,174915,36607,138308,127,88,291810,61877,229933
71890e0b8721b0b569c2269ddb446981,44,30,45258,16576,28682,43,32,56597,13982,42615
b47a7d116d94e2ac5ed6ae3f1beff815,73,54,100307,32092,68215,57,48,84937,38869,46068
85aded71167c80dfb6c77405a33cb564,101,83,215891,49856,166035,105,80,211310,49991,161319
4db5504ebded5c7b91c6e755e35e5509,86,75,109084,39163,69921,111,88,146629,31170,115459
f1d23be2dd92ab5ba1c4d6912a77d522,129,116,396705,93356,303349,150,112,460777,84630,376147
4b27559de01da03fcc51ddf735b5c063,171,136,534847,99178,435669,188,146,675881,90553,585328
56acc75cb5025ecc804ab357ccf37d25,159,131,406198,68944,337254,182,132,477660,86358,391302
76ec86e71a924e84011e07ca1f9f54a9,149,113,526131,87335,438796,154,105,470375,74454,395921
530941c4ca971d1424ee0df9887f0969,135,96,335341,55548,279793,153,110,315040,53229,261811
b47ca4d8c950c748d834fed20e699b16,156,115,405450,87874,317576,145,120,429184,92141,337043
b9a3a84badb7003cb107ca379cf1a233,144,90,315086,36378,278708,76,50,92080,47603,44477
4fe3a6dff814c15330fcf9a836b1e0ae,118,94,317087,105938,211149,121,97,327979,105042,222937
043281e4908f187ec06cbd1dbba8cf4f,2,3,252,273,-21,2,1,149,128,21
520cac00960c9d1e9d8c8fbe6d887cab,66,54,68616,21586,47030,70,49,91076,18090,72986
10abbf4e860d415cf99f6c270d2e9d12,3,1,161,11,150,2,1,89,38,51
3a13d34b552545c598f23cdc8291ab42,35,30,39830,15668,24162,29,28,23035,15144,7891
f7798e8bd2c4a1f57a3da57ee469c76c,149,124,434674,69054,365620,103,88,287007,81965,205042
aee4724b1fe080e85d3a468bb977befc,76,52,60769,24473,36296,53,47,64885,25872,39013
402bdec991561843342230395afe0676,33,25,21928,13899,8029,33,25,23694,13889,9805
beb0c0267480cb4b5d04ef20dc16de12,65,48,78534,24483,54051,56,43,59745,28925,30820
7c71e0c688d0a317b75a91611f0cbaaa,53,44,69737,16419,53318,40,32,52145,23809,28336
ab515b82e9db91bdf631f1032fde50cd,161,132,672384,130596,541788,153,130,562331,125572,436759
b2897d464011b12c05af39b960ea3625,86,73,117929,32722,85207,56,43,64198,21691,42507
a84d6df44b8d2a0cfc1cfd617697982c,37,27,12871,6150,6721,37,27,11411,6800,4611
7c30b621e12202f62acf4cd704c9834d,48,40,62949,23468,39481,59,53,107307,23147,84160
22e0e7149666eb3e1f6944b87232c5f3,63,43,72473,22249,50224,71,63,81207,29072,52135
9e3be12b5572ffe5540985442c6684df,46,37,58184,20012,38172,54,48,56249,19582,36667
f3a6e9ac9a84b544ffc19a236973973c,133,97,304145,63877,240268,135,110,392635,61849,330786
f5b78e465897516007a37d639c21b10c,100,64,131517,20579,110938,71,64,101488,27560,73928
014209e65ef22cfde7b142451cc901e1,63,48,147401,46383,101018,59,49,124787,44309,80478
128a1df6094a6f6c3449fe389b2a41c0,20,15,4289,1745,2544,20,20,3766,2593,1173
d6a08ae382d97cf401a06d273a90f3de,81,66,171530,40995,130535,96,76,154164,30648,123516
c1e3d564b12646d6746225e328263325,87,54,121962,31071,90891,102,97,153425,47785,105640
7ad53a68441dce81697f9f3946dceb5b,47,36,81439,26120,55319,63,47,77452,29762,47690
685a2fa378f62492dcca28dc51a6945c,145,120,472330,89352,382978,185,124,490049,88378,401671
1338d2d6724aad1f7447f976f7b84c37,69,46,107520,25558,81962,64,62,98953,48998,49955
a52029579e545b972b39a5deea07095a,72,55,116376,28765,87611,79,67,117746,30877,86869
e626801bbacf0aeb204e7d7935fdf16a,131,102,363437,74328,289109,131,91,409691,68204,341487
11f81e09e0e1d3fbfac3317208fa2403,40,26,21945,8578,13367,35,32,21068,10138,10930
c032be81736258f5bb45f26dfaebccbb,123,85,306528,85484,221044,142,88,393367,58597,334770
34b4cd25100e62e408c0ef0496282de9,128,95,245743,49084,196659,150,111,298603,37883,260720
033ce6d7e16c35985dc02c8b06f4bd29,24,18,12935,2905,10030,28,22,20151,4953,15198
8868fe35379178ab9742248885c6dc49,128,112,281891,80674,201217,106,89,232364,71393,160971
800eb2ff2e5a5a79533316e24366cded,64,48,86642,23343,63299,61,39,64002,18896,45106
c574e90ad9d7f342ff91cee5d09670d6,172,122,359490,102397,257093,174,115,369063,100007,269056
87bce67543a6e0fe5255f5cbe744ba21,35,29,28164,14047,14117,37,31,32411,11569,20842
7f6c111e7870fbc7e6d8fd8f3c5b5890,114,91,186774,37686,149088,114,92,253901,44907,208994
59c1037dea1f995da0c6d0ca2eb0923f,113,92,284402,133177,151225,131,107,379996,101418,278578
f0972cefa7e55ee1d74122bd5e1b51e5,61,53,97842,32105,65737,64,49,138468,24885,113583
a87952a1b79c03e37cd9bcaae1bd1b74,37,27,40375,13746,26629,60,51,73774,18041,55733
aa5e0231a3cd2f7974bbd94723810536,66,54,77304,28160,49144,67,55,84880,24034,60846
cc04d241c9041fd530f9f233394ae9d1,109,95,282870,98313,184557,97,80,233503,61374,172129
4250adf1055e058f5092a53981ad88ce,16,13,4512,1630,2882,13,11,2252,1733,519
d431556d2152d6822a1fdfd6aae7526b,161,132,345780,124232,221548,137,117,372072,76095,295977
d63b4f3b1a57d3050a7e339080d99219,117,71,181623,26388,155235,102,81,160822,56177,104645
b51321bf357940c8bd76d9330407cb17,83,68,127690,34644,93046,68,54,92943,38992,53951
84635d1c4304683e02a87bf0efec28da,19,14,4982,2748,2234,17,16,4894,1982,2912
ac3e374d92fa59877045f638e584f282,88,63,147244,46335,100909,126,106,251456,53961,197495
89a2f7a32fa01d33126ee50c35815261,137,93,256504,83923,172581,103,82,164682,62861,101821
98091d4d8569264a7552881c7a1acc11,83,64,163626,48075,115551,122,82,209696,45916,163780
29723e7372dab01983da739aa1ba8545,114,80,302767,79764,223003,207,133,581510,80907,500603
08357bc781a32464d549fae930c7d734,131,105,430933,106808,324125,131,97,316358,114205,202153
90d27c88556499c47f61189082d85a41,74,55,97528,28487,69041,92,58,99787,27768,72019
123148b8e4ae3a7240e32346ce6ef42d,84,57,161855,32018,129837,68,56,116240,32754,83486
c504bf6949b26c25b3c8774140909a8e,40,33,37263,13175,24088,44,41,28653,14066,14587
0ecf04807384a8b0c1be8e6338f974a6,110,94,238936,60804,178132,105,83,190817,53376,137441
4a20d620769061f71e0e51eead8912ea,2,2,417,230,187,2,2,230,417,-187
0cfc555f377ad9f2e398395034ba5721,71,66,136629,41128,95501,93,70,150608,37698,112910
32fabd7329c83cce503d03f0a86db229,46,33,36394,15544,20850,36,28,38136,12573,25563
c86fce051cdb426344948d4cb05ce450,153,127,424891,67402,357489,103,72,272018,74317,197701
2b812f1dcee424d1502348889d6bce0c,118,95,240925,43483,197442,122,93,214285,47701,166584
fb7829268726ae49e5a636af4e3c2783,99,72,292631,70392,222239,169,142,472979,82639,390340
890c7e919ce87dc9a4e4d7be15bccca6,130,98,298613,53773,244840,157,115,361018,49651,311367
1a1858e5f650c72b525c66622753ab48,41,33,43418,17709,25709,44,34,45329,17453,27876
3fbb622b326a8cf44251cac0982f0a75,31,25,34522,11594,22928,34,22,26961,15416,11545
4433cdef2a5cb26deeb2a7e72684cd90,64,55,157806,47676,110130,72,65,177293,44104,133189
d7417806a86daf0d8ba9d96cf9e1c553,106,73,256619,40812,215807,104,82,263541,56629,206912
528c4c88cf53a8b0b024af2a1eadda78,107,88,190526,26132,164394,82,61,163365,40985,122380
03816377fd6c8ece82e60e38db1a5e16,132,96,371339,94438,276901,145,102,311025,101640,209385
5547bc945b7f6a3429b65b67294e8eb7,25,29,10020,4901,5119,30,17,11039,2584,8455
1817ae037d32910d1080822b450581c3,72,46,139251,24377,114874,57,52,86797,27634,59163
fbd0d7f7e1e3116e1cd608c8ec959fd0,90,79,178732,52993,125739,116,82,217905,52165,165740
349b7b1ba11254afc6614554a25792ed,234,164,1290499,286290,1004209,202,170,1710411,227543,1482868
08d00b9ea6549d285814e11a7210949c,122,81,248781,73564,175217,163,131,415711,65808,349903
3d4e894a8112ab6edf773e714a4bc99b,194,151,881460,182924,698536,151,104,644679,183515,461164
5cb56d05db20e5f170b37c67009ebea9,146,106,391113,47108,344005,137,117,321727,68870,252857
1668de2f47c643394fc05e51a2438545,173,130,558483,114583,443900,157,105,377685,86833,290852
e82c8559293574eeff29cfd600498c83,119,103,303129,63023,240106,115,95,278279,53465,224814
1c079c7ea24cbe6a9fbf7f38b92ed81a,119,96,200510,42610,157900,69,64,105023,51447,53576
1c06f98d10f441baec486f9df7919016,49,41,64299,16286,48013,70,42,98882,12411,86471
8930426ecf124a91bbe1e9cc4a1a71b4,163,135,497514,107075,390439,186,145,585491,115221,470270
72cab40ddbb30f8bf782bbbd26204a04,165,130,494866,126753,368113,159,92,374894,79270,295624
a2d2635c42420d0c7849e7dd17e080a7,129,86,353204,81175,272029,122,92,338588,62164,276424
8ced6e2867ba75904e9c786b4f31dc0f,150,117,454256,97972,356284,156,116,406053,115986,290067
e9360679d66c3a49c7c4a99e7f23152b,171,120,941071,236245,704826,198,143,1221646,254781,966865
8f79ce0005bf0d57a331ed1a7f93cdf1,28,22,9125,4940,4185,28,25,11341,4752,6589
e9c3ce8adad8d827f2c6f8ca7f9f7bee,54,32,58522,23854,34668,45,40,52832,16549,36283
8558a75d95abe2c6e13aa72cc08471b4,99,69,351305,65293,286012,162,137,581619,128169,453450
a069455369523fa3d27a4da0748b7c3f,67,55,116414,29157,87257,92,82,161420,41718,119702
f66c27122b32afbb6578e6bd0a9abbc9,37,28,35852,10478,25374,43,40,41194,12338,28856
8ad1beed2970f35c9807cbd490cb7b34,5,4,1070,961,109,4,5,961,1070,-109
98dfe885759a54622bd488a0f0c7910d,97,78,177209,67146,110063,79,64,145902,57812,88090
8a061649fe2a202e9f58616319c8c100,111,95,292844,76915,215929,143,124,330759,78788,251971
4eafaf891e1b680050d2c812647a9158,165,111,383479,91567,291912,155,112,432918,68706,364212
6f1280ed958a851dc4dba95450407ad5,85,79,149108,43452,105656,57,41,83646,21321,62325
3a18dca81237de63392fbea37ada930f,89,66,150946,31131,119815,89,75,113448,46257,67191
f5d9d9f301026c4b545cd3dcb8287a64,31,24,25386,7169,18217,24,24,14180,8460,5720
9e510d58ad6bdc3d9497771398510ee4,133,93,307720,93107,214613,218,125,487582,68097,419485
454e8c41da34fb1a476f9f80bae438a2,57,50,57621,19862,37759,49,37,51605,18161,33444
d758d26e3ecc01afc7852eeddee86dd4,106,71,192955,39471,153484,112,82,210135,43267,166868
811f4283f658780e09ce9176bf008045,167,119,368429,80327,288102,165,123,442410,78420,363990
c58f61ffff7cece630fec3fb7ccf794b,32,28,21695,8398,13297,38,28,17699,11915,5784
82a8bc3f1d78581972ef6539d5284826,180,158,623588,125561,498027,173,135,654148,116638,537510
fce005a846230c035e4eb604b21085e0,42,38,46318,17273,29045,44,31,39065,16695,22370
ebe4a4f52cc22864b19245bf09e532ec,63,50,83171,27338,55833,62,47,93113,27389,65724
bebf9f7ec195e6843b96409202beb857,46,26,25855,12710,13145,46,33,36112,10597,25515
5584f1039f5cff4140b36190eb36e9f1,114,88,251966,62196,189770,108,88,218744,54668,164076
a5c130e6b656230658347a281eca0f5d,169,122,382938,62813,320125,145,120,408522,97943,310579
9057bad4fbed31a51e55e9d2dde5ede9,23,16,3992,2388,1604,16,14,2603,2315,288
c98aa65d5335e94125344c0315929562,151,129,633859,113611,520248,146,95,622999,88286,534713
4ebd2e64fac5b20bfa268d25329b1728,20,20,7026,2665,4361,26,21,5960,3063,2897
01e25260957cd71b586a043936436d0e,35,25,19729,7566,12163,35,22,16973,7029,9944
5958c27c27fcd648b78815ff886aa68e,123,102,255031,63685,191346,110,85,244002,49959,194043
d9651d71950deda7d63bc9df29ab737c,91,62,135547,27695,107852,84,62,116094,34336,81758
287689930a406dfaa6fc43de04708087,27,28,10589,7922,2667,25,25,15158,4788,10370
cdbdfebbe15cb2c46ba31815cbff519f,194,130,428412,81278,347134,113,98,280830,99064,181766
1ffc0b4b425432adb1ec88bd0bfd9539,119,88,223640,62547,161093,117,78,206603,66202,140401
f40ef2cd2a4afe68987e3fdc5b2fd6bc,162,131,569321,144421,424900,171,138,781911,173828,608083
91e455b30d38a6db7df0a55f42103d6b,166,130,549177,119391,429786,160,128,616935,126749,490186
c7d2ec1680991d9a3c82780dd71910ff,129,108,365982,116597,249385,127,91,328591,100184,228407
4d18fbb70b75ff4d0db637b2946b834a,122,89,277012,44026,232986,100,80,198839,62735,136104
dc0752cd5e179041d6ae16a5cbac9013,120,90,276470,60146,216324,147,106,305515,66818,238697
c567d0e552814c2c48fe723291cd48f9,133,102,322666,81322,241344,135,109,330217,77209,253008
4c589ec4147313a7908be0791ee0409d,59,53,108881,39306,69575,81,68,113165,43146,70019
e0d5ca62b7323c7f7d8ab83ceb37bcad,13,11,3112,969,2143,10,11,1473,1836,-363
098644adb59d820419c00e6540dc8bec,49,40,46610,11295,35315,50,43,45557,8981,36576
1cd262821fdf974539cbe300e6d6ccbe,29,21,11580,4873,6707,30,22,11724,4507,7217
39b810c664491402824642d0d254d025,14,7,2385,522,1863,10,6,1232,1020,212
6319deb01926b0cc253887101a4075ec,26,24,12744,6492,6252,36,25,17572,6918,10654
ef591c701dfb78e8cf9b4eb608eb16a6,142,99,442710,102400,340310,138,108,395209,105131,290078
a3a95ecd13119d71318b5384becc1e30,106,83,246302,54602,191700,104,79,204801,51322,153479
4636733e11703dd356d8258f5c42ceb8,52,44,52383,24854,27529,57,48,85775,22516,63259
6e6783f4df9e7a945d89201c33a860ed,163,108,467865,145348,322517,195,140,929943,126078,803865
f9e5b543b743cb3a84a6c5ad4ca1e068,177,119,868782,181227,687555,198,160,1023247,209167,814080
141008e88e61409138bd4c944b062fa3,67,57,69337,14189,55148,65,64,50267,18861,31406
52cacf4b96e2ce6f762d74183355fe32,66,52,70259,25683,44576,72,58,99763,29229,70534
1d31647919640901605eaf8d6a91a2a8,159,116,486125,96652,389473,175,152,637498,138362,499136
64e78262b098bc024e86b900a486f07b,25,22,15607,5228,10379,24,23,13841,6282,7559
0f24387b6601546913aa84e37ad3de74,46,33,32904,16230,16674,57,37,72108,15109,56999
414eac6ba0d1064f0898eafc2bc85bf6,120,84,246845,68121,178724,100,93,255617,63333,192284
ca74d0c60e9bd14fe25e1171d68feb9b,98,77,279091,68285,210806,151,89,310664,59491,251173
855737cfb0f774f7b88a7b3059543779,250,178,1494283,246081,1248202,184,116,1747167,200466,1546701
c5717599515cf32942154502023b2786,23,18,10124,3312,6812,28,21,7962,3705,4257
41134a2cb3374d96fbf258a5751ce2af,204,126,959073,173842,785231,179,119,979472,194545,784927
128888f278bd5d4d5a6725ecbc63bc86,122,93,265722,37536,228186,114,95,229204,56980,172224
63f940edf8ee4ab0d3f39b1260f0985b,73,54,124071,30698,93373,103,67,144017,26865,117152
628a970fadec758ce0e3dd07457386a5,102,71,193731,41321,152410,113,99,251112,50560,200552
470a854ae645f4d7dd00d1021acdc734,138,109,288819,85731,203088,111,79,223501,76342,147159
df56739ae25efae77473959d9b5e3475,161,128,410181,79531,330650,122,90,292019,91471,200548
d48265e90379a857aae492ecea6be0e5,160,122,581210,140395,440815,186,132,659895,113402,546493
e003a29136a28fa10ac820e4bb3a3ffa,67,54,112814,52507,60307,79,66,166132,32247,133885
2ab20339c6dee9b052e144a9d2277e22,92,82,123733,36361,87372,115,73,177545,28179,149366
0432b55ae34bb8db5bcba8cd754c137d,38,25,23749,7658,16091,43,26,29118,9066,20052
a5a6caa85ed07ef00354d7933e8cc8ac,50,32,39096,16297,22799,49,37,37584,14870,22714
330b7990cc27642e3604439411a169aa,62,44,105137,35406,69731,90,71,125672,38985,86687
13627cd6e08036cdbe9270a2c5a432f2,78,58,129467,33774,95693,72,47,108647,30921,77726
43802937a0bdbc69961c496350bb87bf,159,135,564260,112983,451277,148,116,549623,121797,427826
dcd957733f5c0d4aed51cc178df930b3,213,164,700108,125711,574397,227,134,682862,110454,572408
ab4c027fbdd86737f33e899ff801de76,147,125,379298,124957,254341,155,111,451660,76895,374765
5f4c8dd01659ccdb07c50dec902109c2,99,69,220650,44350,176300,126,107,263268,61923,201345
863c99f70e118a179a329eaf2652074c,45,37,37854,17316,20538,53,42,65276,12870,52406
72a8df42ca211adefa05c0bd981c99e4,78,48,85218,19149,66069,72,54,98197,17223,80974
d20f9abae9266ba12bf979aea7aa8860,193,112,559768,101067,458701,164,114,486255,120453,365802
9c8df4e6ae720cc3c3b428a06174a15a,94,91,217838,40238,177600,93,73,147587,48182,99405
93086ce59ac5f344ab1f3b028d6e1aaf,115,67,147381,70895,76486,162,127,331048,63820,267228
2fc521b614a4fe0f45a435bc6e7707ea,126,95,301993,81439,220554,164,119,471631,83652,387979
8608119b08de525e54213932b0e16a4c,83,83,118235,36153,82082,92,84,160044,37716,122328
de4c54aed9c97c30d228691d6b5b9b44,17,15,2992,1944,1048,19,11,3371,1037,2334
a1dc7d3e62f325700acbc68b98fb6a8a,138,91,330452,64825,265627,121,109,299789,81495,218294
2d7ea4489b9b27612f13edeee0243241,33,27,25631,9289,16342,36,28,20515,12375,8140
e08444116f70b729b12b452cf4bd4127,42,34,47133,14464,32669,45,38,37888,14387,23501
a706d6f496ae58d6883fc16c14ebf984,131,98,235424,59232,176192,122,81,303436,58566,244870
d35ba95eba44b70ca04e345712e13080,153,90,268388,73456,194932,107,70,187357,64604,122753
383ddd31bcf982582fe780af58eb9971,243,162,695898,128436,567462,183,126,639932,116406,523526
8b088462000d22290d488ee1062bcda6,163,116,387784,113912,273872,139,114,335451,81904,253547
204577a570b748c7021b8c7daf047ee4,61,54,81046,16998,64048,61,53,67265,28320,38945
0098e8d323b932aca326e68472ceee96,168,132,459356,105541,353815,136,98,407354,66837,340517
f051c6cef9c4ad23876d4209420f397a,51,43,33036,20594,12442,49,43,57419,15120,42299
06b7d80208379e1bdfc82c52c8526791,132,106,223925,55461,168464,104,86,191875,55531,136344
2a8cb681789cbc00dc7ee2b78e6c2e2f,156,104,496869,97667,399202,146,119,585720,155633,430087
361e26f1c55b2ae5ee515b1245c785fb,179,129,635523,101812,533711,199,138,711088,121863,589225
f6b0b75a2c4110758c04caeb486c9000,32,25,9985,7054,2931,30,28,17375,4464,12911
723520f6c2d768e2fae4c309582ff071,22,15,6834,4904,1930,20,22,8700,3068,5632
5bb5313bfea2fcf8c588deb48ef4f7b1,36,27,28590,9276,19314,34,32,43844,14947,28897
2a11b0ead6bb430a095c0a17f5e980ed,100,83,223814,34090,189724,75,54,119594,44353,75241
3f445067c9b233042b5471a45e526f1e,202,124,692272,142879,549393,174,136,581552,144471,437081
04c122bbe3158167b50fe51bb2f92447,102,67,169657,33326,136331,121,101,177414,33395,144019
161b0159b3616105005968c11a88f593,172,126,472409,123055,349354,145,112,419124,101741,317383
40f7aed244c73c529c4cbb54515ccc83,191,116,585814,164264,421550,165,134,752613,163727,588886
addef2890f3173aebc07d1fe87dec1cd,76,65,112193,30364,81829,73,53,105277,31370,73907
d7fc83f636746745d850504614f24bc5,74,61,80620,30293,50327,84,68,125426,27463,97963
8777ce32aba0c5614afe30e81797f191,65,43,112523,20864,91659,59,44,52648,28326,24322
111574c134422b04f881410590c1f515,166,132,996004,181791,814213,242,142,808514,172525,635989
909030793bffaf93758608c75265385c,34,35,28693,12629,16064,36,29,26354,14620,11734
d354f75a30154acafe4708798093e7c3,70,68,68592,33650,34942,63,45,91391,22525,68866
6b93f8e1aa568f4226d4ca7618ebe922,161,142,550390,145915,404475,143,103,432662,104175,328487
428df6a375bd1792c1328634a0d9d40c,126,93,266549,66050,200499,88,78,199766,67917,131849
b0f7b86632f18442bb71e5cbe87c3513,69,47,75026,22383,52643,62,42,60358,20289,40069
617b5cc89a44ed8079e344c6c94371b4,75,54,119138,27023,92115,83,77,131013,31690,99323
ff06d82889d0a011b153c22b2dc3cebc,22,15,10405,2564,7841,25,20,14649,4996,9653
ccd4ffec7136237c06aa2651b8c31364,24,21,15263,7409,7854,30,21,14130,8677,5453
56c6d41ad0038b7876a3194cc153bbdb,136,102,575285,104490,470795,174,126,628049,127167,500882
56c07d8f66980b74f9f4bffa6fa99507,97,70,222093,96536,125557,129,94,288657,88453,200204
91ade9af443bdea4f69a1255e6500804,99,82,234427,45430,188997,84,56,177894,41853,136041
0bc47fc3ae06472a10a56bf90f719455,1,0,258,0,258,0,1,0,258,-258
12d50ffc461146e3a23a634a52ce9484,105,75,314415,113354,201061,124,103,410900,104070,306830
05699ccaf6fdecf1feb1f253f1841d16,102,81,237855,52773,185082,91,64,243560,47670,195890
91796bc47cd42ff950f243409db0399e,207,158,1186904,227537,959367,212,140,923734,167572,756162
41f032fd00f6514b2f741f23aa9967f0,21,17,8120,2791,5329,23,21,8536,4265,4271
877d6e39f3b8038599f2f3d1fbc56f50,156,122,545758,190843,354915,181,149,781101,204822,576279
2573a8f00cb0f295221866cef1ee34e7,36,30,15148,4882,10266,25,28,10684,5611,5073
84b4da2411fd78e0595e6c481bce3ae9,128,104,388501,127973,260528,176,126,420047,101348,318699
968caf642feb2ab17a06f0ef3cf20438,30,26,13520,5513,8007,34,24,16263,4881,11382
d92b75e9f522549d38b0636b55a3fb0b,138,107,505418,88258,417160,138,102,361496,66783,294713
59300a3f3b87d28e73c9a0913da2a797,219,146,1202518,154427,1048091,198,146,710961,209273,501688
0a4622437eb8f872f3adf21d6c368e8f,158,99,548317,117174,431143,162,118,628447,127173,501274
d7216cece3eb12ae114c709c67ab5d66,128,113,288908,63271,225637,90,80,163170,45633,117537
4e49fd9cf0f2bbbb65ce33c2f0d960c4,95,66,182040,47613,134427,135,91,264091,49181,214910
e54c74cf165855dcf8d1bef6afc1ec95,111,91,300780,105802,194978,122,112,294253,108942,185311
02bb7c044bb12dfc030276c03a65ec6a,75,58,119602,47457,72145,82,67,140052,43465,96587
acf5bef28cc40a6a9ce94bda3e08817c,115,81,235040,69519,165521,161,108,370858,128072,242786
fa07564c00002fb949720133bd2322a6,132,95,323900,49725,274175,129,101,318193,54340,263853
6fc53d7e870b88f9f8cbc3fb935e3a50,82,62,127598,34995,92603,83,50,111376,25383,85993
5c0d8203734fedf191ec34ed3dfbf352,127,100,250562,44896,205666,107,80,167221,56676,110545
b9d4208fd6539d128dcd1e60f6d96775,19,15,4656,2564,2092,18,16,3823,2810,1013
30f65680229cc2224148275b74939073,26,21,12431,4509,7922,28,18,11278,5279,5999
55c38bbcf98437d7c1afb1af92dca764,144,107,337850,54248,283602,142,89,293687,42297,251390
fffef5bbd0389916866def78a870072a,98,91,263512,56457,207055,90,79,196559,65859,130700
03c67fdb2e2bcd2438794c85a28bebde,151,129,566308,140296,426012,188,155,643647,115469,528178
a91849b790203703b9536367fc5e366f,63,59,116175,65650,50525,66,45,116757,47832,68925
cbef538b02ab2ba98e00bd3c5ae325a0,101,80,180207,30817,149390,87,75,126520,34806,91714
6ea41fe6deebd38856fca97468cd8720,91,56,86318,19118,67200,71,64,74122,25931,48191
616b3a7a0620501f8ee6bda0c149582e,129,99,351119,97951,253168,173,116,385337,79659,305678
01b423725c14a22ae89cf7d0c5c984f4,26,25,14167,5334,8833,36,28,10873,6701,4172
629e6727f3396a1e49857b445f99f364,125,95,364713,105197,259516,143,120,397727,115720,282007
ef8ab7a8b3fb8d42e4cbb7f09d202761,127,107,371682,70285,301397,139,93,306506,66720,239786
a5fdd6c2f87f465935f8cf2ccb5151d6,111,71,192321,36735,155586,83,64,152749,48661,104088
0f6b5628dad94e0ac3493f2f6435a015,46,25,41446,11555,29891,38,23,29054,10487,18567
81566110faec259289f8aa6fd1b76668,102,61,112215,22436,89779,64,52,110908,26828,84080
487b2d402bee0942db653642997f39b4,164,132,625045,88320,536725,164,137,648224,91528,556696
629394a692ed5a8bd46c4419313a346a,61,52,103799,42384,61415,43,37,71651,34117,37534
af30d5403a76026dbec18063996befd7,20,18,5542,1708,3834,19,19,4765,1979,2786
cabf95e0ea2f0f4b0656ddd394d410ae,15,17,2237,2754,-517,17,12,3130,1389,1741
18ed98c1f2cf1f79ad9d4df667784b05,62,48,141660,21174,120486,64,51,101842,46963,54879
54932c9237f2a3a82fc0ea97c43b4e5a,99,58,109330,19252,90078,93,57,126467,26124,100343
17c775596aa20460451ff166c8e86015,111,80,222663,46049,176614,105,98,154934,53212,101722
96340d48c90c2ba241ce78856dd2aa70,170,135,423303,124467,298836,167,113,475862,117074,358788
9649d53e4feb61162e5b6c5dcadb255b,106,83,407074,91950,315124,163,132,578879,106583,472296
1fadbd043252ccd148163ac3df376deb,167,117,573340,137530,435810,142,121,543782,107162,436620
d042e5969ca067479e69b2828a2f9c7c,113,71,177446,49984,127462,102,78,176961,63185,113776
74fe46ba98358ff939e2d7244ab2361e,26,23,19745,7412,12333,27,21,17929,9137,8792
95fafe31a7895d95e244d8ec424aaa9e,146,82,396148,80335,315813,160,92,434782,105583,329199
5ebb74ac15184d38964dfabc4b2218c3,115,87,189738,39596,150142,114,78,183091,46245,136846
3775c1814857dda4cb9266cfcde92a68,31,25,17196,8832,8364,32,27,29535,10351,19184
4f870d5079b84e61567fd8ef05649117,75,57,156016,52438,103578,82,75,206595,56847,149748
6e17cf09b99448bea4fbd6ee20533cc7,190,133,706228,129236,576992,166,118,524501,141378,383123
974ab1d03887b5a5c4903c8d75f20c0c,228,199,1096762,256477,840285,196,122,947942,155195,792747
c93267112f453fc22155d2ffee5b6b96,30,24,14827,5970,8857,34,24,14275,6096,8179
d0da0546c842b5e261a720133e813706,53,36,54763,15472,39291,46,41,51509,21933,29576
5bb96d3aaf108008503f0c55c88303ee,47,31,33430,8929,24501,35,36,23910,12336,11574
9051491ace25b5345b149ccfb210bc57,100,67,323545,92480,231065,134,90,300987,70744,230243
e8c69a20525e1d88d33276d1dbba7a9c,25,19,20096,4729,15367,35,30,30605,7929,22676
ca64b7f431de4ba60189d6d639dafc4b,165,119,797692,141829,655863,159,99,1010034,163837,846197
55999ca7b57f640c142926da8eccc0ee,160,108,435823,105912,329911,189,148,656565,123104,533461
fbf1014640a44ef8dc5e7dfb195b5908,86,59,106258,29372,76886,72,53,76814,21054,55760
3940c8a198b57aa0bf49ac8dd120f3a3,109,83,209833,58600,151233,115,90,282841,40847,241994
6bcb471053098686c0056df0af1577c5,25,28,14187,6153,8034,31,13,10976,2138,8838
4a1ddd08c13e95b5b87a448d6159d49f,68,47,65754,25658,40096,81,75,104590,25979,78611
226032ae6ae976871c3fbcf840d3a8df,95,86,196655,53502,143153,107,92,226677,44831,181846
29c9e4dd0f378aec425143529940af1c,154,128,545574,120239,425335,195,139,655254,122995,532259
0a209c48ce4d83d4c975e7c6233f903f,39,29,21609,7827,13782,33,31,22198,8057,14141
e0cb35139f914a84e30209904c2a5aa0,29,24,32423,12780,19643,28,20,32970,10922,22048
e5e380a3677d30862e58389b861d5051,111,113,222792,59221,163571,119,79,182767,45133,137634
50a2b94bdf2f4530ec06d7eed528ba02,19,14,2810,1312,1498,16,16,2295,1469,826
5235a94bf955050fe046a7ec31634b2f,113,96,172134,39212,132922,88,64,153417,34946,118471
290478ebc036a1e227cf5b99a0a359ae,186,136,541313,115303,426010,153,124,456882,136860,320022
40a32c42d62a36339595d016d7766876,110,82,247558,77979,169579,167,131,393142,91120,302022
4278e2457dfa61511c30dd15d8e906bf,92,53,132822,28243,104579,85,65,131481,33450,98031
34d912e106d00324405d3eb34d605293,11,3,777,81,696,3,6,206,395,-189
6e5305a6acd2d5dd0bc275c122e1e7fd,117,96,371591,80193,291398,184,126,461040,81772,379268
8d191aed34d2bd5083283cc825ba6fa7,69,56,93848,24109,69739,101,81,141792,26995,114797
3fc0f089e3f14d7f606d097326db0456,232,167,1161782,269095,892687,213,182,1252766,206656,1046110
cabf3dcb1804143753b73f1dca4a006e,92,71,182351,23544,158807,95,80,133583,31555,102028
e3c66bc9645a8308631fc847b00457ea,199,133,591303,115727,475576,183,131,536656,97479,439177
ac8072279e9732f4f92cef94a4c55385,103,89,272738,91327,181411,167,106,345549,51138,294411
df24eb189469f260558dda95d817ad74,123,94,213326,37212,176114,85,66,144638,40208,104430
97a2e6e30f7814673aef4703cb3df07c,18,17,7689,3041,4648,24,16,5770,3131,2639
1047d6aff250c045f5c40f46df49ce76,97,96,158846,44795,114051,84,56,127231,24470,102761
c73447b7a92a2fdd597719fb039642db,60,46,60095,20225,39870,50,42,47261,22851,24410
6a09b05ee2a23715a42f06957ff89b73,128,88,216138,43975,172163,98,68,132614,61062,71552
93397fe265a25d0175dfb47618f3d6d1,95,76,193418,40659,152759,90,73,161373,40547,120826
cf936c2ff25aab78ed83e73d8841c2a8,128,113,243518,52277,191241,103,78,225538,42813,182725
a30a0dfd0abd2c856a50dde532d99833,112,70,235140,52261,182879,100,75,287322,62404,224918
fdd20ed4ffaf42a4366622877a868046,45,37,39455,13513,25942,67,52,99360,15287,84073
da6a4dc529823316acbd299204cc64be,38,31,35642,13667,21975,42,39,31957,12539,19418
a96f888eced8b73a8a607ec074c9c0a2,123,114,417078,161588,255490,135,113,468043,159690,308353
af528aec532f8d290abb12de8246b547,111,87,259689,43271,216418,111,91,329459,46766,282693
55a10e83c75c7e6e64038e1b8ec1beb6,168,119,733108,106219,626889,190,141,642865,119729,523136
6949abfe1a85a61630398a5fddf06da5,66,63,96875,24323,72552,70,56,96818,26614,70204
f8fb0c3b7fca8957a7f88d480667f0c1,96,62,145694,35581,110113,99,64,182426,35036,147390
12803977a4a5f16962acb0044f8180d1,62,56,65567,24391,41176,65,60,85538,25320,60218
6a663650db35a3c556cf5e23973f292d,120,92,371575,83370,288205,98,74,271720,99078,172642
fccd3970759a820325963255fe621baa,86,65,97602,29690,67912,69,56,121980,26249,95731
c00ccf7d83129769a32d2e584d2eca87,109,97,248955,58488,190467,106,62,178828,67599,111229
10f39296881c76cf61bc74630c3513dd,24,19,13238,3842,9396,27,21,13427,3557,9870
57f7169cc90d87b9cd3e469cd21d73bf,108,90,181839,50091,131748,100,81,184813,47812,137001
df5695ae7454192f3561efa8118f2361,124,87,325078,92088,232990,181,146,525949,86975,438974
359bf89b73a3256933783cb8e5a9443a,127,103,271279,67734,203545,137,107,340679,55064,285615
4bbe4e176901d1511167e06e419d4c02,69,56,84246,24085,60161,48,37,64496,30936,33560
b1c1e1a77e02bed919561201b0f0adb0,108,79,292127,58150,233977,142,121,412966,72661,340305
75082f1623ee00749829b700d4c6c27f,157,105,416275,85351,330924,127,88,281045,88482,192563
8fd900d138e531cf4468ba4ef78e0bc3,186,123,671369,160328,511041,168,135,658314,155509,502805
f8946cb0958d32e6499a81ddb1c4c94e,101,83,251085,73535,177550,133,110,307745,71304,236441
6e790022e1d426c0022910074494e73f,175,139,593458,145359,448099,182,151,609393,120048,489345
c480a7c4e483e2c989f28461b9d4ebdc,131,79,323250,79136,244114,131,100,315928,114089,201839
9c6250e18a52f7c8e4dead1452ccd9ad,147,108,353785,74089,279696,167,103,453946,72168,381778
1f50a9051e0b8f016882d4e20a3e899a,153,100,346971,53438,293533,188,145,549753,83216,466537
2e1412e000de52b9d7ee4402e21fef31,21,19,10789,4583,6206,22,18,8407,2828,5579
0a3b57ce1e8b5c765bf7f1c3b20e1583,41,33,25520,13783,11737,44,34,33266,9586,23680
c25c2f27601d5d66818a9c753932909f,90,80,227790,88192,139598,131,102,366585,64769,301816
f1f5411927867ee395702ad1d0583199,37,36,31027,12426,18601,40,30,32707,9249,23458
47948eeca3e1e3e169e8ad99c457fda8,151,114,408648,85912,322736,135,114,425125,116810,308315
ffcb21383c3afd1798d4f01b9144be16,22,18,10490,3692,6798,24,20,9496,3467,6029
bd8734f078b5ab54393175ea51e3f02f,128,99,243449,44825,198624,116,103,276893,48008,228885
2ce23b39fc52aa4891b23048de5b3372,167,122,440450,109623,330827,180,116,700364,86674,613690
ac7e45be1beec1536e531c38337ef694,116,95,317946,74562,243384,138,101,360102,53765,306337
02c2f08d4af2a7c97adda10a17b3a59b,49,41,77111,11904,65207,56,36,35649,15885,19764
04135097d6e66286426672f56de3f70c,59,48,60786,25243,35543,70,51,85746,19232,66514
03d52d3eceafba9ab66e3b41600e78fe,143,117,386068,91702,294366,174,153,536741,69336,467405
3ba759cdc1341b6b52259310e6e4bd5a,108,87,260151,58671,201480,135,103,375049,47057,327992
ced4f7b2e216de6b20b06268517fd838,157,109,469431,81531,387900,156,115,441630,105945,335685
90f67fda0af4bf814909fa095510ea8b,109,80,251492,58300,193192,133,90,345000,52909,292091
9dd9e37515eac7e2f27c1cc077b1034b,37,31,31883,13410,18473,37,35,36069,11481,24588
ffdece9f0b1e156861ed45dff844f357,44,28,36264,13784,22480,42,30,32245,16081,16164
7ef8bd48d85b7c8d190b6c7bcaa0e77c,36,31,34942,16682,18260,49,38,52022,15656,36366
8ed814be9e6ac56ab5ef32ce10122431,88,73,138836,50242,88594,132,108,242159,43425,198734
74468999002fc460018db118bc83dbb4,44,35,45751,18784,26967,51,47,65992,20982,45010
8dd7d469e707e727e79b3f8e3d90424f,48,44,48265,15869,32396,51,42,70841,17396,53445
f5c45fed84f9b5cfe3339ccb18ee13ef,71,42,109610,23276,86334,89,65,104870,35132,69738
677886d799d354116065ab156a85822c,119,83,204673,49005,155668,88,74,193233,56262,136971
eb7e127fe1c9386b5ba3558a034f361a,82,64,164506,51404,113102,106,84,156129,64053,92076
e2f8624f206f993faa7685c294188ccd,67,46,88173,22550,65623,97,59,117349,21477,95872
6daf77efd034ce5b2b32831ce395b21c,138,126,354639,74091,280548,135,110,321750,68611,253139
9c487be7f021bfadf241baa47819a5cf,55,39,68801,19491,49310,48,46,54304,21028,33276
4a20006a98c2c75d3f93452216728a76,20,17,11092,5138,5954,20,17,7260,2913,4347
cfedfeee40b3054dd6c58ca44f4e77d6,190,133,518586,98253,420333,194,123,542993,85765,457228
8f36173cb4dc810d84bc6b0d4a10c57f,168,128,609620,158002,451618,171,139,636157,141472,494685
77062b04407bf04599451e0fed87e121,135,114,311428,107626,203802,130,91,374487,68004,306483
8dd82661a9ef103809b6ef1f1a0f9c1c,23,18,6925,4029,2896,22,18,7814,3868,3946
337e8d7915329769e988c56020294f0c,29,27,15580,8711,6869,38,28,19344,7090,12254
53cf54526c523333a10f007751adbc9c,85,63,130170,35043,95127,106,97,164824,47725,117099
9ee19302aff77ea2b64ffa4132bfcf93,86,69,131679,50527,81152,89,75,201567,55113,146454
de381eff12ba9891805f02922b9a3f87,95,76,199325,49758,149567,115,86,185496,66843,118653
ec054985fae9a824ceee8d625d8d6e05,135,111,345113,77095,268018,142,98,385275,78369,306906
916cb03f59a868befbcd29328981a791,73,53,92697,36199,56498,58,48,77842,25579,52263
261ad4ab69e2150ed347b60af63ff2c3,69,61,125486,42375,83111,53,47,65850,43463,22387
004fe1e8cc38a64acb5eb49448f24d50,185,139,635567,146277,489290,169,128,652349,159151,493198
c2f9332827a9aa0077a57c943246ff2e,22,20,6583,3934,2649,23,18,11890,2633,9257
25ad6b0c958aa308fb74ef4197ac6c63,27,22,14531,6320,8211,26,26,12644,7240,5404
f8a72372fdff1e8e21a9f053c136ed46,51,50,64321,21127,43194,63,46,49347,19596,29751
52dbf5232b97415e49c8e4db09c5df1e,48,46,43915,13865,30050,83,52,49344,15654,33690
a5ac1c19b14f47a85f9fdbe0fc24ddad,59,37,78870,16307,62563,80,65,97980,20205,77775
1f14c64c4ddca13a82608dde8a7799d9,151,123,670559,169343,501216,203,149,882767,135102,747665
07d61b821f1212da9654e2a94d04ef1f,125,104,289537,71302,218235,132,104,323045,82996,240049
808cfd0206fcbeb626398304c363e7ba,104,80,219023,60303,158720,132,83,216898,69119,147779
a2e1cf7df02a4930105aa743d634a26a,61,46,73024,20435,52589,64,51,103618,20611,83007
16b2308bdbbde6fa473b8e757faaec68,129,93,280603,40875,239728,118,104,347760,63648,284112
7386245ca5ee901953f133cde110c7e9,72,65,141491,40364,101127,146,108,243991,55796,188195
d738c2c2c32a12db5c45d57272d65a47,42,34,71034,19727,51307,65,46,88835,17461,71374
0ebab172271bfc52572302ce4d0f1ddb,30,21,10825,4009,6816,27,22,7999,5775,2224
a0f0ca19b4f743775b57406e87e10c10,64,36,131311,20731,110580,52,46,63819,22356,41463
9c86a38d87aee090b3b1f1356ac14eaa,32,23,21102,7875,13227,36,18,28707,7415,21292
35c84f01bada3ade9cfc7e4659c625aa,92,81,243224,51932,191292,121,87,241907,83468,158439
2b2cac6b314ef6542bb9bc48b191b1bc,173,108,335461,82835,252626,171,145,403324,85750,317574
3411513645ac23e8b3e8623d6395b3a0,108,86,222435,38117,184318,98,65,233902,33481,200421
410c039553e25e97bcff2ca17f8a8786,50,27,63768,14752,49016,52,42,78560,23693,54867
74b9c9cc9e6bf1aa6931f4d9a5985325,40,33,37816,12008,25808,42,37,27887,12397,15490
e4f19bfea9cb3dbf169daef9386f6dac,134,84,217021,40786,176235,122,81,213649,45366,168283
119771ad580abf92f6a4dd6a8d6dbd1d,50,30,52319,16168,36151,35,31,41008,16825,24183
e88b0e2f37a485c9d353b7d5a9c33327,78,50,152060,32726,119334,111,91,198082,44709,153373
b6297d3c3ebef192553f101a30722228,35,30,30314,9681,20633,43,29,18981,12898,6083
88938f10177d357b15bc164fdf9a4d14,107,77,248968,68933,180035,148,127,377801,77010,300791
7a4762172c900e4c35f41884bd55fe36,22,17,8422,2145,6277,21,17,6135,2822,3313
b216a5bb7b30d27d5607f4472e820e53,52,46,104929,29857,75072,66,46,104676,36925,67751
cce15ed3433631a0074383906b833544,21,19,4915,4880,35,22,20,10474,3662,6812
9bd87a1e3a7a8e784f00544d1dca258b,107,71,328552,62812,265740,161,115,330259,100896,229363
3b02151015b15c57cd5e311fa08a3c45,193,151,926098,172614,753484,172,122,519802,141595,378207
a00ed008dc15c6f9dd7cfe0785bf9399,49,38,53693,18697,34996,42,34,44395,14509,29886
673625b083ebdb6cb103e9d9575a3d5c,69,56,93623,30263,63360,59,45,80476,19562,60914
4b06800eb2ef399fb78087196ba51322,59,45,80874,24054,56820,45,32,61756,22854,38902
8352b86b84fa84ceae5ff61bd857b7ea,88,72,186564,41379,145185,98,76,208055,52176,155879
137827f323922c26755253fcf755e729,109,90,213064,49743,163321,109,91,197951,53285,144666
459a0779173bdd87f200100a5f1e6666,73,43,76930,13587,63343,46,51,53492,22067,31425
cb5d142d5c5a22dc799090e8854b0b48,33,21,22584,7678,14906,37,25,22400,10100,12300
50fcfd8dc0b9027a6da8d7c111b39342,51,42,52721,17955,34766,52,57,73201,20037,53164
17faed45b0bfd6d38f1c14d572d5e3e4,32,29,24184,15412,8772,39,23,25935,9337,16598
2e5249ec22cb5b36955253e7d8e8f5ef,101,68,121660,33066,88594,67,66,131174,38151,93023
6fe3be19cf0e0162872b32a1b3249be6,7,9,991,1385,-394,10,7,1728,986,742
455cc53cb1bf69881541eaf6f948b61e,5,5,860,733,127,4,4,657,784,-127
ba51da7a25eff5bc0524588fe6589422,94,85,173976,47519,126457,96,80,182876,34875,148001
6c33306c3a9dede13c064ce57b929bc6,55,40,68930,16485,52445,66,52,78809,22015,56794
5773bf1cdc3f4378a620affd5b5c1e51,75,64,76786,21995,54791,84,54,83421,28073,55348
0b9b603da9a1215a95dc02bdebe6e660,96,83,133176,47748,85428,98,71,214648,56605,158043
516904928a17cb1f3dab7bb71a398dc2,151,107,377712,76517,301195,148,106,398870,75509,323361
fa4927977517764fc730021d6d2e7dc6,122,86,367735,66025,301710,148,95,358295,55805,302490
7d542c0e71fcf9b99ef75199fbb827c4,18,15,5662,2970,2692,18,14,4849,3396,1453
939de17e016edd864616cdfee43a3f55,93,69,138117,49901,88216,90,73,132676,36635,96041
f4b8372581a638d48986029ec78c5779,74,55,121736,30251,91485,90,76,140576,47510,93066
f7c828656c902cca25dea51ca9157e71,140,91,366248,60528,305720,132,103,336045,52693,283352
747956896f1635dc6ea141b6d90dbc28,20,10,4395,669,3726,20,12,5577,1538,4039
b2b9171e9827756d2ee23909565f9316,118,96,243115,71357,171758,92,84,229521,70325,159196
e8a6ae3d4bfbe324de4f1ffeec56b96a,150,126,564667,108565,456102,165,125,432018,97307,334711
639ef9d7bd2ecbcd605b880dcbe8cc72,27,19,13920,3449,10471,23,19,8431,6619,1812
5bacc61d08fe506d47f6af70029f3adb,151,103,452416,137743,314673,171,117,601459,143495,457964
c6531a0539c0144ba0392c915d7a4ead,124,86,501920,63220,438700,182,158,453514,101252,352262
d89f9c60c65c5db2a09c3862ce80522f,138,121,484688,104125,380563,142,121,485138,87366,397772
a3a2d11bb8a7b9471d134464811ec890,98,76,208322,61977,146345,114,89,236450,62828,173622
525aba6e42bae11de08ce8ee04064984,35,31,32634,7712,24922,52,34,32606,10093,22513
76c13e6571711c691aafaf1585e58073,42,29,59805,17035,42770,44,34,63460,19117,44343
50daa153f6ffd9553d54d09d59ae91ba,103,63,194434,71535,122899,98,93,300652,58872,241780
632513492c283365ac645e5ffe9efe7e,156,116,615476,220600,394876,178,137,724608,196740,527868
41d2225795756b41e0c3ab8e5ec2c111,93,68,198442,60368,138074,119,92,289835,41638,248197
85b9d88913506ec5f3f5fb13e5e8049a,75,56,56676,20243,36433,50,42,58213,17274,40939
8ee0404925664f099cd4d18361732584,16,13,2639,1743,896,15,17,2158,1425,733
22ce8e1499b3f695e27ff1c977b2caa2,155,128,540808,113130,427678,112,90,334439,74112,260327
b554087f6fe32432a500752b42c9ec08,61,51,118371,33882,84489,100,70,161453,32001,129452
5002aa44c174e3900abfcd2783ee5ac7,44,34,31524,6948,24576,45,30,17058,10611,6447
a47c014664ba08c2d39b292a6a509d08,142,121,313989,59799,254190,95,72,177932,56074,121858
ae9f83803b46fc184cb16489eaf7bad7,75,60,100669,28805,71864,84,57,90787,21256,69531
d8d9f027b136535800a93b6813c689fb,43,43,63386,21395,41991,44,35,47806,18393,29413
1fc6f76318d32864334e3ec586206499,39,29,22237,9017,13220,34,27,22045,11737,10308
fcfe737f3880eca9a05a0db87f4096e4,134,102,264824,43569,221255,107,79,193921,39521,154400
1e6135aa68de532f6343c0083815891f,68,39,61992,12768,49224,51,47,48876,17534,31342
17db2c4ceec9ae4d1712ad2da594fbd3,29,25,18475,6100,12375,22,22,11833,8379,3454
048b59ec598fae909985812855c366dd,70,54,90642,23578,67064,65,56,100479,27540,72939
6f5504651f00f71f73b20bcbbbde3ecc,146,109,293736,75414,218322,145,100,395884,65089,330795
93a3e80a4a44c36193ac5ec425d7fc1a,155,105,419835,74208,345627,124,92,311257,95642,215615
00a45a53200f1b94d08c392dd4990380,58,53,66733,25121,41612,48,36,39643,22138,17505
330493d1caae586c843072fd19c131b3,130,93,332865,98267,234598,181,147,520566,105476,415090
2d80b07ae93c01ce690c08da8d885245,174,141,727303,164910,562393,172,131,525015,124253,400762
e3f317fd0afa1f181d3c34cba2de5ac7,38,32,29804,10213,19591,31,32,18943,11962,6981
cd43c5db9738f465ae773440776ee49b,129,102,434387,105931,328456,140,100,401754,99111,302643
64441ad99c3c3166531df3c67933fa39,118,97,218455,60187,158268,111,76,249150,73695,175455
f058af8da8c8a1691c31e4135ffcd16a,19,19,7092,3067,4025,20,17,4879,3106,1773
e8d3fe33404a855e0a2e9f3f4fadd467,20,18,6831,4300,2531,21,18,6933,4188,2745
f418416888992925630bb2737a4d3f05,115,76,190718,56449,134269,83,61,167484,49729,117755
408f90bf0e12b21fbdf1c72691e8efa1,114,82,269474,76061,193413,157,122,520508,74534,445974
fae6eda10a4f3540d11636e5ce020b61,32,24,15795,6489,9306,39,33,22342,8284,14058
7920f4fb433dac0510cd4e8c3d5e57f5,54,43,71140,21532,49608,66,60,61352,30464,30888
0978d98edb153717c2c67c75c5ce2907,58,43,73551,20090,53461,43,36,62781,21617,41164
59bec2071639c9b0f2bf0bc983d0825f,101,81,253843,73488,180355,144,96,303489,74036,229453
f9b6070a47d9bfc4cc4b892e2c18e2fc,74,59,110929,45637,65292,102,59,157395,34612,122783
c815a774bfd97b25ad93e023f42a5d59,60,43,63623,22937,40686,84,53,96676,21966,74710
96cb0ac3107264985a2977a1057a4e84,174,139,617329,99802,517527,152,122,493770,98789,394981
8915622248e16726359a16b4e04961b1,39,35,22109,10805,11304,49,33,35695,10837,24858
f22e56be3c5e63a9b83921666750ae44,60,37,76484,25153,51331,87,81,109715,30974,78741
ee63abaab88c469cec2ed527295fc153,44,31,87168,15377,71791,42,30,41377,21350,20027
662e9cc4a0c8b2437d335a01854196ec,75,62,182144,65350,116794,114,91,264190,62710,201480
f0c82055463377b4c8dd82924b45ef25,50,50,76436,30339,46097,56,45,70570,26488,44082
c21530b97d78d09bd36d175e9148c3ba,23,20,12954,6093,6861,28,20,13348,3899,9449
458e85b46a99eb13fd652c15b38d0bab,86,60,172231,74130,98101,104,74,229072,49952,179120
1ad2d249cbde3bfd491f05e0bdbb9bc9,50,44,47356,23231,24125,46,38,51876,13977,37899
a57b8ea5fd599b8994fd120e4182f3e3,0,0,0,0,0,0,0,0,0,0
9410247cc3f137425a7f734e5002ce38,155,97,546217,122087,424130,157,120,688327,141855,546472
bbf20683c5819e80b5d8242b9adc5962,55,48,57468,23145,34323,71,55,86933,21249,65684
02513471a3390cc6733e5bc1d5f332ad,15,10,2632,1383,1249,10,11,1910,1617,293
ee8141f49e8a9ba018b9e1ddee4460fd,113,93,263790,67319,196471,148,111,283823,58202,225621
1c9deef24d00273ffef3979a75ec4adc,39,26,33096,7088,26008,34,24,20368,10083,10285
4463b12475f996c7564c785c52a1ec51,100,73,206543,45234,161309,85,71,148957,48027,100930
41351a0f094a98a9f7a5383c183ccf14,1,0,76,0,76,0,1,0,76,-76
70adf74ecaa83d14cd6cab9e9ce0315d,123,101,265952,83577,182375,122,82,289353,60028,229325
642e5867147a954b1dea890890ccf3d9,26,21,22223,8517,13706,27,22,25653,8360,17293
9522ac0de60506efbe7d68d5778c199d,13,8,3414,1384,2030,12,10,2397,1427,970
07584bda99d119fbc9dd353ed2795ecb,74,50,91720,19940,71780,66,60,86109,30458,55651
18d57ebbc05823502992063353b21a35,143,102,464654,59366,405288,146,111,328770,59684,269086
5c9e30d671e29075fff326a01e8299d5,18,19,5585,2519,3066,24,20,17013,3013,14000
24a41c7da8d069af4e03a745d8cd45fa,82,68,145685,26289,119396,72,51,90329,23735,66594
fbd246e6132dac60acc4018f5176c7d6,114,79,224982,70387,154595,164,123,333956,70744,263212
356e0ba845420a47d1fa955bfd577f7c,2,2,211,561,-350,3,2,618,211,407
f4a0365d30097c433ae471c4696a9aff,152,107,353666,102804,250862,115,88,298674,88108,210566
e124df536f70680db44b7f10edfa7b78,78,62,237142,91386,145756,150,136,411197,111294,299903
31ea1e106ac5dd176aa5985602d8ba73,82,68,120342,55560,64782,76,57,166091,30264,135827
ef52c7558ecb8b4a7a05a6f50572abfe,114,84,330599,117406,213193,129,109,476935,138858,338077
064732a4493bfc91a77f3e03e60cd3e5,119,102,260935,36749,224186,83,69,150568,59898,90670
7c85078f2884d9805145a59586ade4a1,22,15,7737,1994,5743,30,15,11873,2605,9268
fb305bacbfd128495f59a9db372704c7,63,50,106819,43551,63268,81,66,116239,33426,82813
b8ff6a81df06e524086c0c80a89f11a2,132,84,260407,55017,205390,136,103,237543,52871,184672
758250b1d147ee109ee9e744f7edca5a,37,32,47866,17810,30056,40,31,67324,15769,51555
13db849b3f5817a03c2ee33234b2f903,33,20,20989,11503,9486,44,33,46688,10626,36062
e4cac18b6487e1afd5943f5503c45f8b,40,23,29547,8719,20828,25,21,13981,9926,4055
4148fc739b0e00dae8744bfc9f385123,101,83,226753,63453,163300,152,114,317607,84683,232924
84ada22bdb1417646a8f5f0ad05f2d13,139,120,422532,96467,326065,130,100,302499,58940,243559
1ca1db34043409d712d483a575ed4cb1,73,50,95056,38127,56929,112,99,216885,43069,173816
8d19ffe72b2baba86a8c526a0c0de684,158,134,501375,65271,436104,162,126,460868,67734,393134
e7eda8ffd77be3269ff673445013c5cd,35,26,23889,6535,17354,26,22,14592,9835,4757
4d9d51608369e8a705cf77096409cae3,26,26,10309,5526,4783,25,21,8269,4954,3315
7e52c800b037fe7b59daf8a8067929be,153,121,478263,115752,362511,155,131,506065,134977,371088
83ea8beae1a5a2b5294bcf4987b08cca,143,99,634388,130805,503583,177,130,711876,141553,570323
95cffd87d2c1149ae1899b868eb8130e,29,27,7044,5351,1693,26,21,7487,3311,4176
f410f5426322c36421e7e4739c425014,65,52,92569,27614,64955,55,43,74864,29534,45330
3f91074df1f9b2e60ece59db3bf8a475,95,71,126933,29104,97829,74,64,95575,29950,65625
ca2e1c7e9065cc8a1e8a1d7ca49461e5,118,94,304098,72890,231208,125,93,279674,71133,208541
6db164249bc52ffa0c1d09a1ae21e900,160,118,682021,120789,561232,159,127,487824,118506,369318
b1c2528819ad93848957641e76b64014,26,19,7816,2525,5291,27,16,8992,2812,6180
a4f89896929339524a4a6703b4e37c0f,151,122,650568,162421,488147,163,119,656788,163099,493689
12f6a89426a76467c439c6cb778921e5,162,101,605084,127860,477224,241,194,1018730,130524,888206
0ec8542d1cfb065ff60db7c5512817b0,112,85,284401,45827,238574,120,95,246156,55942,190214
bebad090c1d07cb7df90a407ddb90a9e,52,40,84524,19107,65417,43,28,50527,18055,32472
ff82dd5c200631a6737c2c98a3ba1f02,160,120,516339,104549,411790,168,145,760700,124968,635732
d44f200e0359ecbcfd63765173e0bdb9,128,85,281697,51504,230193,146,118,363658,73743,289915
35ee8e94ae1bc5d80cd0b0ff3bd97360,124,76,272273,57461,214812,136,103,325675,70628,255047
38efab9a9d2dfce16f0fcc23521ebe80,55,42,79123,27304,51819,49,40,80301,32668,47633
7fe848173b74da05972e71bed12946ba,225,167,775963,154543,621420,171,116,684077,184722,499355
16f738b425454b513df22afab19e5179,137,78,360016,64994,295022,150,114,347061,73625,273436
404c086365c17889b48a2e9e39c2bfb9,32,24,22468,14319,8149,26,22,32114,10362,21752
e3a7685ca0e76a5fafbadcdf6734396d,61,44,100538,20818,79720,73,58,90000,28963,61037
db0a8636114cee309b468abdbe8956db,153,120,477002,87586,389416,138,127,403125,121839,281286
2fea545c05cf4cd22951ff201cc88114,87,80,217325,60034,157291,123,92,212880,53551,159329
0a8b85ba65e11dc396da808a1941a08b,59,62,71392,34709,36683,58,45,72422,23528,48894
eef0482669007ffa9261ade22f0df588,21,18,7971,2562,5409,19,18,6258,3232,3026
677c33248432e553c46759542a64b498,148,114,333095,109174,223921,192,136,500858,122163,378695
1ab41b47abbf2386b3716f58a5a34540,19,17,4270,3434,836,21,22,5262,2953,2309
40961cd0032c6f086ed607452093fb25,155,131,489782,82626,407156,134,110,337714,78203,259511
3ea29ed4a8ddf21a97b8370b746b8c3e,36,27,23131,7490,15641,29,22,19770,8107,11663
391da3e4aac7f856d2cc2fb2461a977d,142,117,349856,78710,271146,126,111,427082,79363,347719
7c8923e322045e5e1a4de3045645deb9,97,68,154222,26886,127336,84,63,105680,29071,76609
8580a58f3986c2fe2392e0c2bdb314e7,226,157,885663,118116,767547,153,115,682905,136362,546543
03de848f13abc7079416f31f253aeeb3,46,42,41202,16143,25059,50,34,34278,11619,22659
c20a9310b79f4be8b1b8d5f0290828d3,3,5,170,469,-299,5,3,469,170,299
6da7d440c5d965051c763517427257d1,124,96,246269,47556,198713,71,53,170901,61101,109800
2cb54bb672fa48de2260d0c072746ae8,118,90,204221,40252,163969,119,88,212808,62342,150466
efb5632c76eed8711af1b4b8f0a1dc87,76,68,187339,55432,131907,98,65,240898,60101,180797
bbd95d0ccd8a317e6371f7517a408989,93,77,149952,51455,98497,76,70,148487,45403,103084
46b1e0dbc8c1ec4e3deba33a90b01efe,78,54,88648,38245,50403,71,52,79323,34270,45053
992a6239adab9e7ec935b6aa2d5b96a1,113,85,172103,29468,142635,95,74,109422,35400,74022
e211f4a2628e82abf98ec78c6ffae5bf,172,127,474109,92884,381225,156,98,435352,102781,332571
d5d8e881d058e54ea931db1f1de486df,38,23,27440,11296,16144,39,26,27880,10372,17508
d07120f4ef31579a635f6926b913d43f,85,80,171631,55026,116605,84,58,112418,40980,71438
4beec946027927a85176d80b5989d799,85,56,123889,27199,96690,90,67,157586,40477,117109
a9841243196eb6f7087ef94ac327985b,83,65,111485,24242,87243,59,52,96625,23732,72893
69a763cc6b448a693ecf8376551c1c2b,43,30,45822,12239,33583,33,23,23527,16487,7040
7534497e859e3c802bbfe2b7b074a82a,151,108,373501,76702,296799,114,87,310347,91402,218945
0e78f634f0d89d931803580dcf85f50e,182,137,478966,85175,393791,177,100,386304,91663,294641
da185e023adbac4ffceb17e62ace6af7,38,31,12504,6659,5845,32,26,13900,7444,6456
62632dcc6da6fd69d3593b64ee377f88,118,92,260235,41976,218259,104,90,168296,47262,121034
347c2469fc6f09272d6ba08ad9e2cc8f,143,104,452348,93856,358492,165,135,513081,110273,402808
3852dcbddfeed894d15c5d6bccc2bcf8,25,24,19377,9374,10003,30,24,24857,10063,14794
2639cc8330f83f574fb8cf96ca502035,12,11,3945,1248,2697,12,8,3042,923,2119
59b22f28779ca6dab5cb3d66f439bc69,29,23,6435,3863,2572,26,23,6261,3530,2731
57def071fe90611ea708e2bb714ccf18,190,109,563989,133246,430743,186,132,529716,135578,394138
468adf908398b7c88735f52eb655528b,34,33,37188,13256,23932,29,21,25597,12017,13580
66499094584dfc4013e9bb042e39468b,71,64,82642,27712,54930,93,74,146256,28895,117361
a1d85cbf776d7d24e19df5d649a6a3d3,210,136,1199431,234322,965109,246,186,1357117,269627,1087490
74d614e1872be9352252ae898c33f340,155,111,423173,68597,354576,123,96,319535,102391,217144
67724157daa9bb3c282270c5f7a1034f,39,34,47546,9634,37912,45,39,31244,18201,13043
389b13f315d3e456e99397c81d94f1b0,132,96,501896,111694,390202,154,122,558404,122517,435887
c63a93ceb3d38a3bd2b332a3447c966a,71,61,113265,27367,85898,55,43,86485,21337,65148
0aeb86f9450de45c3b67b658a16ba0e7,24,19,16625,6834,9791,30,20,26142,7839,18303
5d0b0b60c33288489e861aa959c1fe82,166,129,454870,80527,374343,102,83,274542,76497,198045
92f91129f8c3116649ee046791970a09,136,81,249514,79367,170147,135,111,339857,87397,252460
f63de04e35169757545122eace618a1a,93,70,274086,100076,174010,191,135,476391,110816,365575
53908e62a1ceb4eb35c33cbca0fed36e,108,82,158377,43208,115169,100,76,179736,32363,147373
4e965d43770952367c7b843730e5d440,109,74,257468,43546,213922,103,83,253410,49455,203955
8d875868bef0f54319d035559ddade5c,114,90,213182,58621,154561,129,91,248008,63510,184498
4a87e33c1d3e055534e8b830d6ce91d3,120,76,298406,58289,240117,140,109,390923,85521,305402
0fb38a0657afe49dc6f298be978675c0,42,31,24525,10989,13536,53,45,38112,10258,27854
4a01b0894a445612850b579c4d08e87e,23,21,4895,3173,1722,19,15,4490,2272,2218
aebbdacc72742d7ac47d267d3085c063,50,45,51300,18159,33141,45,37,35887,16625,19262
5aa55ed1d9960235ea39bd98f35d1259,179,121,851949,152304,699645,203,142,789743,202443,587300
00887432b12cf13a6adf0d9c2e8e8bce,187,140,804454,181597,622857,205,161,869400,146640,722760
ecdd9df65f7c6fb79ca51677d503fd15,22,19,11405,5429,5976,19,17,13495,4760,8735
c22f5f989c471f2a6350fa61ccc231bb,113,99,271679,55278,216401,105,87,269140,46819,222321
616a8e4fdddd0ba1af9608a2b2b19c8e,69,51,125511,30138,95373,83,78,128550,39708,88842
6faf7bb959cb9a514997e207e79ca4fa,76,51,125394,26510,98884,74,65,132744,37173,95571
62ea22eafe656b277fb908d37b02e175,124,95,356585,110310,246275,187,133,422454,106180,316274
606d41b28d19db5ec187efe577dc7ede,24,21,14474,8116,6358,25,21,16263,7528,8735
e3b43322307327187fb9f6a62aeeb3b2,84,55,142495,52359,90136,106,89,211407,56722,154685
5a2fa6aa9af915ad1b8dd1fd96a429b9,40,27,28530,14054,14476,40,38,33986,15072,18914
9b4a24f49b02898326f5dcd1bc9bf125,128,89,304179,55560,248619,95,82,139450,76568,62882
6ff803c64a98db73843ba196b60acbba,18,16,7832,2885,4947,22,16,8400,3079,5321
753facc5f294e509119b838447711855,83,65,186080,33537,152543,90,74,124575,27800,96775
5de51c37986cfb3f64e2e757a443f94b,162,135,557883,125232,432651,174,124,533239,115226,418013
bdde87beffbf0224ebfc0bce1ac0df69,49,39,45392,20341,25051,47,36,51234,15784,35450
d2c91973166eabf9644e3450b1d21a4a,40,32,41853,11041,30812,39,28,29088,10291,18797
54aab297a2e51aa75bf9faca55c917d7,138,121,300383,70846,229537,177,120,358092,66974,291118
b9ddd88e6eaf87ad6c19513d4f8b8709,34,24,22701,7009,15692,28,22,14662,6142,8520
7886f78b8249e993bc0e712265814a43,69,55,106848,30121,76727,64,50,74471,36127,38344
780bd2e4171022dd383cbdeac66cf4de,144,81,412072,106382,305690,112,79,384796,116911,267885
debcd5cca081549a708d8540a9a4b61d,34,29,23053,10279,12774,30,30,19554,9569,9985
fe50a602030c257d007f40b0c022a8bb,45,40,53938,11480,42458,42,37,28356,20547,7809
253f2c20163d695afcacfd40c5df3980,164,122,503178,67214,435964,174,129,585699,73605,512094
525d2d15cb14dc02bdc29739506356e1,31,24,21660,6066,15594,24,18,9513,3882,5631
5a89a46b3fd3bb8d6b92570eaba69602,56,48,104282,30715,73567,61,47,106555,28948,77607
28dcaabf523fa9a27577138d28b3761f,93,82,155357,43553,111804,118,93,192989,37933,155056
5625586c6e8e733e7c3d38e73ad44ada,111,93,220302,47827,172475,104,74,207889,39902,167987
1cc71a5ddce1c3a91916292638d09138,121,108,324308,62415,261893,171,126,522736,46687,476049
b552c81130612bce88ccdb15cde0148b,130,107,414418,99272,315146,176,136,534854,109287,425567
6ece2c9ebef113a0ed56259fa7db0461,96,67,220927,31519,189408,95,86,168582,32760,135822
9627e475abd93139a5e8e9a2c512b4a6,81,66,123689,39062,84627,73,47,105801,20279,85522
ef30e13a072596f8ede102406e5059dd,163,105,426684,114256,312428,192,137,511051,136512,374539
96abbe5ad0a0820029e0de89f3fc1abd,172,105,339429,72663,266766,113,83,285190,68420,216770
ba6b454fb7e231f4e616e5a814cab64c,60,44,88395,20741,67654,52,45,60890,22041,38849
72f0ce746729d51d005ef2fbd202d317,39,33,33299,13974,19325,53,42,28689,11222,17467
b97a6d5a43987f814d779eb4aecc2922,36,27,31803,13638,18165,31,24,33261,11425,21836
ec72b0897dc817544165c9e4480ebd39,58,39,66880,24425,42455,56,45,70200,28805,41395
16ef45bec3ac4c13b3b4c5edf4866c23,108,79,259936,81449,178487,124,109,332836,78170,254666
f04cd811f8d711119873b2a59290e23c,162,131,435426,74357,361069,110,84,236627,62893,173734
2449c5ad52d6f44adbc7910077047356,203,152,661506,123611,537895,154,115,542284,169917,372367
04e026ad70eded43bf3b037cab5afdd5,238,140,1148981,260763,888218,201,154,1325151,337843,987308
debe24665148e7783ea8c2ad3b1a3628,78,62,164678,43788,120890,93,82,175349,48206,127143
d222a781aa9073462dcc30bac4bc515a,29,25,24109,10305,13804,30,25,16569,11073,5496
4da14534e9567bfb2637ed1dda56544e,221,140,626857,118590,508267,183,149,863716,159508,704208
97a9277b105dfa7a77b01d0061b14723,77,41,242948,47407,195541,83,54,248842,64182,184660
213a1e9b695e991fadba4bd51a488b4c,143,109,453179,73083,380096,124,91,250756,65091,185665
ad1ddefe8b8f759672f360c3b92bb0d5,116,91,346431,72109,274322,132,83,310091,65455,244636
094bad3168d054e8f1d12b22a19498d6,155,122,583057,131268,451789,148,102,519437,98492,420945
669240ce2271316e85a8cc7c393124f8,28,21,13875,8739,5136,32,23,19400,6223,13177
dfcc2a1bc2e189b615bb091c2be063b9,80,68,96049,31758,64291,75,56,106757,27285,79472
653f7aa5263706d3c8b58195c8a6186c,33,20,16904,5647,11257,40,18,14993,2678,12315
4fb978b415b947d13a41d8b8e5fe0466,28,26,25985,13353,12632,33,28,22699,10717,11982
3befd8172bca7f6c9d02a8b36dc505d8,139,123,397913,95172,302741,109,80,284968,80243,204725
216f73d0a8728aafd91105ca6ec0cb72,137,97,401374,93226,308148,139,124,425333,142774,282559
9017ed32f76c386543077643ffe484c7,151,112,615827,108870,506957,186,155,536565,97854,438711
0326aa4e971abb8f39fa0e6d6780589b,29,23,14297,5603,8694,22,17,9389,3044,6345
abbe7a06bce9c4977798e3b949341b77,48,42,65379,30142,35237,51,42,73208,25495,47713
cdcd9c0332a8f479266c69d81f94c6fb,120,81,388615,101984,286631,140,103,468050,97751,370299
420189d8b9066bd0c5effd70dc019ad7,142,111,449647,95545,354102,178,128,526040,92975,433065
dc12d870db48651733fcb3993d2c0290,25,20,10806,4807,5999,24,19,10693,5168,5525
f801fbd9bb308006b1a533bc354bd48a,41,36,45470,12400,33070,53,40,37569,13127,24442
fea08ac1a776024ba92e9f73a610aae4,72,53,113487,20332,93155,109,88,124265,32771,91494
dd9299d2f794615f21c11d2340a46772,152,108,464203,71784,392419,155,125,445346,117079,328267
7d6609a0518ed2a0735f9d5dfa79005b,173,141,492823,177893,314930,185,123,666954,133446,533508
637f39bd2ef96b8bcda49d651a3a15e6,108,78,204379,50715,153664,66,54,108792,66303,42489
464204b99b4269d68cc3051e49c36cc3,38,35,29277,8533,20744,49,41,42661,7918,34743
1dafa309d0eb9d4de96aeaa6a515307c,69,60,92834,35725,57109,69,62,110832,32178,78654
a3077c9520d6f6f8cc3d36ef952523c6,106,79,243530,52084,191446,149,120,300818,70717,230101
45f0fe9eaa18e985f2c5d74ecb7dfaca,170,113,470558,81339,389219,177,132,553650,104146,449504
49ac49dfaea80792cace1760aa250e97,132,101,309238,72637,236601,142,120,344847,83289,261558
7f328c8e3d960cee2acfea12453c07a3,7,8,1923,843,1080,9,8,1449,2070,-621
60e7a182e6b76c1266553c924dae9a3b,29,24,12240,5243,6997,20,23,10072,6761,3311
c979afdf9e2ee28b0e9981e9a92e1875,29,22,26871,8673,18198,28,27,19723,11230,8493
dfcaecaaf81d749da0945e44e4a09e4b,136,106,320745,99642,221103,144,94,374306,75425,298881
565868914bce3c4fae256b12f224304e,104,79,167706,41621,126085,89,62,132973,34322,98651
6b51643380600251ec53e588b8edf32c,100,89,200750,45152,155598,95,76,160417,48358,112059
cffca6e93dc304f7dc3bfb6df6dd2928,53,36,53214,14144,39070,43,33,30713,10905,19808
ac9743cd6eb161ceff2b9e4d14b580dd,58,45,62281,17060,45221,51,53,49018,22062,26956
a65048b9bd1c968d7d57e1b57e1f71ec,49,39,45131,23316,21815,56,47,45102,17267,27835
0e9e97a15eca0518b0395f11dcf21d4d,27,28,23939,11965,11974,28,26,21751,11699,10052
952edec95cfec2ba064f71ab52539629,19,13,4622,1902,2720,17,11,3295,1342,1953
163a8495ceb3574e40fd52a94135dde4,112,100,214230,57599,156631,72,54,106157,47628,58529
e4dcef45509e6a9caa9161baa7572617,154,91,337353,105366,231987,192,106,425987,87565,338422
6f92f7f4d4249f049206f9148df5ea67,18,14,4490,1714,2776,16,11,3299,1797,1502
e59b074f8ac701f1029a83a99c113efc,35,30,41077,10284,30793,41,32,37227,10621,26606
a55fb2c835a091fcdf530b05de679f68,53,33,60468,19622,40846,53,42,86079,19210,66869
04b06e13eea0ed9b0f2fa4fb3fbd064f,136,108,293103,82426,210677,78,62,183862,76040,107822
b21bc796435ebadbf594a126324c54ca,16,15,6287,3223,3064,16,17,4901,4013,888
102b101423f407686047c25efae0bad8,86,63,197184,42344,154840,93,78,193680,55909,137771
9170be1a223776dd2745fedbaad84f41,122,79,203289,48977,154312,117,93,239969,55064,184905
abbb328c08f0a5ed1829148108d0e413,179,142,618732,133645,485087,148,125,576175,98274,477901
60d36fd0242159237314a04b324ffdba,36,35,31333,13865,17468,45,37,46704,13411,33293
338d8ea16560d0e6bed659f59cbddfe4,69,53,115366,31900,83466,109,79,142203,37105,105098
9652fc84d36bfa47ec0b83d29bac7509,130,93,259714,52525,207189,111,87,221914,63675,158239
220c4efb0ac2376e8c65b370b6416d60,93,65,163493,36731,126762,72,59,123341,32829,90512
864d4113be1133a4be9ff4650e1ba5ca,119,79,340170,63712,276458,190,148,571412,98446,472966
16a5c05645762cfbfb2bd061bac62cb3,145,108,322649,44989,277660,117,91,197191,50499,146692
88e001bfe0e393715d366bc350afca21,36,24,22509,7147,15362,28,21,22143,6628,15515
b9928d4b43f10f6bdc43a023ac2b107c,22,25,30435,6340,24095,28,21,20489,5696,14793
39ba28f8b0c1c05a1bbd47653bbcb98e,216,177,900275,203954,696321,188,142,735005,175485,559520
b3b4df323c695baa16f4ebed70892a90,140,108,318223,79955,238268,113,99,272216,65876,206340
e621ec3d9cb84137cf645234e016d530,65,44,79992,19254,60738,60,57,88885,22857,66028
c69f31e99874bd58690537a52a45fd20,84,69,152468,48141,104327,128,104,291327,46762,244565
880acb0a919d1aa9c437d9d406c6d2be,24,14,9878,3419,6459,21,14,8838,3145,5693
5f49d81e1ea30102b9c44e1f208b54c4,73,53,80808,21275,59533,78,56,78165,22666,55499
a5143cccaa62b4105dce1b948ade374d,101,68,129300,32821,96479,75,62,108122,38725,69397
cfeeee04c3b6897998b5e8f6eb9ba2e6,157,103,455708,103594,352114,120,103,341156,108966,232190
29309c1496947f7786645ca1f09215f2,58,41,53724,17236,36488,43,37,34292,15672,18620
d3eb768069855fcccc878de2a3d59aec,77,65,145582,62419,83163,135,103,288180,38823,249357
8bbc86789c06e2633372b0b9fee7068d,44,35,78166,21278,56888,51,39,77852,16531,61321
e8199c24dbaa854c3dad257b47369eff,117,84,263264,50899,212365,115,91,240979,39533,201446
7609047c4dfc96bf94754eef21e94f52,141,122,472207,71363,400844,152,124,408177,80087,328090
b17d22cd81561d991321e7089268bb0d,121,106,359281,75597,283684,86,71,253334,76607,176727
e40b3b450c5a9b850f205bffea8802b6,30,19,18718,11658,7060,34,30,30199,9264,20935
27f8a798030d627b5f1c369b8beb9841,47,48,75182,18448,56734,46,41,33685,17510,16175
90b0a1428465619d3bf1d96dabf4dcdd,89,78,92187,36472,55715,75,58,87022,22888,64134
d31431ba8508f0a7039383105eee26c2,140,112,420757,78073,342684,139,113,369692,62138,307554
9e982c714c90c3a270484f5d7357b6a5,24,22,10642,4780,5862,29,22,12733,3495,9238
8771f1dcb2ccf3ccec9403e699a46c04,81,71,174736,47280,127456,103,84,258524,44441,214083
0e0723d65cc1be4955ea34da45993e01,93,68,178647,45357,133290,122,85,209242,42600,166642
048e74ba128b10ddac34cfba7e3823ff,26,20,19534,8491,11043,38,26,21285,7308,13977
73aa48ecc847722f674ccd463474383e,96,76,161606,51751,109855,107,87,181459,43938,137521
afb6be4bda05623c30e7ab94b8408b25,45,36,37327,12896,24431,45,25,27454,13469,13985
b2b5c7d7946ddcb652036cf1fea206ae,57,34,68290,19206,49084,70,52,77353,19332,58021
e37c1a10f5a415a6fdff67af3ea6a0b0,83,65,83964,30492,53472,112,62,114901,24566,90335
7f1db7912c340544ea3594d1bd0d7152,249,164,958899,178053,780846,170,109,795559,207632,587927
8b28929352c1e3e08f2609ab8244b013,96,71,191913,46553,145360,87,65,148336,52327,96009
644693b9736442ed32348aba4d5fdb23,40,35,36822,20206,16616,39,38,50354,13322,37032
92add3e4ab23728cbb45bb27fdd4d8a9,56,45,98259,34007,64252,50,37,82440,27085,55355
850a6ef1615eefe9d6bf4bfa10a12a61,84,73,128771,37209,91562,74,68,112101,41924,70177
65978541d69d5cdd16a0cfb8e5072dbb,67,44,100323,20974,79349,64,63,83973,33926,50047
7e211755a027ec34ec08103b394c31c6,121,77,305998,78771,227227,178,138,634355,80659,553696
49064cd211b3456a35f795acc1668803,169,124,446724,122848,323876,192,141,628293,92221,536072
00dabf2606f8700ff22f1ded8fc97476,75,55,132139,33706,98433,54,43,115073,33022,82051
2fe238d50e214be99bf2160e2648001d,31,24,35231,7236,27995,31,25,19541,11775,7766
13aef93381385b6a043345a6f28795de,88,72,159012,60139,98873,87,51,172180,38837,133343
9fe381ce4cdd43a2d280c2a3b024ee32,126,101,297883,91433,206450,112,106,301343,104154,197189
717814444c966059697a3586cf30da93,114,79,240684,55720,184964,119,94,230787,75296,155491
689de3098922a3e35e566bcac851bf2f,115,95,259011,58544,200467,95,80,220329,51355,168974
a96fc2164a9428333b7e73bf2615bf2e,127,119,389473,110705,278768,134,99,432301,121135,311166
0b93b1ff43c96285d910e359e4b0ed4e,167,133,620108,108507,511601,159,136,474602,101314,373288
c14782fda32f11b5fde535f051b35e6a,30,20,20122,5406,14716,35,23,13165,6785,6380
5615da90420221cf0527e38de19a1672,62,48,82524,21743,60781,81,67,132633,33495,99138
1aaf981cd7e0bf555ee2213c0af47912,38,29,61980,18438,43542,48,34,66893,14689,52204
089d93ee8b74c1b7f8c0e4f0e6ebbd60,36,38,25399,12648,12751,42,38,29089,12862,16227
57a6ea3fcf980c64c184ebbd4c840f6e,79,59,123202,28652,94550,124,100,169502,31339,138163
1ca33c777a2e26ddf83750f3bdb4426d,144,121,469955,95006,374949,105,79,316303,84870,231433
7a5105c1734eb260f49d91f86e319523,80,54,77283,31672,45611,74,66,97717,30481,67236
d69a7266c20e2743ceb1ac2f05314c6e,35,22,24454,7787,16667,37,31,29321,10878,18443
b2c2542cf3bb630cf10fcd7cfcca274b,159,127,403852,52456,351396,140,101,322446,53316,269130
3f2dfc51ada39120e04eb76ed0d23052,175,139,471157,88032,383125,158,124,464884,91881,373003
e0216620004ce3128b2a92db8aa3303f,156,115,480033,114384,365649,168,132,572511,95541,476970
325fbd88b71d8154224ca2fc99390d93,13,11,1866,1503,363,18,13,4450,1588,2862
5ea7df7d1f0db2ee7addeb56778ac13d,141,118,365839,98356,267483,124,111,323129,104583,218546
51b90398c9e87679fe9eac91c409b092,176,138,550903,132023,418880,190,152,657459,95667,561792
a06d91e8af1af3821466d86aae7a8e9a,160,116,362689,95223,267466,114,88,268591,68060,200531
5f02e26d39f72c84d2e3de7db1fc40af,26,19,18881,8214,10667,27,19,24548,7537,17011
ca2491ce7a4e6df153bd5d2b8559beae,95,84,169390,38050,131340,79,59,112299,31793,80506
5e2df2f6cee50883fb8822d6594baa8a,76,60,98505,38014,60491,83,63,150497,32906,117591
9a93df11a98f2231c96f5ffd051beba3,172,126,750754,104583,646171,204,120,540388,131344,409044
cb9f44e6fe97c8b0acf0c541492d9e6e,158,109,627672,87906,539766,202,153,625206,146615,478591
7b40b2461f6fed2d511f663cae3d33a8,132,104,354234,95956,258278,222,136,600460,84204,516256
67684d66be387db71746f72724b63df0,122,75,226611,46885,179726,131,96,230937,59881,171056
f377e578bfe33ab4a2621f6bba911948,71,52,83733,19356,64377,74,57,53674,19837,33837
a26e6f2fd287649bec88d6f823bee30f,53,38,39569,15357,24212,53,40,41354,17619,23735
6ff4ae1e31937585ac4b2b94ee1430a4,70,62,109196,34561,74635,88,75,118507,47154,71353
7882cb66907fd67c36d437b9ca0e2dc4,90,74,163618,63661,99957,125,105,288141,53911,234230
656bb2efb56967e401eadaad1fe38c44,24,23,14737,8293,6444,25,18,17442,5683,11759
c4169698ae0c178ada6622bbda4822d4,31,30,24604,14816,9788,33,27,29088,9502,19586
735a04e3032056f52e7a2c96e0db2aeb,176,102,398287,74951,323336,172,124,471374,96182,375192
4f0391df83869900f1f5800ec97282d0,193,142,729100,179103,549997,172,116,949055,145730,803325
1dea7ef3ec56c03584657e015668c75e,124,97,280230,64546,215684,128,96,293732,47553,246179
668514a991996e6a04af5e3b2a727be3,173,119,754426,169359,585067,199,134,582103,133193,448910
0cdae3df5053ff39593a6fded42ac8ee,169,131,576791,107727,469064,169,125,572517,127535,444982
658cb6333b6950fe6dea6a12093b0700,30,25,20730,6857,13873,27,17,17354,8937,8417
d7c9c2fee21db3d9f9adc63ebb1fcdf6,70,59,68244,17069,51175,57,45,59252,19507,39745
4fa17e77adc4eaa6e9255138371e5d0e,45,39,48240,18737,29503,62,51,76811,17059,59752
daf04204b47178f992a18b47534557d4,19,14,5819,2630,3189,17,13,5983,2332,3651
4b7471d6e97fe1f43ebcfa99f300ee14,150,116,412544,117482,295062,158,123,559639,137324,422315
25e1dffa706c818f7bdcda5f2c6aeeec,75,64,100612,23194,77418,70,56,95871,19926,75945
2eeba65f93dda225188365a57f097318,133,91,342605,71454,271151,109,87,276582,69878,206704
f70b8b05031e6065f89166bf5e8e67a4,3,5,277,653,-376,8,3,803,287,516
ace3abd4994ab0d2ea0e839fb7975fc5,70,62,84329,19566,64763,69,46,96070,23255,72815
c288aeb53be4a3658d3fb13b4d44e61e,169,103,353352,78186,275166,134,113,556686,83953,472733
16fd0bbedfe74b9912abd3d07131d4fa,108,79,239820,49418,190402,104,91,249400,63789,185611
35fd9641a065d749d85766905a24a750,103,77,219597,58408,161189,110,76,231936,39992,191944
184e967ccce5ab5ba636ec8f62e72410,136,102,477453,62494,414959,142,107,396852,65868,330984
513a7b05c403a4892f7622f96416ad08,51,45,68518,18221,50297,50,41,47656,18831,28825
545c27f549d987841f09125bd8b8a6ce,35,23,12635,8029,4606,32,29,17873,6617,11256
1be2367e58fa1e28d0d253e3874adfe6,42,36,45061,17059,28002,43,39,33181,17610,15571
f3c528adf67aa7b8d29082511255470a,77,63,165028,47134,117894,94,65,167485,43576,123909
0a685af40e02bf1ea1686584508a7782,51,40,49267,11944,37323,50,39,30960,11780,19180
ab14b2137f96498c8381504aabfb1d8a,166,134,602082,139758,462324,140,117,562043,117642,444401
fbe761f2ef45b034cfec39d7c5fd4a41,40,29,19798,7819,11979,46,28,39592,5679,33913
7719a9754df5f18c8da729da180290f3,139,103,305608,57689,247919,118,106,328522,69354,259168
50737a87cd6b9b7a2f3147d7007e20f8,91,63,201351,38629,162722,71,65,118503,49687,68816
9e0a77b269f3d9889a4e11c856c36165,41,36,36965,17584,19381,50,44,57786,17291,40495
cd4eac3b228334efe553231682585573,114,80,187293,27881,159412,113,94,192748,40784,151964
ac15e8b550ad0bc18277e9e8b016f2c0,30,22,24565,12418,12147,33,23,25326,9987,15339
5c4e59ff7d767b8554bf92ed05afc50f,95,70,215151,54128,161023,102,80,185534,63153,122381
8217fddf53475446f46749f8f1e6b9dc,79,63,171997,52527,119470,106,81,200633,44903,155730
0c3c6c66779190f6e22498ea09f8003f,38,24,38580,9764,28816,53,38,60078,16377,43701
0fecbf9754a7dbf6c1bc49bf57875fa3,100,84,312687,91887,220800,156,106,398359,53398,344961
2ec2d8099f9d15f36393272a0b0fabf1,100,88,224509,57249,167260,125,107,255596,51582,204014
1b106341e8a6d944c91b5249187b549e,65,46,75362,21622,53740,73,57,108020,33503,74517
c118b4c14a71e00c0677701bcbf62463,115,94,230560,67614,162946,93,66,173504,59078,114426
d0f99d766d084c01561d22c877eb37b1,22,16,6909,2418,4491,25,21,7076,3297,3779
b14b5910d99506e105fbc66e4fb9140e,210,163,730291,142315,587976,195,138,836061,110504,725557
127ca6f42472e179246ba5e7db38c729,112,93,192122,34823,157299,108,91,237573,34494,203079
67eb01c3511f7565e3cd4a83677dd3e4,167,147,543608,113165,430443,171,124,599644,98583,501061
40f0aab68e72be4a1acaa77914dff5fd,81,64,86722,16989,69733,54,43,60197,13561,46636
fb767ec0dd696dac3b7a540855adeee5,137,87,317754,76974,240780,161,124,402919,89153,313766
92ad2aec65fc13eca06bed159c1e3b8b,56,46,60286,26280,34006,44,36,66111,27668,38443
fec1e815e82db0da4bcace7d42b6272c,83,71,127240,36032,91208,83,55,135975,29232,106743
39d6b1b35f4cfa6ecae1a1956fb60c4b,53,47,119814,26679,93135,41,31,57050,19118,37932
24ce1026fe136026f06e335b8d04e9af,28,22,20819,8840,11979,29,20,19662,4818,14844
609b8b16d7d08bb539d9b72179e129c4,64,47,77121,23139,53982,69,57,106120,20341,85779
7ee42044e8c64b1e6b2a1e770cb3d933,205,163,710606,99828,610778,155,110,486503,100312,386191
1009fe22db8bfe86f00e8b2e6820c200,65,52,106217,25022,81195,67,63,98505,29955,68550
1e94800792b25593405a222958b50e36,122,100,364248,96869,267379,146,112,440175,88443,351732
5ac1c9d2f553102c757bcc35a17d5895,57,45,64625,21416,43209,90,76,103738,25666,78072
56905fa86ca9d71cff2279a09c1da42e,158,94,418318,107690,310628,182,119,567545,112357,455188
a090cbb3651131a539e92f49db892415,26,21,11866,5846,6020,29,26,14746,5163,9583
579f79820c33ca23c91db7023ef03431,106,86,244610,49279,195331,137,116,331008,71716,259292
5de6baa83375390aad68ccbbfd095bdc,103,94,221589,79395,142194,126,100,316840,69725,247115
e518f3ce7d3885103a769fad362047fc,184,133,613645,127309,486336,164,122,578214,140597,437617
a183eb3ea6b78dec08d608b15978e04c,133,111,260231,75723,184508,154,136,368106,93957,274149
f2a8f356c69a43442a111a4d6d7e5525,118,76,208181,72366,135815,125,87,252084,64581,187503
250522c777e1415ffc7138e53ec2671e,77,58,130426,46072,84354,103,60,154421,31511,122910
6777e95462a74c1491a20e3b5edfc4a2,96,66,172220,54444,117776,136,107,310305,62056,248249
24150970106ae4ef0ff8a032519a76f2,121,96,273063,70166,202897,122,90,340747,84571,256176
f232dc8f0b1fe9cf50a50f2185ea84d8,66,53,113651,38974,74677,105,85,154730,31908,122822
ba9e1b83a46f171ce8e2771b37d7abc5,78,63,102642,36770,65872,74,68,110519,34817,75702
a5a1674c37a1595bd5cc2570fbea9699,86,57,164628,41940,122688,79,63,145269,43919,101350
164fd328a9d6aaf32cbee3eb87fde1a8,59,44,40918,24927,15991,60,43,88212,15463,72749
690e5e701c7681ec370b8319f6c4bb0a,23,24,12735,10399,2336,29,16,18361,4239,14122
7ac51b67c8011487cd86fb44b042737e,26,16,6024,1962,4062,16,17,4002,1842,2160
7d682dcd67d8f4b0f570a9ac30ef9a4c,143,108,310300,53210,257090,146,114,315408,54942,260466
7849f5b0097273bb45096db471eb3570,106,92,186734,93752,92982,91,57,194644,41701,152943
30ebf71fc2d1bc3f4c71646884e0b6b6,101,85,178775,46507,132268,136,105,292014,49471,242543
edca73a6885e60d1cc1608381b959912,140,105,287863,50599,237264,125,115,267955,54623,213332
8916ae28b48afd8fcecb7fd4dbe2b131,192,139,819520,188305,631215,184,144,1022238,218625,803613
96e15c1de268e56cd27c2d72b760143f,60,56,80687,24151,56536,53,42,54022,18835,35187
74e1cb1cddc00f29dd1c3772192c03a1,181,117,563250,93366,469884,179,131,605039,108080,496959
696d2c81e93d96093a49061414fb338e,209,157,953099,291127,661972,222,174,1159001,197619,961382
982dfbbea9d6d9ce5ed28aad34f959f2,184,156,652082,97520,554562,180,131,545288,138810,406478
0936b55ce34a1dcca750f48ab7c31307,67,50,93095,20096,72999,59,39,70576,21044,49532
7084b4a93ada775bdb156042bf4f3459,22,18,10302,4543,5759,21,22,9549,4717,4832
c76d3a493716f5852a955bfa7c51134a,33,24,28880,10352,18528,31,26,29863,10608,19255
ee2e1f7c6a704b7c2173ffb0bc9b0069,79,64,112628,36884,75744,90,83,197686,30179,167507
a0a10b2b3d2ba1945da97e6856ba7b04,33,25,42996,12754,30242,40,36,38993,16725,22268
e10c0238c5e2607d8037b4d848662f26,50,35,96200,15003,81197,49,43,57825,25181,32644
041e8f532452c18e525863c792f05b70,74,58,195947,77287,118660,167,131,315996,113669,202327
59e8376e95f323b6dde29e5f840c2814,115,89,310992,83152,227840,159,130,512151,80723,431428
bc06479b7ae5ce83d2399f808d078103,31,27,14716,6014,8702,36,21,15461,5450,10011
5cb5be97ae83de72141b5e8e4e29624d,101,87,200792,61180,139612,122,98,266410,56908,209502
341e879963188d14f042e696923c383c,186,146,539056,115016,424040,132,101,441116,110405,330711
fdb5b466bfbc9704df4700fdccfe227c,182,132,529330,136793,392537,142,102,486145,118920,367225
29e9346dab1ef4632efcd64182e09760,83,65,127342,35384,91958,76,58,114531,36624,77907
7d9a6400f3925770af57ab33f86c157d,72,49,123899,35452,88447,110,79,184177,30656,153521
20651e998937ed13c9be7aaba33bdd1e,140,96,417098,118676,298422,150,125,566244,116107,450137
da74748406b21acbaa580144d2598e14,151,110,552657,129570,423087,207,152,777154,95406,681748
e1b620ec2ddda40e199ed01c90185692,25,21,11729,5906,5823,27,20,11778,4399,7379
16e03a8e80b8ccedb663c591f6433bdf,214,140,728483,168526,559957,204,138,748756,152931,595825
900b77765660e91ea8932eca5ac3d86d,47,27,37404,12009,25395,34,26,18721,13424,5297
135d1af3b4cc097e09920f99bd858df7,65,44,83293,25116,58177,59,42,90056,23911,66145
7419a795fac10701511aed581e377cfb,154,103,614319,149278,465041,174,127,644183,139197,504986
2db6a3542584efee8b9a5278ca0be973,161,116,390261,83602,306659,137,95,442173,41730,400443
4b56c095ba542e177b1f6ced7bfe0612,225,164,812240,204052,608188,202,120,972148,176161,795987
2ad9d65fab1c320809b08a9841869cf7,105,77,239509,55909,183600,130,106,255585,65732,189853
aa306c4e733bfbe1ae368082da7f4d66,127,100,303469,57754,245715,106,84,187828,53774,134054
c7b2e06b2adc16c3202821811c12e13e,44,35,36420,13406,23014,37,30,35502,15785,19717
497a955dfe81dfed0d372525fb7c1d8f,88,68,142787,33596,109191,61,51,88136,40980,47156
ff91b42d0f91eb5cb4a76ffd10cfc01a,128,99,425939,79862,346077,126,91,304605,81670,222935
b348c0300ed0b6157eb1626bb3a72352,54,36,75315,13994,61321,49,39,59775,17761,42014
e442ead6c7bcad9faced8ea09b430e2e,30,19,15462,6982,8480,20,17,16098,5344,10754
aca1d201ce692a2c6012c91cfbcbbaba,51,39,89925,31062,58863,56,48,73662,34462,39200
bafef78cbdb5dfb938b0df9a0accd5a0,30,22,11432,4720,6712,27,19,9798,3438,6360
07dc4f25f7cca5270c8c81fd90b6cd19,10,9,1190,754,436,8,12,1067,902,165
e41d1b826d2929ccfff93e02a0bf74e3,134,113,318138,73757,244381,136,101,348780,53691,295089
a36f86cad5d5346ea1ea0d890dff1e9f,60,40,59541,14467,45074,47,48,54593,21504,33089
7ba6a02fc86e75cdf8bf0953066db955,23,18,14649,4741,9908,25,23,12496,4067,8429
2f1b1f439ea672f6cf12c33411959b36,26,15,7339,3991,3348,17,14,8053,3377,4676
f74938a1acb1fd9d2384b10cad53e317,138,110,365285,89426,275859,163,104,422925,66478,356447
c44d04659da3855b98eb480ad135c388,92,75,183263,47254,136009,92,71,185399,52570,132829
b9186fca29a030e54af5ccee80204046,53,45,62831,26942,35889,53,41,66403,22557,43846
c622bb6e267ae4e8594eed5feefd6a67,150,110,522499,108948,413551,145,115,525958,101183,424775
eab264abf2ce777485ad4225f16f8471,61,50,76528,17559,58969,69,51,67186,20660,46526
b8b10dc237f3f6993cd85b45398461f1,67,57,148588,32141,116447,86,69,119953,39116,80837
a6ea2585c67600cc198f38c19328d9cc,24,19,21941,4495,17446,24,20,13700,7953,5747
b7f944def907dcb175b4918ef2d13b41,193,150,798459,107253,691206,181,102,616070,111429,504641
814c548938319ab4b85f7dd3fabf9e41,50,43,60861,22715,38146,48,48,59501,23256,36245
33a275193f7b3a1f41c744891eeb2430,41,31,20399,10192,10207,37,38,23387,9919,13468
530acac8e617f2735a55f48b21bfb48a,61,57,101069,28452,72617,76,63,94258,27449,66809
c968133c87f584a26104595f4462b881,50,37,43089,10693,32396,40,33,29067,7469,21598
dc2d2fa4c136d364b75ad288bdbb6559,30,18,13637,6733,6904,28,21,16438,5930,10508
aae4a56abc8141e1189b0fa9730f1730,59,42,53755,18953,34802,45,37,56220,15795,40425
8ecbbbf820689f80460b34b4950f755e,145,109,328189,74586,253603,131,92,298306,63438,234868
835afc156b9c7784260f065856f5d45a,147,110,431917,86387,345530,167,123,406086,74520,331566
1d11e2a32b663fb9b3427bb448e03aa2,129,102,250383,68974,181409,149,121,380588,66213,314375
a00ad05cc915db4d46fe6432df1cbc53,38,34,29848,15393,14455,41,34,38869,13704,25165
9a4a54bd4e2055521644df7795428d0a,15,21,5198,2989,2209,22,14,7328,1623,5705
07e206147b2ebc1680871758f6604fbe,15,11,4141,1267,2874,13,12,3141,1103,2038
a4d2db354bfced8e752130c0bada969f,63,50,94420,25768,68652,54,42,57263,25798,31465
96bbc050e15d220ab933196780725033,131,113,344010,84686,259324,119,101,303921,73300,230621
a7e8b7b78074f1a1cd86721d84f00def,81,65,132859,24059,108800,72,49,92436,27510,64926
f7f08cc6ceeac41b6b6594d52cee078c,82,56,133451,47924,85527,105,73,154105,54206,99899
fdc11574dc3989565fc68d7a4c95639f,141,105,465135,81356,383779,175,132,600177,117070,483107
b937bc1b914de5ee978ff4955dd23937,81,76,113683,46952,66731,146,85,236223,37219,199004
c016eb59da8677762a7b30cdf40e5026,38,32,34984,18293,16691,41,32,48307,15168,33139
014626b9ea9ca26d9fb7163c14ab8520,29,21,18623,4596,14027,21,21,14692,8877,5815
bd6b3b3698c081cb97e3d2d19eb1143e,138,112,329059,77135,251924,121,103,289879,72106,217773
308f0db1534cd2def323d89643a41005,61,44,88036,24735,63301,53,40,46307,30241,16066
5810972de398f5f8885d76df64bbdf49,124,99,264864,43586,221278,124,83,242353,44108,198245
f0eb1f97a12b59d11ba293be201cc861,22,9,5696,1179,4517,13,14,2454,2415,39
d68fab41068f9fd8859fa411c201882a,195,147,862836,191562,671274,214,139,1537033,162243,1374790
2846b4e6909087f87808c0cd78f01a26,198,132,551682,81394,470288,144,108,356346,90455,265891
d284e18fd1fbf62a5df10fdc65bd3147,6,7,736,1547,-811,8,6,1595,736,859
79db88a3885d42f4383eb681ecfaa4b5,33,23,17613,6150,11463,26,21,9954,6517,3437
6588c74bc1f460a5f00d1f6a97f0e2a3,101,86,182427,31113,151314,110,95,186733,44472,142261
9eddfeaf805d58ed6330cbd110ccf873,43,40,41108,18849,22259,55,39,83120,12091,71029
37d0db1ebb8fec5a6a8aab559207f5b3,143,110,350554,63778,286776,104,86,212773,51503,161270
902606c627f08e38c6842c5c4d4d7179,128,100,309893,48587,261306,139,116,306924,68309,238615
93338dc920716ea53a3329035bd72f0c,51,45,82514,26543,55971,59,46,104008,23476,80532
092454bc5f94a85f663debe78e2e41a9,154,125,325547,60490,265057,115,70,328794,75340,253454
c7fe9420c7c6218a2807cbba2e8fa1cd,24,21,7258,2530,4728,19,18,4510,3962,548
909f6b76a5bf1cf7d8125f4f405cb681,59,46,92322,29077,63245,65,48,122148,20343,101805
645839bdf48e3995e9417df7af6a4d53,103,80,161467,48805,112662,118,84,214574,31860,182714
8cefeb2300d5a2bda429d22aba49c4c7,24,20,12938,4621,8317,27,18,9807,3750,6057
0a308ae79edb0d15a16ed23f03eeb66d,98,80,195361,26274,169087,79,75,117787,43536,74251
986562443dcd5974944684803f398878,23,21,11440,3978,7462,20,16,8039,5153,2886
c076f1e50cbd45d379f3a44af796fd96,13,9,2948,1338,1610,19,15,3849,1573,2276
9a198368470867401817c4f2bd2a48b8,28,28,29749,10805,18944,34,21,18126,8699,9427
7f08f594bf2f62561de99fe92b3b0d8e,116,86,245407,67137,178270,118,98,316913,59816,257097
2e0ad3adc23e415203edbea57af72478,105,78,145339,52824,92515,99,81,163742,55770,107972
1505af0b928ccc4e3c374ad26821f49e,60,47,62999,23861,39138,70,38,77914,21254,56660
dda604a653cb0b39eb2549ca85843c9f,144,96,266175,75486,190689,100,81,189618,88060,101558
5754a4d0d19da3d27ecdf04cee84f511,94,71,182942,45094,137848,110,106,206288,58087,148201
090f940e4bfd74d1d0964eb9144079a6,130,99,231162,32926,198236,69,68,118297,33303,84994
85d20f16d12559baa82389841567dd6b,165,136,562632,131615,431017,114,100,407266,104579,302687
63eee06f7925561ea8007ae913813f3c,174,123,418253,109243,309010,203,156,490017,118855,371162
cc9729d1f7d0ea39e708984d7c1a700c,17,14,3621,1967,1654,20,14,5385,1435,3950
b6eab6ccab00d8ebf0446b0801c648f4,109,80,272825,50103,222722,133,109,319367,60856,258511
ec32c630344d16e0ec7878429df91593,118,77,256187,98381,157806,165,137,377369,90409,286960
21ca5a8f43e013085b8a7c48b71b0c39,125,85,234989,42938,192051,80,63,151526,48577,102949
d32f7a4dba317b15ecd8dc9c3725b8f1,43,35,33768,10479,23289,36,33,28918,9939,18979
a6e19cc4b1916850bc88bd6d728a66e1,62,47,59648,20174,39474,60,50,77998,19364,58634
46097e4d322b12547bfaa27db3dfebc4,154,125,366540,69210,297330,126,107,233355,60212,173143
b1e585d35ed1d75961f360310290fc6d,63,49,58290,18915,39375,64,47,50944,21683,29261
8b97006d66b0880105b09186d7c2c606,34,26,30388,17581,12807,38,31,53103,15873,37230
55ef18bac5eef81e5dab27f8806a03b0,66,50,93934,22189,71745,67,54,106542,20198,86344
51c6530e427b88c90bc1e1554f584602,94,80,176573,49266,127307,111,76,222017,48290,173727
aaf15142263a6179023508c1a83f9e57,189,137,662750,162903,499847,235,170,755258,188188,567070
ca6249b6a13ec7232df72cb22bb2554f,149,125,455903,100519,355384,137,94,442177,85498,356679
8ae1b610b3195617f78cc5e6d1a251b7,99,91,212938,57399,155539,95,80,186468,51463,135005
f3b43357d57a7be5fcc89b8a841cf24a,79,58,85521,24954,60567,93,67,97851,29240,68611
a47294aa26aac30b417de06c3991b8f4,193,145,708559,218191,490368,197,152,879645,181958,697687
e4a7232dcf3e57ad2f9d85e228104ce1,31,25,21697,8054,13643,28,21,19115,5990,13125
3258eb2b5d8fc1910aa78b64a7c25857,127,105,311181,43002,268179,131,96,298825,58732,240093
67807232c9d2e62b701c66cf883fe947,0,0,0,0,0,0,0,0,0,0
f5fce7321ed65b11f0a0a03e478e0e2b,78,58,206912,37015,169897,81,67,172362,53207,119155
91ad3d4f7642818e6cd6515291cd6d5a,134,110,441186,93333,347853,197,157,533049,78885,454164
7476d348057c735c9a6899073d1ac4ad,44,38,32121,16487,15634,68,49,51575,15386,36189
37767c12d26d45ce0f8171059908bcd4,144,103,396868,104284,292584,167,127,375319,116123,259196
3d12d299d8502489012415111bbb5cff,39,29,28869,15077,13792,46,28,33678,12640,21038
cbfdd63288d02d398470db416fd6aa02,27,24,8092,5331,2761,21,20,7402,4762,2640
a8846b3e022356976bda32d85a4e78da,122,102,385721,83463,302258,179,140,447981,91714,356267
766e81702cb5d91cf92468311a5b1a18,111,93,167253,33505,133748,98,80,153797,32289,121508
34c4fe4509da28345e50e500ab2f863c,95,59,176074,42483,133591,85,56,139945,47689,92256
d47ee3597254d292c362e3701f5fdd67,21,14,3902,1419,2483,12,12,4980,1081,3899
f2550426dd557b76a778f05eb5483360,215,167,863795,204726,659069,202,148,990182,156995,833187
48ece6a37ad272a7ee70f27beaf803ea,197,159,757869,159620,598249,147,114,561952,119656,442296
fad55b66496cb4551ae56745684a2ddf,27,26,19999,9136,10863,32,25,28826,10181,18645
860efd8b0616d08e7393d3afc2ac4774,64,47,89992,24614,65378,69,46,99932,23589,76343
91a06976cb9710cf6e1267f951edb54d,51,37,53242,20983,32259,58,50,89437,19166,70271
0866bc8a06941afe4ea349748d9ccf50,42,30,25571,11059,14512,38,28,22651,11308,11343
0172ea4808d44e7578c25e0ac179a378,71,55,118066,30770,87296,50,45,93380,23207,70173
08996c0c0a977250eb936d3520ae2922,72,51,81814,28207,53607,60,41,69596,22186,47410
67b73bf6bd0a2f75be58402dd80ef800,30,31,22931,7953,14978,32,21,20430,5990,14440
3d3d86503c3667d35a98558f5d2ea982,25,18,20841,8751,12090,33,25,24866,7107,17759
d5fd47ec3310f34812a2a7536d0566a6,46,31,47414,15323,32091,42,34,40336,14243,26093
ca7f8973300b15dc02b0919b5921798c,161,93,359538,89160,270378,190,132,487855,93731,394124
22945b313a20da429ed05227ba0f4a42,44,33,62354,22854,39500,57,40,72394,20142,52252
a01b3269023d2404cd070f7670f08a4d,80,64,105257,20588,84669,70,40,73826,15749,58077
9f7fdef2b64a0640d6e19f6801df69dc,147,99,407637,64774,342863,108,73,277428,69085,208343
6a2b60001c01a2841dfc1b8b325bfaee,43,34,38130,11755,26375,42,31,34120,11576,22544
6d68692a35711b6f74a6a8a7b5b67d0b,28,21,10867,4259,6608,27,19,9482,5589,3893
121a733ffd8f19d10b290a2a9d684134,152,110,554733,96846,457887,217,148,597715,124234,473481
596f6b2f833e2791ad8bf03a721d0b80,205,131,1715294,216739,1498555,242,185,1570451,202936,1367515
634e592e44af878ae9b8f0dd24356b12,9,2,791,152,639,6,7,448,433,15
d1b4ee7ee524d7cbc43ee4f0c601a743,82,69,189106,60305,128801,122,82,248563,57674,190889
484c715361ebff6093316b37f45c66f2,128,102,430347,90350,339997,116,87,277994,87429,190565
9fd79da19a75cabf795806536f476759,34,27,29237,9905,19332,55,35,29740,12919,16821
96bc69aeecebf1dbdb30b9279a316ece,90,62,150365,41393,108972,72,61,133702,39355,94347
3277c5255a96d13ae289a12e7c272958,135,100,292903,72031,220872,158,110,417402,74698,342704
bbb9d9652d8ce63e878516b48c4116b9,186,127,652052,145652,506400,134,127,457590,134596,322994
96853b80bba89c69f32a578912894467,82,72,162600,49834,112766,95,75,166146,41625,124521
f870aee6f70b92acd62e121f6cbb4d10,29,26,23363,9359,14004,44,36,45685,13113,32572
7c0802344d4d4fbcdc7642679077fb04,90,67,205084,63254,141830,79,67,203031,72145,130886
6bfe1a53e9d05e3d9638239b2f710bda,76,62,105317,36400,68917,109,97,193049,46999,146050
c66d15f964b0dd842beb2efdefce533b,105,80,214693,62435,152258,87,82,189447,67760,121687
93df103e5a431f4a35247ac373fbedc1,132,105,306474,62887,243587,141,104,330083,78098,251985
390ee1c02071de0085e799eb2f88f462,38,23,23336,4405,18931,25,21,15954,4314,11640
30300f5b4792eff296401396f88dc1b6,13,8,2290,866,1424,12,8,2500,1094,1406
b9829ed00dc064ce8eebeeb58b68203c,79,55,108240,36263,71977,103,81,169628,28199,141429
13a74784d18ec06376e0d0d2d9fcc764,51,44,73239,21628,51611,51,39,58720,25328,33392
92a4d6ce416620ff8738d5ecbb2da141,58,44,72345,17402,54943,66,57,63329,24085,39244
4f9767e3e820da991e68af71ce4bbbc7,21,16,15121,3391,11730,28,18,7450,5013,2437
cb481dfd4ff34d2417dbe59a218aae5a,16,15,4447,1550,2897,19,12,3200,1867,1333
d777a2e04b8fe44a1839072cbfecb4cc,121,89,310829,65203,245626,123,109,362354,86933,275421
8239bc90b3013e8488e4559fb3133ae0,123,82,227647,28974,198673,119,99,236933,48983,187950
23a4c688c827d7ef26bf39ebedc4ea6b,135,110,462754,110720,352034,169,141,601621,143543,458078
e4b14a794350cd1984d7d6c7d71dfda0,75,55,130882,36365,94517,67,53,107770,49134,58636
b0550cc3a08d956bee711feb6b3169b2,136,104,262687,41837,220850,114,95,270559,44146,226413
2a111df0a6264fc720ea30dd2900158e,17,14,3052,1564,1488,11,9,2915,1740,1175
45013055943efdda63c37ecaee3d6e2b,53,33,70901,23083,47818,35,31,47574,25833,21741
a51b1bbccac4f87fe89a70187d870c86,48,38,55117,12988,42129,38,31,29449,11644,17805
92dd2d53f9f526c9e1de03eef47f7cab,104,79,248587,81281,167306,102,81,218458,93546,124912
2b772e0895082ba9c61306d763fbc3cf,38,27,29426,8081,21345,35,23,22527,7113,15414
381e177044b18ff79a13045f73aeec3d,140,102,322386,55971,266415,118,98,287513,58719,228794
7d8c44ae149f82211f0cc97312bb04ff,105,75,157168,39385,117783,142,109,256308,35559,220749
8f9226a6379739045b07165737a9818c,63,58,78346,28093,50253,65,55,97266,28560,68706
877b43144c440032a3211d15264f664c,26,22,21127,4317,16810,32,22,12400,3665,8735
ba9c0e0eb0707b39b86a27cebb717991,115,83,273066,83674,189392,131,100,283405,81669,201736
0e71ee320bdc48e9d7b97cb291cc7cba,34,19,17532,4786,12746,27,23,12617,4994,7623
9b960fba079172635df8fe611feaa347,148,120,330407,81333,249074,138,113,351115,57131,293984
e46a0497ff318312870ce15638f03051,117,94,293115,70198,222917,123,88,304293,47434,256859
cf096736b6b3caa235b2841ec668ae5f,140,115,468972,117266,351706,162,125,494949,84699,410250
833cfb9020cf393f444ae69e866901df,178,140,762668,172014,590654,180,147,797471,116571,680900
7cee9c00e7e11055ac4a3ce1783f50b1,114,94,297342,58631,238711,113,92,251701,60325,191376
554ab1f45b0ab3e83f8c858055822a1a,110,78,249366,61700,187666,118,95,285991,68418,217573
63e7c6689f2374cf5a88a5c2c0618be0,44,34,36130,15167,20963,38,38,17181,15494,1687
65b9f5262573da5c691365becac6a05a,99,86,189280,34291,154989,92,74,188277,48650,139627
d7feff775b71f183bbf5724916cc4609,36,28,57812,33783,24029,75,56,139017,28590,110427
715960f6b79e6dc9231d4efbd9fd8687,167,132,653231,150717,502514,188,146,473227,174610,298617
bf278e7e7c8bdf7eb35e9d26db5a3622,29,19,15185,4286,10899,26,21,10593,5800,4793
e34c3ff5e0607d48307441869170f5d6,23,20,7686,4356,3330,36,20,20032,2890,17142
705e7e29a27d421bdb0482b8c315dabb,206,124,574348,99870,474478,208,138,465192,99723,365469
be475e2a019dc7eadabbb750ab333c6e,117,87,509865,106642,403223,183,133,683605,73331,610274
43777f9555a331e3dec1e21b64761a73,108,68,300110,76386,223724,130,103,346690,69155,277535
101dd664f3d1b3da346f4846089d6f99,177,115,886770,109233,777537,207,133,930005,177126,752879
81c186497555286da1e537561d6201fd,58,50,77739,24309,53430,54,46,60156,27058,33098
f01d3a66cf5f456f09a224b99806d0c3,76,56,87678,16970,70708,82,58,76959,21778,55181
2c0866d76383335a74ba80a3a4ec5acb,25,19,9615,3291,6324,29,18,17933,3954,13979
670a4d7b592aead8ba28b02a2f2a1837,38,34,47849,20156,27693,44,34,35292,21227,14065
80d88977576a79b7d6194b51d061cc35,74,64,154736,43559,111177,97,89,269927,52210,217717
5fede7181e11178e9dab8368fafbd33f,98,77,220440,49017,171423,96,75,228872,46567,182305
0220df233848a684e03c86d09607a897,39,32,43388,20730,22658,41,33,40429,19077,21352
6f203a92b14fc11c7962874a4dcf971b,169,122,496361,109016,387345,147,100,508060,85359,422701
46b6e64a0a62097aa3e019244df3cead,74,55,118034,29248,88786,96,72,125058,35250,89808
b3c38a7839068f78581bed959ed48657,18,19,8423,2995,5428,22,19,9655,3384,6271
d54214b2777464a7a6b614d29d177ac3,89,77,224024,49340,174684,129,96,263624,49335,214289
075fc074f8df394720cca413df781f67,148,108,304627,58193,246434,153,113,321684,60641,261043
d869eebdf6066b77ed5e235248c0fcce,55,41,73377,19876,53501,54,41,51859,18622,33237
07af19fd7721fb642c6a0fecec410ac5,139,100,356873,94738,262135,142,103,355379,92109,263270
6dc84626278d75d8521ffb1c6412c2fc,148,108,375122,67926,307196,102,80,228092,71780,156312
238ecff64ef943ed9d0168c507a236c0,18,12,6711,3882,2829,20,14,6008,2985,3023
e100322694b2dd8433e775b848f94c93,129,99,515014,129421,385593,210,127,715776,116577,599199
665879fb56fc6a6b738cf996affb75c2,73,63,113641,23125,90516,71,48,47204,24310,22894
ab6b1971e69172baef8726ce4e09026d,102,65,169821,53663,116158,89,71,216682,53482,163200
041fe794d29ef25a98897e1f313bbe64,95,71,232148,84122,148026,118,75,234909,66949,167960
8cd377f6e654fc9ed4efba8517789862,40,34,32427,9409,23018,49,37,54330,10953,43377
7da0368f5f09dbf0eb17dddd3cca7efe,145,98,432700,111210,321490,143,109,488250,137372,350878
97a0b18b821e78399c4d775f93f0211f,84,65,214563,95927,118636,124,84,264518,50723,213795
f3e2e52aa0b1697ce4df2bdf0de2defe,209,167,834827,261146,573681,226,147,1455949,201835,1254114
5af7e1e21b4253462fad26e13f2f24a0,107,69,148571,30106,118465,96,74,150238,31502,118736
bddecbce70077ce497523560e7428875,130,107,285577,66349,219228,147,122,415690,65102,350588
7ee4ce6d84585aa1905fed826c0ad9e6,19,13,2671,2117,554,13,15,3463,1623,1840
8b677a0b50c4384b402e1d71ecd210d4,140,94,305699,61103,244596,113,94,276881,82927,193954
48bfaa5b5c2a68b5cb45e499328b60a7,109,82,284221,76925,207296,131,95,304288,69363,234925
a64a91e035cd19af546f8b5490210c4c,100,74,250117,84899,165218,156,115,307329,56610,250719
682e40cf68ba2352a6a757b1d08fe1b6,199,164,1135830,183933,951897,205,134,920914,149063,771851
0cc293180c7bc7ffa1d0a42fb12b08de,103,76,243422,61102,182320,116,79,254571,52210,202361
3777e950004e0004e6742fcd9ef1766e,39,35,24035,7437,16598,39,28,31985,7291,24694
8a1731467ca82c8e4f7705f51e6ba0d3,37,31,31119,8925,22194,41,37,25194,9674,15520
00da3005ecc28109851b266fd7124fec,36,31,22565,5232,17333,34,28,13864,6539,7325
c800ee3330876cfe31e7dca1594ae322,53,43,41332,16285,25047,85,74,95354,29432,65922
c682980f47fbe7301a96793442b54031,22,12,5988,1412,4576,18,16,3865,4221,-356
783ec79357a11a21ef1e5013a7d56eff,90,52,123945,50346,73599,100,79,208234,48352,159882
68a2c513d4792f2915a635afd049ea66,92,81,152660,44652,108008,78,70,121263,41538,79725
ed9eccf5cbac4aba7ffdc3a4461af68f,46,38,56339,33932,22407,53,45,93737,22897,70840
31ca6d63f9d28581d4d99cd71be18cd3,46,41,97691,32000,65691,59,56,86614,35035,51579
d361a954d7e5d098871b9dcf2b31e6dd,85,82,175006,49751,125255,60,46,123246,31845,91401
9066984f9e4f340df8e5b41dfd886ce6,150,113,455033,187777,267256,135,106,521228,155185,366043
ec0e945d02b180931b897ede30ad01f3,59,47,65059,21170,43889,55,41,60462,23170,37292
933a7fa901d9b675291de92362999344,55,34,55995,19822,36173,51,40,43522,16539,26983
5014ef534888ee46d2d575426489c1b4,149,113,539004,105996,433008,187,156,612914,134262,478652
4939772277184f422db4f90b7b9bd42a,21,15,6333,2052,4281,14,12,3530,2435,1095
c5452d1c3e48cb259c32dcd1218aa0e5,83,57,89494,31698,57796,88,64,141529,30475,111054
f3f7831f6045ee70e65b2d94bf35164c,4,3,593,363,230,3,4,363,593,-230
0c02e86cb2b3b0a0c03a351910c959ef,129,104,203771,52864,150907,144,112,294932,50824,244108
bc8109d651537afa44e126804725c5ba,81,64,134445,46099,88346,88,74,175925,29789,146136
2a4b1b60794ac983826a912d0cff9e74,75,63,100462,41694,58768,77,66,125588,40830,84758
fa149d52259f419a587970407883c759,139,91,236102,43900,192202,119,65,157927,36993,120934
15387008649c3ad81db506fc0ef86a0e,39,29,39232,7912,31320,34,30,28204,11836,16368
e6620859fe10932dfdb5e4fd579bd454,119,83,417800,107104,310696,177,119,421557,89570,331987
b88a6396799baa2caee37304e9b082f3,100,68,129562,20577,108985,60,50,68521,24767,43754
0524c6cc9b1c4a9420acf309c57ee53f,196,153,543921,122287,421634,179,133,658092,106579,551513
8e1b805b494030ce58ed57a456d9f6b4,132,100,252769,64815,187954,117,83,252139,53135,199004
89faaa634c3a6e31230a31bd2b40e1d6,133,93,334655,63233,271422,131,97,235927,85904,150023
6145070029ea16af6aaee19c4aa1b70e,45,38,34812,16101,18711,43,29,48841,10355,38486
cbc519411a47ce161353941bab52ad9c,13,9,2890,608,2282,13,13,2050,719,1331
6240710ab703db7f769af305aa482e3f,139,123,475483,97083,378400,148,99,383061,103463,279598
c106101224be601eb18615b05288b1bc,95,58,169413,36227,133186,98,76,172395,47754,124641
42861df0c8f77c0802bcb38d31f46ced,86,84,212318,52881,159437,82,71,218571,77337,141234
4b31eec78e9906510cd24ca308d57f21,168,135,549357,82428,466929,192,145,688564,62052,626512
9a301c5f47e4bca8fb0ce84bf91ad661,78,53,128291,31784,96507,81,67,124700,38438,86262
5f06f30d9c8015e359e2914242f2e1dd,163,119,531651,73906,457745,152,111,420192,106218,313974
3258b4d3c3994125e49cde3a73d04787,33,28,41972,16189,25783,59,50,77383,16489,60894
df4dfb9c8ec42dc0f612acfa788a0b33,29,24,16219,5399,10820,30,22,16545,6734,9811
237a89f698d8e57e04a2495bc869e553,120,92,271758,60796,210962,131,101,276800,55906,220894
5f8af831ab1515a7c2d5b69209b30c59,106,81,192271,32035,160236,99,83,125120,39219,85901
8d487a1a902f6248df0ee9986cf49989,107,80,210813,41950,168863,83,78,129700,57655,72045
41de8b4cdab37aaa1759320ad8e3d8b8,80,56,175756,41285,134471,136,114,302206,74117,228089
be532632ebe9b31f216e82f35ee5dc08,75,56,95301,19358,75943,47,40,56543,25105,31438
dec83bd1d4d5e771282dc97d1331950e,183,139,981379,126722,854657,188,121,814303,119958,694345
4713542f5ee4a619ba36083514b4239b,87,71,161820,42427,119393,76,58,135476,29484,105992
bb00a1b76d385ee8fe2a7897fbf67f14,122,83,189438,39130,150308,133,101,303336,43774,259562
5bca10ae58718089a74eb0932264c6af,28,20,17077,7425,9652,28,23,16383,8345,8038
c1f9cd61b1ea80c2f8722d2cf0bd6b01,69,69,110164,37349,72815,76,55,85906,38104,47802
37ab7a7824a621644f3f9d0ee6639a45,105,70,213968,44414,169554,81,61,145421,37674,107747
61ed2a911f4be699ea53d24c6c6b69bf,36,23,20770,6547,14223,34,29,23392,7424,15968
793a1db1c5012e3d4128995272c58680,16,11,6519,1569,4950,19,16,6194,2206,3988
286f9c19da1f8269a38057efb22a2616,69,45,106656,44466,62190,66,58,123501,47904,75597
9820cd04dbaf4c494b12c9651ad50101,61,49,115564,43730,71834,105,78,175487,59414,116073
f796e07ecd95255ea2484cd38d185294,56,38,75060,19361,55699,79,77,105362,26258,79104
9d7fbb1675e8c1a52d5230a9b138444c,75,53,114619,26970,87649,63,54,102225,32477,69748
18e56f18944469a4c226b4a612323500,173,138,503337,109637,393700,163,129,440764,78736,362028
e68a6361b55ee2379fc5209a80af22e4,34,26,26616,6773,19843,29,22,22466,7967,14499
6f39bc198b0fd5c200c7af6f194b1094,150,124,556317,103902,452415,185,121,600192,72166,528026
3acd0007916e2439a4a71b4615a96bd2,44,34,38259,13796,24463,48,39,45857,11237,34620
001ba606557372d5152372804c93cdd7,97,71,205774,95113,110661,71,59,188324,72032,116292
2b0293c83150729fcf13fce3ebb329ce,25,20,19289,8011,11278,29,23,25636,7438,18198
7a03f872fd0b243c7173a58aecf8a35e,130,110,325566,96448,229118,155,125,449827,110427,339400
db5144b62802d86fa1135ad6e4ed3524,85,50,98113,25707,72406,78,48,70688,28513,42175
caaa4f84d2570150418f10fd90506321,58,46,123436,25063,98373,47,32,76207,21753,54454
853e01bbf1cc2e9e7644abd8275e8a20,161,131,688456,144970,543486,211,153,881100,117003,764097
38961203d7c6afec03d75c0982ab3eca,132,89,256124,29897,226227,77,48,113721,30398,83323
358f274cb870a457f65c9b396e3bdaaa,118,92,548012,149907,398105,138,106,620257,161050,459207
33df64f44897be3a1c681cda5dd5a6c4,131,78,193517,57427,136090,86,61,169486,53407,116079
d98e3eeccf50ec6fe32bb831abc9f358,110,88,309615,83618,225997,121,95,282002,76748,205254
9330742f4b3cec5a72a7eb51dd3bd266,107,80,201860,58491,143369,143,89,247168,77712,169456
dcbcd094d62f58b72aec28498ac78c38,173,103,544377,118559,425818,158,139,559669,137840,421829
406b1ab8072d82aa13424fbc20404bc7,84,68,115613,38138,77475,85,68,170736,30589,140147
5c9e0718ceb4607b0eb52fbcdaa4d9e2,37,27,19986,5871,14115,27,22,15546,6105,9441
b9849702f2fa00a881b8581b4f7f0f51,119,100,207494,44618,162876,77,59,82197,48306,33891
ef63f85eb3396c5ea3fec3d7769a87f3,77,56,91068,36514,54554,84,63,114173,34446,79727
22d787b7732f3efa33922b3eb65a8ce0,70,55,106343,29874,76469,54,48,95774,26691,69083
af4f1e62f94b8c95b3441a519fef53ba,43,36,30699,12327,18372,42,29,25491,11975,13516
29f3ce09f10a69f2da0e360984848ed9,152,115,543030,101905,441125,147,125,500699,102818,397881
4dbc28409ec13ea5e7a5fb4d239438f9,116,88,287790,58493,229297,132,89,317555,38877,278678
1022a5eac11788c229a416721f2786bb,83,69,228384,81359,147025,139,105,358568,59507,299061
a56f07a6ac5cbcb93453b011d4ca3b6b,124,97,234263,65152,169111,121,86,229845,46775,183070
f5d3b875466c8b90527193ba2af86a3b,35,29,32998,12727,20271,45,33,40439,12760,27679
1bcbea445932db8549429767647bea17,32,26,18996,7430,11566,26,26,16959,7620,9339
f677b1f72a6cb54ec7e2ab52de5b739c,43,34,43338,13526,29812,43,30,29692,15777,13915
2e4eddc693325962bfbcd33f7d7cb584,128,96,349277,85639,263638,141,127,379115,92864,286251
f6920aa2bc6c5d9bada64f11948f697d,110,84,294149,50597,243552,126,86,214314,41454,172860
cea5fd69e71de1df5d847077eea731f0,237,143,3101739,363565,2738174,238,157,1160608,268290,892318
a57bf5b03d6b056668dc8a76ede7d8d8,43,42,36995,12902,24093,45,36,28003,13219,14784
b546d59be2c6e4046c73a0bcae20e41b,104,78,176911,30323,146588,120,96,265546,37706,227840
48d608bb8e8102a723d1417814592a6c,40,29,21592,9469,12123,37,34,25396,10690,14706
cdd687b4d3f93ee2e4e6b32ce7f9caae,67,56,86811,21036,65775,63,46,63794,22947,40847
26152869902f2fd029533de876bb7fd7,102,78,247401,56222,191179,93,77,206399,57616,148783
88c618035a56f3bf98e0b577d5ae2112,27,19,16428,4486,11942,30,20,10440,5089,5351
20b22cc23fa5bf55353562dcb9bef8a0,204,136,760541,131124,629417,221,141,673123,116732,556391
683f287d23614f52e96c9c5e483fa97e,31,21,14453,5865,8588,33,19,16472,5036,11436
9ae95584a6049f938f7b094f0bc7d815,58,40,77104,21069,56035,59,59,77240,25445,51795
44b8d1b73a1810330f20c0f47b9f8d7b,48,30,51289,18203,33086,82,63,81280,21400,59880
d93d56d2dc44750d66c8445ffcc4ad29,97,82,160185,41179,119006,89,65,124475,49125,75350
769eda8f9d16bd0b14d26e45ef341288,22,19,7602,3306,4296,20,17,7012,4205,2807
b37371548cde9431750e87e78a7767e9,25,20,11001,4671,6330,22,22,10310,5857,4453
b3d9b79be8c229fd9533a2d53d033802,21,17,3103,2038,1065,21,16,3709,2173,1536
7fb587b91a8f8eb4dfcc8c793d367d56,96,67,155623,29958,125665,103,78,175500,39306,136194
5968228696edbad394fff623ea7be2c2,184,143,576259,90551,485708,160,142,459273,78290,380983
79908b651d974d3424ec8f11f7b5da78,29,23,14054,7267,6787,26,20,8656,6185,2471
2c8cff562ba45dacf3f0728990a3bcd5,73,52,85814,28887,56927,72,57,88813,29307,59506
d86e4bc5e7dc86977d580259e689ef6a,159,101,611920,174103,437817,208,155,989552,140815,848737
295360ba3e6454b0d8d26c5fd5b64171,26,21,18464,8637,9827,26,24,21083,11031,10052
9fe20aef48cd14e30cba762aea99bb4f,28,27,21999,5780,16219,34,25,20641,5472,15169
fa662a8d409a80e3ffcf6dec9b46d50e,129,84,308232,81923,226309,166,121,490991,90396,400595
ead68b1c552d21138baf85b0242cbaaa,90,75,144943,39950,104993,95,72,167783,43238,124545
5f0e91cde7691dce41bb3bef49366a1e,38,31,28011,16750,11261,44,32,48932,11307,37625
911f37a097806c88413e4c53072d7867,150,118,328603,60543,268060,111,86,255147,61470,193677
a733986d4858f3838b09a66ff5bcd51c,92,77,159025,52134,106891,149,105,275908,39663,236245
53298987a4e5cadf4a34304ac43bf660,118,94,242756,71573,171183,114,101,250169,55411,194758
9a83941beeb85c06804fd10aaaa6695e,25,23,20176,4983,15193,29,26,12109,7183,4926
617ba38656d7e714623bc4db1599286d,18,14,4176,3141,1035,28,19,12006,3550,8456
15584207a81599af4b64fb2298d53a36,79,51,139124,15386,123738,63,50,65384,22563,42821
9454d9d1229a8ce25997fb55ab7d5ed8,18,12,2953,810,2143,13,10,1896,486,1410
3276baeef8e3913f409de8f9341b2adf,65,44,107601,23264,84337,52,36,83889,24357,59532
23ac1b38dd2fe71676f4fcc464a8ea71,157,121,455418,58628,396790,155,143,468277,131358,336919
530568cd686ab3797ce0cc65a3d2ac26,154,101,604438,139431,465007,196,136,739180,154650,584530
da637e5d985f09416c613dfa852554a3,158,102,737786,119540,618246,246,140,685964,122163,563801
bc0a2ca2a4e465d0673f8f0d0e34158c,85,64,130109,33387,96722,54,44,59080,34586,24494
0075b0306ac1067cf2ed30e63cea1ad8,81,64,119141,46762,72379,78,67,115990,46141,69849
83cdd2bc580123dd59601a1bf455d0c6,153,115,406286,96850,309436,175,140,590735,85018,505717
35e01c97aa293942073c1597896c3912,110,86,195352,34599,160753,128,93,198396,36079,162317
ca52a26190a675bbeb0123872e7b689d,85,75,157235,83464,73771,125,96,256333,57295,199038
7c0d0454e75ea54dd9e3a6890cb00589,122,96,360856,61973,298883,84,72,172196,88748,83448
c2e4b2583d8594f4b6931678907037ff,87,71,132342,33349,98993,87,73,149776,35784,113992
5ee99bf2ebd1a0e82dcd3c2b0097c94d,89,74,148991,50898,98093,136,84,245521,46236,199285
257a0d2ee25652bd2ea01e987b5bfbef,146,91,325020,63501,261519,117,65,224947,64373,160574
1506c896ecc6f717dfdff7affac0dfe1,23,11,8742,3485,5257,23,18,7799,4341,3458
10e336f47e807b7de29790fd99b1af99,28,23,12389,5391,6998,25,19,15915,3566,12349
ae86c996d21b920e7727160b65e39934,35,31,27448,8576,18872,45,30,23554,9979,13575
3bae3b1c4524362c14e79ba1ee7db4a6,105,92,270193,80350,189843,149,124,369840,87050,282790
feaaa4dd46bbbf1440ea3755183f1bc8,73,75,125824,30737,95087,48,43,81298,20423,60875
8d1760114881fc75c86ae7525ebeb3f0,178,127,477551,96838,380713,118,83,298722,114482,184240
3cb0100266d63a9bd06edbb14a0fe2f5,56,41,51339,19847,31492,62,55,56430,18404,38026
d2d297b7793efdc9c0d09e3b7249d1cc,115,77,254928,52995,201933,126,119,260441,64758,195683
abf5728c7951b1b8127b769d09ec6026,83,57,142332,41238,101094,105,76,166285,33171,133114
30aec79f78a533cc78306a6e387c3f61,87,88,121138,32417,88721,74,55,91437,23051,68386
d6aebf062bbbc5d46c4f00c979ff6509,66,46,77642,19938,57704,65,51,108406,27839,80567
7ac4cd7d9cc3cef50df831cb8b5aeb2b,167,111,518559,119787,398772,129,95,393265,75371,317894
43d92424bb1d9d1f1605c0ea43fcf6bc,132,115,337048,67678,269370,139,106,371189,57626,313563
e70a56076c78c0976bfc76676617e2dc,71,58,82901,29100,53801,60,46,84583,21243,63340
02df14bc8bdfcf19f92779b1de60d315,61,46,56898,22595,34303,46,40,50285,19735,30550
99da8eeb82ca301145a918433ea988d3,26,25,7665,3576,4089,27,19,8843,3929,4914
c6d9bb3960c7d2cbd761bc8bb5c1f4c2,106,76,301463,70466,230997,138,87,313783,107033,206750
e280eeb3226b1c1612f3f39121e0145e,176,127,610340,147873,462467,199,143,865759,155327,710432
c3b98e6c1156b783d9530dfddd798c57,166,127,623959,106591,517368,142,105,541143,108878,432265
e4404ca4f1ef17a030548132d3f7c66f,43,35,41935,18383,23552,55,35,46772,15557,31215
6bfe717b40ad30a5f740ead33b2cadb8,18,13,4376,1792,2584,17,16,3882,3491,391
59347e590a8731abcac39665fa18fe45,86,59,138896,23087,115809,61,54,90325,31766,58559
a2c65dd54d05629355bab750a1697da1,70,63,121815,27098,94717,87,63,146256,24378,121878
d6e89f0f19fdb5115d7caf86771e074c,25,18,7916,4405,3511,23,17,6253,4865,1388
652d44f097350a390c16592d940a5219,136,95,409392,47587,361805,128,93,270157,66986,203171
eb766a71704a9952ce67d3b70403d832,85,55,167048,36226,130822,97,72,194515,29712,164803
4223f2072cb4799e7f8cb73b28508c99,87,64,130098,35129,94969,89,69,134434,30423,104011
63678fa486f15aac06057047a94fd66a,81,60,108117,35292,72825,88,59,111952,33403,78549
73b7500464a1c96a7b99fff2d9b18d22,173,112,438153,93226,344927,159,124,482048,94985,387063
114ea6be613656e4d1cbab12361de1a0,19,22,3388,5835,-2447,28,17,8428,3138,5290
fa89f671a8e4e0e7ba4b0c07e6b0ea94,79,55,156529,42107,114422,117,89,217606,44778,172828
7bf64174e2e8b42baa9918b65e7183bc,130,90,286382,66236,220146,166,113,415956,69304,346652
de25d502dceb272df503f643e262de91,103,79,164666,41729,122937,129,108,270159,31118,239041
f6fb14bfe21e2c4d636a101ee8648a4a,88,58,131309,35401,95908,110,98,203793,42226,161567
20fad08a52bd714a496a906dec8add74,49,38,97668,32824,64844,82,78,149237,65349,83888
6876689c458fe81e40d588518af72084,67,57,100556,28742,71814,58,49,66367,34639,31728
21640e60887308e001ec63dd7d298b59,114,95,278118,44924,233194,129,92,193922,43437,150485
5a96af59576abe72467ba02c421ef1a6,42,32,30793,12881,17912,33,29,24698,8890,15808
b4d76f0f84cfc7d485f1f38b35c38aec,143,126,582422,117214,465208,128,108,461201,115395,345806
c851a85b4943207a383a802d425dd3a0,60,44,98136,20443,77693,58,41,52833,23877,28956
f065e90ae6212506ed98b70e1dd30695,103,62,280688,36005,244683,73,53,121356,53831,67525
87d9c6bad9fd11add6e311777d6ed125,99,74,217601,71489,146112,137,108,311370,56598,254772
64aa17160ef9905a117d08a6ad7d0367,20,12,8251,2239,6012,12,14,4686,3761,925
2be0874b5980d3f28ea2c0af68c93898,60,52,92326,17164,75162,69,54,71098,25527,45571
0eefec5b742852b4bc5d6a2effd8b9e7,121,87,327734,106832,220902,183,130,370841,65453,305388
c6322da0367ed32900452fc9dc1538e8,112,85,306585,94806,211779,163,121,359606,93381,266225
1a1a2475fcb34de0fac50a28036fcbd1,25,18,13644,5246,8398,27,18,20496,6218,14278
40f59420127b7390bd3421d3ef3dda5c,136,106,321509,83743,237766,105,79,254642,70188,184454
6c4fd4359184178206a78d8d0c90eb02,133,94,288941,68361,220580,113,78,189035,52541,136494
2a86e7c347643d0a3801adf6d725f433,150,106,313153,72710,240443,137,100,342432,54159,288273
dce52525dd26f8acc8dfd10268b0bef7,77,66,91561,22234,69327,73,66,97985,30328,67657
451b4ccab476c2939e5f4cb1ebc4d10b,140,101,358718,68810,289908,132,103,367252,68936,298316
08174ccb9e145f805fe5ea6a5b683a0f,42,37,33045,7688,25357,37,29,17934,11330,6604
1faf3e7f97ea09522f655bb74992b0b7,190,141,751250,150389,600861,194,150,786491,151365,635126
87b467d4f305be14e9938ceab27a984f,55,42,80470,24063,56407,75,61,93879,25847,68032
6a492e2e307a38fa42615617074846bf,103,81,219920,49083,170837,138,106,317765,60081,257684
9f896fde92c2d6b2afda1c2fc51e5aa7,145,105,377657,80181,297476,91,65,267433,83637,183796
b7d3a7a147265f2e92f8e256a8c3c0e6,34,21,10553,4944,5609,25,22,15677,4456,11221
1d94a3593b06495a3f88fef5b209e0a9,176,124,726646,114004,612642,160,138,582255,113726,468529
6949de3a1af89e9e35f4074581ab72d1,136,101,307752,47874,259878,130,102,284688,65517,219171
2293a0581923673836bbfcfc03324135,18,17,4438,1363,3075,19,15,5200,2381,2819
c01d3af01aa4dcabc5e31d9ff56ee788,138,107,346066,45903,300163,132,106,249100,45134,203966
fce1f27c39f76bcbbc6d48e6468f92e8,136,113,447012,132786,314226,148,112,508461,86066,422395
3cd92a18b03ee1e9d5a2412d4cf5ff9e,141,114,410873,82081,328792,130,119,287600,73107,214493
b9cf7db6681e9b783392c77f93db4234,149,123,473140,108947,364193,155,122,522684,97700,424984
81071196cf8c62b281a6982d385094e1,173,157,621869,117811,504058,131,111,412779,97295,315484
f4b0f581391c5dd0dc303cbb6e66a2dc,196,138,751638,108753,642885,173,120,597408,106811,490597
2eee0610306f2f77653422fee449ff5e,50,30,37280,8622,28658,39,29,23963,11332,12631
efc610466450e696c07b91b4241762ca,176,105,693827,155240,538587,214,171,1056727,146494,910233
9dc33bacb03b7f5e2fe9f798a0920d00,135,111,391845,97786,294059,170,136,501246,74418,426828
a3807f25774a2eb98fbb7873b54ec085,170,114,718393,92619,625774,186,142,655569,107047,548522
9e9a29ed3459d57f86a891a64e1f2b48,125,95,280926,86444,194482,120,96,286581,75974,210607
425085810cee564bf46b97ac7fee599d,120,93,300621,53151,247470,133,113,391554,53722,337832
ee057d383603211c74192eca8a68a41b,167,116,829654,160607,669047,178,130,719586,264942,454644
9a6dccf1e188ab3ab2ec9125402048f5,41,36,33121,11922,21199,44,34,34028,12363,21665
d763c106e022ef1e670ee2cd01bc4c13,40,27,49006,25111,23895,39,37,62883,28461,34422
c5a029a861dc1ebb037518c055b0aea7,167,116,534521,88633,445888,144,99,526377,76356,450021
fbc65fc266179c07ad99cebe6aa05135,57,46,56341,19498,36843,52,41,82066,19307,62759
976ea5f4a691c00bed61abf63b80f565,82,49,148094,23388,124706,84,61,83501,22511,60990
9c063a9a7bf3fcfbdd12d77637e8fa8c,161,110,384092,66430,317662,171,129,385812,85842,299970
4df6dc0bb0f1de16561f09dd58fe8113,56,39,82525,31002,51523,64,49,74057,31369,42688
80cf74884e323e8a4a70b8ad2824c3ae,30,27,15513,4837,10676,25,27,9027,6913,2114
c3f6aca84fb73ac666af9040cd9b4b76,119,98,247325,68083,179242,101,53,190472,45284,145188
73b78edc4511e4a107c2526a94760235,75,63,103738,35531,68207,55,47,106024,29021,77003
b22a51998bb81c4a431226038b788247,86,46,137532,18670,118862,81,63,89989,33442,56547
35424348a04beb969123f7a8ce33e0f1,43,29,55780,20154,35626,45,35,58782,18686,40096
723df940c61b5be5719c8b17fb77cfb3,136,104,530962,95576,435386,168,131,517212,127305,389907
40b1e10383d0be1704319d971804e003,131,109,447844,138791,309053,191,133,689099,108695,580404
c91edcd58531bc3500d92264640b2814,59,46,74716,29490,45226,76,62,95270,31990,63280
73fe91d79371ba0461c5049d9d6c4acc,55,40,54677,22168,32509,51,35,52992,25830,27162
fc2f504f502aba7650a8a4f6cea96d2d,54,50,121515,31213,90302,75,60,123356,33216,90140
5f7a2dd0a3b7465f76737dd9b5d66ca0,145,113,387026,104894,282132,180,130,501687,95687,406000
57fe8eba1453c644d15732e9da92cae7,149,111,545487,84232,461255,188,123,513547,83883,429664
5c816558b8a2e1bddcb4f150fdc91bf4,47,34,61780,20142,41638,58,51,69812,17810,52002
a3df72f8d18599e5b7e766f8949533e6,124,94,360737,109139,251598,141,116,537072,84157,452915
2a90c96900cd504aedea7432b316a3d3,58,48,66233,27345,38888,58,43,79943,20681,59262
236902b23834fe323296d22c6b1d9d6c,104,81,192335,44415,147920,114,89,238462,53921,184541
9bf3f60bcfbc2b13ae247624269af9fa,128,106,347664,78746,268918,140,102,405627,74672,330955
22b77e2bae6fdb4a25742b5514260f41,86,73,147630,36953,110677,79,63,181173,39888,141285
85c4e7659aeb665eceb0f7ede75c3cb3,152,112,328803,64922,263881,90,65,155127,51433,103694
dee7d9523985e883c8dc131805e0191b,31,23,19820,7867,11953,30,26,20860,9537,11323
047857db902d9bb31c2af5fbcaad1e31,53,37,77180,22709,54471,39,33,86530,25366,61164
4495b08aa83fb39c4e4d00be89f22c50,73,40,86739,17741,68998,69,57,74390,24570,49820
9c5d025451b1b2ddba8bacbafb31b135,87,74,194889,34600,160289,82,65,105320,50617,54703
7f3dfb1f47c1cc738ac49be38903ea68,198,116,530730,83840,446890,186,132,528394,106559,421835
54dcbc7fee9b2ab4a503ff288ac22962,24,21,10426,4969,5457,28,20,10638,5093,5545
30358c901e8efad3ed2b7a8c81f5f694,187,125,567617,83070,484547,134,94,289560,96040,193520
0f7019444767b31e881630fbfebeea83,23,18,13704,6452,7252,35,23,20759,3182,17577
17ececc2e47319362f3f1143e87ff2b1,38,34,47946,14470,33476,44,31,42924,12533,30391
e7f902948b20685aa1dfbab7ab9cb0cb,164,119,448180,89876,358304,120,83,375955,91557,284398
bb326dac7cfada45603e5984601c78c6,126,98,204678,51359,153319,98,77,195379,58522,136857
4bab852026c04f286d8a5e277bc899fd,91,74,195772,57014,138758,70,63,107007,64547,42460
2f9aca9e466d74885fc530c8442b8a47,131,104,465973,73339,392634,112,93,330183,128139,202044
293cee9897e4b040d1e8402a81f354bd,34,24,30155,11267,18888,39,21,27343,10871,16472
dcddbeafb705347e1b9330f1cc01178e,93,65,169749,45592,124157,58,44,103188,44111,59077
2927d2f822574e9b416036c39a6f32e6,157,107,517714,108440,409274,189,127,537068,153262,383806
b6ac8f6994c8c5a9ebcc4ae31e14e1b1,35,29,28043,10111,17932,47,34,42610,10871,31739
380df1b12feb1afbbaafe3504fe36fc4,145,116,373894,119722,254172,126,88,391807,111870,279937
aa27847db10c455a605b87473b6d9339,81,62,153984,35211,118773,72,66,135709,33075,102634
aaf7748ba2ac9433423cede7a31f1f42,41,38,34477,10158,24319,41,29,33810,7934,25876
5e09ce4ab72dd73c93dc68b5aa6876db,25,24,23832,8555,15277,31,24,15554,11360,4194
0e5470dcaa3e29ba793ad60bf396c7be,33,18,12349,5561,6788,35,30,14527,6580,7947
f90c257b0f3554ef8da5fc97bb5943ac,124,94,383359,85825,297534,176,128,418711,109264,309447
b006084653adfd958abb9a0991853c1f,170,124,302972,74427,228545,120,99,294705,61132,233573
916f638e4bef782d72e76d5455cad786,37,34,35621,17507,18114,38,26,40378,13292,27086
92ed742f9c069789ca4a34fed2869aaf,79,60,158049,70694,87355,115,78,244573,77469,167104
c771db0d07a8b067607d03217e631adf,155,101,458408,111249,347159,136,92,439873,102209,337664
6c782a5abf62e517ff094e20c1d2f882,90,75,321806,87730,234076,185,143,609473,90890,518583
0dea434d6952ae6c7bef414d7b11ff28,167,123,381209,89888,291321,147,77,323832,83315,240517
931b2a24beab0a87d7fa33d8ca694ca9,112,71,248022,35520,212502,119,94,219875,49014,170861
9f465f27d03a2d60b0dd19ef59fa160c,66,61,111111,39944,71167,91,63,151649,32481,119168
1865a01c7cdeeb44fc0cd0b87b5a3f41,87,70,177409,41437,135972,103,73,147696,52459,95237
b189e6bea4ffc4fab7835c25806dcc1c,26,19,11770,4357,7413,32,16,15493,4350,11143
f9b5fadd55f9f254015b677c29b11b4c,40,34,29579,9820,19759,35,25,25557,7028,18529
a206d58ba37cd08de72e9b893fa77f0a,24,21,11794,4829,6965,26,18,12316,4551,7765
a8828eeb4da84a76347b1779d7d51252,30,24,21105,11114,9991,32,25,29125,9006,20119
c8423e492029f0a53c74d9d64e957c26,152,116,486343,138950,347393,141,104,413962,134495,279467
b658a171687590af0bae2e5a98d412f7,34,31,18781,9421,9360,34,27,22773,7522,15251
58b10eb4e12ffe8b93540b827bf6a5c0,44,28,35860,13527,22333,48,38,46498,11767,34731
2e65e1fbe51aa5c202a5cea2c01738c8,137,94,358778,81445,277333,179,129,513359,99639,413720
729140431ae086d24a6a04e66a843aae,73,68,94499,33197,61302,66,50,116309,26769,89540
4881dfa5169b178d96c49a68d85d453e,149,120,464746,82976,381770,132,104,359457,65931,293526
7a3d071ce3a94068150988db43c49993,71,45,67070,18849,48221,62,47,64829,25471,39358
b7ef15609294124bb3b1f11e8b994e4b,62,45,64212,19990,44222,42,31,62430,19664,42766
6dd2061dfa6922609dfb4ea81f13da22,95,79,154414,30315,124099,103,79,249420,43399,206021
106ffc655e26887062a0cdeb7dd15cec,129,104,322955,71679,251276,114,93,300722,71114,229608
0291d2aafd98f06839cad38765b23e15,52,39,86746,19295,67451,64,56,78921,33562,45359
66bfaa90f25f01b7ff7860eff93f2f22,66,50,71174,25085,46089,59,58,66874,32285,34589
2dce87aa5dc23b242972e5d23d562f19,170,125,539778,84361,455417,182,119,487691,71111,416580
01ecd8aff5cfd4da88205ca478945b24,149,120,357067,59373,297694,142,107,288606,65197,223409
d2e7fb955e1d2defe55e476abd8e67b8,87,68,140440,43632,96808,104,81,164932,40407,124525
c49877532eadd6048755e7c026ecaebd,38,27,26336,9604,16732,32,29,21512,8627,12885
f71f39077f665898b0d06e6529a23b84,57,50,51285,14319,36966,41,31,33429,7786,25643
17fec6688b32ed72f5fb4ea365757c3d,85,68,156464,59599,96865,96,81,211451,70413,141038
6cc937edf415ce1ab00fc452414a94e9,2,5,187,481,-294,5,2,481,187,294
b579c18c0ae2f31c88a4382ed3e6c5eb,1,2,117,99,18,2,1,99,117,-18
468cb3c9472a8eeb6ba25366b83ccebf,122,93,449723,157096,292627,146,115,501728,147247,354481
5b809809ba09cf7d74efb639705c0a13,190,146,563454,142134,421320,141,93,468192,112127,356065
780b07954463ff9273962348402c3ecf,127,97,211880,53627,158253,86,67,139937,50485,89452
1d703520a83449eb9bf289da341c71ba,135,91,447580,69228,378352,209,115,542739,80086,462653
5da84db836537b443aaaaeea6fb57a83,90,62,138744,28130,110614,90,59,120815,27844,92971
05511afb6857aac4d7c0489451b9a2ae,69,42,76802,24817,51985,85,63,115071,29500,85571
6de6707c8e6b8c717490a5906b49ad2e,43,31,47706,13450,34256,38,29,33907,14256,19651
d5744973c8817bdb802bbad28fa8aff7,99,85,214240,73222,141018,128,95,326236,69608,256628
5ec057b7606f40a7ffb5cf14778e7c74,171,125,807400,127627,679773,232,142,843891,146169,697722
ea5280f497f945617f778b4b2c54edf6,98,70,202155,64069,138086,78,54,180372,48112,132260
d2df252dffe4be23d12d3e5baf331a8b,151,84,296115,64954,231161,153,126,322408,77084,245324
18edc2fb6f6e9fb597839df3b8faa509,20,14,8384,1787,6597,20,12,4412,1906,2506
3caec849fdcc95a1e131089c4cb2f085,245,150,1107973,155029,952944,220,150,1062863,170624,892239
dd9cfe10948b47f362ee0078f70ff927,111,92,197563,39855,157708,112,85,223652,34278,189374
a1a16da0caa66a7b60bfd41f7bda65c8,102,75,155038,37870,117168,119,103,210970,38905,172065
c93b1b0b2a4db47ba99b29ee9e73c61c,61,58,99327,34417,64910,73,55,81894,26817,55077
deb23f0fcaa1a2cbadc2b4d145e7f2c3,75,66,200631,30829,169802,100,88,186573,40252,146321
fd6aa2ea7808865de4e6852b073f35af,181,135,616226,118411,497815,145,113,467327,119142,348185
b922d49ac855a61824135295b7805873,89,70,203576,45438,158138,123,100,308656,48486,260170
a4c27834e833a7a4b5648a42c584abf1,78,55,100582,26166,74416,69,56,79809,26780,53029
b6d4539a6605f69cb25b820bc4945fc8,116,103,319843,64815,255028,119,98,256267,83897,172370
20e47d120af96a3834b12ce8d3736c6a,117,77,198961,50806,148155,84,80,170796,77181,93615
6b24481c97926575138751860a842f05,47,36,44873,13693,31180,42,29,30735,13476,17259
71bc3ccb3e567180f9f9f18e50d4de3e,83,63,129287,37006,92281,68,47,89305,31376,57929
533919d75a4a8643a24ce8030b19bf0c,181,116,497076,96110,400966,147,106,498067,90206,407861
c405089d830e9bd78c0e600e8af063dd,81,68,127150,32498,94652,81,64,83116,27899,55217
354ddfc08f7db188fb82d82eab687aa7,37,29,28699,10640,18059,43,30,17693,12209,5484
4cfe2db9fe5adab117f8ac824b14b328,119,83,262168,49030,213138,82,83,155449,56979,98470
e396972d01a736f42c4f9ee606593cc0,138,103,362354,62612,299742,136,114,325488,61831,263657
4c68218020a1a365009716af4b6fccce,143,113,454810,126730,328080,153,113,517277,119413,397864
9b1bad419345028e7f229bd14877edb3,152,137,325155,83530,241625,130,105,250737,80691,170046
e41a2550507af18606fb50b02a42d327,209,151,725828,81503,644325,156,133,709801,97530,612271
70dd0624254c9f23e91ed61db6e2ddc1,67,54,91767,29279,62488,59,51,87467,28715,58752
6ed0c9ea01a36464c4d103598849fdbb,54,42,81219,22923,58296,51,41,62395,20817,41578
39c31fd0fff2141df6d6e02f59b843ca,106,71,240086,62010,178076,78,60,194806,54616,140190
ad91806c1807ca8b3504599d0aa0070e,95,81,142662,42099,100563,92,61,196529,31135,165394
6915ace93fec5b954f9485e48a58dcfe,171,136,424440,113170,311270,135,106,393733,147558,246175
54d1d76a69095633f2be68f97247e013,64,57,97122,37834,59288,59,48,89161,25959,63202
aea509dffb847a6f880fcea2f4ca9bf1,166,143,460745,88975,371770,138,105,374983,81497,293486
08fbd072163705f73185a142a57f97b8,183,150,694041,94889,599152,205,139,684635,88263,596372
cc64d0141146231bd47b7c792aed5b4f,213,158,713058,111563,601495,124,92,366103,116558,249545
c98bdbbd33e0de76f74c648382471ca4,81,61,109956,22891,87065,69,48,95749,16007,79742
466435f21dbf99cc777ed8eb4dc5f910,123,102,353582,93129,260453,145,91,320150,92153,227997
b7c9e63642b5587025d7b84adf3393f7,44,35,54848,20011,34837,42,33,63165,20205,42960
d5ff426eb0ab027b1926e22392e1b63a,79,64,103891,29962,73929,77,60,129010,22253,106757
d080d618ce8373da3f44e0edbe9c57e7,142,92,435578,102300,333278,135,107,455978,149036,306942
739830b3b6fd9dd8ab3c6cec93d4d329,61,57,108530,31759,76771,80,50,97039,40567,56472
3b5c7377bfd34b671ac50d8218c8d885,131,92,290303,57769,232534,155,124,373571,73922,299649
2992e351970ddf502852516cd9fec97b,199,148,922278,165381,756897,208,155,754115,182090,572025
2b78d016a8e229dc849e2113ca30eca0,182,129,805024,143412,661612,147,111,864958,112685,752273
33f58a1fa4ebd8f935ae1ec7b76aad24,167,129,467904,148048,319856,135,97,418159,88240,329919
d3146f1563b26c4825b5adb83e3c7d7f,29,21,10977,6127,4850,26,21,9269,6680,2589
30fced31b607ea968225d506043e69eb,209,136,744401,156267,588134,188,148,874967,139878,735089
ea5d0203a763355d4db6c6f8b266150d,142,98,319406,66481,252925,159,103,285460,59502,225958
f0f21400690a35a02e2f007e615e69ba,65,56,86344,36571,49773,74,49,112045,38465,73580
65b02c131aeb5c90c405315971d2b7c7,165,132,406255,85028,321227,149,107,424345,89534,334811
ebdb3ae509ca525730d573866a4d62a5,33,30,31615,8620,22995,30,24,25386,7960,17426
abe037b5719eee11509c34c950b8ce10,152,104,335657,47327,288330,95,90,243222,71112,172110
393703d5542bca514edc0060cc266c59,91,75,135995,36224,99771,86,69,151569,26269,125300
8818c3522de92b045a74f360080b2781,119,94,302340,66363,235977,139,82,290131,53287,236844
0b1d2b754896351fb7a155ffa5eaee24,127,86,311824,71314,240510,170,139,499838,77930,421908
736fbc35cc690c8ba10e0589f16ce2d8,154,126,455322,63943,391379,178,143,384130,57257,326873
d3ee55731787d73dceb3fc8af6a9efc6,116,93,217852,69278,148574,103,70,210149,49930,160219
51f48e2dd32e1e7da68cde011fb7da0e,69,57,125788,37698,88090,92,74,192691,38953,153738
b57f151e94d5b3c86a3bd4e394a08c8e,128,90,314507,57424,257083,109,94,226943,67030,159913
5bc5485de6648e30b589e531b850b549,31,25,17372,6816,10556,26,24,23426,8580,14846
e1766f7f6ba730c7631f19db795c3cb2,30,21,20362,10197,10165,31,23,23836,10709,13127
cf61b24f1fc316abb65b643ec40734df,146,111,365153,82406,282747,151,114,370109,85433,284676
1a7b53a3c1878bdf0e7e68041e472b2e,85,75,155724,37000,118724,66,57,106049,54661,51388
f2959e3911c59fc4653241881f189ae7,21,15,4122,2353,1769,14,16,3412,2497,915
50697622130c4fe74dfd52ff911c5954,18,15,5486,1779,3707,19,9,4274,1297,2977
ed5eb1d85db2357def27b2e11088bf62,38,29,33785,6537,27248,47,38,45745,11643,34102
bbad905d5839777887c5f6713c4c0873,40,27,28655,9527,19128,53,33,27891,12997,14894
5d6dc447057fa032307cf0a55dee2d90,34,23,22124,4888,17236,28,22,12668,4830,7838
6c7321314c7cd43f057a543065b6fb2e,159,106,659126,84392,574734,213,158,656119,107952,548167
b105d1890a7cab6eecf72ea0ee0c6224,47,37,48626,18995,29631,44,39,56180,18752,37428
38d5a292f97f9bd4694821025cc4ab2e,108,89,206202,40776,165426,90,71,150451,44156,106295
7b8f2d040cba556bc1ef8b51cd75680f,24,21,10876,3733,7143,26,17,10928,4175,6753
c6cdfc738b3c7f2823ca735ad70d0d97,149,115,378963,68913,310050,169,101,457382,66472,390910
de1d3606a337dc337fed53a39f93e150,38,37,57875,24431,33444,50,35,46439,17199,29240
fd296a0bc71922c323028ee63e4ec5fd,2,1,89,60,29,1,2,60,89,-29
6091f02d6998c545bc350dfc024fb32a,34,28,28890,14926,13964,31,28,52077,13478,38599
283c08a2e19bc1ece8f1015904bdc33c,8,5,1695,1292,403,5,8,1292,1695,-403
7da5926c2bede748178ae38200586ae2,50,38,59806,26914,32892,61,43,57713,21698,36015
d45bbe65e76b0a77b12719738f8ea943,164,125,554937,126946,427991,155,117,683428,108752,574676
0241547945718a4527d1fce5808d57cf,57,46,65902,18543,47359,52,38,53247,18734,34513
00f84b5afa8aa596a6db1a9178410b0e,52,42,100346,24934,75412,58,44,59931,34455,25476
1da7bbabcfdb79dc73e149dfd5c64b9f,72,57,122358,21656,100702,66,43,84455,25636,58819
5a15dc5560aef26f6bf57dcfc62b9b99,33,22,19864,7451,12413,47,38,29432,5404,24028
59cfce38ddfb5a9f3752dedbd2ee27a6,8,8,1117,392,725,6,5,909,199,710
c126f2b7ff613bebbfca6c213ea7515c,101,83,331358,108533,222825,154,118,378122,75421,302701
479521f268ac1f472a51556263e8acd4,149,112,640957,114330,526627,155,110,598696,100598,498098
5cae3df44b2c3eac11020503556c285f,107,89,302547,93762,208785,165,98,353769,76756,277013
b12b9abf455d27ba03357fd0af2ca1f7,71,61,112097,43371,68726,84,77,167323,32423,134900
89de0c0207f1f3a9eb6984374fd83844,201,121,913496,150733,762763,213,146,872495,185522,686973
2125f35265fbe9bc103488224f7c50fa,80,51,100250,27737,72513,59,51,85921,29611,56310
fe21c6a5f5cc43daa2ae0b31995f440d,129,96,338233,57801,280432,134,107,336028,87357,248671
50fa219213897d7de67a92999ed2a153,30,19,16347,4224,12123,28,20,14247,2945,11302
a53b2728a573f5eeb77831decf35b719,171,108,344124,67849,276275,130,85,242250,81027,161223
5939226a7bc08fe30bc8063b19fd5b1b,53,42,133456,33556,99900,72,62,114363,41717,72646
9c22fe5eaadccd2e75a19e32674cb198,138,96,347355,93012,254343,124,101,386616,81432,305184
d41a09cda3d7c5e1a2617b0b559480ae,190,141,999022,103316,895706,222,144,844708,130827,713881
4d5888314723178f9b51543e41f7c741,9,7,1477,478,999,7,12,1920,1203,717
db9cd6419e396c50dd5ac49740efff88,33,25,19277,7703,11574,37,33,18253,9561,8692
70a95216a270368bbdfba8ed6fd48110,1,0,67,0,67,0,1,0,67,-67
e908abca963514953bf6c5c58a1c1342,85,62,142663,40346,102317,87,76,161097,28849,132248
5b54d51715270dcc3e310b39a40980f7,98,74,150666,39347,111319,79,57,174201,27570,146631
a0672d7a78009e314d8a53c564915ba9,0,0,0,0,0,1,2,45,111,-66
db5748c8c63fd2652989352ad171b2bc,98,78,169012,44467,124545,86,74,169261,38518,130743
a90a4f837a63166fd71554f80aa71ddd,171,136,599620,144712,454908,140,105,453107,112829,340278
61b72cd84bb782e2a35fe21793468e08,126,87,329504,91757,237747,163,118,325247,101897,223350
916be7d00d42a3bd2912e76009b691aa,54,36,46216,17102,29114,37,36,55168,15980,39188
42c7edbfa89f19252666f5111f02b5bf,10,7,2131,1220,911,10,7,1909,1891,18
a3cb4a85cb6760fce073ce5af1d59621,22,15,4876,1855,3021,19,16,3775,2260,1515
4b105ce407ef8631ecb5354cb4baf1ab,45,35,32061,10441,21620,40,32,29468,8829,20639
e0423242a19cee3057f1802d414944ac,33,27,19807,7407,12400,34,22,27643,5832,21811
6ea0e783893f5b83468818c1f490ce96,55,40,109419,20829,88590,82,69,130382,41665,88717
a21363058ededac4036d539cedd70929,120,96,365109,83100,282009,169,124,552490,85975,466515
d69ab1220f359eaeed5b9ee02d1a5a47,37,21,34692,17066,17626,37,27,56510,12906,43604
c3da6c6e98f1387c834f7bda46721fef,34,29,23218,7576,15642,32,29,19475,9636,9839
9a00191c486614ebd2fa35ea87432d76,202,134,423645,87239,336406,138,108,291130,106147,184983
7f7757b9bd5bf614a2b8cef7d406c494,151,127,560807,149844,410963,163,138,642028,109961,532067
1554b75141e6b6f24d46b7dbf9335d40,77,62,138663,38848,99815,62,49,110955,46098,64857
a505c2f9e70a2f670acaa3b6a44827e5,176,130,512896,74617,438279,168,141,575263,87983,487280
1c20d3deb195493949154436d750fd26,26,20,13357,4686,8671,18,13,4405,2969,1436
5769f0f0f29059d70c67b66f45235efe,27,19,9946,4240,5706,26,16,15230,3165,12065
b5651748989ff4ac061a5cadd39414ec,41,40,53578,24685,28893,38,38,49202,19090,30112
b73b507ebb4769d4f7eb35baad338771,175,122,607681,101941,505740,168,121,491142,126835,364307
42045448c4d594b9d1f5a52d2811f042,40,31,50835,16753,34082,57,43,102996,22919,80077
89c5b57b06bb977c4e9a73a1c6cd17a0,38,30,31931,15871,16060,52,45,41380,16717,24663
71d86cf5e3aeb50998d0dd82e6390de7,168,108,633520,103628,529892,183,141,675418,120897,554521
9d13e86be90ba5ce2f5a160f93f3f848,37,34,53682,20218,33464,48,41,69761,15366,54395
90b7b548272f7099c7f682c8637e6798,209,127,1107388,247145,860243,233,170,1595210,225774,1369436
118735ea826e28c0c6937a8b39688a9b,198,124,773260,108913,664347,213,146,722568,106701,615867
16c284bfc1d4963729dbeb6011b9695a,54,45,80824,27375,53449,58,45,55688,26186,29502
0775d4c7b7869e8d9fa1fdc61083f5ac,29,21,8998,5112,3886,25,22,8942,4267,4675
f092f902694dff27200458fe6388bfea,131,79,232943,71649,161294,128,95,355814,59416,296398
ab551a9009df65220456b4cbcee83c63,131,97,254577,64975,189602,88,81,111213,59098,52115
c04b4e03dd61e70f6c8eb2fbaf73d17a,25,22,23918,7511,16407,28,17,18115,6849,11266
57ceb0dca4d334722fbba540d8a4e602,21,14,7939,2312,5627,19,16,7220,4279,2941
dda8bc51a5ba263ae8a6bf119424de48,58,54,71249,23087,48162,89,82,98774,24413,74361
da51f7d149cb4969fe4ec03a08ce40f7,103,65,153901,37332,116569,82,54,126166,40026,86140
3ccf57a732628f21151c7455c416b933,35,29,24486,5581,18905,34,22,17080,7591,9489
074c035d2eb763030150e144f80eea93,52,48,52776,17070,35706,74,53,75351,25447,49904
6efd1fafb8058c6a8b8ed2da8f2468ad,116,94,224091,74144,149947,129,86,329958,57904,272054
b2fdc856599559141d3af0348429ab71,101,81,171897,34290,137607,83,61,90377,43451,46926
669d44da5d880cb574ec58960eb62bf2,73,49,101444,22339,79105,97,81,127177,26125,101052
b4a78fb409264aa9d2dbf5a5381b3ce9,149,107,306187,73825,232362,131,85,281998,67490,214508
84f411f368dabc4c66346dfb056da06e,43,38,69770,25458,44312,54,39,63536,23933,39603
a676ab740324d348ebb8751258d8a535,179,135,575526,106222,469304,180,139,521182,111490,409692
a15baeeccb404320f9d801c501f5ebc7,86,64,167123,42504,124619,99,71,200093,36215,163878
f2c9ce33ce913705076d3fe81af037c9,163,108,460889,71568,389321,144,112,397140,72466,324674
ad05d5ddae3ea3f1613b19ca42204467,31,22,11863,5113,6750,26,20,11381,6433,4948
13764d59bb8d827bcdccbf8a3c0b186e,60,33,53564,19623,33941,50,41,59596,17340,42256
dfe0ac8d0c4fc617c073778ec2e46588,147,88,332062,84873,247189,168,118,472136,88012,384124
2d4581c7d8d52f145ea0f65fec3ddc63,155,114,579933,101300,478633,163,116,491108,113445,377663
146b9836b5b16da0d2ad7c3a466f0d29,71,53,116885,37755,79130,60,43,94075,38030,56045
b65d7ca4070c1b31c2c979c7d7b0a242,163,121,477537,70961,406576,195,148,497603,89938,407665
5676a8f3f9cdd0369e350e231b2c60e8,151,120,531204,48832,482372,142,127,457457,69413,388044
8a8766e07038fd0f75a217d8e76af863,195,137,708203,155784,552419,206,152,1163266,151777,1011489
873366a68e1e269071cdcaf627fc6cc7,39,32,20877,10069,10808,39,35,31788,10468,21320
b326f23c0d13376056677d5297ccb371,25,18,11530,3833,7697,19,20,6028,4253,1775
0b6e78ca37212155efb6488f7fbc3c6f,223,135,639104,179193,459911,217,164,824756,160573,664183
acfa0f0159701c1533a93dc1f92b57a9,10,5,1448,470,978,10,8,1654,525,1129
dc24cb0a10cd6d064def6e07fcc40e75,82,70,175833,49226,126607,86,75,173335,56323,117012
8143e78a6045aada162a9e449ab1ec6c,120,82,276179,79812,196367,140,90,267540,95064,172476
dc2d6fbd431bf000ebf3cbf4ac5158f2,137,97,405343,120653,284690,169,120,511166,113212,397954
6ead365c957392a1162efd96d6171021,96,79,132162,25387,106775,83,73,108918,28239,80679
57cbad58fe46c80b32ac8382c17311a0,121,96,403773,113562,290211,172,130,820248,98621,721627
d8118465ab9b6674216bdca927dc283f,117,92,359190,76525,282665,109,80,352438,79598,272840
fb4bb11d543febc4021a5fd77a48318a,121,83,226598,37367,189231,113,90,200014,38956,161058
6d5a4c09542af47de3a202765fc38f48,150,102,440795,87737,353058,172,129,520981,58561,462420
8ab85a4f79d792b29bab759387d2d6e4,69,58,89392,52560,36832,78,73,162112,40823,121289
ca7ac2264432af5c3767699221167dec,95,75,254004,56474,197530,88,70,181999,76968,105031
864abf27b088aa180240841424836430,150,124,622052,146511,475541,142,106,390053,124790,265263
532aa5488f876dd92e15c205d91f218c,130,109,333192,100796,232396,141,103,439152,77725,361427
81a2479b9d1be369c93b13aab84a0f49,170,124,473931,99558,374373,148,112,443069,88342,354727
850f9d5d8dc922f8999cc7b9c62e540d,218,162,622532,104061,518471,160,119,450707,110056,340651
123d0ad8ca232d88d3afda5a6365ecdb,8,12,1559,1773,-214,9,7,1924,1029,895
4ce5051e6970adc581de65123e1b7818,104,72,179215,34694,144521,112,95,189852,48412,141440
aa7830a8fa662d6d167e60e2d6a9a724,9,5,1358,716,642,9,8,1425,919,506
0ed047db5441430b5a28c0e85d9f2f10,49,38,46824,17973,28851,43,35,37450,13330,24120
4e6ad9efe70fb0a0a1b162af42322d68,49,43,54154,17945,36209,44,35,49100,16770,32330
2b43fe1bf23e4874c271ef4dbe74bdc1,32,23,23070,3912,19158,32,20,18936,5964,12972
ffa1aa25794f89e75c8c8e280bc20a5b,73,59,73290,18959,54331,78,52,95865,17054,78811
5283c012df304081a66bb536b34c9770,29,17,15535,4914,10621,24,19,18407,5037,13370
daba6b2524873ec67450b35a75eeb572,23,16,7934,2688,5246,15,16,6533,4020,2513
2049a4bc2aff5c6b1ef69215685c8b47,68,56,95999,48610,47389,74,60,124675,33504,91171
d182aee56febae562b3b3fd9aeb0fd1c,29,27,26971,16953,10018,39,30,43827,11228,32599
db80dfff4b6036b70b55b6aa675e0e77,132,92,270744,49151,221593,112,99,212419,70087,142332
e03a901394d7f726bed95c9c659fdf7d,40,33,33323,12918,20405,38,26,33408,12189,21219
01d1b8bc61e10f8a1b899ca4db6eed19,31,26,22579,12018,10561,36,26,20725,10973,9752
46463eee1aec12a312fa4f449803865a,34,30,19353,5673,13680,31,27,22601,5127,17474
0ff7c9ab62a5b95da8b1a953e6250c6f,51,36,69859,13947,55912,47,42,50846,21979,28867
3ed80443f2fadaa68665dbadec857cdf,172,119,446750,76990,369760,221,161,595426,103810,491616
e57264ac0b59056a20b5c9e933773107,121,93,272522,51348,221174,64,56,166922,50034,116888
9623010a45e2400d9e80bba32fc7c95c,128,91,181599,53822,127777,135,97,208106,34964,173142
8d8b9d281009e46cbabb08d7e43ddc16,152,100,387240,93510,293730,139,113,355077,98560,256517
d36699b67dd920f60b2c286f573f993f,80,68,126287,40389,85898,117,94,209619,41185,168434
059419c724fcb3bda55d7cc364b8d739,63,50,64447,24582,39865,61,42,77536,16180,61356
6fdfd37c23de67726b3198f5d642f91b,68,49,102521,16077,86444,39,41,34156,25992,8164
6224c6ebbf948f2497c826dbdc7a48e4,137,107,472663,87947,384716,152,132,595061,102898,492163
93d24e7a710aa47e001b08773e1c297d,114,87,238678,73745,164933,112,83,277190,53093,224097
75ef40397f466302914cf51d592058dd,111,84,469117,87168,381949,198,181,862085,161955,700130
e8ea90e10873ec73aa38897b0b10e356,137,110,392980,91581,301399,98,62,241058,70180,170878
7a35a488fdc6ebd31c0ff6d12bab251c,54,45,72185,27560,44625,52,44,78266,21316,56950
93f5fc333ddcb29070446726295fc94e,103,74,132516,37188,95328,103,64,149097,32868,116229
cebf26465d62a9d727811e53bbb629c9,28,17,14495,4145,10350,22,20,11579,4189,7390
4fb4fa3c6341daf07c42527dce05514a,21,21,5077,4203,874,23,13,9186,1489,7697
f03a5c2b4485b43ace936bacacb34317,44,41,43296,15629,27667,40,35,36720,14508,22212
5d10b139ed279551a65c52db802ad796,20,27,9707,4965,4742,27,18,10112,4008,6104
b7996a89e5abe24f1c65e9910c4b7039,30,22,16653,7374,9279,31,25,15340,8217,7123
3c7f1440a5b8ba886fc3f009a39f13e2,112,86,202155,38856,163299,144,106,214180,45245,168935
a8ffc9e8baf6c5fbb73d96e6b74261f1,107,84,243956,59025,184931,149,89,261744,50876,210868
4fcf4d13ec450877572d22ba5677f5d5,121,102,230125,67024,163101,97,88,199093,73995,125098
70aef273dddf05089c8be250cddc5e5a,51,39,57260,10179,47081,61,45,61017,17373,43644
d0486501e19031a82c200acaae23b98e,16,11,1620,588,1032,10,12,814,911,-97
cc3eaf01e0f63baf55db52d00031e7d9,39,28,25402,7100,18302,41,32,23382,12577,10805
e08ef43c9073feceacaf3bddbd66221d,124,79,244113,48010,196103,63,49,124169,49694,74475
414e338db01433346fcebe3b8a47fc77,117,94,316023,109380,206643,95,82,356806,99848,256958
49f77f45257d5633c9d8e0ce9d14057f,21,16,6188,4429,1759,21,19,9878,3452,6426
edfc0c75b40ef0c8e2936af5588de8f2,23,17,15990,7063,8927,29,22,22712,7654,15058
29f01df81ec49a9dd7a3cd7a121abec9,22,15,7003,2567,4436,22,17,7505,3006,4499
46422728ed2f6c5fe110ba0732ad501d,170,125,419391,75429,343962,143,113,354894,84053,270841
bf096c4a0dfc2b54604f33b9b2d5973d,131,102,325355,114631,210724,162,119,542341,112129,430212
0d23dff1e586f984c14c73bf9eb0ae0f,148,111,413616,68270,345346,101,88,278705,88504,190201
9ceef61eddb97f1938d4ae0198bfa4f5,59,47,72720,22105,50615,50,43,56174,20993,35181
203d778ea0924083336561362397da74,88,70,159119,41800,117319,68,54,119921,34210,85711
f4162c50e663b6192d40d92bec1df8ed,187,140,896572,168945,727627,219,180,1199209,169131,1030078
716d7178c5de359f84d8e2333ae48a34,25,20,8867,4137,4730,24,22,8043,4047,3996
b86d5117bf3db1fb4d009aa2ec68c329,146,89,357332,91800,265532,184,156,476469,99551,376918
277e4a72c5065febd73ba9e577ba8512,124,98,282592,56313,226279,114,87,204274,65485,138789
7cea5abc54e07270242dc15700c6df93,34,23,22651,12970,9681,30,26,27983,12108,15875
c6fc4d6a3a0913c4f9813bcba8ad945f,59,42,74786,19867,54919,63,65,82009,26162,55847
a7da81e8855e6d2347ef6cadbba7112e,161,123,547625,84201,463424,158,122,504882,84051,420831
f95c7656718d15ddb519b3e811fcd712,63,47,73532,18009,55523,54,44,53844,21000,32844
b2c5bc333752d3a508fea5dd56870bff,143,119,323544,55125,268419,106,71,193986,36867,157119
90c8c5ac06fe1b1c945053d57742d36d,124,97,294479,73450,221029,127,98,282715,65777,216938
06db8f62b5dc940d03862cb413580ef4,140,96,345792,61656,284136,119,90,274267,73169,201098
c58f1c16efb266c1a289787639b8780f,36,32,29033,11453,17580,35,30,30309,12017,18292
050100a444345cbb80ae40b9dec30bfe,70,63,107431,26978,80453,74,50,105745,28415,77330
abee728b7bffa9eb75aa3e6eca8aea3b,39,32,64621,19890,44731,60,56,71816,23603,48213
c514041e18bd99bdeb931c29626fe38e,143,92,329339,47703,281636,154,128,362641,59659,302982
00cef8f2eb856da315dfe37727625d51,46,36,50332,18101,32231,45,36,49653,14749,34904
6c9aaa5b47d8c6304a56a99f7dd6050e,163,100,450073,95110,354963,148,93,346234,95728,250506
c5e33666fbecb830c805f611bb353a8b,103,84,130364,33323,97041,96,62,123669,30167,93502
4d391bc4469dbbfc85b028d5b5defd8c,123,79,360746,70771,289975,147,107,347705,77096,270609
ba192177fb984b61a2cf58e0a322fcfb,48,27,36609,8450,28159,39,31,41416,9646,31770
88a1daa007d0f51de2adb4dbaa208d0c,137,103,415116,88085,327031,148,120,349438,99865,249573
28a8b7937bac0891a4287b5c8812e06d,169,86,422351,61755,360596,125,96,319370,83760,235610
cfb47e644466171015af7ba0511e04aa,167,147,465892,97228,368664,119,96,355763,103133,252630
493b41baace5d7ca43543ad9efff28ff,153,75,301783,66208,235575,104,80,249085,85415,163670
5bda6c719109da8fd8f4feb3d30f135e,38,30,23167,11384,11783,47,41,53495,12266,41229
517e70d7f6554b8eb53e14dff909c3ce,21,18,5144,2275,2869,30,22,12786,2424,10362
0c1b793bc034d78c24a3190ae0bc7832,188,147,392794,76472,316322,134,97,386140,68455,317685
130eca4e9e29594ec984dd0ecdb6189e,84,69,137725,36856,100869,121,112,195948,40959,154989
2274d6a9af36787fc6eb285eec1458eb,144,122,399158,77599,321559,140,99,441434,77886,363548
7cc6aa6d87a0977e02af0a328409e053,27,20,12951,4564,8387,19,20,10636,4251,6385
863a68903522b03dd00b9cd33b7a3a68,26,24,8926,3883,5043,29,21,8669,3021,5648
afed912379f60b63bf9f95e633fb55bd,146,111,448479,67466,381013,103,87,236921,46010,190911
e6b10bfb1117cf64eb97298711975e92,101,65,193135,50349,142786,103,78,222794,41708,181086
d0cd09eb51b6f158cb8cf986f7133e20,85,70,124251,34032,90219,81,59,107999,34370,73629
e594d1b9cf9155dc91953b7b10c9e173,73,59,122671,40637,82034,100,86,146650,46130,100520
2dc873d1033cb8e06e3626d65441650b,170,121,388563,66094,322469,152,103,291871,73706,218165
5f78f8d64273eb89d90039b1bffae43d,108,83,235668,72478,163190,122,73,274278,49677,224601
1b43750a856dffee36ba32e9766190fb,73,56,88034,36966,51068,104,70,95863,28578,67285
b3a2edc88070f1d1237502724b3d7246,92,68,128195,24640,103555,55,47,68710,22483,46227
03d3de20c2b28b0ef802d001f41ce320,113,91,232535,55560,176975,70,59,173865,35807,138058
774e0315adc3fd079f655c3706863a9c,149,119,461857,86036,375821,149,133,453445,100733,352712
fd5a82e7b16a52d0b847e3990fc3a0ae,48,40,56939,17978,38961,49,34,62269,17552,44717
0cd8e7dc8f90fb9b4120eb7545a6feab,77,67,201986,52360,149626,59,52,150630,53765,96865
214cac7cbdec9875056f63c98b81e0d7,30,27,16611,6881,9730,25,20,15148,5546,9602
d695b9616f4f41e8af075363dd39150e,5,2,561,190,371,2,4,190,463,-273
29241096812ed17805527bda3c614449,48,41,59369,23074,36295,51,36,77434,15912,61522
0ec67bc47ef795975df23539477f0b5a,53,39,75879,22929,52950,43,32,37849,15056,22793
af027028811993b0dab62bedadd73d1d,134,108,363425,102953,260472,193,159,423218,102782,320436
1c9d924532fff0430c5bc8db464f8c73,67,52,72044,17411,54633,65,60,69341,19686,49655
b7fa805d25718fb3dd80db0a6af4e7c3,48,43,38767,20902,17865,52,38,45947,17476,28471
022fcc74abfd1d5aa10b8a8c2c58ee38,96,80,131371,37682,93689,71,52,100698,24899,75799
6f2c89fda457b03ec46402bf67a0b540,80,57,119746,52589,67157,100,86,171473,51788,119685
fd7a0f585351e80a23f3c709665cca68,158,119,278054,55442,222612,125,79,183696,54198,129498
4d20ae10f7af5c812f0f43014200e111,0,0,0,0,0,0,0,0,0,0
9c8648c28bba2f5cd9a6244e7d135a35,149,123,457037,57292,399745,120,104,361415,71608,289807
eb3fa1679094e8fdd0cf655552b041aa,146,108,481411,100136,381275,146,96,371999,121885,250114
35e5b804642707913e41e9393e1773b2,53,40,48190,17703,30487,48,32,51025,15457,35568
b616bd587287c7edb082c919c0748596,207,158,953100,170385,782715,220,155,753715,242421,511294
8b5dd7285dea494830c23a59b3c452bf,74,61,91408,33777,57631,73,62,109986,20348,89638
b8c22f663121d3dd578024221e8af4fa,135,103,411412,73230,338182,166,135,485459,79609,405850
e21fc9fc5ef605304a325b34d2842c11,150,111,439342,77833,361509,132,114,440354,99257,341097
9be81a73b15b523d9a36d684b27006a1,145,116,353963,57803,296160,120,97,222714,62022,160692
ddc01acd1edb064b637601cd2a4d79ca,103,107,220650,92935,127715,140,103,345589,59234,286355
6217e4f96e7ea86e0cf562a39c279c9e,161,125,515302,127394,387908,213,131,655829,120816,535013
f12d6034979a13884d81c52db9144626,34,23,25388,8969,16419,29,24,15553,9380,6173
c1c4589dbce8b725a6397e0e28778b8d,95,72,159704,61366,98338,103,79,192133,39624,152509
e3f1fe36205dacf1efc1f184b3029672,140,111,469229,150041,319188,143,107,459578,111747,347831
0fef596a1922485cc40074529de6c146,50,34,30744,14545,16199,38,32,41290,17096,24194
e614acf482ad4d674d2fd70bbf9c4dbd,87,59,113117,17377,95740,60,50,57826,26265,31561
5db37cd40244391949c7b83c137ede79,18,13,1898,939,959,17,6,3255,609,2646
9bd29fbeb1029a84339dadf205533024,99,78,166772,47875,118897,69,52,153914,29868,124046
773058510be2b791b9b61922d7556656,184,153,840968,142961,698007,172,140,631028,146543,484485
b8f8c5f5b118ea88f359e3f464ef8779,128,113,329659,106572,223087,172,120,398531,67795,330736
5a20b98459e85dd7d0c4b65a3e163e49,63,52,136734,31020,105714,71,68,90340,40645,49695
4d389332655e450b3cb2dbaac72b5f9d,90,69,195468,45470,149998,91,75,123539,60408,63131
2413f6c92fc21912e5eb804c9243fe82,160,112,452547,73952,378595,137,101,294512,71874,222638
0ed23a339e349832d89c505cc7452df5,22,16,5660,4077,1583,27,23,11670,3493,8177
0cd0983e423467a0c7ca280f3aaa3652,158,113,372845,77777,295068,197,143,621453,71453,550000
344a2ab104a8645ec0f47e2a43d63bc7,95,77,238613,82732,155881,173,133,523595,80426,443169
05f05be246bb0951d1f34f1593373fc8,110,85,249655,64192,185463,124,96,276816,62211,214605
1ebde83e7c88d3a039f949e60f805f00,128,104,377566,102334,275232,191,151,555038,108787,446251
598b9be801dfcb6dc603955708a9c42c,46,33,45703,11226,34477,29,27,27803,10387,17416
e41f2ad14662274f7bef227747f2b066,85,53,193875,68822,125053,122,96,292538,70383,222155
315641f0f54c7decc444484b78b29a0c,141,97,228429,44998,183431,97,81,157961,59151,98810
d573514c54754b17ce0b844610e4b873,115,80,250885,49739,201146,113,100,201508,56948,144560
becff915bf0613c02879e1a0fdc59089,36,28,19305,4901,14404,39,30,17176,4473,12703
fd9ae0183b17c052ade1ecc7eb15c829,158,98,347052,65354,281698,139,96,324059,69529,254530
4eef96506270e15e537502958cf9616a,33,33,20584,9966,10618,39,28,28203,10522,17681
432f6cb7a02a84e9d519c5968a8078ce,119,105,296690,100061,196629,114,73,296436,49936,246500
3b512c183e950d7da3901aa3a7ecf102,29,26,16061,9823,6238,29,27,24379,12053,12326
aa80b5ab395b42b5a052654ec73a98f9,151,105,315446,72159,243287,128,91,266892,67952,198940
0cd3b8441c94c4051792877cedf68907,121,99,259380,38889,220491,115,86,179779,36399,143380
652435ac6e37214d80b2d6e7f627a57f,48,32,27404,9201,18203,40,31,35391,12937,22454
28217c95515c629f689f4ebfdd84f8d3,168,133,644539,139846,504693,184,128,810757,137546,673211
3c71d5c2a4a098472280d16d794a0e41,38,30,33290,14881,18409,36,26,40877,9225,31652
a3d06f6f345433d66d3ea33b2c564019,95,74,155818,41086,114732,85,59,135676,34074,101602
80845e1f9be5f85d82ecfb3d93cddde5,186,154,579825,138554,441271,140,106,515904,130942,384962
17ff0a38dd26344501485caf36f510bf,124,85,263875,90151,173724,172,124,396087,77829,318258
b9767f0a4fd4218426239b526d2ffdd3,114,80,265452,40151,225301,117,92,225954,55343,170611
bf71efcc08cc07d90dcba778567b0287,41,31,33390,16173,17217,46,33,37367,13579,23788
8a758c0855903e12a5f8e151833160b5,57,50,95227,32211,63016,53,45,93880,25957,67923
c7f7d8d4fab279adbd33ee2b487ea65c,63,46,68560,16538,52022,58,42,84591,13193,71398
ebb53cb6fb5b36b3147ce95bb664ab74,122,76,236516,46748,189768,92,59,167223,48126,119097
90fd5dc523cd6f5c81f0fb0998cbf54f,80,52,121339,38404,82935,71,53,118608,36153,82455
a4755e9e2380f01e3eedc435f47ec434,76,61,79538,26853,52685,76,68,90533,31065,59468
de543af37604626c285c94d8b1b7f6ca,138,96,341538,75160,266378,172,139,429621,70118,359503
59b334565c932a7e72fcd9be89c731d9,61,40,89721,22046,67675,77,70,106100,28518,77582
acba0987be6db5feaa263d108317a222,95,85,219305,50747,168558,119,96,230188,50055,180133
45e3aadaea4ac7b7f7ee9fa80c202bbb,128,110,359582,69709,289873,124,103,355616,76577,279039
432e14092cfe57ceec5aa984428453df,159,110,358721,81067,277654,126,86,288293,83602,204691
d3e5e340f232578568f2c9d31b7c6ec3,108,83,259243,100757,158486,155,116,348136,120985,227151
133b41e7c6f4d95134b038ef99407050,42,36,81056,34499,46557,60,55,105259,35483,69776
5a8bc32e30a177683984d7503e656a6c,47,43,57281,19929,37352,75,55,62534,20421,42113
52a54fd2564cda669b83123dd5471c08,2,2,101,203,-102,2,2,203,101,102
782201bc2dc57f058177deedbf9e4eae,131,103,340834,94703,246131,140,94,302291,76794,225497
56e5cee21079ba67a75040604371045e,34,28,17208,8207,9001,29,24,12480,8120,4360
cfca1b3ab7df329f91b0bf9a9c3d75be,25,13,12381,3645,8736,19,21,10285,3644,6641
c25b4ef91bf31bdd99b678cf68cecd12,223,182,638331,172638,465693,203,166,822539,152402,670137
47d7eea622a95f0c4504c842715b6e7c,62,47,77091,22508,54583,59,40,72950,21873,51077
5ef5f7dff8823452a031e5cdc94bcae5,39,32,34560,9695,24865,29,23,17592,7522,10070
94613ada256568962485c64cc6ac7ea4,167,138,625499,89404,536095,171,125,601432,96287,505145
8293a235497cbb0506105ac2b664fb0c,11,12,1940,452,1488,12,7,773,346,427
6535086672a0d92bdd6d32154b784c82,114,93,210022,63357,146665,105,74,205560,61854,143706
62ed854d584ba1391c8f9da943ff05f8,131,110,424388,135074,289314,187,128,559839,102237,457602
849a3b31aeb0047ff3b00fffa391ea00,140,82,330839,60224,270615,111,77,234170,68039,166131
d84beff835282b57742232cd6d065546,163,122,613768,108270,505498,178,134,623348,81066,542282
b9c73a071a08c34b940c2acf15631ccb,45,35,64388,13927,50461,38,25,45771,14845,30926
0ed106dd6beae27bbbbe15798b7bee33,74,64,120846,41094,79752,72,73,148672,48284,100388
4292c43facc86dd56687c4863b5c23d4,171,126,584947,124618,460329,201,149,555027,109662,445365
2a1783b303a081c22492f76b02a2bd1e,176,149,622921,152573,470348,135,86,548958,104687,444271
53125506ddb6be0bd86a5f265d8aa50f,132,107,400932,114209,286723,171,148,674701,101954,572747
f857c83e248d5776683677df9e486a14,58,38,80517,25804,54713,57,49,65432,33675,31757
2caa4c1e36cb667c6f617042402dd74c,155,101,550564,133470,417094,163,142,615935,108061,507874
f261046ef2c5bed4897ef41ad1a425f5,28,22,14541,3886,10655,31,23,13491,5222,8269
fd30ca9a2ceb83f5bbdf16a677797d97,139,79,204437,55090,149347,148,95,270142,53603,216539
f26655820282585ce0aad5665a3cde08,43,32,38391,16551,21840,51,39,47774,15738,32036
83f1b00fa5be0f3e78289fe9c8d89239,37,33,36927,15796,21131,46,35,46479,16644,29835
62c1488387142d536841def2c095df85,83,61,143258,32013,111245,58,44,108490,35318,73172
c5103ff24042d68699085fef467d26bf,59,40,89341,20595,68746,46,45,52320,31617,20703
3af1d95e4d2e31003b04a336c8d36cbf,155,123,563572,110826,452746,132,110,522662,99297,423365
a184a86bf305110f93635e3f405e8aaa,143,117,337942,81320,256622,109,87,199995,55906,144089
d061dc80e2eb3e801672388e349a8082,60,56,81035,24991,56044,55,46,50688,17242,33446
04769530dc393cf9f4e111f58362bc44,50,40,54244,24196,30048,59,50,68442,20721,47721
c1599e78d2b01caac7d5ec6f57a7bb45,116,88,447836,105975,341861,204,161,729801,94366,635435
a638c4ff242d6290b86904f7fe1cd79e,26,17,11810,5900,5910,39,23,16089,4119,11970
1469df69ee6cb46e8694ff875df28cb7,78,62,122010,29404,92606,74,70,101809,37935,63874
731758b53290f23aee89532d7f55b20a,25,21,13578,4002,9576,23,22,9943,6248,3695
70f251c1bb070e38966757c172fc2a1b,99,72,179729,45283,134446,110,100,245747,59894,185853
0272aedc0c588fd16ec373efe36ba5b4,81,78,116417,28281,88136,92,69,74814,25044,49770
9c2024e1f03b0128488521ba0831cdb3,162,109,584057,89170,494887,173,123,543299,130846,412453
8331fb48b5df633f0c733c733a01cbd0,134,111,384282,97637,286645,156,114,359960,52316,307644
2a6087e4da89a233c126b09932b55eab,90,62,139274,32290,106984,87,60,86478,29916,56562
09f6be29da8d4bbdda4e25c8410f0e02,154,107,431819,80875,350944,117,89,258183,82517,175666
675096bd1f30d2b8734f0fafd1dad8ab,20,17,3619,2148,1471,17,17,3864,2165,1699
f4fa5728e91f338564c02c36a0ec6976,150,93,253248,66957,186291,87,78,184603,76914,107689
2fd256f17651aff69136ad94e1ae79c1,130,94,307839,87406,220433,113,92,424083,87399,336684
d6f1156b5585f1910c17cea36bd1c086,26,21,8937,2776,6161,28,21,8938,4084,4854
517f096308970939f70de3caf53c31f9,144,100,348215,59153,289062,107,79,256678,57895,198783
755b23cb36aa53981435ce38eb9be51e,141,85,378436,55097,323339,119,80,305273,68651,236622
59127468755b9d1d4b0e608db7873175,133,97,361015,50318,310697,105,74,184757,64238,120519
b6d9d3d95fb0347c54131d2b9208e40d,117,93,256464,50553,205911,128,82,233555,39354,194201
5d4d86d55a7d15b5bad4d3b6a1c78789,75,56,162365,49922,112443,122,87,273236,42510,230726
a1d959172ceebc294f8271ecacd1c2be,91,69,133439,21545,111894,92,79,127234,42028,85206
abfbf06e28c28c72c883ef9bd1960e0f,104,87,233088,46214,186874,112,86,184018,41360,142658
df1ba3b28cf8d89b67975554ffcbd795,123,73,178293,42423,135870,97,76,170457,53717,116740
2e4cc6f514cf05ea5481db68afcc7f8a,25,19,14651,6160,8491,31,21,17846,6094,11752
71cfa4e4af151849bba5b70849e19892,147,95,554684,112332,442352,188,154,809678,130710,678968
c6877826246b8d5cecda520d941c044f,54,49,64937,20625,44312,53,42,41449,19784,21665
3484eb9d679cb680ad55e4190f1f20c7,34,29,22973,13895,9078,40,27,30894,8242,22652
9422b4fe2da9e433a8b904947f6320e0,25,22,14640,10276,4364,36,22,24756,8536,16220
7e9f5ffe211253bceb7c93e3b72f9fa1,64,42,82881,22835,60046,83,66,125987,23508,102479
030b6a74fb8d7fb6f288ecdb73e076f3,11,10,2004,1671,333,15,8,3058,1349,1709
d635f41a73431e9f6e365908b298167a,96,74,174712,41086,133626,69,65,145369,54628,90741
53e87d656263cb4794f5bf204da2301c,156,119,386297,76983,309314,113,87,314970,72148,242822
56ccc31967600a547996ff2b2c9bc685,208,103,540607,82614,457993,209,138,713918,116737,597181
040ef71194127cdcaef758321306ed6e,46,38,53259,22788,30471,68,46,106010,20465,85545
6f0dd8ceb4cf3b640952941524c14b97,29,23,11167,6529,4638,28,23,10409,6446,3963
15e8c5bb4a0f38a2f0c7b55ec5cbe3ce,13,5,2228,188,2040,14,13,1695,990,705
d7e391219e1bd5b05c582b83f6aa7526,36,26,20338,9795,10543,46,36,29424,6936,22488
a9ca26a630fce446538bdba412a7af22,87,52,73421,18173,55248,41,34,54167,15162,39005
afeb10f6319cced38b93238cd1e2f18c,184,123,598486,96888,501598,136,79,469061,86866,382195
7041969ceb0d589a0fca88e45cfd7a87,30,22,25490,9120,16370,26,23,17517,10658,6859
1088c3a76da0c29718cb388389c50907,124,87,196959,48590,148369,108,71,183450,41606,141844
e195e17fb05fa902a737897125b18c4a,126,105,218996,30798,188198,125,94,224575,43909,180666
0891f097c95c60696966fc96148c6905,89,60,108297,42095,66202,94,80,158937,61392,97545
cbe8a9f7c51df1fe8732d20c4cb0df75,74,65,128309,35940,92369,77,57,91678,36385,55293
a2cb77e82bf56fd3becf205c17ba0ee9,23,20,6751,4181,2570,27,21,8421,4253,4168
5ad28f1d69b78ef110950a356ab0f79f,38,26,28919,7102,21817,45,30,26280,6826,19454
db90ab459e804c9f39f54cc8059029c7,47,42,66937,30013,36924,55,40,81535,21950,59585
fc309e7155bfa38644df4b9503ad5c03,137,89,374579,95374,279205,149,91,361999,74814,287185
741c19a4dbe5fde8fe7f83a7a5de4ad1,52,40,61409,21528,39881,50,41,60889,19414,41475
b1a9cabf1b39218fe1e9959ad24d19a2,144,113,330365,44334,286031,146,117,381462,55426,326036
5997c8de28cb2a3800fa2035c4326b70,126,100,368327,84194,284133,146,130,526485,92185,434300
a245231ab2f8ca97bead15eec71102f0,118,91,258246,59378,198868,109,97,247975,85071,162904
ff14707ce37e3ba9149cf252029af8e3,8,4,1255,395,860,7,5,663,802,-139
1b0b74dfcc3b49ee263749a8cc12bd22,51,41,80574,25736,54838,55,48,79586,21151,58435
6e910e4693dd4985fd1c17703e8f28be,79,57,135409,37752,97657,79,64,143646,27940,115706
1ec330716ea282b166359632e9b6c295,144,122,322751,74277,248474,110,82,217445,68633,148812
bd621072c4a7c220ffb11a7bb42c6a94,44,46,52945,18471,34474,47,34,50682,16624,34058
219b81a5cd1653e57156ad7e2005110f,131,90,312713,59016,253697,127,107,346772,76189,270583
4af8e37f8de6a8a734e3357763e90435,99,75,193269,54536,138733,134,90,251346,46687,204659
1f7ac45810358c73015463e0e92a1f51,174,144,515291,92000,423291,200,147,459511,88191,371320
279ac31d8afa42898810ca340305877b,176,130,573426,112092,461334,124,90,373923,132694,241229
15a4d8a0d62b07579ff335616cca2032,122,98,256008,55489,200519,98,71,196012,51915,144097
f052d743480bb0da370c8753adcbae50,23,20,7679,2797,4882,28,19,7808,4732,3076
727439b8c85243a1ee019439651c279b,58,43,42429,15601,26828,48,41,48488,11544,36944
ea41bd0897e9bd18be65ae9af62d4a12,110,69,221491,42793,178698,123,81,215361,47653,167708
0ef5a4bcbe6762d11bece0aaae1aa812,109,83,249805,61629,188176,109,93,231831,64050,167781
598c01029010e547d4110ae35b75e714,133,92,217395,46425,170970,132,101,312366,59625,252741
a47bed099f66ac7d66cad184fead386b,33,22,9292,4062,5230,28,22,9264,6022,3242
6ad933fcc22e405b73e1689146a339bb,101,85,194811,53396,141415,87,73,196500,57517,138983
bc09f57875037384fc24ae2d9d8f813a,115,92,236296,57894,178402,116,90,189473,70937,118536
6e58fc8e1be98eb3b42591bb2a168153,156,98,572793,104793,468000,174,138,527072,88680,438392
06914c389cad9072072c1ea8be95cada,44,37,33510,18700,14810,47,33,52271,14731,37540
304e0816d43f6b2626e0683dbbd6f4b6,233,169,1142283,238628,903655,182,151,1490586,226385,1264201
d3737d69d2bead44834cdc4b469e85b1,70,51,107658,22513,85145,43,32,69407,25065,44342
2e174a01c1b8695e1e41a2b9d538d446,64,53,90771,27215,63556,60,42,70098,26958,43140
cb52235370819f24261432e2093e2584,93,80,139179,47671,91508,80,63,127576,35667,91909
6f95785c00012363546744e538c31dce,50,45,50608,20738,29870,59,55,63433,18643,44790
c2315d677aec6ffbc448c511856c84c1,32,30,12634,8465,4169,35,29,16536,8232,8304
c7aa6c4a718b94025590249941e9123d,129,99,235960,55910,180050,165,120,370704,65420,305284
9be9c618d9e2b4e8624741861586bd72,163,137,717792,129243,588549,162,128,634129,111868,522261
45d62cd385a657a1094832daf0cb1bbe,122,88,344261,78228,266033,137,102,428959,92287,336672
0a34c4a0c9e1fe7ed60b5b7d011af183,121,85,216831,56926,159905,107,88,237126,53556,183570
e9cbe4f2da798ac37d2a3e847356a9d0,134,116,450277,88323,361954,107,80,284935,96207,188728
b0ef043a7c5f2cbd9f64346ca94264d5,21,19,5926,3148,2778,19,17,8726,2965,5761
ef093a81a6bec00bbc1a30ff17519121,28,25,25732,8144,17588,28,20,11275,6728,4547
2dc7e0c398616db7446976b514311d19,47,33,78427,13649,64778,41,34,31047,18592,12455
9549edffb695d60a63e87203b594067c,59,54,120881,40993,79888,69,47,125280,35110,90170
767723674fef00b21bfb471a1539237b,50,37,62342,21365,40977,44,38,55628,23744,31884
2d5dafee058bd6196f06ddbcc0af4dae,29,22,12009,3941,8068,26,26,12731,5220,7511
13a2a2106d6683aad4d141266b0bcab3,29,19,11906,4675,7231,24,19,11884,5839,6045
754f7c684ea2371d844db78536665e65,16,10,3215,1105,2110,14,15,2469,2004,465
0fa04e590d78216a639b06d8b942eef7,121,71,186620,43262,143358,92,63,156743,43959,112784
f966361e4a3d5f4b2c595689c1955985,63,49,67257,25879,41378,84,58,72761,21050,51711
4a86c45a106a91f3ccce7b80dba48327,44,36,57324,16192,41132,44,33,46777,21944,24833
951238ab1802acb719ec0bdb81fec0e4,41,29,27438,10535,16903,39,37,32412,12614,19798
a9ae7500713535e50e384ecff245f85c,135,96,379160,106586,272574,185,127,524786,91490,433296
c4f9fc842c4e9ebfc14de25c5cd18bbf,153,129,415828,90302,325526,139,109,360892,101643,259249
eb297be953931847f6eeb7eb22a502e7,43,38,45126,18065,27061,54,39,66297,15257,51040
d244992844f51fecbe77caea26ab7e74,108,95,251724,46701,205023,97,71,131599,60782,70817
2bb42d5704278e796be5e9d2e5cf6c5a,57,46,62193,27228,34965,64,60,94287,22980,71307
a383eb9ab97e1cd95bc66369d919a815,90,72,143231,54208,89023,76,54,149994,46026,103968
5a1902a8535eda1bb10a4ed1ce98cf90,42,38,53510,17008,36502,41,30,45022,11143,33879
882d893547076aea17defa540637b5fb,54,44,73294,27175,46119,48,38,60952,22830,38122
936f147e8dadde3c9d7a9f7a9eb8da60,118,95,369868,65029,304839,103,90,250891,58682,192209
278f2153ace5736d23cd1bb80007d1be,100,85,241649,65710,175939,122,83,263415,68284,195131
a320f2ea061a67ef19578bab05a7843e,99,82,193667,48919,144748,114,91,242390,39285,203105
b9c649e73bbc61787d21e67ed45a610e,113,90,226512,52759,173753,118,100,229874,56570,173304
98ea7fee49b4533f6503a278af1420b6,183,136,567127,108735,458392,161,108,489600,147843,341757
5f71cd7df25d5e9382a8820749b25391,9,13,2041,1450,591,17,9,2076,1346,730
7525de8f61ba900a384c5c025f35a554,81,56,130268,40664,89604,88,64,146960,44619,102341
c7093d686daa45b5c0b7b209ccf0b3d7,127,105,361536,137868,223668,165,123,507631,87923,419708
d96dd8068d78befa4d3f79ebeaf26053,79,53,103100,20855,82245,44,36,54819,27616,27203
76820ce434ba30b9f6837d2c210e67cb,33,28,19700,10182,9518,39,29,24863,8870,15993
51417278ed5efebefb91b59587dc9d08,17,15,3814,2456,1358,19,12,4956,1816,3140
88c645b9cc8add2259adfc5555c36fc0,155,109,706635,163973,542662,181,140,702701,164373,538328
5d93f3d1b59ec0abf9496eeaec558e41,211,161,999707,146119,853588,261,185,1082052,183938,898114
96737a77a248c70ab758bcd800f61975,134,102,455740,95448,360292,182,148,534609,148010,386599
7e352034ee29c3815fcea0a263329ac4,163,122,351734,75996,275738,114,77,283843,72668,211175
7e58c557e64da0d458888a5b83e83df6,168,143,514550,137826,376724,154,131,573000,111563,461437
1f02ee940e9cf3bb454329ba367b2caf,209,166,1794522,251082,1543440,212,146,954480,177941,776539
29b62fd0a426bcaf917609c9f61cba9e,26,19,9454,4535,4919,23,18,8815,4756,4059
cbe43b70dfd146576960d0bc7b6929cf,21,17,8451,4220,4231,16,13,6937,5060,1877
81aee3694edfd9249514accc348a6cec,164,121,591340,111113,480227,194,157,796696,110331,686365
8c31e8311146842b2a85203f1e6fb559,158,119,449262,86312,362950,183,127,406734,75526,331208
6f50cb33a6fd278f6f1569d7784eb731,122,99,502332,77878,424454,208,164,608278,81787,526491
c993e8abeb88bae8f3d8b3509f1bce06,49,43,56349,15680,40669,39,29,48731,10232,38499
84f7322fac074844f63a0c7d904b6bdd,156,116,411211,132716,278495,127,94,310328,89047,221281
b2ca1dd0387ea4533bba5fb9bbe8dc46,155,128,411038,72695,338343,137,92,389814,51524,338290
1cf01dd93db56a59ca48b091707a1e62,73,59,118463,47868,70595,99,85,140285,41764,98521
5100bb17b92efc6af4b3db862af2dc9d,151,84,515815,126140,389675,189,122,430376,131011,299365
19e7df193e946227f3b36fe21b0f9bc1,23,24,11766,8527,3239,33,25,31873,6724,25149
df7f6b422b203da9671d04239bddeb75,80,53,107492,19791,87701,59,40,53193,23474,29719
5e95c666d18fc74c7d135f09405ccb68,117,80,370599,72100,298499,131,101,430112,79519,350593
ecd158609dda7bd23a173ab1adb9ed09,211,155,605475,82773,522702,151,132,538604,135398,403206
11ac5ff4b4a32971ca7bd821f96ac6ff,123,94,273655,44008,229647,100,89,177037,41116,135921
ee8620aac33273f9864bde33362a4585,70,46,89684,28949,60735,64,55,89624,28901,60723
b67b719a8abd8a8050bbd766e316a9d5,134,110,260654,88875,171779,144,118,327849,69461,258388
d41dcf047c68f27e9d49f742810155c8,152,110,490465,111126,379339,162,121,530261,142908,387353
e8fbb47be89d23dd84679e7517f17d17,18,18,5619,2689,2930,24,17,5619,2754,2865
da6140d027726825118510ca7d5a66e0,87,73,198259,55555,142704,93,68,152975,47111,105864
e70730b460ae8f2f421dd3dcc24bb403,41,28,38130,9613,28517,44,33,37517,15234,22283
b273101d45a715974189d93e7032c932,168,103,421061,68678,352383,136,79,300477,67118,233359
6df20a2216291da3ff9f79cbac2f84c6,45,29,54654,13267,41387,57,36,65973,14393,51580
d11ba324b5fb2c6170b37147a5737585,18,20,4913,3603,1310,20,22,6718,3502,3216
0a29c1b73a935ba17f60e06a8fe074d3,41,30,37839,14020,23819,49,36,52320,14654,37666
fb9a61ce76bbb316470bdbfb0b1fcb07,46,34,73593,17932,55661,41,28,49077,19184,29893
5d890e865b83906e0613972def47c0bd,58,48,44187,9453,34734,34,27,31842,7682,24160
00e8ae47b60d2a457c055c8f97378f03,69,51,101823,23359,78464,59,33,97756,16105,81651
82ad6f94503d225b71e8b01f15cd18c2,43,37,43644,15105,28539,38,29,33241,15656,17585
bb626f74beb36b9117ed5428da157dd5,34,28,20820,12898,7922,44,34,41256,12807,28449
86c107ea32003ed5aada2f1a11097976,49,35,50649,26360,24289,85,67,139820,38801,101019
27055a9d0035bc5fea9d3f20561f59c7,109,88,250477,49413,201064,102,83,203213,67397,135816
54c3b09bc95f30cc56da541f7fcdb564,117,112,332588,96400,236188,159,124,390049,61685,328364
d33419a423eaa0d2bb7dd26daeab57a3,26,26,31595,16540,15055,36,29,39751,17617,22134
722b45cba51738a67826c4ddb9f7d411,89,76,232362,77512,154850,133,107,301810,69306,232504
4c50a41611443c2fc2097212dac32cc0,15,11,3151,1724,1427,13,8,3961,1414,2547
e338c9be40b7efd9da34589e32bc68d7,31,27,20074,7227,12847,32,24,23693,9371,14322
b80b602fb8b298ef2b481d6aa9ca6bf5,136,103,426636,136235,290401,183,118,526302,130579,395723
386a63454b8212c9b75ef0f6838c5d15,156,126,341558,78893,262665,73,58,167926,58894,109032
cd7f8dfeb1f6363be394579baaf83cb3,50,45,74755,17696,57059,66,39,48956,18107,30849
fa9953db8bd35f433f8b40f5569868f6,169,126,694382,192754,501628,173,127,717056,242841,474215
c2510bcaaf1f1084c983a99e885dacfb,44,38,46357,16095,30262,48,39,44761,16524,28237
ada899b9d4b721b012831cc44a819eb7,96,78,192401,55556,136845,81,55,172909,50789,122120
687f57e4abfa154e6b41c998552829d5,130,105,237511,63549,173962,167,123,366424,54686,311738
0181e7ed97f711eca3b858c8b1c835c7,137,103,470296,82022,388274,150,122,468229,109570,358659
5f60648c7ad9046f74ab8dce0524bd2a,171,109,494243,101108,393135,124,104,528344,105861,422483
49a724ff64cee9f88291976d62d9b1ab,93,79,151719,30401,121318,76,61,127921,25722,102199
dd36c670f9d44fc666fb268f9130ffff,72,64,140420,42713,97707,80,58,105408,26041,79367
3f864c6888568ddf4065b3b464b86357,59,45,82361,25796,56565,76,58,83274,29244,54030
265e3f742b62271a42fcb931907e7fd6,142,116,746787,143073,603714,179,135,587603,131187,456416
7da0e7f4794a3f2e6bef4521feb23d40,25,25,13858,5359,8499,29,23,12063,4981,7082
dc5c9c3c2fa5d7d73f4269403ec0a10b,111,91,229641,43053,186588,133,98,230800,49714,181086
e1d88f2c1615d6e1c34f8f3efd7b1bc0,0,0,0,0,0,0,0,0,0,0
ae7c6b0ecd30528dc0c69ac0e8fa6f2c,128,100,366530,78904,287626,142,107,321607,91470,230137
b3520a0519505e4d0d5b76f79826dc43,196,139,750601,207933,542668,175,142,1029887,181331,848556
8b565693b63620a486c3cd75a2dea2f9,137,111,327053,57613,269440,143,114,298805,73283,225522
79a85b0fdb49c99c3afe61f3f70746e9,22,19,14695,4316,10379,26,18,11675,4261,7414
7a4abccf085ae462ab5fccad0ea663ce,91,69,157068,24440,132628,80,75,106909,36602,70307
931b025a15991ec73cff14c41afa73fd,90,66,130315,40065,90250,124,97,270304,37534,232770
2195a588ace29d8947b6572633a37dd5,42,36,33893,19392,14501,50,43,48656,18909,29747
ac7829a7172c9b10748dfa4216cb20eb,106,80,176245,49229,127016,133,85,215656,40496,175160
78236be6be940a1753982770937fa59a,65,50,111382,38101,73281,110,91,234372,47830,186542
030c8d6bee046a527bf0d302c19bdc30,215,159,1268386,243067,1025319,221,135,1217316,190392,1026924
b135edda30e0611df515c5ece6e7e01b,132,86,282898,62347,220551,157,97,269083,66794,202289
4215f768d66382a49e56a46592418df9,144,100,447849,81083,366766,159,123,409143,86306,322837
4004bb3f4a43b038c87f66a5be69c77f,63,50,106973,28168,78805,56,43,94891,26823,68068
cb19743e4fe5b142ac20ef41ef40824e,91,72,142315,46801,95514,89,73,178247,47199,131048
fd1288bbfbfe8ca9863251463a9d0fc6,1,1,178,74,104,1,1,74,178,-104
01980eb66ed206cbb39407285225fa04,20,15,5966,3062,2904,17,14,5575,2125,3450
18e3e1601bb76f316b60511c5be5fe6b,19,17,4974,2477,2497,22,12,8123,2463,5660
217285f4be4134e6619f0f7c353df882,72,53,80617,28173,52444,59,52,71142,31860,39282
c4b3c85bdca255f7c3d4a4976e2f9543,31,27,26027,11966,14061,43,37,38274,10784,27490
056f3a4433c2a0177a2dea64937579fa,44,34,34907,10963,23944,51,37,31481,11305,20176
a32d5dd3b8e25f492832e90388c1cfd9,90,82,147354,49020,98334,82,62,111527,22796,88731
de4e1003cf0e1f6e2cc398317c08291a,31,22,22293,8371,13922,31,29,17790,7353,10437
47194ef5979de37893b00ce22ee5eee6,90,74,154531,58791,95740,134,76,248665,33598,215067
3df5f0c3560d6fe9f6b08208737dc21f,107,91,558926,116851,442075,139,98,372891,103465,269426
d3154609ba9fef39ac2c33fc3c92b69f,67,50,60692,14250,46442,67,53,67157,19224,47933
148d3460e496f6f211b1ca926bf818c2,28,28,25152,10972,14180,32,25,28471,7306,21165
89fcd3acbc620b07d5aaa82b10d2d107,171,129,687698,111811,575887,193,165,572597,149138,423459
b4b4c2c25f651e38a462a9485f198dba,145,94,290298,80449,209849,120,98,254012,88018,165994
4185ec0e7ace891fa161ff93e038edd6,153,105,299263,42449,256814,163,116,342353,39999,302354
505509771b2d84f1a684d143de098c80,73,62,142604,40594,102010,59,52,109157,36998,72159
4d8287ff756bda354dc38f8bb1aec87d,25,22,11838,4935,6903,29,18,9076,5305,3771
1c88d723cf36806a4baf641eb3284b81,34,35,19081,4716,14365,29,24,10823,3844,6979
2b0a48b4292f9f89761cf9fa08015c12,116,72,183746,61987,121759,143,103,335850,58696,277154
a3a00b086e52e4e5237c9dd19bf25e26,108,95,320800,88926,231874,88,77,230663,76701,153962
fc7d795aabccb254a75e1f7de742a4e5,25,21,7048,5240,1808,23,19,9502,4750,4752
61fb1875fe5577868c3d2bd03eb88687,157,102,539099,87224,451875,167,115,828557,101193,727364
165d773e273c13daaaf8518234d91b6a,220,137,910648,154135,756513,203,163,885319,155546,729773
677e250251f50617ce46e46e338df3f5,26,13,9067,3160,5907,20,20,11977,4602,7375
82cb380128967b4a72a978bffeaddb71,90,68,152265,33439,118826,82,73,116688,33865,82823
facc24bd555affed1fdbc1d749662e45,71,55,136563,49679,86884,103,64,209838,37353,172485
43722f6549725b1498bc6750b97f1bf0,163,118,495060,138089,356971,158,127,607391,132196,475195
171296cee65e94d6758c328cbd10a6a1,54,48,57414,17929,39485,63,48,86211,15569,70642
5dba4f5590b9ea16ff217c07795bdff2,11,10,1277,1421,-144,13,8,1913,685,1228
84895c243e454c424662dd79732f4f24,61,48,79772,23136,56636,64,49,106631,19852,86779
de65db5cf83edb628d3db4f573ceb378,151,122,461485,105021,356464,131,107,507659,65934,441725
979d6d0229f8ce6a00c2960bf86821f3,55,32,39452,13934,25518,54,36,37780,12087,25693
438c6065243a02c5fd1a9d6a8c6e709c,122,92,399994,69154,330840,124,107,358366,81334,277032
0ad16243d43e4ec854130fb264402b31,15,12,4218,1865,2353,19,15,5407,2014,3393
a4698bd73e73147651c4497fa13e964d,207,152,1085106,204731,880375,175,134,811899,222847,589052
3385d8ead486b3789f180e40ce2ee17a,31,20,22202,7023,15179,28,22,25203,7659,17544
f913715efb57bf99dd372d5176735105,68,59,76484,18990,57494,61,54,94408,20644,73764
0a1457cd2ef9ae6df4983d3e4956c4f0,51,39,53815,14089,39726,66,57,53601,27689,25912
0f9e2cedcd0e78e5e4b23d7fec5493da,152,127,383307,78597,304710,117,92,325548,74804,250744
1981fd4bd2c3f65807c17af9b8f78ccf,32,22,15045,4286,10759,29,25,12668,6457,6211
3d16ccb16952fc111aa1f8ce1782b03f,117,84,320123,71618,248505,119,100,328531,101211,227320
463c8ad21d947869e5198f80e54f56cc,104,82,227342,59638,167704,96,77,228754,59307,169447
b83e8e23b1006f1dc88b2fbd34175ea2,52,36,78345,19293,59052,53,45,59435,27509,31926
17a03080a679bf89ddccedc5e582e344,88,55,96756,20037,76719,54,43,64274,22814,41460
2ad61a8175a93de32cb8240fafa25af9,214,114,564222,87177,477045,182,128,569095,104380,464715
096cc5ca3c5b00fb7c5c659f85ce7132,124,93,282905,59095,223810,114,89,279129,77069,202060
608c7813b3a7c1ecb06e72b11ad02b9f,155,104,384581,60837,323744,126,97,273575,112571,161004
5e13bd95463ca6b238780a5653de3873,26,26,11271,5344,5927,28,20,13053,4460,8593
af3141f30efc5aa280d7bcaab8d1074f,124,102,334211,118396,215815,156,118,561909,82894,479015
9aa8ef539fc0601e2beb608dfa30ee7c,98,75,167050,43093,123957,104,72,177938,43462,134476
a1927dc065f3986bf4503656d91698ca,112,80,232867,47514,185353,121,94,199018,49808,149210
8be02a0607d919ffe2455526f6f3c3c5,22,16,7871,2777,5094,20,21,4917,4549,368
80fcc5df59f94cd309e9445b269e0cef,85,63,165926,29078,136848,54,46,93759,44732,49027
b330867306b94eeb15151a1804ab184f,80,62,104101,36968,67133,70,46,97154,35486,61668
953aca28b24aa71a96d304944e6ae522,110,96,210656,52308,158348,76,60,140126,46738,93388
e95356065cfe63d6a9deeaaed2fde2c8,198,148,1112842,163850,948992,208,153,802274,206611,595663
d863617815aed303c6f0750bd3a325f5,53,40,49332,10387,38945,36,30,37280,14300,22980
203baf11f648014d6a10d4a596710fbf,83,56,87509,23637,63872,105,75,141836,21287,120549
4a21aac6723d628cea883d80439fa7ce,26,27,9724,6254,3470,27,21,10498,4441,6057
37dbe4f84031fd32d6b50ec3a0eb79ab,131,104,581996,165829,416167,153,106,577048,150143,426905
a1d20b4f44a7b1ea9c237166b5eb4a38,143,94,231532,40699,190833,140,129,272810,62385,210425
0359bd81794d9d5aa6a66f58dde1da68,54,31,66683,16888,49795,41,34,55653,17097,38556
0b485497cc69fd816f24fc8ed235f0d4,52,41,46388,19283,27105,53,43,51502,19993,31509
6b3c2b77ba3855e9bbe11eba0c4b7da8,20,18,6301,3110,3191,24,14,5748,2353,3395
c75f96afb278601d421ddabf3eb07277,8,5,880,431,449,5,4,501,477,24
d65627e6166d795d89a166a7c0637102,34,19,14736,5946,8790,29,23,15538,6047,9491
e1c8a2f6957410a29b3b9e9cf7e14b92,77,57,146320,55203,91117,101,76,211303,59180,152123
0be074bd0e2ce6c16ae957db792887b6,30,21,17847,6323,11524,32,25,16071,7432,8639
aed8fe4cb25ae8cbfd730c4f96f1910d,77,74,124534,40761,83773,67,50,111893,32522,79371
a9f92a0766a9a3e7d4338ba892b70f41,28,34,17414,8468,8946,30,24,17096,5628,11468
22557d1bb07d401437aca899d3396c22,31,24,21701,7606,14095,25,20,13914,5839,8075
a31aef09fccbcbe01ce551b45ed4c36f,117,92,203877,42262,161615,122,100,240166,58234,181932
da0c48e750422ac59bf816ec7fdcd470,168,113,419417,77786,341631,111,101,264801,82986,181815
9b9fa00e63fb69a8870c25ddb7d640e1,125,104,307461,88934,218527,143,121,355243,72359,282884
abb69c6c705d6e2b14118103e9f6ad75,131,96,296152,60171,235981,140,122,312235,79383,232852
4e7447643bec64074550faa77abd585f,32,22,24630,9121,15509,33,30,27340,10496,16844
65ec6473283130bbe7024ded49ece72d,70,40,58356,11865,46491,79,58,56199,17978,38221
fd490dd7610ff9bae7637cfba68f58e8,39,35,33472,16784,16688,42,31,33713,15747,17966
3760a14dcac116b16a2f0a6731025161,111,84,181132,40107,141025,119,100,241486,39456,202030
5a1585af924726688501987f33544b23,80,66,104768,31680,73088,95,70,139234,30187,109047
35b99a09584b624657398ce2fcf5fbb6,155,134,589903,157252,432651,156,114,546419,144511,401908
37c15c076e88823d77026e50a7238a79,27,21,13254,4753,8501,22,21,10755,6080,4675
51a0d49ece6dc728dfa25e85d74f49a9,185,141,694285,101222,593063,170,137,742074,102652,639422
b639ce80d402047913b2b6be531161fe,178,122,653122,131741,521381,205,176,855233,146271,708962
178745869af59cf5ebabd2931f1abaf6,36,28,28433,8542,19891,35,24,25784,11423,14361
d0b7e48e8959f1e6555f312d950d35d9,69,53,90741,22261,68480,43,37,64658,13714,50944
6f168763f13b48a33b5467b8016b0fcb,86,66,127718,42121,85597,115,96,252122,29179,222943
984b85b0a86002a7b383c607bb4b8ca6,3,4,447,501,-54,3,4,738,538,200
b9a7567f765ef11a9423cd8bfbfee04c,63,44,92227,22682,69545,76,67,101512,35252,66260
d8ecf3c150746d0c07a4b14689085666,68,46,86452,19274,67178,62,54,75065,18620,56445
4de4f6627997e604f18ab55e6523a47f,160,124,323945,91154,232791,145,137,365876,90856,275020
574fd8e6046bd4f340f663fd60b819c2,2,1,150,152,-2,1,2,152,150,2
adc661319d4a3e4dd775eebd2b3aa314,115,87,270664,76773,193891,148,124,331668,103959,227709
2b098757b2937782f9f65e6ad767bc6f,60,46,76137,27776,48361,53,35,69352,28264,41088
86c54d02ebebf36de5a08180be8016bb,45,26,33429,12438,20991,32,30,30601,15553,15048
6cab6213ddddb59a17b5b30c87663437,40,26,38921,11157,27764,44,34,37513,11987,25526
a53a3ca6657243b3fe8293c8984fed40,88,67,195405,48834,146571,97,60,188989,43327,145662
a57e007b991ff0058808b5835b85483a,88,79,137628,50041,87587,67,57,102536,40584,61952
247827a6a90de71446560575cbed5f38,120,96,187936,43685,144251,99,79,153590,49913,103677
2c7449a3de893829158119a88220076a,101,62,162518,56414,106104,136,100,289268,69500,219768
781dd89964640a776be4b61a4b439eb4,55,37,70035,15523,54512,53,39,39010,17884,21126
d7af1b777ac3f3aa46e125218fca2f1a,40,34,34688,14483,20205,43,33,40574,11247,29327
a10b65512e3c49123f6d9ce97cdd0d8b,32,30,17318,7935,9383,38,32,15846,7807,8039
50ce0e9962ad9c7bf60ffb9f12dc9ba6,118,76,283041,60119,222922,71,56,161171,64463,96708
4016ebe73411bca7166b8e073ee5bd90,167,121,450537,91434,359103,164,126,551724,100591,451133
3eb680f1c31e44b07853eda6578c625e,40,38,30598,14408,16190,50,30,32860,10490,22370
74f21f001927473830c3b26b8b49bc1a,47,35,48272,11854,36418,59,48,59397,15699,43698
457de87f7f4a1399b047bde894e3fe1c,156,123,429841,133371,296470,173,128,425522,100245,325277
f9240b4b672790a7df806865ad87e711,106,91,260362,60343,200019,75,58,178974,60673,118301
734bbc2e2c359eb85ffaf8706dae730b,23,20,9495,3363,6132,26,15,7665,2405,5260
402b9a97c0bb6f470f893cd704a8272b,67,47,67462,19765,47697,51,45,53666,22611,31055
3f2e2a8fe0ae453f3c978141d8b965f6,138,82,382951,150379,232572,139,85,467501,110864,356637
8bcfa533436941823b3ad001ebed357d,91,77,214705,38277,176428,76,71,130628,43164,87464
2d5ebd626561dc97934aeb0af481b8ef,63,61,89901,36290,53611,102,71,179685,19327,160358
aa079c2979d1f3c0ebff2cc1f80e8462,46,38,53970,16690,37280,53,38,61280,16096,45184
dca043abcdb6838b054bbe41da9545f4,43,31,57666,17016,40650,61,50,71925,22280,49645
b58865d8b30e368fd2e76fa088cb2930,133,99,322561,80360,242201,92,73,208054,70703,137351
6d0bf789501c1ec2189c5928a35dcc8e,95,67,175013,40652,134361,72,44,133958,29930,104028
a24c45913720a8cfa042b19eb7324e31,142,125,518306,89765,428541,187,132,561930,70081,491849
905b13f4dddf6394b2c244b98eea9672,133,102,339958,65716,274242,137,105,370215,58888,311327
d2a3f83f9576449d328eea69a8759484,127,97,451328,106386,344942,171,134,535581,81353,454228
f9812811f8cadde70a4993baccf9a2f7,26,21,14137,6763,7374,26,20,14456,4826,9630
26b96e23ffb1205edfd2765bc6813365,162,127,426450,62580,363870,124,102,322239,64746,257493
4c101abdf6e6829a2109a5d6fe8234a9,48,40,69916,21505,48411,39,34,61158,20094,41064
37f14526cbe7abd27e0b71d82194c204,35,27,33090,11998,21092,39,27,31944,10482,21462
adcc220805afa8de10616c40f94bde17,23,21,9642,4226,5416,27,18,9348,4159,5189
cb4a2e0b8afbeff26bbb72e7b22ee2c0,105,93,331581,88582,242999,159,125,447783,65142,382641
6c0118921ec78d710357e5e2e88031e7,117,89,270921,75599,195322,163,105,424694,82714,341980
80e5ca8703f1af8963e9d2dd79094d9c,14,14,3121,1629,1492,13,18,2072,2405,-333
91c995c61973bc41fe71eaea2cd19c2a,149,109,400794,78358,322436,140,114,345880,73570,272310
141e7178674667dbf63e4d088b62708e,31,23,22287,6344,15943,33,31,24476,7087,17389
476235153882e1e465579ec652555f2a,103,78,192121,42948,149173,80,65,141731,29750,111981
0d95af8857250ee63444f97e74faa860,36,31,21582,8378,13204,36,31,26534,7698,18836
3744b7540e1c884dbc914c55770c1172,80,55,93434,34581,58853,97,81,113308,30571,82737
877241b1f98bdc12587748abe40aeec8,155,128,356138,81720,274418,119,81,229428,66373,163055
ef0ba525ef63ff4d7bc75c711a3aac1f,78,66,143242,41029,102213,76,57,159537,35295,124242
f230a1106865c9785cd421753b5d82f4,218,162,1068570,166091,902479,216,157,1235080,185718,1049362
2a1c43705f7f22ebcd440e9450a169e6,60,43,55988,13243,42745,52,42,48375,15025,33350
9eed8d897d5bb8eb9430ae14229741e5,159,125,305038,54886,250152,138,94,307165,56962,250203
9295cf8960fddec5890c858bf4cc10f8,39,31,24074,13335,10739,40,32,34155,9756,24399
e16227247c04641bf0d8e2fffcb4760c,26,14,13512,2305,11207,19,17,8270,3773,4497
c88a15953355613110d6c71d832b1d28,81,63,138778,56986,81792,150,106,346712,44759,301953
773dcf05d9b1556a2085785dd5db2ef0,149,117,440959,98063,342896,153,134,551392,115307,436085
a93af98c51f4811898509ee2889c05aa,99,74,145931,32411,113520,94,67,124636,22826,101810
713ffdfc681f3bb610080031f2478845,50,43,73924,28175,45749,53,48,105578,24110,81468
3391ac3243c6c264fdd753e6dd889d3d,69,55,82753,18199,64554,63,48,53862,22130,31732
6f3918d5e42736b7ca4789e79cdf6f0e,34,19,14621,4693,9928,26,19,11803,4125,7678
a5cdcbbc255ebac9f0cf32900d0c1037,80,69,160600,39318,121282,92,74,154112,45252,108860
862be8c39844f0773b8f3b9ab9358bd9,51,34,46860,9713,37147,39,38,27555,15944,11611
49eab5ac6f158a5213ee0d62ad04fdc3,104,80,179830,64038,115792,103,76,197104,55106,141998
6e712dbde9b9e164bc3f6e48071d0bbe,136,107,376425,74041,302384,146,99,303668,62468,241200
a8ea436b8e6d3584cf1f77040c5bbf65,95,80,193177,56663,136514,89,71,173715,48394,125321
e4cd6a28384a05a25c2770794f8b5a40,76,64,111690,46251,65439,81,67,164062,41408,122654
4b5a7a80dc807c33ef48e1b86638a084,65,46,77004,29496,47508,69,57,106464,24050,82414
2bd771c12d312f489b4eb949a7e82976,71,58,80044,33861,46183,82,64,138626,28068,110558
c660eb46042bb561282f8aef08022673,79,61,151588,46481,105107,95,77,262345,34985,227360
914d4a9785b3f6d959d83724642e33bf,40,26,33524,11081,22443,41,29,28843,11449,17394
7d03e8de5412c13ff6b5ba37d46a46ea,38,37,50413,16504,33909,40,32,54524,16050,38474
36050b9ff055cde429022b3af7509ef8,72,50,74345,31727,42618,66,54,117216,35141,82075
15790cd50860781dff4eb2177d5d86d1,58,52,96303,26099,70204,55,47,79781,26937,52844
aac4c28b1b302234a1f16d802ec14787,92,71,97733,34341,63392,78,52,100592,26130,74462
23c730b8961674f4efc94699ebce0ea4,69,57,97328,29783,67545,59,51,66374,31562,34812
5ba42fda328c3307236595fd2b6f9901,31,26,26888,11682,15206,31,25,24450,10796,13654
1d2177a757d3095727e17417b1b10b24,36,30,27448,7888,19560,41,28,23224,6698,16526
2adb4c37f0e1fe666e41e70caa3fd87f,33,26,19445,5987,13458,42,27,24264,5870,18394
3b58efff09b6d62cfe081f64c37efd77,29,29,15227,8140,7087,35,22,17936,6226,11710
6d4a0d16ec749ad5f11c347193dce41f,40,30,33252,14811,18441,53,38,52780,15872,36908
60dfe631eb46089ee094709a98fb1525,234,137,680606,88627,591979,147,93,544288,87185,457103
2101a44855f43908ed011408dbe058d0,72,52,75187,20580,54607,56,48,52719,19495,33224
78e122b3edc597ed8bf983e29b5e7679,58,43,78578,27746,50832,66,64,82733,24068,58665
a68f9302af587dccdf87b439ea18f7c0,107,88,224414,57260,167154,105,85,191028,60779,130249
d3450cf222a918f7d5dfb789466e5ae0,84,54,168591,46309,122282,92,75,181016,55803,125213
2ebb870b95f86c72782d442dd5c838d3,90,64,149651,55461,94190,112,78,222688,33193,189495
967e78e83cbd1959f471c9bcf9c3f763,33,25,16246,12371,3875,30,24,27872,9264,18608
e44312b8ea08913cfb8aaedff0840c8d,162,97,439010,77498,361512,141,94,419471,87339,332132
3a0087981807efccac5c30c4e337393d,45,23,29682,5868,23814,33,29,20254,8354,11900
8c4c5d3fbcc7dd373a2d6bf54bbb0491,23,17,5576,2994,2582,22,19,7599,3918,3681
369f377e1f34c303b042729765c0c51f,32,20,21487,8990,12497,47,23,58784,9309,49475
befb1165c56184999a248341d307bef5,152,119,285169,50590,234579,147,111,276077,54156,221921
89401d818451dad21bf0062d5b2f8c29,77,55,141973,30653,111320,82,74,174235,28735,145500
5f0351deec49fa3b40ab615f0604434d,42,33,41592,14807,26785,45,42,30997,18182,12815
1e29cf377d578411ba711139afcba10c,113,91,194982,35105,159877,138,104,238232,46047,192185
f6d499c6fcd12db555c511ef9d2f8cc5,148,105,292170,82695,209475,150,113,332533,87341,245192
7b1a42e18abe2b00c60bb07f6c2d93a7,105,87,169480,36429,133051,118,87,161744,39926,121818
5ca4c0430f58847b25fc51b29358c911,180,92,521454,120736,400718,162,105,485509,129043,356466
1dfd7c97ddd84ffbfac10e2b423e8e31,91,76,167629,65441,102188,140,104,250695,64753,185942
593fbb4b9862c1f5e4e04b9b22019253,50,35,66588,25063,41525,70,60,110608,23034,87574
642363f1682c46c036e1a9ecc5d6ae8e,159,113,400135,83187,316948,125,105,321259,81676,239583
80877f12f3da7e688487b6cf96e6629f,74,65,113094,31489,81605,66,54,99180,33288,65892
76ce74c4a7f6ad552e2bd5f848af2f79,147,100,367397,76182,291215,180,136,486830,101532,385298
371a4447c00ecc729f8ebd0ea1d8044d,196,113,985796,212336,773460,215,138,1157149,180703,976446
4d26c98799a8521867689ba634b246ba,87,83,242653,68352,174301,114,98,271356,83262,188094
1d7cc5d43e302bb1742879daf1bd06db,92,68,163284,42180,121104,94,73,165826,49647,116179
2b982ab274308fa3a79d0c65c345fa0c,36,23,35063,11629,23434,29,23,18831,9739,9092
2074f622d77406c4a0340636a92184d9,158,119,364959,69117,295842,143,108,351312,55686,295626
7498c977c11eb666b2bfb217dea666b0,80,69,157154,41238,115916,65,50,116512,36410,80102
445adaae57d56d729433c6cc69d9c97a,134,97,402326,79312,323014,142,112,452456,78659,373797
75b06a82c245b18aac0951d0453e77c6,72,64,92850,29990,62860,54,31,53774,17855,35919
7075e11cb118fe9108d03670c8b65367,151,91,459642,55277,404365,154,108,326306,97111,229195
ad62b80b09b1f566daace32b637c2988,37,22,38828,9814,29014,37,29,30287,18809,11478
a99eeea5860ea556c296862138b8f39b,137,125,257446,54281,203165,127,103,244577,58463,186114
26c36133a679866d3cbc14a4ef546efc,131,91,302806,82325,220481,160,149,418439,88070,330369
f5231b3fca37935251797fa27228dbe4,52,43,68196,19020,49176,64,56,84327,25373,58954
d36bc0f02c2ce87725616d8f49570c46,21,15,3773,2304,1469,13,15,5382,2500,2882
05b00926ba46756277a26140d4cb9247,22,17,4846,3267,1579,19,21,5245,2785,2460
c0d313b4f94056fc8e8d6d6198fc33d8,69,53,116396,33902,82494,77,62,122982,26632,96350
550b866322bd40d99922b9add0010a7b,159,132,557034,98980,458054,186,151,657661,141999,515662
f2a0e5b0c8fa2947e65233568fd6cbaf,156,107,395981,59271,336710,99,86,300796,85624,215172
df1c3940def82520268f87b41671fa64,43,39,39123,9208,29915,49,33,30614,14001,16613
656808121fa7dbacdcc4c3671e6ffe23,59,43,65478,21337,44141,94,50,106699,25553,81146
2e0e3e05a87c164d3e7b36487cfb5ad6,224,149,712339,151898,560441,110,84,570306,127744,442562
abada42fe2c6da4f294a785961de4371,107,91,198912,50366,148546,99,83,254089,57926,196163
aab392fef2926d457b3813354d441310,150,112,379473,66158,313315,119,86,291303,66725,224578
3117334cdb85b93a3b8989ff85d15fdd,140,113,344017,84181,259836,126,101,313522,68652,244870
a212fef7ebf2d36d060f60af964e62b6,29,29,25788,10404,15384,32,28,29916,10596,19320
86be899e447e493bcd06c7918fae133f,73,54,136863,40759,96104,55,51,95091,37387,57704
eeacbbafc975e2667663d205ce3596dc,83,55,162234,41791,120443,84,60,163844,39472,124372
d06790d8af34b27423c2b96eb244c1e7,148,122,410815,102861,307954,115,83,318059,106319,211740
d52d2a1a75875e264ce15e52d5d71285,108,90,214207,45524,168683,98,64,204617,29016,175601
3fba03dc248e9814996e0848b2876fc4,42,28,29651,9262,20389,30,29,24364,10675,13689
72d07332ac6c67890ec22b36770c37a5,132,86,273479,71871,201608,160,99,321522,87821,233701
0e97c1d97d6d5c4411dfd6f022309a47,179,133,639821,93498,546323,197,131,603243,72141,531102
e96e8f5f31e9b38a47cd23d277974c67,80,69,141183,34611,106572,70,55,110629,33800,76829
240cf5cb0893e95ec578bcd3c4c30748,111,88,208112,37143,170969,123,107,184493,42998,141495
5bfa59253fa2d61765cff3ece0492423,130,114,364091,77262,286829,132,100,308905,69868,239037
6767a535d3eba48028b3cc0a578d18ff,47,34,40350,16361,23989,34,28,27956,8522,19434
b5f7e171565bd9c55fa2453c5962965c,149,115,662828,154405,508423,148,100,507622,96463,411159
9b67ee41b147440fbcf576fb514d408a,172,110,474587,102633,371954,91,78,430037,74845,355192
bb2a12e4d7f274434e252ced2a5c5d96,181,140,518192,113164,405028,167,139,551934,103415,448519
387944a8d7ccc01fcde5c4ec07470498,83,72,142884,67844,75040,66,56,126201,52957,73244
9e035df520ef588a1c8a5f750939484c,11,8,3387,1446,1941,13,9,3109,1811,1298
970b37ad22efc85461f48a316f2eec7c,32,27,21971,9711,12260,44,33,32289,9627,22662
2f18b80a93089ec6755e8dad7cad250a,58,43,71839,33055,38784,67,47,97996,33515,64481
6cf8e9205ea99a5237cff58bb9168da2,98,89,213564,71018,142546,149,85,264995,57061,207934
8aaa5b4d59d2a2af66a016118ec05a25,136,91,234298,88811,145487,130,96,264917,61485,203432
f25dc3f6570bfb6ed4b418e8adce5a5a,60,40,95564,30625,64939,48,33,84596,22183,62413
41cf4c381df55f3183b2041d48ad4da1,20,16,4304,2175,2129,21,13,7709,2332,5377
c49da880ab5bc283eb64e7551760a603,65,49,140234,36050,104184,47,39,99076,43879,55197
f9d8794522d9e859511ed4490c8691bf,102,69,158612,45864,112748,78,63,160759,52259,108500
2353ca40ddc1aea70655489fe54f9918,36,28,41587,13077,28510,35,28,35897,15459,20438
56cb67ee0d3472dd8935c1d588f25b95,125,84,301712,70696,231016,136,111,316153,81222,234931
886ecf680768e08703e299aa8521a120,33,29,23268,10678,12590,36,33,33147,8356,24791
035c8964b4ec28a7548543608aa4cefe,93,87,199899,66571,133328,108,83,241298,40231,201067
46d1af45f367dda8e250a8819a242fb5,71,50,148955,38962,109993,87,76,157104,35812,121292
5b38deae6d8b2344059eefda8f8d2675,12,9,1847,1075,772,10,12,2303,1049,1254
a94b2354dbbc256b46f6f1581cd4df69,20,13,5639,2205,3434,20,13,5832,1922,3910
a8641e979451130593c1e857e223c177,59,58,48331,17664,30667,46,38,52219,13611,38608
5c5deacd5359d0ea44b6fed6d73fcf1f,2,1,164,104,60,2,1,145,125,20
50d6657e6c81702a791501a4da0548b5,74,65,136712,31781,104931,111,87,180630,34597,146033
44d53727f7d43f0f526671e701877966,40,24,52716,15255,37461,36,26,44787,16535,28252
99c99e56be84d578ddef5ae5804dbfc8,41,24,21483,7588,13895,33,31,24453,9854,14599
ef41cadb57f775706fa5626d3ca8ef12,59,53,95480,37496,57984,60,51,114530,36528,78002
4101c76f6c2903419acf83326d29bd8e,200,117,423920,49067,374853,155,128,377839,76170,301669
24fdae11a471d1ed6e433aabd110e1d1,149,119,475665,113291,362374,162,120,579407,110832,468575
6573c082603f963336332784c0c9650a,118,92,246018,36494,209524,119,97,241699,66468,175231
7c0d9e13e6bc60f991aba51196ee65fd,127,84,340088,69999,270089,128,93,282942,76270,206672
939411d9068d81ee2882363396651ef2,158,121,629973,182028,447945,164,128,881713,137077,744636
5247204c85089d2809f3c5f461bb0376,121,71,381107,91194,289913,128,85,383531,109873,273658
9121e36459f559b6b5d00f0449c4e7ce,174,98,819138,99284,719854,194,151,786243,116690,669553
91a1b663b59d44e80f397709c69ec955,35,25,24612,6178,18434,35,23,16233,7805,8428
4c5f08806250bf5839a6524ea87b0c44,126,83,303319,56301,247018,95,67,219987,54129,165858
3d04a6c73deb52965d22e208594ebe41,176,117,338960,45652,293308,107,73,197521,57670,139851
3868c0509ba2f0ad1093b2fadbf14e42,113,91,257952,68282,189670,130,89,400316,60574,339742
c066638886575947c71ee4d208516327,157,125,537592,84834,452758,154,112,391802,51896,339906
da30870632433910fef5efadccee314e,64,41,84736,22184,62552,60,49,74124,22533,51591
562465706be97952f41afeea9df98286,134,111,387242,133493,253749,117,83,367294,116700,250594
3adfc39750c9175ed7d0d3507f35cfa2,158,114,483807,96816,386991,143,116,429172,85799,343373
bf15e95db5b7904e1c7bded480baa2c8,147,141,512546,95042,417504,100,81,278995,78246,200749
b6618866869c01cc863e672284143468,74,62,130763,47218,83545,92,82,157162,55956,101206
7dc1b9759525d1230cfd15a0e0efc6ff,57,39,59672,12857,46815,40,36,30599,15318,15281
27a9090388e817e01bb244d85045cacb,54,43,83543,31004,52539,55,41,80725,26499,54226
d86648af21962c266dfd31b7d104f70d,82,61,156962,40306,116656,114,89,234685,49199,185486
8e9d424ab6c775692526157ce8d1069f,77,63,127779,31837,95942,64,52,107130,29649,77481
10152232535da7743935a950f0781de7,43,36,38587,13071,25516,49,39,39953,16275,23678
6a7336cf42e8114c3bf162cfad8615ec,30,26,21881,9467,12414,31,26,22601,10445,12156
1b37dfc1ff1ae3154a6df4d657ae5af6,31,18,7871,3214,4657,24,25,11566,5386,6180
f06be50c9f90d0755a523941b8b25cf4,15,14,3436,1603,1833,13,13,2838,1881,957
c1bee4bdcfa74de0c886376d2b8d161e,106,71,146885,43396,103489,126,96,212141,47399,164742
1f7079249861e5b4cf893ce00ebe5db1,143,102,312000,104558,207442,104,78,245410,83602,161808
19ce1b3271e4a51fe95f702ad0f270a1,84,52,88090,23376,64714,87,67,126988,33649,93339
beaf9cd2e9aa874319831878456eac0d,132,105,351245,65984,285261,131,92,320092,62705,257387
5736a2c1e92e561e420189dbec9de9fc,26,24,14142,6480,7662,27,20,14825,4317,10508
f7943e159d72f7c1ecc607bf3c2fc990,16,13,4122,1970,2152,17,14,3558,1623,1935
c3136c6959d5967b71c4aa1ce14d5403,71,54,89929,36001,53928,66,49,108369,38102,70267
529c4ceb98db76f2ecaad800c4fe5b5f,37,36,51763,28104,23659,42,28,72718,18083,54635
a9a239111b74c613f1bf7b60b38c8247,98,83,175847,47698,128149,101,87,149154,45178,103976
bc54d32c2a0920ac6f9f53c29b0bd559,30,22,24433,9317,15116,30,24,20208,10559,9649
eb1df10be20336ff68543167a94ab2c3,77,66,152787,41644,111143,103,92,176788,53497,123291
69805abdf9a334cf8923bb6762dadcbb,14,8,3382,1044,2338,14,7,2918,956,1962
ea7eefdc4a7742b565c859be3112c3dd,153,114,350071,115311,234760,182,110,437655,99602,338053
403fbc1be5855f26cccd8e522aeabe4f,112,85,236305,64449,171856,103,82,274160,61141,213019
d2e6b38489e0a7aa9d1ec408e498d348,28,32,51065,21216,29849,40,34,51773,20948,30825
960b316ad5ccb66f5837e0a27a7e29a1,101,82,233040,45452,187588,91,58,195674,45162,150512
715409cc0e7dfb1b1bbaf47d2ca7bec2,194,134,831606,164305,667301,140,122,648484,134929,513555
279c882660c807b57d2e2cd9f47eda14,132,110,468838,87421,381417,150,116,417494,119208,298286
725a707c50692826bcad02d67cbaa0f9,113,91,209379,61155,148224,120,92,261949,43812,218137
720612bb93072b4a784151cd715bc60b,124,87,201089,29966,171123,131,107,248066,43472,204594
a9bbd446d6ae249a51cb6affeda82793,82,66,125629,43645,81984,118,91,175886,42538,133348
88e2894b4fe336d62fca344f346746c7,205,146,1158649,194650,963999,196,140,963581,207944,755637
69aaf630007afc51214f2736075c323c,18,18,5001,2062,2939,18,16,3463,2204,1259
d1f8511fabe8d41e1cb9c3954387d583,78,55,124436,43664,80772,93,69,162732,41321,121411
5f35c003a80802016d4acd03be715a09,99,70,199293,89558,109735,148,112,374552,78045,296507
7c1e0c51401802c18a9bb871e9d339bc,18,13,10804,1576,9228,13,12,8165,1344,6821
669e7032d35ef6706292e3887c3e78d8,92,68,180875,40686,140189,105,96,241355,61595,179760
0e2158612bd15f15641bf8217283b3ae,65,62,103025,24575,78450,54,49,55152,28750,26402
e235c5e54b2e0d0dec200e7d438d7078,41,29,25980,11234,14746,41,26,31420,10251,21169
7c423cede3a4bbe6c6014d3f70071d82,202,133,587136,85847,501289,200,137,586461,103418,483043
5fd1a18f1a6d63f956726d01cff111ea,89,81,189752,65374,124378,107,88,189929,63159,126770
24dc9388f478a385f74eac5c0c283e9d,156,103,530906,124431,406475,146,105,444221,146103,298118
5416cbc86907f7f7e1fb66b3762f31ae,23,18,12390,4807,7583,27,19,14061,4299,9762
0308f04624e18bfc0dd9baa7a9c29083,20,14,7764,3186,4578,21,21,6592,3532,3060
3ebb7b8ce2b1fc06072f21ee955c4c93,33,22,22429,10409,12020,29,23,20949,10203,10746
e36fb15426fa9a329af23a2da063df69,29,24,16136,5483,10653,28,19,13835,4760,9075
c03e3be1462b30103a29785fc6be1778,88,47,159409,57199,102210,96,78,187896,63033,124863
4340011be58d36e3cc12a2f7a7e56f81,166,125,474462,99254,375208,171,139,405276,105180,300096
8b00a4600a3037fd30b885c83f1ea819,44,35,39762,10579,29183,35,33,34421,10383,24038
3a924d8dcc47c8d65b0471e3351a80e2,152,101,410672,103629,307043,138,111,395542,135678,259864
44cf83fa31f7ae196f3fa062a5599e6f,98,78,156125,35947,120178,104,82,174958,45480,129478
075679a7459d6441eefe183d330e2fd7,41,29,37196,11754,25442,58,41,52635,18843,33792
46a8f92556c8c26ee358350a5296cfbc,153,117,368134,73061,295073,145,102,278658,73775,204883
17f4a4b323df98e5a43e67ff9955282b,79,52,97543,34689,62854,80,62,103026,37199,65827
eedbd48fc9525e2140c63b339f27aecc,98,70,187740,59877,127863,113,70,180725,48153,132572
0bd468d0a7ca3b56229fb6868f042220,114,92,224722,76017,148705,123,103,224791,54780,170011
ff85525c6dac01b3610db5bb84b2eeb9,21,19,4523,2451,2072,16,17,2935,1818,1117
3b91c8efed26c2331c97fd22018c152a,168,125,561021,67655,493366,152,124,409252,60821,348431
8eb780d56101e2fafc30d4ce254c3f01,36,24,21039,12953,8086,44,32,32315,13298,19017
a127da55b6419c4924f096d9f30bd982,66,56,84674,19389,65285,60,47,42825,14585,28240
5274c99a4b55a10d4b948a69559ea8ca,176,104,590165,149504,440661,211,143,718440,146974,571466
aac1a9d2a01baf5b23aa4a296ef64b03,35,27,14971,6550,8421,34,30,18443,6245,12198
97d986d806b5f8d2e68624f0b0ca807c,38,39,55263,20351,34912,44,31,41962,19613,22349
a73c5c0394a07ecd8556971acd5862f7,123,90,278427,77572,200855,181,115,415669,90519,325150
d8caae5a44e8cfd18b9f9651acd0a3a2,190,133,623653,98478,525175,186,139,668039,113401,554638
aeaeadccd895e7f48f9ed600bfd4744d,182,132,574481,133175,441306,155,121,499885,111310,388575
92c0ce366ffadd9f0ba034207258ef7b,37,29,37931,13650,24281,39,32,45720,16270,29450
a6f659d70ebf762e134452c1a0560338,148,101,500598,81217,419381,183,154,604856,154034,450822
daadd11c71e92c3b43b9c829f0ce8e7b,21,22,4545,2363,2182,24,15,6378,2225,4153
36a693646b04cb4e988b07d07abc6665,165,132,589641,106202,483439,167,116,502830,134232,368598
e43a79113fa445586b637e945b69159a,198,118,1010528,96521,914007,229,127,696694,121237,575457
78cab65cc47d4c8f534cfb692fe4d753,30,22,22527,10212,12315,36,34,38706,11110,27596
bb09972f5cf205ffa9d6d7d9d8ee5f99,27,22,14805,3220,11585,30,25,16369,4743,11626
714f47ddc262d2f5dc9fb1787194dad8,31,23,15764,5384,10380,26,22,14976,7304,7672
658c2420123fb58bbbb9e82408199d4e,29,23,16684,9130,7554,27,22,19341,7305,12036
83996af6a8984e15f4236f1b10269591,152,137,526961,102477,424484,182,157,587601,95673,491928
8ab38192e1c73ce9a443356f93660367,41,32,40595,10465,30130,42,37,31248,11789,19459
8c9199a622f6de7884105117e5b1a73e,73,60,121561,16718,104843,43,31,67673,16483,51190
f8b01c73827062af26ba944e8bc70111,143,115,388184,61285,326899,152,119,380327,53973,326354
dd145202ef94b1d27fd1cead0beccf05,31,29,36122,11594,24528,42,27,32881,12327,20554
ae291ac03e677f5a8f4bf4d2c3bd3812,106,76,188207,52889,135318,113,89,184222,65715,118507
ff3b9a2656c69aa972cbaa8d340c848d,65,62,144365,52004,92361,83,65,190620,53090,137530
6215fffa2d4b7ffe41f004c602cfb152,113,73,203700,35106,168594,80,60,113457,47541,65916
6d8c6020af41c9880df401476d7be230,50,43,49200,20806,28394,59,47,61278,27035,34243
8f1396611900c1c789e7a804bb9b0c2f,17,13,5023,1644,3379,19,17,3056,2451,605
ffb038f31852408a0ab255767d9a8409,85,59,135779,35320,100459,89,77,120330,33400,86930
c2437f461d9de98bb5b9b50bdda1ac2d,108,77,282541,47650,234891,132,98,266194,57037,209157
b2c9d383da5c95af6702f72281571506,79,61,137297,62782,74515,109,78,202528,51861,150667
169435329b7ff12a4d43dc10c1a5c926,87,50,133640,29778,103862,78,53,130284,23240,107044
6c386dc829d0e0c806b9b3d1cb4b79cf,62,64,109932,28836,81096,83,67,99232,32220,67012
6f573d33851394381ac38598c8d16ae4,93,66,213165,47119,166046,92,80,204285,64492,139793
6c3d0dcadd7a77db442f0e60dc0f5a2b,177,136,584682,151089,433593,210,130,616363,148264,468099
e509b680747667d71a2b631c9fec65ef,200,146,886328,154484,731844,172,126,571658,150641,421017
48a8f482f56212d977b2e081b0e8200c,43,31,49169,14306,34863,48,32,35246,15123,20123
8ed6d4f978a46ac03efdd43c4d290078,146,115,300258,75958,224300,161,101,336548,64944,271604
c63658d11c94733ac868c163dc2c69c2,95,77,121998,30929,91069,81,65,96182,23224,72958
2a13910abadf018ed070362658e93c95,114,87,210441,56940,153501,147,116,313966,46020,267946
f71701ddc9cdcd48b0d649aac7a41f31,46,34,32817,16365,16452,43,37,35869,16444,19425
1a6e14a8854ee1536b175117d95fd3b8,150,118,415330,83234,332096,135,120,426400,87177,339223
2447d54b637cfb7f7b22afa9e7e1f209,147,118,452525,120317,332208,136,112,421172,139101,282071
b4faec8bbf3e811d6d50315f2d4a1828,68,43,48184,13184,35000,53,48,46040,14969,31071
29a78c9f29c9dd77c1912c874826cfdb,21,20,9782,4442,5340,24,20,6672,4403,2269
41b9781ba72bab63771e38b92baec27a,21,15,6542,2818,3724,16,14,8193,3350,4843
a05547c771f04b9822e5edf87e5d9484,67,58,84494,22321,62173,62,50,68163,23403,44760
22a15aabacfdb98de5bb95bac40ad8d4,124,98,378428,59259,319169,164,113,367352,56769,310583
38a0a62a6b32c350058990d5d8c583f9,6,7,681,437,244,9,6,1301,681,620
bb0dc2fcf368e9961be33ef834fecb1b,25,18,5799,1713,4086,24,15,4775,2180,2595
a13c7909e46e46d4d288d46a830e0bc6,52,37,55220,19923,35297,81,48,85443,14373,71070
5fd6e64d44e4f80307c6a4f5a1e1bf13,176,123,803351,145988,657363,208,139,664385,184035,480350
bbeba293ebc623a1f0ae595f8dc678e6,3,0,232,0,232,0,3,0,232,-232
b1c8f6c37fcb23f8e14405f88fbb1520,147,119,416836,67647,349189,108,91,280048,89737,190311
07c90cb07a17d57827a4bb997b897618,49,40,61802,18632,43170,53,36,59091,19726,39365
bc138d46bb08afea40707ccef3fc6f52,144,109,492429,155839,336590,210,129,660253,125040,535213
5309e48f8aa75f72ccb3efb85704f1bf,121,95,312161,77542,234619,146,119,322693,71741,250952
26997b06f9e2c62b1ddeca0eba144a79,79,48,237408,32175,205233,96,68,158000,37384,120616
b3c7760fdc57f2b8e70f3825ad63d3f3,50,35,58716,19814,38902,60,49,78182,25869,52313
0244be85f2383c176ffbe7bed6bd817a,57,34,52916,10961,41955,39,34,36308,14413,21895
4a2e7d65c0ecee7a1315cecebff0e252,138,115,357913,60084,297829,117,96,285133,61556,223577
2fc11c063aef54639d7e1a50c9d1c8fa,117,93,299994,71868,228126,118,86,210491,75143,135348
31b34aff6ec1edc136c56313023d6cd6,75,60,147333,43178,104155,111,107,220973,36100,184873
682c527aa53d605352414707ebf8013c,188,141,984091,115314,868777,187,143,1022153,139528,882625
dadb5750f56903dbcc3bfc7f11e2a25b,82,57,82935,29867,53068,76,50,93406,22586,70820
b12fd5e5d5200b44d988ccd2d1685f0d,40,29,44078,12981,31097,52,43,59301,16990,42311
e8315c4c751c47f834883f92c336e6ef,100,79,304467,88941,215526,157,112,374604,108307,266297
7c63e58d0755ad5358ba0423a64c3fdd,81,57,118119,29191,88928,79,59,122197,38314,83883
ce8a22a494d89da393427dbfc4759989,107,73,206789,30292,176497,110,99,167526,49009,118517
34a748f617bc319b175188afb602c7ce,121,100,247743,53004,194739,110,91,164808,44150,120658
20eed591b2e8a2dc8d864003ad12ec76,42,25,21379,6965,14414,32,26,16760,6966,9794
9b5284675acf60eb7e8fd5a76b89a5b8,51,43,55349,16790,38559,41,37,36272,19801,16471
ca77d06de4ade4334a8bb57b028d5a23,76,60,160935,28541,132394,91,71,121503,30376,91127
512d1fda66be59a70bc0769e8e9f6584,20,16,7173,3302,3871,22,15,9092,2970,6122
5c09500cfb215772e468a3b5ff93e8be,46,36,37315,12270,25045,34,27,27153,15954,11199
165f0c5828a7c876b0fb0ac8c9a0121d,75,60,142660,46444,96216,75,50,164391,37787,126604
a1cff861bef1b3456183b02b9dc4fe3b,119,102,219629,60443,159186,86,69,137212,26743,110469
94731ac9ae4cd84eb3760348c6aa244d,24,17,10717,3158,7559,30,27,17790,5113,12677
fa8603dd7cf437cf38ccac5afcd89c20,51,43,36792,10282,26510,49,42,56010,11661,44349
da351b0299ec01f94fa0f7b0819207c1,33,22,28582,8131,20451,36,28,34886,12511,22375
228b4632ea3225b2fde6b1f4696c9bf6,5,6,556,819,-263,6,5,819,556,263
045496ec2c0174588073e26e0e7e4510,84,70,202388,52025,150363,108,95,215087,56461,158626
e2e7bf315b3e44499278d38feed0f618,124,93,310720,85305,225415,139,118,371375,108740,262635
681b16e21c2805587f4ddf84038b4818,95,70,137323,31605,105718,138,100,210143,45251,164892
777e14d5f30333d15b8d2901598c229d,133,92,338594,60702,277892,125,106,297713,83311,214402
1c0f14eaded18d519ed471aa4a9cca19,163,117,377980,97368,280612,159,129,448512,115180,333332
89086d20e9f2a7661e3fc63296f47c7d,83,54,227316,50350,176966,146,119,425816,56428,369388
a13532b685bedd85fedcb947dfae8644,31,29,11835,8062,3773,27,23,11105,7795,3310
13d60d0133078be0d04b8b6f65eadd5c,143,114,312261,92387,219874,130,101,321720,84407,237313
f4bc11ff7c1535977f29518a903d1c5a,43,36,33633,19676,13957,37,31,53225,14334,38891
6755a50c0a13d9e1570a84654eac9f85,83,73,98944,28868,70076,55,51,57162,25559,31603
0ae37a5347c60be3df6e272a0279298d,64,47,85918,24057,61861,53,44,66139,29161,36978
a34c59034e9d3b96bcf07f5a0c7ad4c0,186,125,499665,123755,375910,221,113,548797,84632,464165
6a2bde696f1564d21156f66b8a3e0f86,37,39,50527,14197,36330,46,30,30142,14627,15515
feeed8dd1c8eef611f5d858a86cc41b1,46,41,36443,16461,19982,60,48,52244,18261,33983
d2f3632978d854c28feecd8493831c03,103,98,217146,45430,171716,111,90,193048,44005,149043
32f00293a5240366793f087d9cd9344c,144,99,497865,83031,414834,149,121,587636,161424,426212
6bf1ff1a9e85061185d7a66acd93e2bc,19,16,6061,2714,3347,21,20,4374,3532,842
4aeb10ae3db554d4babffcd6326649ec,10,10,1214,1325,-111,12,9,2456,815,1641
1500d2aa79290f03a74e51fdc0d076bb,135,113,345246,77427,267819,175,125,409529,92192,317337
515024dd0732a3a0b35c0b392c10051f,39,26,34121,11446,22675,53,37,33793,13664,20129
5e82f45e244c6e32ba6ec1497d5c4531,46,35,54351,14604,39747,38,30,22616,8489,14127
29aa7e0d8948af814cc6380d300abfad,152,125,404970,65085,339885,157,133,467176,84351,382825
645f6f1219ed6e61630bec7925d67abb,101,86,197333,63937,133396,127,105,305374,50433,254941
89c7b97d5ab05d384378385bbf6c0eed,39,27,23627,7013,16614,34,25,21934,6685,15249
823cef915bc56d3b233d49e2d4c04644,171,111,616685,68059,548626,191,143,678163,95106,583057
fbe52ead578b4a1f201c2ee49a097004,106,88,215627,57487,158140,110,85,200027,55432,144595
971988781b64e8f86b73f258c5eba1e2,155,144,429557,119417,310140,148,105,460379,82600,377779
0ed8d4e28c854991d55c4cb0bf33dbde,4,2,538,181,357,2,3,158,480,-322
b3b586fd72d352ae7e8562815e3db5ee,29,23,15051,5055,9996,26,20,15260,5837,9423
0a6125d13da7e903b743cd619b368c93,35,27,46886,15755,31131,49,30,49242,16216,33026
b207b3ff2ce341d79a87a3f2420637ad,46,36,44219,9846,34373,37,38,37112,16572,20540
c350c971b471cbc210d86db020840ac6,55,34,83566,12273,71293,70,58,82171,20700,61471
e3cbb0abc37d761ad4b230e2434bb93c,24,16,6675,2880,3795,19,15,6820,3160,3660
11474874521289647451242a556900fd,73,66,105088,26224,78864,67,57,86447,32188,54259
689cdc11fa4a5fa72367a6ac1983aaa9,189,144,739175,165124,574051,173,102,650640,114666,535974
1558229fd5716c90c242098d78efac56,127,95,311695,79954,231741,127,109,297844,108676,189168
6b6527dba04f2e78927b4494b2d54431,102,74,136566,37503,99063,80,60,160592,27095,133497
4f93e1c93c4fd31a406fa838b6542627,41,34,90641,25055,65586,48,35,81768,28592,53176
c50cb4f74c4c00b2a800aefb6b74331d,70,54,95566,44448,51118,73,64,186044,27515,158529
a05e82c7ec920e7325a71540cccb93bc,20,14,4236,2084,2152,20,17,4007,2402,1605
306aa99b47202a29eb70d178fdea8a3c,46,38,56247,20121,36126,63,46,101610,23386,78224
5621849a005850e03c4e40db9abb13f1,107,81,163070,54539,108531,77,66,143423,49331,94092
a436f5d62e012e9a12a9a5beba8458d0,180,145,761424,224056,537368,213,140,821732,136479,685253
dc9ee1d995f96584f9e7ded9322ab651,125,104,295520,62625,232895,115,102,293545,84848,208697
8132d9d38f71f6abd57205fe85956be6,99,82,180815,37929,142886,70,60,120551,35967,84584
64b142fab9b5e251bf951176fb6e8b64,62,60,71101,31971,39130,71,50,94877,24432,70445
e45fe53c5effec5a3705ccbd7f0f59b7,153,97,729408,136743,592665,162,124,543886,125652,418234
ca9d92790e26fff21cedc97990d2b209,39,32,42649,21826,20823,41,31,50805,22103,28702
15e1fdda482e421bfd536be83287cdd3,35,28,30477,10509,19968,40,33,31761,10172,21589
a598638ed2bfdfeeb99df62bbb5c5c10,74,61,113109,30394,82715,56,48,91181,27108,64073
ad0e8a1d23eda8ba453dd3d9e55e92b1,69,54,102247,39640,62607,84,63,141322,31818,109504
491d8cb399e7e18e01e63c5bcce4b600,42,37,27611,10919,16692,45,33,32166,10547,21619
a59903c069c65373e85946ede8918211,26,20,14280,5768,8512,26,22,13690,5238,8452
dec06a1d11ecc1a564f0b16c7f0f2a46,20,18,5525,2290,3235,19,17,5038,2713,2325
e72053ee3ffcd614bbefd4a5a1fef449,11,8,1810,596,1214,12,10,1781,944,837
aa0edb9e32fb038cfb3037bb82f339ab,256,153,1133935,187752,946183,218,145,1480263,171072,1309191
ae2a7b9abaa0a153586d4d72ad77e187,25,16,10895,2264,8631,23,22,8173,4346,3827
9f694dc96e495e04e6aac73ab4baf352,113,83,205067,40522,164545,94,81,180919,46555,134364
a4d3d9a21d1763ab27c85fad133f39ea,172,145,631564,176830,454734,175,134,619857,132013,487844
4fb5c0553442fafb06038df34efbd16f,108,84,234993,65421,169572,126,72,222447,64906,157541
7e96bc6be30294dca4ccb29d8f0c1a5c,36,26,19781,6776,13005,34,32,16196,8387,7809
80eb4ba2faa939ebd956202696aeb799,34,24,20847,10558,10289,29,30,22514,10806,11708
8f1d2d0491c2145125a471278c4a720c,45,34,56819,19054,37765,36,28,44591,19429,25162
d24777f495423c72cead8d4a239fbfee,47,36,58588,24591,33997,53,39,56700,19211,37489
a13fd42a9402dd2217f05fe928a218a4,137,99,366362,80943,285419,119,81,282148,84669,197479
dec23bc34969c2c290438ace9eead196,156,129,462199,99624,362575,141,99,392650,65933,326717
4e8c821a4a0ae75c8495698ec2b3769d,60,58,105259,41367,63892,90,49,166129,34729,131400
88e0a60fe9763e3374c49694ce4e492e,58,53,79513,19871,59642,72,58,66324,28190,38134
e2316df9c301fae5ae21a8e93248acd4,109,82,173388,33931,139457,117,86,176706,30099,146607
daaf38d3fa6bfefb94712c2e3379de53,48,32,44502,14810,29692,53,44,71893,14001,57892
e2df6eb4bfb8381d3f0345d5633dad32,192,127,421073,51103,369970,154,123,394285,67033,327252
40feddc2673f227fd82d373b2974ff1d,177,123,657079,99833,557246,148,107,374314,101020,273294
a16d94ee9c84616f92c8c96a89bb6001,194,127,1080734,257866,822868,198,142,1718252,252777,1465475
8c76cf6563ec1309b070cc8e77773ba7,107,74,156162,48416,107746,103,84,204435,42091,162344
5678090e52136668bfb60e032ea73194,107,84,195064,50522,144542,100,83,155767,46984,108783
3845555336e792bd185d565f42d755c0,11,12,3194,2164,1030,17,12,3679,1145,2534
61ea8ec74ebf8724c65abc1a221333f1,23,21,10198,5369,4829,26,21,13798,5466,8332
440f0fa5ada16dddbb67be5bf97b2255,25,20,12159,4606,7553,28,20,11527,5560,5967
3fdb8529d94fb308a20f363867e69846,71,59,101777,21543,80234,106,76,142301,23193,119108
905cb299b0c04609452dfca61f209bbe,83,60,139904,34190,105714,99,82,180221,42385,137836
5b745a965b9a08e069f63c62cde28d94,160,116,599289,136164,463125,185,155,717264,154835,562429
0d771d5e866dac3d42d335ee809ff79b,31,26,26238,7264,18974,31,25,20942,8851,12091
80ee21c0256336c3525d66d3154a3b61,110,76,168467,26002,142465,97,79,192080,32264,159816
df0f1970fee90fd9d80314c4c464bfde,22,14,5855,1021,4834,20,16,5555,2038,3517
b4846563b99bc086aa025f04ef0e45db,33,26,22916,8223,14693,47,37,40185,10392,29793
e35545ca8b7f609a4654815b12d93def,26,19,15911,5822,10089,31,20,15661,4127,11534
019ef7a6b6570811aa9feb7a153f8553,62,34,39811,13824,25987,53,46,49042,15206,33836
66ddeec1adb60045c19d0bced1ac4b69,190,166,501659,100257,401402,95,90,295195,82569,212626
a553e0acbcc04a94401781af2a341427,157,119,488792,69157,419635,190,141,534475,70459,464016
59d87f38083832d62f4136a7bcd167d0,172,127,430811,88865,341946,181,112,442571,88171,354400
1cc84ec22b24ddc6d6f231d352613f2d,52,47,57301,24624,32677,57,46,64037,17147,46890
5015419af3717e7cb63600c9cfc93643,74,50,106337,20631,85706,61,55,89672,25894,63778
6d0a681ecaf1d7c45d9cc1524a2cdcb6,142,86,383708,122682,261026,131,83,395812,88037,307775
3e06ddf2f94c65d9b2378c750f33bbb3,90,56,149176,25319,123857,78,60,126888,42857,84031
363746ccbd120bd482419b6e2af62785,41,35,32403,12926,19477,56,36,39607,7975,31632
082957dc7621fd169fecf6ee043d2d30,88,64,150113,30944,119169,96,82,162910,40870,122040
fb715501b986d6f5e6d4ffac69e5a072,56,42,83889,26614,57275,69,49,69626,32940,36686
cbf278d79a6d7b8062d970a4c31486ce,78,64,100149,35193,64956,87,69,111732,34532,77200
574bf0963ff4be4107f8d0919e26354b,108,86,257206,68679,188527,126,101,329958,90238,239720
5c3b5a549cc59f3814acee8cb417fc0b,104,73,167889,42570,125319,120,106,251149,59454,191695
e160a6b4ff101965effd49a82424bea0,150,111,513659,125011,388648,157,125,620133,115780,504353
1276795d794323d0e02fdf2a52309f9b,45,38,48738,24566,24172,45,36,60489,17029,43460
20f97053b55b524d02992e7f9a1e2b6a,46,37,51723,17207,34516,48,35,45019,20722,24297
202e640f58d06fbe6637611b366c4324,150,115,336505,92103,244402,172,114,374063,76356,297707
237b36ce9928d44aac3e6f433cd24e19,36,27,34427,14251,20176,33,26,33651,13829,19822
23a7a22abdd854c1c17d8a5428bf90e0,179,133,405246,112352,292894,172,118,425889,101915,323974
546db7d38edc385a2ef3f51a152b8d9f,99,73,336212,118011,218201,156,124,475010,110753,364257
dc72cf5c5af84e606cf7d77da3648eb6,146,112,525153,95403,429750,148,108,383094,120920,262174
67f4e54fb056ca7f048c80cc0a8f191f,141,103,352710,114628,238082,185,134,644488,92975,551513
acd2939584d6169765071a8141a88dba,152,119,545689,68956,476733,174,131,474045,58720,415325
9f44b6c1d25e887102cb742f27b1c1d3,100,76,206730,48958,157772,123,102,290478,61934,228544
5352f5ad16fbcd9ce2c6586d70db6a54,36,24,17550,8562,8988,34,30,18086,5836,12250
ec376401a59c0ab4eff786439b41a860,102,84,191728,60342,131386,96,74,164681,53661,111020
9bff2df623f8d5a9986101e7db768116,83,63,101993,32826,69167,65,54,79443,27599,51844
b83bf60674be470048d5ae0e25c80559,36,23,25227,9455,15772,29,27,21222,9424,11798
f00780abc4df01a17c6243fe2b236186,49,26,49013,7496,41517,42,38,32511,16136,16375
e617f87e8dc24716141bb7314c8c6def,10,9,1207,671,536,8,7,1613,545,1068
231931c551d5d6dc46a61953987954c6,149,118,407360,73608,333752,151,122,433331,88217,345114
efaa90729df4c0c8d71d267a4c893e9f,53,43,55297,15653,39644,51,46,56891,13065,43826
97cd39a62c578cdc0c6e9eaff8acebf5,150,108,379188,84039,295149,93,81,213643,78874,134769
a2497430356f925c2f671f0547435d6e,37,23,37708,9340,28368,36,23,30547,10681,19866
2d296eb986ba65f7622929a34b9d90ae,62,48,88585,27393,61192,73,59,95802,21776,74026
9d3a37790b4f4d334bc542702a00feba,117,94,262898,66773,196125,144,124,288001,91719,196282
8668f2712bd43362c3a37d8168573b81,93,74,158474,23329,135145,62,53,64354,27758,36596
fb852e6cb6a00cc1cd7fe57512982059,160,118,890338,148215,742123,194,140,679068,144856,534212
aba622f1b13df007573a48eb8d5de035,24,23,14739,8434,6305,30,18,13043,5255,7788
4a183e4d34dc7c4a65b9c829801a1198,123,96,212177,59435,152742,126,110,271758,52379,219379
66b90ef442193e4ef91e0ae4b07abb27,43,36,34828,20049,14779,43,29,57509,13837,43672
9c51a2726f3c6134b42855276cbee212,58,47,102155,27326,74829,57,46,71397,31603,39794
c2e5f412d9278963225f2e5f1aeb7336,124,110,308699,95372,213327,105,73,221379,63300,158079
2aa2efa3110e4ff969609895f34ac5cd,145,122,498585,125860,372725,169,104,533943,92045,441898
d560f7b0cfe76e9d4c3f72552b71a99f,33,21,28124,8418,19706,44,40,41141,14096,27045
cca5ae827500ac12b6b29f5a884f0be4,113,78,214405,64253,150152,138,104,253070,46140,206930
c54033d19d7f3d1e5b900932defe5bc0,160,132,490193,85251,404942,156,125,449678,81778,367900
2713f28e98721459e6481808a826b8ac,80,54,106541,31197,75344,99,85,149935,33499,116436
d52fcc13dce99d881d2124922367bc2c,53,51,101048,31696,69352,68,52,169042,35405,133637
664e0e800cfb905a803756b6162e3e69,127,95,217461,68459,149002,124,96,315972,60116,255856
79b1dffd47846edf9b53f75d0ce0c7e9,131,105,338530,69458,269072,125,98,296203,74588,221615
6b51b5fbab2ce10b6fdbe0be635dcefb,83,73,175336,55084,120252,145,117,325578,82031,243547
8e23e87da89ce2d35669d417581c3ca3,29,24,15847,9258,6589,40,27,19761,6699,13062
67117501caad1e3fd610c243acc741e1,53,41,45383,22800,22583,58,40,62366,16649,45717
a367c0383cc6ee7c2926b394541c5b2c,74,68,91709,41792,49917,78,54,122831,37905,84926
4fc9ccd83feb2e00d7a297f182fdd01f,34,24,32366,10566,21800,26,29,34331,13310,21021
6b21bf7e7a8625130828f412a3f9b588,10,5,1076,317,759,8,8,1359,168,1191
d6eda22f9274a5c89e6e7150228b43ac,50,40,37083,26086,10997,51,36,56096,17761,38335
cb4458bf694459b25402416fafb1472d,102,72,146952,32979,113973,115,70,138364,35534,102830
17a73891273766a8a4fc9df1e8490979,59,50,85551,28447,57104,72,51,79050,23471,55579
cb806b799cd6fedabd59104db4598ad5,95,74,270807,73085,197722,130,110,307260,68871,238389
2c2cad02685bab066f54286f49ead949,136,86,291931,95361,196570,137,99,407938,107481,300457
daba4e196794f062add1b427536694eb,222,172,815501,193612,621889,167,132,739788,148650,591138
be8cf5289a233d2aff726608056b5280,66,56,110873,19659,91214,71,61,93369,29138,64231
4d04a0a19ce9810f578ca12ca5f97a8a,223,153,905176,154306,750870,177,137,1022875,151314,871561
dce4116a409be595f362db9b468f08bb,101,84,190128,33428,156700,89,67,140906,37757,103149
a910a55cdbc15ee734f1fdb24bd9a2fa,81,78,163482,48792,114690,109,103,240595,50869,189726
e244f84e0518eef35e5dd2ac70d4b174,60,46,79655,19306,60349,58,48,88293,25120,63173
ca083ec94860b6c64ec9a44cbdfae555,106,80,174604,53304,121300,90,70,146241,41898,104343
5dc2d88f0c78f1a5c078c25218e0d98b,28,27,28588,8425,20163,51,38,59643,16018,43625
08f79d2fe8dded4b50a2ca1abd63e739,10,6,1558,694,864,10,7,1395,550,845
bc5c0c2b973a073b5c7e00433d83d5b0,83,70,142950,50398,92552,107,84,163168,48522,114646
22b03bfbfb62e4e530bc1a2b5e7474c2,94,75,211928,44155,167773,88,68,185836,54214,131622
fc89c7c3bcf7fe9272e378724f0e7719,99,78,180119,57518,122601,110,84,203434,53991,149443
7909726d030f811949f0669ad4a20ca7,162,113,403000,60004,342996,150,115,245573,75358,170215
95c511643647a104ed6072935af9979d,170,125,485392,102140,383252,197,163,669799,132062,537737
321f8e75724ce21e4fe266d5ab091648,74,56,112064,33119,78945,94,76,150150,31642,118508
baad5959acd9cbabdaff9f63d1faeedf,42,32,49761,18722,31039,53,45,74998,18913,56085
e188a1ae9c0945bba3b12713e589b36e,172,111,485453,84156,401297,191,138,480537,138422,342115
38df6a5aa99fb54bb4eac21860eb56e3,106,85,246175,55299,190876,104,91,261270,77860,183410
f1019a7f4baca8e1e1ada69827b37245,45,30,24494,10537,13957,49,31,41038,9561,31477
d6391067725f5b4f34e74b5a9d1fc9ff,102,68,162885,30910,131975,88,62,109092,37813,71279
595e438bfd6eb07776c01a38e1a1ff29,40,31,46024,19525,26499,50,41,63513,21797,41716
156cc6e5d065dda305e0e23ca92a5406,52,35,64218,22169,42049,43,38,75653,16369,59284
ed48d3d270f3c39cc6c85be558eaf16a,11,13,929,555,374,13,9,2514,520,1994
b609ff227f3cee329b7f62487fc32493,52,29,38321,10662,27659,65,49,57697,13987,43710
78d740037d54b17bb51cb82e3b6f0fb7,134,98,362660,89807,272853,162,142,491309,89675,401634
e35f950b5ae74cdfe74ef89e3f0e95a3,24,22,22279,8665,13614,25,21,19928,9335,10593
88d9a474bda0c0704a9e94e3e83fb5f8,59,41,61025,25162,35863,52,33,67099,18005,49094
54fe799f80e3fb5ccb321df40e4c9c2f,19,16,5003,2085,2918,22,13,8512,1803,6709
51e5ce04045d58f4328952a408b2d648,29,25,10876,5392,5484,23,22,8327,5108,3219
ab67676a89250eb6c206161b7fb0aa39,34,24,23722,8758,14964,33,30,23649,10579,13070
c1c9e06ab32f180cc7d1e16b5a79a905,112,66,190869,53605,137264,145,113,303153,62227,240926
49d682d4112ab2f843d57d0df8db0467,141,103,299509,77235,222274,107,77,251026,69932,181094
06f963165bc7314fcae33492aa6a80c9,96,71,235912,69488,166424,137,109,279473,75038,204435
ef19f7b62d7dbbdb18e56a471fa89221,9,7,789,846,-57,10,6,1096,532,564
7b2fdce85cb655003b08b1485f049495,69,55,98448,26450,71998,67,53,79033,30690,48343
6f1b67101d6f3b4a5ea1ebaecb3bee2a,116,104,332286,126787,205499,114,91,401777,67284,334493
7428daee35f85348926d02c891048345,44,30,65218,14447,50771,52,43,61647,20835,40812
6e9445096b981a919277c52b4d58ae97,41,29,27244,10158,17086,42,30,29911,10208,19703
44a797a8a4bf8735a85f113134432f95,104,79,329710,77259,252451,145,105,343765,70005,273760
7c5d0e98d5866ee868a1432e164b1468,51,40,108665,30983,77682,60,33,89571,32607,56964
c9be3ffc4566105d0214dec6bceca0d2,40,30,31957,12351,19606,52,45,47017,14756,32261
b53496e7acb758cde0b1bb994a9d5b3b,92,82,106900,37766,69134,72,60,101580,26950,74630
32867df81b689f7618edf51dec412921,110,74,176541,30665,145876,138,103,209655,34524,175131
31505e6ed04edb10714753ca90bb556b,32,28,17666,7817,9849,27,24,17531,7182,10349
868c5569f7973df82fc14ac4fc53ef3c,29,23,17462,5925,11537,28,23,10245,6194,4051
a2f67079ca82a99a10167a9770f24600,47,37,88060,15741,72319,69,58,99143,29764,69379
53764a98a366b9b4588370321a411a7d,34,32,26096,10367,15729,32,26,18960,7303,11657
ebd42f85d089e6ca37220db409963e4d,20,20,5895,4772,1123,17,15,7300,2859,4441
a4819dea637042447b1b0e7c40c924ec,57,47,83632,24285,59347,69,53,120847,22415,98432
6e89e88a7cc93bfd79754bc8d778137e,66,54,184498,41416,143082,57,51,176890,46193,130697
9e23f767da54c91e6c1a94e1aba60e6b,105,83,244885,81858,163027,142,109,360328,91698,268630
af736cb9fe5a78c55a10b525aad46a86,90,69,200174,30766,169408,113,93,190192,52985,137207
4713fd8e5792ad7c93c0ea6ddd7d76b3,120,91,311015,66315,244700,116,87,235537,86144,149393
6d4e213faa85313d362714fffdad335c,127,92,314725,83769,230956,172,134,367150,95959,271191
483f6bcae856f2f4a3302984d7a64bda,31,39,19987,10136,9851,35,27,26709,8965,17744
fbfbae2fee21ff0f496723a187773328,27,18,6178,2899,3279,24,17,11531,1729,9802
691e99a89d0bd2e120f119ec9be269ed,131,89,339961,82762,257199,201,139,484729,100314,384415
8ed7bfe3141d88911b8f6a2332c00dd6,91,77,170867,61420,109447,154,118,311043,81566,229477
92da9a79f34532ae4b1c8e09bf98390d,31,27,20819,8873,11946,41,32,32592,8138,24454
09dd6ab2b9dc25bd5a86af117274ec54,111,73,149666,37580,112086,71,51,87484,42897,44587
4139d23ca4e3d9666b830a9a978f1adc,125,105,260406,73801,186605,116,95,282100,77553,204547
bc0aa24c2fd6fa1c13dcf339786e64c1,127,93,323269,64550,258719,128,97,353083,65470,287613
90d5bd7d17c6abfd1683599bf7cbf1fa,27,20,9178,4600,4578,24,18,10070,3625,6445
4fee418b90f132dfa56dee653ed2f543,191,153,753223,157436,595787,217,138,646824,134034,512790
5fb9394a5b648dc4f07085454eff5cb6,45,37,78764,21498,57266,44,28,49589,26729,22860
f07ef74ef898473d83da76b397fa6ffe,166,126,502963,95712,407251,119,87,412400,75405,336995
0db64f564ae5c0257b1c116a53f8a542,138,118,363654,93508,270146,147,111,375854,54984,320870
4710ac7ab7068dc517f3db4172135f89,126,86,291416,51583,239833,156,114,347428,58721,288707
77c6fcd8808ff47c10aee4935ac5b257,132,108,307767,54146,253621,100,87,231360,50746,180614
12efd3c9de43719e0345ffde253213a1,160,116,310651,58673,251978,134,119,338824,59612,279212
a0f5f6dffec97a519801fe33abc70806,16,12,5362,1181,4181,18,17,3995,2231,1764
445c988e179146cb0e049fdbf0275657,88,61,131554,33964,97590,97,61,115182,34412,80770
6fd370b81e8d8136650c7848a0c296f9,84,49,94119,21130,72989,71,52,57615,26608,31007
ae5949916deee6a66463d44eca199f3e,149,86,199952,31758,168194,118,89,145657,44701,100956
789e83f592ce59c8c579360a3de6d068,32,17,11992,2786,9206,25,25,7846,4023,3823
4655bdb5905327e469bb2c5e568e85de,75,48,80921,23409,57512,61,44,64741,21438,43303
088d61a4680ef9413050db5cff3352d2,180,121,524036,141456,382580,167,127,534217,107323,426894
e01d74befa11822b4437584f72870505,67,59,90260,27163,63097,89,62,104222,25356,78866
3b3ebbb6eb759bd97877b44f162bdf6e,71,53,84499,16938,67561,63,47,53644,22465,31179
9a1c9f2036635ce75639e1ffc9af2019,172,122,327278,64496,262782,120,98,282293,64684,217609
86d4cc0e236291b55652ce6034c80616,74,47,107641,34337,73304,98,60,127728,29407,98321
5ba13a9b390561bd157ebcf1546b052c,58,47,68867,28583,40284,66,57,107300,19962,87338
205713ab7fb0217185f5b3fd7156e95a,80,71,196207,61686,134521,148,103,273233,58041,215192
71ac15e5f3f1fd65d9c3ff73732cfb91,55,47,59039,20230,38809,51,38,53325,14547,38778
f43d9f3ebcc6a4af43ea06d1f4730501,117,98,202865,64219,138646,155,122,342529,55705,286824
cb3cb17ed213f8bab6e949a8c28b6717,62,51,77561,19464,58097,61,47,52638,14541,38097
ddfa57668fed339819d6e729b93734c0,54,49,92287,23008,69279,96,70,90373,27261,63112
94523aeed08e1412aa6c356dc8415eff,93,71,129237,26579,102658,71,57,114358,39730,74628
a890ed217614d7e2e52d319b916486c7,24,21,7515,2982,4533,26,19,6948,2117,4831
40bda5319915c648d2d06bf49cb34084,53,34,54792,17850,36942,55,47,79603,23870,55733
b0fb49720da794195c93c785a535f675,115,92,409536,133548,275988,134,115,546407,138308,408099
6e1cebe614bf6a8ba4d463790eb18b3e,82,63,147556,31179,116377,72,48,122244,35291,86953
724b4f8d8b88bb39e2818e052708170a,40,29,30462,8747,21715,38,33,24136,11469,12667
fe22020c23414a64bbee5a1a12545332,124,93,278718,85541,193177,185,109,374703,93827,280876
8e5cb97ed1327bc6ddfa39ed453ef2be,23,17,5077,3999,1078,22,17,7544,2612,4932
60d1b17f292b583287e920da788e4cc1,118,101,305566,79557,226009,112,93,234462,72429,162033
8216527ed9b593d4877a3c1a625ad3cb,63,48,83575,24109,59466,79,73,119223,27719,91504
d35adf0421be2898ae5ab7c61f1c4dc3,142,123,588737,89040,499697,184,151,698647,129849,568798
64f9d339d7ff01b3c9b23b4c28eb19ce,137,115,399464,95548,303916,131,100,445191,90957,354234
ade713258b5d542728b2d7da8cb48062,27,26,9279,4931,4348,26,20,9601,4085,5516
91283f9c7a61d3424ebb1a60bd6f5c4b,82,71,96990,39261,57729,90,84,144760,22188,122572
ce5c3759da6875a797451120894bc622,50,41,59706,22056,37650,78,58,93879,34467,59412
7a983372e7c0008489830dd11b1ac244,27,22,14390,4664,9726,29,19,10962,5455,5507
f3976398183a87b20d933a1b490a229c,154,112,372797,87687,285110,132,102,358783,74307,284476
1fac41e3825c7090f1ab4b33b4ce532a,43,40,36271,10593,25678,48,40,35015,9750,25265
539e2772f9b670cc4c844d70616e4e4e,9,5,582,145,437,6,3,413,170,243
36214e9f2c883fb5e72e084f8d76136c,129,102,270670,50416,220254,126,96,309618,50754,258864
7f81bc05f69787214426b82babc1820c,149,121,494449,144585,349864,168,131,658118,146307,511811
6893df5e0f8de58f480c0906f6f70a80,1,0,31,0,31,1,3,119,70,49
368ff53f2809a90fb99913b8e00af388,110,89,190235,77221,113014,91,69,210412,44434,165978
b68d0b9035a3831b9bb60825503dda24,105,84,186854,55369,131485,103,86,212231,62022,150209
87b79a3043cefed36be767c783c1ee4a,64,45,82395,31820,50575,79,66,128742,26202,102540
5b898773bc96d882e001d37fa73bd971,79,64,110699,26557,84142,81,64,85838,22872,62966
b6218deb9f3b2f112f13b706a8ea3a8e,154,116,308691,83572,225119,102,88,243596,92315,151281
6fb20028c2f5283cc8547438d976d5be,109,89,311461,126197,185264,164,148,444624,149119,295505
ebe60e58e3e12b4a79b63f77252b313b,186,130,608267,108096,500171,162,130,671800,137972,533828
5d7b6059b544f31032e5674dd132f251,42,32,29983,8471,21512,29,33,26943,9759,17184
6e28a4de6bec9e15796c1eaea5bab131,50,32,70562,24237,46325,57,38,86430,26226,60204
2d8d6876b067eeb1dd82572701df2729,131,101,288421,53361,235060,148,113,304643,54393,250250
08312092e31ee8d4f97f4bb4eacff545,57,53,71074,22064,49010,59,48,60816,28033,32783
7f9234f684f31a13b1cbcf3829a4cfb9,95,65,190292,53778,136514,95,73,200862,42095,158767
c03e308ac750456e458d4b4b4128f4be,115,105,221242,51349,169893,103,80,156417,44282,112135
fbd2c0433345d31178989353a036f464,70,50,135650,35735,99915,93,80,124418,40073,84345
785b53ffb05a861656f302e894c0b6be,72,59,160713,56406,104307,109,90,242899,71144,171755
3a302a0590a86323aaffc3d00deb3c0f,125,102,331077,52264,278813,118,105,232598,76357,156241
e560c2bd2d2b7e3a93fa1106643fd16b,10,9,2566,953,1613,9,6,1742,1212,530
48521ed507f033b14212fd9608291fce,14,13,2767,1337,1430,13,10,1714,1042,672
1b11b76e2858ee1c0a95bb2b76b0d9d4,126,93,559632,145054,414578,173,122,513459,132624,380835
3489aee2997f1e9b03c78e17b1f8a7bd,141,114,401012,77652,323360,85,66,234589,72721,161868
df0a2c9a1ed8231f820e23c1b7e9a496,60,58,115019,33874,81145,59,47,78219,40259,37960
3dfafd0a0619e5fb1a40127b25038eb9,132,108,341166,67811,273355,125,104,299937,59926,240011
6745bc6f54820ce65a9575c7eaf4ef71,111,88,201328,54874,146454,107,83,199330,42368,156962
f9878ea83bc9c70db9efe28d519c6683,38,27,22316,8662,13654,35,27,29148,10701,18447
13860faecca1d563ec4fc1b43794e922,100,96,215440,65585,149855,117,96,258074,57207,200867
3c298142497da0ddd06f67ddd574751c,27,23,14151,5446,8705,30,20,18867,4191,14676
57b1a7c9adde01b520d826cc7175804a,189,116,761322,207044,554278,190,129,837639,209117,628522
17d27c70270e337143bef9fdcb0c2ba1,17,21,5355,3551,1804,24,15,6623,2671,3952
532d312bc22aff6504c5baa4258d426f,128,93,357409,89227,268182,126,108,378515,103718,274797
34778a1448345b2c399b63a8d165ad5c,10,14,1587,1413,174,13,9,1962,1169,793
1cdd090283ded4d825099564112e3139,72,63,142920,63185,79735,105,87,210824,60471,150353
c5c53ba8ce9d89b48cca3305dd36a355,159,134,486575,122683,363892,165,136,438660,119171,319489
adce83899b799ddfa3d24b5a9eb9cb6d,13,10,1492,857,635,17,16,2081,1074,1007
9c165d8a5b51d3ab634846a173ddb537,34,27,21987,7931,14056,29,22,17028,9884,7144
06de68eea830bb1a1b170adc375968cd,127,88,270287,35402,234885,129,97,268941,42925,226016
4e837b98977903d21202524272363594,31,25,24904,4964,19940,44,42,38225,11547,26678
e2bec237f1935886e11a31b95296e0e8,54,44,44605,12445,32160,57,44,48154,12397,35757
75dcf0dfabc97f5f641260c11d60b93b,100,64,339857,96820,243037,120,106,365276,103199,262077
bdac9c26641d7425af71bd67c5a75ee3,98,75,182051,71133,110918,72,64,192584,54734,137850
95eaaee68321fb77af1a2825bebb51ac,36,27,26657,8386,18271,28,26,24918,9816,15102
929ba9ef47c91ccd25acd8028c8cbcbf,143,95,683236,118965,564271,140,110,416889,111412,305477
ff1a8b6abf73eb503226f7ddd2622368,140,118,478749,71899,406850,142,116,459654,82638,377016
e27722d678f0c01c8e467a7cc699ca36,127,90,271060,41803,229257,143,115,253711,65244,188467
51067c6f847c0b5dd00c21dd484daa3b,83,65,202352,55906,146446,104,94,227909,53003,174906
b1abbd4b675cd88ee3310fdc792e906a,45,44,35677,18023,17654,44,33,42224,10929,31295
0ad4ed98af72e26a565d53c0dc9dc3fd,88,73,135333,24089,111244,83,72,119422,29581,89841
de376c3080ae99d61464724586f0919e,68,55,86349,25268,61081,73,58,69664,26425,43239
9b3b257ceb45d554ff9a97816932ae8a,150,105,362184,80050,282134,129,96,316254,77900,238354
9846d5594acb123ebbc23f57dd677e43,164,123,531245,96848,434397,151,106,521785,92798,428987
25cca63d2b8f1d66d5308ee266e66cdb,5,6,659,631,28,5,4,443,471,-28
98e00ca29fd8e42de3a443e75730f5fb,90,78,158306,41821,116485,112,89,198639,43506,155133
b32a6e1989e1e81381ee1027e2c02c87,130,95,197956,53746,144210,97,82,170802,39655,131147
6f28ce22730adb11f0981ed95167b7df,2,3,113,431,-318,4,3,576,258,318
ab72a5f7ebe494a04ffc31f35a266689,7,4,1154,823,331,5,7,928,1083,-155
6806aaaf09f8500023a06e21b5799991,159,119,575748,145580,430168,205,142,763880,129387,634493
b8677896a5c4d53000644f0caad00b4a,165,103,478906,66566,412340,142,122,404514,87607,316907
3c32bd14180a26f551b2871e26cf7027,40,32,38182,10600,27582,42,36,35694,13168,22526
dfcdc117c443deef87c9c812a2e8bce3,55,47,72365,23615,48750,85,50,101388,22067,79321
576acc73827370cfe864f36af48c21e0,170,108,418554,72124,346430,122,109,378410,76368,302042
f3ec3ff3a4cc8ae7581f7f9cd7744f48,129,95,440744,115005,325739,165,113,547748,123052,424696
2e83e42aaafc2cb330927c7350adfd95,7,10,1659,1548,111,11,6,2270,791,1479
1834fc51b36aab138d9314dd7d1adfe4,24,21,8577,4310,4267,23,20,8094,3595,4499
fffe17eebc4f4be86ead78a14912d8d2,100,77,187155,73039,114116,145,134,319822,68736,251086
c56e4636214ffb50a7e8c3d04d480c5b,79,61,99971,30030,69941,49,47,79604,29568,50036
3a49fff1e492c08111304d8957adab19,129,111,220361,69241,151120,105,77,211242,51980,159262
08637ddb6acf21799029d20427d03671,88,79,155556,52480,103076,103,93,185299,52324,132975
d486677c7b136fbb4fd7b5642ac6dd93,189,145,725312,128092,597220,187,145,609744,146841,462903
3659c8df4f1873011cb252bae6be4fd7,22,12,6853,1789,5064,21,13,4721,2164,2557
69e23f0fb6307c393c102e3454775e48,95,70,179049,49434,129615,121,103,253784,48045,205739
ac801db3f5a4c6bb91fa2f4d60896fd1,90,63,121233,45965,75268,71,59,118103,43712,74391
fa6ed43e98864954abe243f5334fba55,174,147,898005,212609,685396,238,188,896025,209467,686558
a862729e603b5d00fd9d6998692bcb3a,120,91,361577,109179,252398,163,105,377602,78821,298781
7b1dffb86b8cb68f35a655fe9bbaf255,135,110,375522,97824,277698,141,110,421378,81990,339388
2f319816cf317aa34f3d9b114af1705f,171,148,605948,148698,457250,180,137,666673,86797,579876
74b8f6012415a7413da62782bc196311,66,57,90052,23141,66911,70,53,89631,17569,72062
95b43f42c2266179ed97a78c2cd51ea3,72,60,160059,37721,122338,51,42,127337,35160,92177
cf37997160ca5fb6318996942e65ad9a,36,27,35276,12859,22417,42,29,34276,10641,23635
394e23fa0f01df9f9bac7da256cd3acf,123,107,354535,78492,276043,120,100,312423,83655,228768
a9ff0747468ae0b9aad96166aff932f0,106,68,308114,107621,200493,148,97,376114,82624,293490
b5615eb128918942b56674cb65ec89ec,88,71,161603,47449,114154,95,74,135814,48812,87002
98148270a09d68ddd7398167b787e3b0,86,71,155074,42112,112962,92,71,160924,51995,108929
b207987008ee6f81be3a3ff32a6ba58e,147,121,456767,119311,337456,111,72,343622,104506,239116
bfaaf41dc62631840acb4b40cc8a139a,4,3,333,314,19,5,3,672,253,419
56c44dfee810f4de119add76c623e680,129,97,272396,49964,222432,152,108,339524,62179,277345
2fc430779facc38106135650942da330,131,104,304744,46379,258365,154,111,335726,63360,272366
d6d6db10d4dd6ed6cd1e8b4651fae684,120,92,229191,65314,163877,114,91,214679,69717,144962
6f2a51f7ee96332b5a11f310d74be3bf,209,160,1105750,175131,930619,209,168,1064255,247985,816270
c1aec5d286c11db144a664d81fcc795d,51,41,53979,15066,38913,54,40,74985,10458,64527
79dafeb9875aa53418d8855ed2a6d7bd,53,36,54675,12583,42092,52,37,51143,17355,33788
084ac18e3a19753cefd52f29705edd7b,132,89,177358,35229,142129,88,70,114766,35435,79331
4d42b73688b2dc6a9d7c6c42de137c47,123,103,229736,45570,184166,119,101,223246,40396,182850
38f03d83530d7804964fb9fe3406905a,108,88,225707,83274,142433,115,88,354377,70458,283919
0750a31ff9441695b2b6db161bb058cd,93,74,147044,50140,96904,121,98,243087,36750,206337
6daa30f498fb14d1ed24ded6de1949fb,80,62,160245,52625,107620,87,69,181720,52199,129521
acf3b30d232a0c9335f8f55815be7b44,74,64,186122,52653,133469,73,58,162126,31999,130127
be202aa094cff47e7b9a6f2663d6a670,193,145,882477,107120,775357,209,161,923660,154563,769097
940c650b78875e6ab6b5cb47335c798d,110,88,337601,115925,221676,168,133,481058,96810,384248
282a630bc4879cada43d5559cd25ea37,170,128,476126,71921,404205,139,114,321886,109301,212585
2adaf31afa7a3331644dc69c5e97379a,186,143,527536,108672,418864,162,138,437378,89599,347779
cb293f744b440eabb8372071346f66bd,144,101,430392,129638,300754,231,103,547507,101934,445573
3dc95e0b1a8822163ce8b13abe2c9909,35,28,33471,10707,22764,36,26,22022,10605,11417
96e6a7ea3b12c971935134da7bc2944a,88,65,161336,46303,115033,124,85,184890,42795,142095
b1018ecc88b6ec354ae4d11921b9c07c,47,44,68523,19647,48876,59,57,74135,21797,52338
5fda3de6a521860e66f6c0727b5f690f,29,25,15425,9479,5946,30,23,16599,8062,8537
4d116f0a7968c15711679db13f53723d,21,17,9005,2603,6402,29,15,15559,1943,13616
d67184905982adb7ca054eff1d498d25,103,68,171463,26731,144732,102,91,124368,46992,77376
b462644a80d7761197fcd38fc92fd360,40,36,39474,18356,21118,42,32,50705,17963,32742
6c4c47b71f9289c6d774c9de68eb386c,142,129,343750,70075,273675,140,107,288170,66069,222101
6c99f5cbc61ed905b9b2c004a79f265c,42,32,51961,13275,38686,41,35,35987,18278,17709
1b71f55f08799f4863254f52b83e1f66,150,95,420481,70540,349941,156,121,353072,74909,278163
bf061103614d3a3ee81248a8b5774c6f,10,7,1057,244,813,7,6,401,649,-248
943ca06dab98711efb28a379b9289cc7,75,51,110400,24001,86399,85,69,159544,33611,125933
624fdaabc8fb067fdd8aa08228ec309a,95,64,216825,76503,140322,134,102,364560,72646,291914
0c706824f6d93432382fd2742ad6c16f,109,80,298958,73211,225747,96,78,235242,112298,122944
f7baa051eb845669f2895b281e55b05a,127,94,317964,60071,257893,94,75,205241,83908,121333
a5a4e8d351c66f667b3a48f5bb60e93c,22,14,6523,3332,3191,20,18,6905,2965,3940
a03b538f6b102929438c1890fc1a3859,121,115,278547,99563,178984,122,95,334156,55812,278344
9847ef0a04c87a7719df99b60515232f,111,86,370337,50379,319958,159,108,393825,43113,350712
25eea8fe8796427a903006484f7f9d20,23,15,4627,2407,2220,21,16,4884,2608,2276
37ba9865ec90af428507b8f2350e261d,99,79,252265,62677,189588,125,85,285565,39106,246459
ece450a261e8bcd860b86003b2712a2e,45,42,129062,46179,82883,53,36,139122,41525,97597
687066c72e596ce4ef423125b9a33340,96,78,331929,83044,248885,154,126,405176,99971,305205
391bcb807622b0a76062d073c1a44ea2,27,20,13539,4092,9447,27,24,14167,4941,9226
af181ab557bf9a76f75b5c74a8ad51fe,22,22,10020,7593,2427,26,22,12765,6505,6260
25e711d703b3b29ab25f1c6fd8f8a8ac,23,14,6309,2068,4241,25,15,7685,3500,4185
a0d2afe43b7973987ca4778b44fbf80a,129,84,250433,57661,192772,118,98,274601,42668,231933
6ba29de7b2ed78ae985ce6ccc0119b9a,26,19,11086,3613,7473,22,18,10130,4593,5537
2f6c8c0649e59ec1c36ec84bdfcc32b9,96,78,234727,67005,167722,96,77,226490,56033,170457
cf5618c0dcba4caf4ee0aca2f54233c8,33,26,23956,7733,16223,38,27,25312,8417,16895
2caa6d03ec928fb69b4249e468019e6d,179,115,534008,72811,461197,140,109,461341,88029,373312
caa8d38c41643153497051dd6138791c,85,67,108327,25151,83176,91,70,131457,32514,98943
c5b112aa2b866833319ec5dc5b121431,152,112,523460,73965,449495,133,95,415866,73917,341949
bd4f1c18a9b8841c3038570bc4d7d85b,60,53,82584,25892,56692,64,43,70063,22702,47361
f80a92d5c587ecacf82c1adf884ca952,25,22,10184,3807,6377,38,30,21156,6970,14186
96442e8f843f6810d3aa7e8552385d41,44,30,76555,18490,58065,43,28,66047,18450,47597
537568c9bb56f34341208c8914213340,28,26,22858,7643,15215,33,25,19375,10826,8549
32969582dd4722e261e842c1297fd3e8,156,111,478762,100819,377943,181,116,641626,89268,552358
3b66332345e12a8946651753ae99ce64,104,72,194514,35880,158634,93,73,158795,50984,107811
e36a559472fdea0309a3ec97cc29ee52,116,87,260031,46636,213395,107,91,202878,40533,162345
2b471a2e649012908eda9073037e02b8,165,122,379633,61486,318147,105,73,224416,82512,141904
c5849a5db4d49c83befbcf7f0a3c7bdd,86,58,130979,32519,98460,84,52,114934,30307,84627
e11fcc373fd5fa2c3cf08c5d18c017d6,28,20,15666,3879,11787,25,22,9598,4157,5441
06247723d8172b29480d126bd1f27a79,122,93,241131,48428,192703,137,107,266456,61914,204542
72fa2a94fae266e97d55022aba757a78,117,83,304495,100157,204338,165,143,381177,110619,270558
d57406da4e59bca7cc02fc3e130f631e,116,75,195652,28587,167065,104,84,131235,42408,88827
e98814e89f9146314d58671a2b914174,182,133,766152,187705,578447,181,129,641467,171960,469507
66d8aa6229c91920b13a94975c994802,61,49,76612,25502,51110,82,57,111891,16068,95823
eadd8ad10a63cd09f8d44eb5099d6bc9,35,29,24491,14730,9761,41,32,36669,13253,23416
2f4afed838923c4bbcbf190ccdeaf6aa,27,26,13555,6017,7538,28,22,13110,4796,8314
23bbc405a2ed1b7cc8813f29c6219d8c,69,55,112519,19580,92939,97,75,100444,28211,72233
dfded62782a85d90588a8d1e4470727b,144,102,395480,96807,298673,135,93,330107,113072,217035
2db08fe21e4ec6d286e812010efa7d3e,90,74,154819,51532,103287,134,102,260270,37256,223014
d463aa3eabcf4aa3fdb524d439f2eeee,133,119,362668,94527,268141,143,113,313719,99303,214416
83c09f86c8e50c784cd02df78b4fc5d9,6,3,771,110,661,2,5,101,707,-606
d9cc236ba149e7e197d71a232120cd61,44,43,35232,16315,18917,58,47,60375,14917,45458
fd9d7b807b0a133219dd1adc1434a058,72,45,89646,20173,69473,110,95,158783,35178,123605
2e9f4af7bdfbf6c08236a5c5eeeb7392,89,80,235933,56152,179781,115,109,227134,64809,162325
7fd8cebc1ddb457afaf1529e8751aa85,12,10,3290,1321,1969,14,9,2122,1465,657
1aa179064c71d3fc2f0bdb92f960ec7d,30,24,25192,7857,17335,32,27,23699,9996,13703
eb7d384ee0945071bbaf6bb13df3e210,97,72,161435,52950,108485,79,53,113708,31633,82075
5698e7b44f758ef82b8867ebb40ea5ed,129,93,278723,36455,242268,139,119,337432,50248,287184
1ad4501c9018aca08452261c317f0201,79,48,193452,29421,164031,80,66,139777,44161,95616
2965a2ea08df870d4d4bed0eddf618e2,123,94,180977,38463,142514,85,70,140683,42105,98578
3e49f9509f20efb1d59ca265d3ffa11b,150,120,277885,52026,225859,113,96,188605,64110,124495
92ff7059ac4984b74cd8f07066796dbb,93,67,131771,31683,100088,94,68,117484,33544,83940
01dbc306614385da565e4dc3e340e571,75,68,94564,48575,45989,97,75,165203,38494,126709
a17fc294d0736bc317703b3478d1f3b3,12,12,1798,2013,-215,18,10,2998,1454,1544
3e6ab8b69d35798c60207dbebe00f13c,77,68,166371,42138,124233,123,105,226220,54377,171843
028871f66c6c3801fef3f008e8a8f974,197,162,842823,203043,639780,188,158,791346,208486,582860
0660cd761faf6e1866e5ea8c544d52e5,89,83,185264,45008,140256,116,97,214858,43947,170911
b3a855ab9df937de1835a2d87943b87d,81,65,143938,34335,109603,90,75,127282,38412,88870
4aa9c874dbb18ef372493cc180843848,33,30,31383,13049,18334,37,30,34180,14771,19409
7bf05f98a0da5ecc7b333f9241db52d8,65,49,100327,32722,67605,81,67,139398,27486,111912
232ff74d5b2d2bba653c84d2f93ee9c3,92,77,206728,62631,144097,82,76,196527,69433,127094
68096832a97f5fc16d4102381e1e26eb,38,27,42470,9737,32733,61,54,59313,14158,45155
773b2a7eda63f49a54f6214b16e14090,30,18,17728,2582,15146,21,21,8823,3737,5086
ef268f77f2b051910a53e62fe2a86905,22,17,9055,3122,5933,24,23,12873,4856,8017
737d3e7c0b03e51c6a953e9d83f24da8,125,103,242142,54964,187178,99,81,254377,55127,199250
d34f72dba70ae01c47dd781b1779c324,30,19,15363,4552,10811,23,26,13510,8968,4542
66367352f698e431f5a8b1998e1340aa,74,67,87763,21900,65863,73,54,87987,23587,64400
e1e4c62721491eeae977142bda9b133e,53,45,90893,39721,51172,66,54,117060,38302,78758
21573982db3f6601a354df644dca9eb7,80,68,100152,37216,62936,137,78,180455,24472,155983
8cefffd99e5f2c3edc121585a2367050,144,116,350259,91563,258696,112,87,303946,67114,236832
0c06751848101f0a71c1a7704dd5491c,193,145,636114,198930,437184,177,132,659038,195522,463516
161c4133ed11813e3c6ecf0037e39ede,23,25,5811,4218,1593,25,17,8879,3854,5025
fb9e778329c5dd6d2b8e666d34875599,67,45,95140,21125,74015,76,55,88803,28426,60377
8ea0a56274be12dba3093f4b9bfd218b,52,47,69081,23346,45735,45,42,62305,23290,39015
dd2555a574d90acf7aedd46ed1221131,53,41,83673,43837,39836,71,49,146962,32404,114558
9a774ffa664ddff7e7f3efc780565010,173,151,362826,44463,318363,141,117,281779,65890,215889
ce95f2c8537509b554669e7057a8a7d3,110,99,289941,53017,236924,99,79,210625,54885,155740
91ac8e29a8501522d9c0eeec24f4b923,35,29,17697,6557,11140,32,22,16958,6912,10046
deb91574ca14df72efb07071749e3f05,69,56,104584,36076,68508,100,81,141999,39160,102839
7a2324a0de8c72881aa16ebeec465df0,37,26,35802,9294,26508,38,27,43521,9545,33976
23f261c62cfd7491531cb60586fa9d90,128,97,345494,83813,261681,152,119,393707,76255,317452
2c8c4e7a9bcb32463f5e248e47e826de,131,87,297722,91521,206201,166,121,420959,72215,348744
0b04adb4f5cffd3f6c4a69e1f128446d,94,77,249281,78715,170566,176,147,385712,101516,284196
ed274dc1359e133f5951dcd97aa3b913,15,16,7884,2140,5744,19,13,3984,3205,779
00486d7d61adb4d7bb2c8b5f5112a615,135,112,621073,154882,466191,179,145,692491,112306,580185
1d74543fe0f647580245d2c481fb66d5,75,52,99254,16310,82944,52,41,69300,25742,43558
ceaf2483324b5b2be82513ba61ae578a,124,85,215946,49499,166447,105,84,174132,61540,112592
54c654f33801dff09f1209a5ab530500,68,57,114393,26881,87512,84,64,94647,35352,59295
b3c0f81e249593a035a424dab73f8e7f,54,42,51582,13228,38354,52,48,47301,19398,27903
2bc64b7f272dfffa56ca103d3f12f7dd,92,73,132199,41404,90795,105,95,153459,54257,99202
4c8034c2f4c9b0b2b1018dd869e63b40,140,96,319631,74501,245130,120,94,299516,70492,229024
3fee6f1ac0bdd148d1d7195c673ab24b,157,132,525836,137515,388321,187,128,544771,99544,445227
c14dd05768f1e5b77488fd371d6cc9c6,14,13,3929,1307,2622,14,11,2126,1387,739
716c231d629cc2d5dfaa567251d34299,142,116,596653,99211,497442,152,118,489018,113774,375244
cf34dbfa9fa5687cabc1f9873303998b,87,69,130053,48133,81920,76,68,133021,45908,87113
cf73209969ec13c55220fddb8bb95cab,143,111,468649,110323,358326,139,111,466170,114947,351223
3f7c39d5947bbdd5663a1be3f519794b,83,56,89691,30421,59270,78,57,132792,28888,103904
b9627a5e8243c7b4b6b1b35e45e6286d,103,79,179341,49135,130206,95,66,216506,33751,182755
3bc048afca31a65d346a77cb15542967,131,102,442464,130766,311698,160,117,551583,124255,427328
3c45675c3a6d7506039a687f2b7bec7e,53,41,42220,17187,25033,51,37,43861,15574,28287
cb5385cd0246876181ef059507ac2305,51,42,63683,16987,46696,51,46,59948,23133,36815
65450631adc5cd9a2022b0db36906472,140,110,265256,76788,188468,145,122,340648,69936,270712
b9e51a541313b67335a3728de39548fc,119,90,234244,49808,184436,84,61,179558,36426,143132
cd212876b265cd0d85cb1a69a4420b25,116,89,249938,47919,202019,82,61,161559,45044,116515
1448be7a194901a9127145a9d3e1289c,157,101,557908,102221,455687,197,171,699485,144282,555203
64517057bd265478fe34f51f14ae8b0d,40,30,29449,10494,18955,35,26,25759,10206,15553
6f589638221e1481f69ba3e6bb186737,107,67,166315,29539,136776,88,62,135819,38849,96970
b4f8c5cd67ee1c03909d6e9a7fb9179c,74,61,96876,28718,68158,74,62,91871,31187,60684
e459a88cefd0d41bd4e32060f55271f2,33,22,22401,7634,14767,37,28,22944,8859,14085
56213a834cccb65c54f2c8e8e8dd0c35,184,111,491706,49904,441802,153,130,404217,71168,333049
17365f509afb12ef4ce706afcf819547,41,32,32279,8979,23300,38,29,33610,10398,23212
55a7328f0e795393027b425f83d65943,123,90,241743,81704,160039,136,109,347310,76051,271259
de58945e0c06cf906440577beb358a63,86,54,116602,30680,85922,90,70,110151,37251,72900
271283d341fde3d3c7e625b100c865aa,24,21,13771,4969,8802,26,22,15542,5795,9747
0ef7e4be79eec693b66b56151f327d69,33,27,19010,8987,10023,30,25,18400,8433,9967
23959e999d9454657b34a4173d63189a,97,68,145184,38307,106877,84,74,96236,51420,44816
de33cb03a198e9b4797ce0c597760d76,49,44,72010,36825,35185,76,62,116718,32136,84582
77629ffcc7ca9b2f0afb85435d6a4b31,75,63,103693,33065,70628,82,60,105750,21933,83817
027ac8a0dfe27386ef2604fb996f41d1,99,82,242125,61791,180334,119,113,284387,101281,183106
4a48fcc70b8caa17750171dfac61a9d4,79,65,171462,60245,111217,108,91,241481,51448,190033
da2c25029f97200d717f012274eb6c68,26,25,8355,4506,3849,30,20,12366,4794,7572
8c0721b3264c716e322b5ed6aa18c824,120,77,258834,48028,210806,113,66,226285,51288,174997
8443b91810eba8da7acc0d19890cd791,57,52,88910,32966,55944,66,54,117145,28736,88409
ad0a4f6d697a7473c2980548b93b6a0f,10,8,1723,669,1054,7,5,1143,749,394
720ea1f8a400d05f3fc2a5fffd807cfd,137,96,350411,114170,236241,163,118,478499,79637,398862
6361e6065dbf21185599b3d4c7a6646d,17,17,7426,2835,4591,20,15,9191,1969,7222
18903e14ff6a54a97ae7e6cd874b668b,121,100,343050,84241,258809,125,111,376028,77389,298639
e359206e2c1d3c6ab801d0321aa017c0,149,119,349097,65418,283679,128,98,286259,70375,215884
1dbd9a92588c9de3cd11fe70e55e15b9,47,40,49909,21006,28903,74,59,121104,20762,100342
dbb852686954d98bcb02a5fe2b399bbb,23,19,4700,2324,2376,15,14,3175,2206,969
303deebdfff40e780231def3e4fa81c0,31,31,21770,8206,13564,23,22,14570,6400,8170
55f6160e74465928fb8f8e3bda941755,186,137,679599,171046,508553,189,134,766532,117979,648553
c56eb6886373b8def52728bca23a963b,145,128,336254,72891,263363,193,148,544939,77343,467596
9814a490584fc79610668234db186078,135,103,419717,103636,316081,117,101,435965,113401,322564
b5a54e11e5b57be626082e0c0d91ecf7,115,85,295629,66517,229112,156,123,326131,77690,248441
392816dc9b05aaad45bda171e8d166ca,128,88,278914,46619,232295,95,80,190521,53536,136985
f12676022796fc33744fd17b3e20b50f,32,27,23022,10871,12151,27,22,19461,10059,9402
5a8bc06b405e6089f78c4de842a559d7,106,82,162807,35339,127468,127,102,211130,68166,142964
f4953a36dcc277bbbb738c583b4da414,128,98,270781,40273,230508,137,95,277033,39264,237769
0cdaa800f74d35f53f2e3002835b6bee,139,100,491177,95778,395399,135,122,620371,100709,519662
1a9de303f8e587abdd34949611ca24cb,0,4,0,1169,-1169,3,1,261,56,205
4b9d0f55b3bbb67ba8c22b769adc5d36,158,133,432596,75061,357535,145,126,340161,61056,279105
141ba583d705383ae1974f77f35bd804,45,32,78553,21741,56812,40,29,76600,21974,54626
15f929c6a7d3dc642adbf498ffec4c2e,124,96,193872,47512,146360,103,80,192550,44090,148460
c00c2aae9b4022ebaf29d489de4c2cdc,152,99,308748,58994,249754,115,72,275504,59508,215996
68f00759a79c6766e73327c32046d59b,61,49,79509,17793,61716,73,55,75144,21689,53455
31e89fc40aa175064ea681f80eae287a,31,29,16841,7082,9759,33,26,17718,5715,12003
8cb5653dd5f5dcf60a629acef9dd18a2,88,56,132445,31944,100501,72,55,111644,28650,82994
18725f8e209c39905b56d75cae5aa2a8,149,129,470185,61755,408430,92,72,199008,67689,131319
0f828c163ec40d910b0ac14daa976950,18,14,4274,1732,2542,19,14,4063,1977,2086
49a60bb2dbdc8a54060365dac78dc48b,84,71,114482,38122,76360,126,76,149611,27392,122219
774f6d75380715b43d736f83d0d65cbb,51,45,55163,17080,38083,37,25,31291,8756,22535
c3aa6e1975f48da5410224283c15d57a,50,33,67750,17038,50712,54,49,55513,21482,34031
5e0b6e2d28fa2b1ce87b5f0900a89ba1,36,30,27034,8530,18504,47,38,34303,9102,25201
5a855b212f3a64889acb5b7cf2355c39,143,124,437736,100953,336783,167,141,493417,96055,397362
66026b4f9a7fbf8b2dedbfc6f102d50f,188,146,624911,97925,526986,144,100,640175,99907,540268
adb40fa45b5d306484a4d3b694aafade,156,111,243725,48203,195522,112,86,174460,61304,113156
e5908dc075093dd1f4173576a14586fc,62,48,82236,18439,63797,56,39,57944,16748,41196
c3deadd686c2973cf1b9e28e8a870e4a,32,25,11700,7363,4337,24,20,12779,5820,6959
13e30987a6402c9d95c1071bd46d7d74,132,101,346664,82541,264123,135,126,349415,99095,250320
c44a1e1cc82efee88752905fec47f4b9,14,8,2060,413,1647,7,9,1126,619,507
6997f3bdf80103dd9d8b633f1b864761,42,35,36328,14641,21687,56,42,37997,11007,26990
68f70217aa40f36e5ce86a895faa3df6,36,28,37052,5783,31269,42,38,27272,13216,14056
79362b947d9d17defd97f43d4bda3896,183,162,613766,141015,472751,123,89,353668,65804,287864
1852fc9cddc3a93b3a225e921d4cbfdc,83,61,189374,67199,122175,132,112,451154,64385,386769
bf9416feb8ff78678682c74a002fb350,221,129,735954,147197,588757,230,166,1053069,153023,900046
a43dc35715d2c54e6fb44dc15adc5c08,50,40,57888,12919,44969,36,25,34632,10689,23943
1c6be3f494a0a153af5fbe93e62808c8,141,113,349238,42800,306438,143,92,294452,38027,256425
4c656ae9531ea9a29075ce8a9bbd15c8,16,13,5239,1921,3318,18,13,4887,2181,2706
129de9ecc4d4dff9454e047ddddd6d4c,79,59,101715,24492,77223,88,64,120121,24871,95250
10a16ee5b26b91149d9a81f826aca68a,61,49,101889,35631,66258,70,48,98131,40359,57772
de9330e8f2ce3d918fbda9f4d03422ab,52,42,55487,22145,33342,66,60,76354,23230,53124
2512d1e1d48e167852eccba610e9737f,128,95,404862,60608,344254,143,118,369547,60521,309026
86dc9614a15ab54e950b90ba21d42172,47,42,54566,14968,39598,34,31,27796,14061,13735
9c36b5802684d89b3bfd79443a5c8b7a,44,29,30841,11224,19617,45,35,48228,13086,35142
1cff5a87e571a809d9531de2823449bf,56,46,59040,24052,34988,49,42,67508,21382,46126
e9684d193bcf90de004648ff19739848,29,24,31705,8606,23099,29,19,22825,11575,11250
07408a6fa0b7f756abba7121e15ad91a,160,117,410463,67929,342534,127,111,382266,57300,324966
b48eea46e2f7ef1253e4581da596c41c,40,28,45443,20765,24678,47,47,62884,19994,42890
243e95f0bffb041a8641fa17bb3ef381,44,33,25056,16008,9048,46,30,39378,14015,25363
ae6198f48dad96fb624bc692aaef9923,148,98,393873,91937,301936,164,143,462394,140056,322338
09a2eceebe3ea9b10170214d9c554299,35,31,31864,12300,19564,45,34,43721,11569,32152
a4fe4b804cee44770e1c09ee148ca3f6,145,102,358705,81069,277636,194,150,502969,113619,389350
4b78986891bb56871b352c23d40c1161,55,43,67201,29695,37506,68,56,105805,27946,77859
98fd94b46310322c9fe7ffac58c8b3f4,32,21,14537,6765,7772,25,20,20177,4402,15775
88eb4fe9867546060cea26d579b84205,127,88,270947,76258,194689,122,79,335740,59148,276592
686c765f68087779351111a67f9def59,118,103,291062,52532,238530,96,81,181531,51150,130381
a6b808c8c65ea03c1300c1e63cdba44f,73,56,131412,36434,94978,61,53,110389,46641,63748
9a5ccd81194958ff7b8dc43d61e724bb,36,27,46186,19395,26791,41,35,56699,21836,34863
95a3821f8f48ce51d509e515fbfcbd3b,108,83,266542,83176,183366,122,99,292900,87553,205347
b776661033858e514e46cb98ba2e5f76,100,71,202677,28701,173976,99,76,166828,39267,127561
d7cf5280155206b36a9cbda4405b6e32,46,34,36140,5996,30144,52,37,40871,7519,33352
8d6cfba1d770b0c2b826dcb7cbde8735,146,111,336263,64209,272054,143,108,266616,70785,195831
e7f3357ee61d7070d7684e087e8c98e8,102,81,138841,58792,80049,133,105,249837,67029,182808
58de3cbfe1b3879107bd47deffc398b4,151,102,408871,94691,314180,134,90,295359,74860,220499
fd316bb8775956ec89a0ab120d343857,155,99,415145,56649,358496,111,100,276523,87610,188913
00244572f97c85f074ab7afda265968d,100,90,198403,70194,128209,123,104,243831,44044,199787
5327c77f053fd521f1ffe31a0919e669,66,51,81923,33154,48769,67,61,80548,29544,51004
1abcc5d4affc074b85eb8169d0fd8f77,71,62,93369,23166,70203,72,56,63979,23264,40715
b13396eac6392b446eeed9a84353b07f,144,119,373004,128047,244957,171,133,547734,112741,434993
42afbd365d13d7efee7c41fabb44d80b,46,36,41668,8921,32747,49,32,36379,7497,28882
c87d908eeabc895bfa7e092dbbf56c04,91,80,137592,45763,91829,101,61,134047,42844,91203
304cf892fe7d6e0c20f63685e7a7de17,112,81,243232,58871,184361,103,86,188848,74236,114612
20b2f6ba6539ab5df9409b9c638c4077,49,39,61213,29857,31356,53,35,85553,27973,57580
465e15780df5606e672c2981e09278e5,24,17,7607,5030,2577,22,18,9518,4771,4747
c4074425ca456df05dbab8cc350ccac4,151,119,495175,116297,378878,159,118,480936,116571,364365
e2e8ff5b47372e9a4397d3e246071741,189,136,438830,111371,327459,170,125,539118,90437,448681
98c5bd0977b5954c10a9cacc1aa6361c,63,37,64793,14991,49802,49,39,56000,19451,36549
dbc7e77e7ce03ffee9a9d490fa522d85,147,108,768599,153200,615399,196,133,845520,150575,694945
a8d0bd6a0fc4bb2fc220cbcbcab712f7,268,159,1037898,201668,836230,132,94,804459,129217,675242
2ccf957448e4d2fdfceaeb79b13d413f,47,45,39884,17862,22022,49,45,40323,17368,22955
7eb31c56c469f08ce6c6f56c0d40241c,148,109,419054,57524,361530,109,94,335232,66374,268858
f1452f23fb785157f32c65e0952c5edf,67,61,144216,39029,105187,81,72,149766,37501,112265
0e1469ba158538d513d089d991e05d9c,68,43,76900,15687,61213,72,52,82770,18980,63790
da15f1baf3454a05dd4c3e42e06fdd22,65,51,97046,16755,80291,37,28,45721,12916,32805
c4a1fddc99751e33c2e8164a6842d944,97,87,160357,33922,126435,88,73,153124,37245,115879
9ce8ae5e879184df4be0000ba672fa44,119,88,241516,44459,197057,101,81,181690,39092,142598
91beb21397ea5ab6b243da155e10ee79,57,50,101332,24472,76860,79,60,124183,28720,95463
d77964d47ca4696cb210fa890449ae59,64,41,46010,21143,24867,44,34,39256,19862,19394
b44e0f91c3aca6afe5d78fab623696c0,48,37,36855,13655,23200,76,56,77399,18784,58615
019e9ad8789d7e32eec9074e4177c287,84,59,94970,25425,69545,77,68,78407,29406,49001
9c746620ec6a04b93dab13f892f8f7fc,103,75,129730,50581,79149,130,100,193323,42804,150519
a9e1da6b25e0a7d9cf67d3817d379827,189,154,740837,128168,612669,169,126,536795,148972,387823
d1ebb016aa314d1ce4931d16964a88a5,31,21,15978,7604,8374,29,25,18488,6095,12393
3544a2c55f8f5c57acf5d01af81a3980,102,74,219622,47314,172308,108,79,238945,50818,188127
58e0f1c5ea380658b51b8a9875076431,71,53,92631,28212,64419,93,75,123517,36550,86967
eaa7cad3bf8cbba6e232e170ccb6ae53,158,110,354127,64369,289758,156,108,291088,65310,225778
fb2800997ec198adfe00dbf8f020fa82,112,75,142984,31713,111271,90,54,169458,27190,142268
46d18eeb5e64e34ae8144764869b54f7,88,74,146224,43742,102482,85,73,155790,43795,111995
b8f2c761acf053d7a711ae3f5631ce35,166,117,453664,96585,357079,148,114,449772,97668,352104
459e07e9fa0c965e8fc56df4cd81cce6,154,119,370288,69611,300677,111,95,259559,99240,160319
92ad59e46d22c4581ee45e06a7588e04,104,77,161260,41953,119307,73,54,103247,47508,55739
d3bc02910fba0c3178460bba6fe19807,85,59,158438,43261,115177,107,82,220205,53959,166246
cff1a44df4cdc95f0edfd9ba4283a322,99,79,173822,40571,133251,104,76,148487,37453,111034
01404f82775d97fdc41511257084dec2,0,1,0,14,-14,0,0,0,0,0
cc219eda6f7e44f4effc072a6e76dbda,63,45,81638,18678,62960,62,49,57172,16045,41127
78b29cd3cf964c18fcff3808b64ad560,40,26,22712,6712,16000,32,40,25133,10825,14308
1d7277862a530bdcc4d6f1fd2e707379,127,91,264444,52794,211650,104,77,168005,61959,106046
94ee5c7ef4071b4fc80075710404ce1d,106,83,218944,45108,173836,73,58,128992,48765,80227
e7b09d1d93e1791ceedee0c20796b070,38,29,37506,12304,25202,39,29,28564,14523,14041
813593df9822463f44a8fb3f0f4b9906,133,97,332254,72290,259964,142,124,462512,75843,386669
95f215e453a2a7ae297af5bc512bc95d,87,71,150100,26978,123122,81,56,131615,26642,104973
aeab4e84ae14f86de0e400cf9067e4e0,139,98,296149,57927,238222,174,127,306138,73212,232926
5bd6e79c8ad92e907398a10ebb21fdec,35,36,41541,12072,29469,48,38,50946,16223,34723
d3e271397f89ed2d8f2593c78e7cd0ba,46,28,28609,12599,16010,43,31,42113,12761,29352
d95d721c148f547e8d78ca42d8f1c413,119,86,260861,54099,206762,137,114,336041,52623,283418
cc8f6769fdfd35da9677dac2e6030bb3,169,125,564382,89025,475357,191,149,580042,96332,483710
3b6e1c15b9a6b45c6853f089a60a8ffc,169,124,845969,163748,682221,210,157,776346,164689,611657
b941face55672f7e445864c242e601ab,119,75,162913,44794,118119,92,55,97225,36970,60255
d75625e143c69ad3adff5ad8377d3594,176,125,646644,122850,523794,168,117,593091,138854,454237
4e45ef95b3a33d69428b92c0d0cc16a5,118,98,246462,72078,174384,105,82,178501,54106,124395
5c5bdf751de7d550e706570f62060b0a,33,22,25865,8783,17082,43,40,37691,14792,22899
835835eceb02469f51c84eeafd4d2fb0,55,43,84470,27066,57404,58,44,94369,22608,71761
73ff317b6ec32e8441911054efb38360,16,14,3980,2903,1077,13,11,3574,1828,1746
aa30d1418e320b0a81db48446faab6eb,30,27,18890,8980,9910,33,31,22722,7528,15194
6f8e03b7754f3eb445e54212c4c886a0,109,77,278845,78867,199978,184,135,462644,79894,382750
84283837480dd92b3d925918d0cfa10f,42,32,49707,14668,35039,42,33,34685,14383,20302
7de4c65401c65040048e11fe2a9ad01a,68,58,73859,24644,49215,64,51,91159,17174,73985
982004d123960bd5d0bf3ff1f45af5b9,22,20,12561,4235,8326,24,20,9494,5695,3799
0b0bd037733e1b8f12547c3079748019,43,36,38288,14095,24193,35,35,33322,10808,22514
b561c865fd926964ec3e82919c1ca1ab,195,133,590527,73873,516654,153,122,448261,87322,360939
3a47209fd305bd5d3dfc73e6bb097efb,140,99,309685,62383,247302,119,99,281233,69982,211251
6e516423e5ec91d64566297aa90a4900,119,56,164131,43377,120754,92,77,166394,59973,106421
e5fa7aae5cd109ed470a90e55cc8f679,58,52,57668,18391,39277,73,58,76559,19601,56958
15c2b2eab38b87b6ba8f08ad16208ded,64,45,71622,16524,55098,88,62,108942,23246,85696
0209e17c5f369593fbc7f88caba02ebf,74,64,189013,55951,133062,70,48,138875,49818,89057
c98d1a8f64661b64d2d550ae7dc29492,149,95,480612,86286,394326,196,119,572173,79215,492958
0300c25eebd6c842270613640e7f10f8,2,0,183,0,183,0,4,0,203,-203
f493077256b0a966e9bade4777543553,141,121,379964,67230,312734,172,119,514784,80454,434330
1149a4d4601fb2476542acd30bf93ee1,93,72,164400,60599,103801,86,68,132172,51369,80803
dbd3431246cb2a4d6b81e9e447149d4b,152,120,469099,110526,358573,116,91,365923,97393,268530
f9eddca13d5e29f11b04b6f4010d4028,177,151,548310,105108,443202,136,109,351921,95737,256184
2e767ef3d93544b1b20b72e5ef636c1a,118,108,213876,43434,170442,113,87,184097,48975,135122
0469f4c8ba8049ad8ed90f6e1b5ede44,26,21,17985,7043,10942,33,26,22595,7889,14706
1f85d22a2f3343548e1be23fe08a7aaa,117,95,240861,38738,202123,115,88,207359,57594,149765
6c01f5a6208ea6448ed81b1c2ccecfda,185,138,646789,55148,591641,141,109,483721,94544,389177
6f7f768eafca66bebb2ab876827f618e,23,18,10608,5039,5569,29,20,12899,4609,8290
440f1ffd2c533752590a4dadab497145,133,113,300719,69222,231497,144,115,361884,78295,283589
ae51e6221a359be18ea22afd41889466,29,26,19315,7919,11396,29,21,19507,9953,9554
5a04ac571b9ccd5c8da40afb7b11c16a,55,45,77591,26370,51221,48,37,63184,27228,35956
949219de989185df0b590b625a73cc40,55,44,51602,18792,32810,72,46,65952,15070,50882
f7386b14c50d33a85790f9aa999cbe09,136,107,274982,76953,198029,156,114,456358,48701,407657
e9b7a75d9c25f2754c44b4c5f1c7b6a4,0,4,0,290,-290,3,0,281,0,281
a5a365ff22e833d766008d029dff5e15,29,24,20411,7284,13127,27,20,17912,6788,11124
da709b4414c97dbceaad01345b1991a4,33,24,15441,5201,10240,40,31,14223,6004,8219
9a30dccae4915cb18388e9e78f5dbe33,78,68,113956,36535,77421,62,52,105047,39057,65990
668ad086ac074e0e36dcc969756fe95f,120,77,322214,37796,284418,120,92,237509,67548,169961
ba0b7bb4031f1e84421242fbb35cb845,95,84,152994,46045,106949,115,97,209480,50261,159219
af7b0a16eed46398e295f0170da38055,163,114,387987,91020,296967,167,130,441406,90435,350971
1b19b5ef9d8c8059ec85ab409182b925,139,105,418321,91597,326724,137,108,352104,73133,278971
c3019bb83e6721fc0822a3e162ca6530,47,41,45689,18740,26949,50,39,60400,11366,49034
21f24e3dfab2719f8548696647f99486,99,64,167810,45592,122218,107,77,167934,38645,129289
049494e22740aaf13df1f369c11031a8,185,128,945794,164217,781577,195,132,873054,138049,735005
4dcced937492be0dc422a435415cbda0,113,85,214499,59821,154678,130,98,256897,63985,192912
8dbd88eab31ba6fec05d2bd8c614e4d3,38,26,26241,10963,15278,36,29,33871,11969,21902
45ffd0763582e88d7af96a674efac86f,59,55,109606,35022,74584,82,67,100159,35247,64912
bf053f91cd9f5dcb68827c9b363ce015,100,79,149980,40733,109247,99,85,208434,47007,161427
5af372fa918b4eb2224ea0ceff2c6794,189,147,931257,131469,799788,150,108,484355,105895,378460
f6ea46e4bdc2e0c83bf03d6a39f334f5,142,103,503982,209335,294647,181,133,650298,156797,493501
c2e706c6919b43413b055372820c8924,46,40,33870,20230,13640,44,32,49393,12107,37286
30cdaa84485fa73abf043ced9f29ef30,106,77,225325,53443,171882,98,72,249236,46831,202405
449cca9a6dfafd6efbee1bf8ad66a4fd,148,106,419522,50489,369033,143,120,307728,71412,236316
c2eb5c6d59ebecff3f2854eb66c37146,74,53,105230,26879,78351,87,72,118524,34061,84463
bcffe877318039ff694528ca76e87645,126,102,240869,75719,165150,178,121,414761,69765,344996
18fa48dd370b9d3b6abe15e8705299a9,147,103,298471,78632,219839,122,79,235088,86523,148565
ce2036865f1bc1233ee7c070ac288a99,9,16,2389,2405,-16,21,8,5672,835,4837
b5678011a91aee46d5d68a0c038005a3,137,100,382606,73405,309201,180,116,345588,105410,240178
aaa16189370222f1a0b654a8e0f53c70,172,127,563248,113788,449460,170,109,694501,124896,569605
fb36b8c136ced7befbe40dae805601fb,47,34,42986,16130,26856,55,51,39420,20580,18840
1cb1ad5bc95721e3f44387b607ed8dad,35,32,19397,10315,9082,31,27,23919,11245,12674
5f43959107d76f305b54e07871c5ccf7,55,45,44639,20013,24626,57,49,62451,16813,45638
30b5b5e67f8a5f7abb436d0d871cc989,87,67,141394,45242,96152,110,94,182545,53847,128698
2889fb62c641625a8a06a05ec7e909c0,53,39,51531,11016,40515,42,38,26448,12943,13505
415996e45ed7a7481ddb991ca5fa964e,98,77,173677,44762,128915,117,90,203408,30538,172870
d808e086fa3f4171c494664578e961a1,146,102,346881,64252,282629,152,126,378379,88616,289763
6ed44022c1fb1948958aab56e33534aa,127,84,416947,107205,309742,159,117,456219,94135,362084
7d79e32a05717983937c608354d39939,203,143,853973,128516,725457,150,100,719205,123894,595311
7bc4ca1d0984a2e727e7c847fe6048a0,91,81,238146,52702,185444,115,91,240377,68447,171930
f26342f0d290f12b6b768425324d04a6,132,82,381358,75915,305443,112,83,262975,87977,174998
d4987108f7fc8520ba26aa6cc375b00b,87,68,140607,32487,108120,94,63,139579,36051,103528
018af77f8918faffddf652a7dfaf1bfb,41,27,25349,11703,13646,52,42,42235,10902,31333
a4f476040aa150980f225e9613a0f06f,16,11,2400,1186,1214,14,8,1982,718,1264
44c3a232a884477290f1a009bfc1a274,42,33,47867,12824,35043,42,30,43695,11708,31987
5b62e71df8ff2b31bc73ed07879da7da,81,54,128540,17996,110544,75,63,107311,19779,87532
f5d68e4ac269bfa1b4af7ac2132d605c,142,81,277004,66809,210195,159,115,444574,64185,380389
1f61e3c7b99017c8a5d4c7aebe64f8ea,135,102,319659,78141,241518,164,125,485899,66946,418953
2a7b5065e666e4b9a3834d9ed26eda3b,165,132,373958,106019,267939,121,97,325674,104952,220722
03a7d4a51bdc09f83a78aff019164c8a,33,22,10889,3769,7120,26,19,9994,3467,6527
71f8b81e6e961f367d67c56896264bce,37,30,41332,17804,23528,55,47,76671,18831,57840
03efe5aeb6ea7f1c3a5b2b404df1c419,28,26,9893,5310,4583,23,21,10822,4924,5898
c88fa1e7881c40640b38f437a7c132f7,69,52,106910,43360,63550,84,77,160563,36220,124343
125c44f6692104c043bc933ec54e8721,2,3,242,300,-58,3,2,300,242,58
fe42973d0e04efaad94eddf13777869b,122,74,402106,89748,312358,168,104,403877,94445,309432
984c533703c6ff1bf48c14f747f88420,42,35,31924,17739,14185,52,33,47570,12612,34958
376d618c915b2a161e8ee2e1a5880705,15,8,2546,741,1805,19,13,4197,997,3200
f5669e2c7f4eea86072633bf415336a7,56,43,59834,25062,34772,61,54,69430,22825,46605
5d5042e6f61d3b88a68fb17a413c3aee,182,133,670755,96342,574413,173,125,627165,91884,535281
da505b6e3cd3fa7bc4bbb114ba4807bf,201,163,983034,176054,806980,215,161,1663321,271809,1391512
ea94686318799988aac4a03108ca1ce8,47,37,54101,16034,38067,37,28,63245,14329,48916
aa95b86bf137180010413fe955b0e978,142,95,447381,75785,371596,151,102,350853,92339,258514
a702e8243f30f1f94d2464cd7a9c9438,23,21,7876,5277,2599,25,21,9862,4977,4885
c7730f9340152ba8a2f1a2472fc89058,144,115,460947,164809,296138,183,142,548088,154116,393972
cf2edbbf1d86653cc28c083616a1cada,52,44,47685,24268,23417,57,40,71464,21186,50278
3e66e2235234d61f379b8f72b7de1027,94,71,109209,33566,75643,65,55,114033,38598,75435
42368090b5f98be6ead35bb94082baff,152,119,456447,114581,341866,182,127,481709,110812,370897
ee8f8e4d1d16f516467c6053a4cb1d12,197,134,917350,272293,645057,179,146,949352,262645,686707
87c94b462346ebe01f2433c36e4dbd41,24,19,12000,6089,5911,27,24,17413,5885,11528
c146247a1aba73124c4eab3eff6a3ce6,147,109,406807,90322,316485,140,92,451725,80046,371679
09c47c963632707e0f77580fb7d9ddf5,116,87,192846,49124,143722,75,58,104607,38558,66049
f762384e1f24c6e23d9b5fe97203bf69,39,34,21290,7407,13883,40,38,27918,10704,17214
7ca1932c30f647546cd67a7a33ee0ede,18,14,5635,1857,3778,24,16,8348,2407,5941
3eca6c6e693965bea92a3bc0015a572d,115,107,303745,57167,246578,124,105,311935,68716,243219
eab713cdeb7b92280db865d339622f4c,50,37,60810,15613,45197,57,52,54109,21607,32502
950d7d60926cc865f379319c47f7efe4,72,55,83758,20379,63379,46,36,48260,16324,31936
f39358fa3b3d561ffc66b725d4511df6,63,43,81868,23427,58441,61,49,71818,27167,44651
6bd815e9fb5829f02c3a154bc0fb827e,28,25,17690,8332,9358,35,25,20548,6734,13814
9572c2047b920535ae83b9ac7b2fe03f,189,134,533182,131202,401980,175,147,558784,137704,421080
9d97762fb338ae78576bbe0b7b00bc25,73,60,140543,31218,109325,65,50,110263,27738,82525
2833950081234abde00beaea3235bbde,189,120,745936,87781,658155,207,141,732984,114690,618294
9639c9d20fc2e5514ab11c3f36fb526a,81,71,155229,56089,99140,103,83,210563,68956,141607
8d2f90b73bcf7ae25dfc8c75d85e47aa,90,72,144627,31497,113130,88,60,124850,39407,85443
6d554732862f93417774707edcb3742f,167,127,515894,128774,387120,188,152,782607,120108,662499
7c7b9cfbb694b3b4df27b14add442e3d,11,9,1830,792,1038,11,8,1365,1235,130
e2ef8d5a91b1f75599ddd6e854ac1e55,79,64,152119,44494,107625,121,94,244060,48222,195838
2b9240b078cb7ea6f9bc7205458b31e8,43,29,68225,12568,55657,62,52,76986,16797,60189
e4d7127a78ff52e0f6ec48f96deda6fe,88,70,139325,40931,98394,89,77,118045,46751,71294
e312615e4855d6678482c105c65e4b50,128,116,284494,69898,214596,149,103,334007,50655,283352
406d98075e140bb2be232793a0ac9cfd,111,82,250561,55587,194974,125,94,283542,48709,234833
d2d6cbcb45a7a8584ceda1b0b645f4a1,37,36,32214,17293,14921,43,34,47679,8739,38940
9bc4008f0cc82cec931dc8a7e331cd89,134,91,288429,74713,213716,129,105,281168,75894,205274
a0e01dd3cbd525481667e9da8b89bab9,136,118,462797,90102,372695,187,130,596089,94138,501951
3aa4c824e586aa8c6c44fef6e0240796,44,34,39273,10991,28282,38,33,28327,10181,18146
c87761a3ea8bf16a80054dc4e2454b97,159,128,506087,105263,400824,131,110,373795,80171,293624
8e07842782fe818d3e079754ab5803a1,95,76,161304,25205,136099,89,82,120539,47856,72683
e2168299719580ef1e234977a1f7257e,16,11,2859,1517,1342,12,16,3575,2105,1470
5b9301592c5812ee48e49515d71bf60d,69,55,103055,24752,78303,80,44,91869,28830,63039
1449db59499b15c3923cb3b740b564e4,50,37,73539,15832,57707,30,22,38978,13637,25341
d60cf7cfe82811ca7c3cd9b23bcc56d2,158,126,460921,129288,331633,152,126,402629,126519,276110
4678dbd7b045f09da06c7d4fa5902e8a,66,52,119952,51591,68361,88,74,174935,48570,126365
275b743299e8b5844206f0407634559f,34,34,48652,19586,29066,45,29,44844,22110,22734
18565ed83653d9fb6eb13a7ef90085dd,25,15,10675,3343,7332,22,21,9645,5593,4052
507371db3eb6414e635267b3b3cfef63,31,21,12532,9082,3450,31,23,21304,5848,15456
3b84f234aa4b2b462f58da3d58beb0e9,121,91,284688,86245,198443,131,107,331789,87341,244448
fb8ffd4b375bf7f9a747a49d032cf27d,177,132,614922,110175,504747,168,116,657769,93677,564092
b68d1ae9628b3f2b0dd92d3ba9f6e04f,180,146,671387,202639,468748,174,145,581226,83113,498113
2c0c0253da0d3fafa25d3672bdbf0296,178,155,542998,92425,450573,181,142,601962,80010,521952
9be4b13215172e68f0179915d359b2e5,16,14,3429,3186,243,25,16,7831,2743,5088
193c8d68686234a6f53695bf15584825,10,6,1523,1306,217,12,7,1708,897,811
bdf97e6be1397565d4fe34877c594687,76,64,119083,48098,70985,99,76,230998,58456,172542
6b87f536f404a1bf35002ec690a645b7,98,83,183289,50593,132696,93,79,147604,35838,111766
63c3dab118aaf21f3e49cdea80ea8623,26,19,14203,6989,7214,24,17,13626,4609,9017
70507bccffdd76abe3c6afd9a60185cb,140,88,295174,53339,241835,153,103,319184,44478,274706
b092110c90d8eee65e7ad67f277ff4a5,121,85,274462,61006,213456,166,127,403194,58065,345129
198c57e40b6b4317c759f5941616dbb5,83,72,202042,58769,143273,107,81,210418,53370,157048
ffc5491e547e3766a5837b99908e6f36,116,83,295047,55400,239647,132,115,315026,62052,252974
bc440633601e5bb27e1f122bb698b183,13,12,2964,1524,1440,18,11,3613,861,2752
14e3957833416dcb629ff54c63ec83dd,90,78,176415,46958,129457,114,92,210938,43045,167893
b15d89aecaad2a57b2e62799aa2d9077,50,41,66044,29624,36420,62,46,62705,19507,43198
4539bf44ccb1d3378a79d713ee1b021f,55,49,116974,30448,86526,64,48,91564,33093,58471
55bd86020aaf04b34a0b464f6b1f6cc1,104,79,227033,38830,188203,91,78,197766,71450,126316
bea82e06f881644c5e80364bfcd1aa04,62,60,80437,28227,52210,80,56,78477,26312,52165
503d627b978571dfee5cd54c107fe362,80,66,96945,27468,69477,76,61,100944,21073,79871
d8160ae208385348ae3c255b796cc290,155,106,560785,75394,485391,152,124,530511,143972,386539
c58929635e959eb00191830cfc09f87b,59,42,69113,22451,46662,76,66,72211,23233,48978
f88ff868f36ec59682e79c3c5e8eb51d,103,75,167825,44964,122861,74,66,103853,44910,58943
8a41aba782b546334eae7fd9d9a24cbe,220,137,1701581,300179,1401402,252,193,1324450,272429,1052021
26530961ac7c464a4a98c593b70ad495,29,20,12249,8466,3783,28,24,22103,6891,15212
f75e979430665c7025c08b596ed71ca3,98,68,172825,36109,136716,98,78,135232,49897,85335
fe8c7bbdc16fc5c42b836c84c77c9b75,6,3,931,329,602,3,6,329,931,-602
9277ae50e4522aa2e04e8bc6432bef21,238,150,861178,156923,704255,193,125,787096,136292,650804
c22a7439ca3adbb3cbcde148f1a6fa4a,22,17,4612,1768,2844,19,14,2796,2802,-6
74c30057e452cc8acfeacf28c7744b03,30,23,25363,6588,18775,25,18,22208,7391,14817
d57ff681c2cc4462770c62fdaa4c7879,72,53,109002,25847,83155,81,47,77332,30042,47290
6d259bdff505c000806c29f5ea6e2b38,76,56,115363,41344,74019,68,47,106873,35081,71792
bc8d8f0e05f45a660319a3f7894b80c8,154,119,427002,78178,348824,123,90,364534,81259,283275
f9fc7e1aef80693de8612198900021d1,131,109,265092,59786,205306,122,98,232942,56316,176626
30d79d5258993498da754ebb37fb210f,144,114,381735,92022,289713,137,106,322128,91892,230236
f6b3ab0d1eb14283de5c7ba9ccce3ae6,104,65,163580,46149,117431,104,79,181224,52867,128357
2c6f86a70c5176449fe08791389e8caa,89,81,131987,38214,93773,65,51,109642,27494,82148
10c60cfd0b2591fe26fdf105b86419eb,53,44,81889,22350,59539,45,39,51609,28853,22756
c5133d73f483df63172e3fa0675321de,190,127,596927,133824,463103,202,136,577515,158321,419194
30dcd4aa1e5b47cd6f82111545973e41,93,84,167238,55420,111818,88,75,183712,39154,144558
b5d3a3f7dfb080890ff0f25c0fce23d0,154,115,363897,75502,288395,165,133,377119,68634,308485
ad72104fe1a79e160a0f63a44ad77a7d,83,73,131941,48549,83392,72,58,127007,40720,86287
db988788a5592fee7453678489985d2d,117,97,208166,56748,151418,114,65,185196,46324,138872
15c5812b6ed135b46b4bfd26590be727,57,48,96770,27251,69519,75,59,61961,23217,38744
fd5b589f7eebe49c2903c070e63f5ee5,111,80,207798,39712,168086,104,81,171191,53338,117853
98e162b56c9eadc4de5cb5e92be412cc,60,41,68001,19475,48526,66,46,57373,24125,33248
38f6855daeb14711cc769d676676ae19,153,110,343779,55382,288397,137,94,340154,47415,292739
ad6fb9b3cf92d5d73f2a67a8d410903a,89,52,150875,27112,123763,69,41,101400,28927,72473
b4836d1a2a8ec64c37fea9ea4d094a8e,94,72,217045,45635,171410,151,123,358357,43191,315166
3b4794ab4edebfc8d71a88c3db97718d,58,42,74315,23770,50545,69,58,68206,27071,41135
38b444847119605bf5c38745e4a03307,90,78,152718,54209,98509,73,64,139639,43884,95755
7effb9639b18596c45e5f25eec17f63b,42,33,31538,17567,13971,52,38,50617,14619,35998
8cd983b1a417aaacae1e30025c748552,124,107,197242,53461,143781,108,81,174513,41872,132641
1e1e080bc493d3b843c7d09a4777f457,193,131,547465,93758,453707,168,119,573895,95197,478698
de44546d6d6e6865e9d036b5cb2ad66a,124,99,451967,130317,321650,189,150,671017,136714,534303
dad02531f51f1446a3f909231978e332,38,23,27121,9626,17495,39,27,23071,10628,12443
47939eb847fe2ca447d534a4377f5639,55,56,94918,27830,67088,55,36,84964,25362,59602
646d10c340de70512f264c6ab480b7ab,24,24,6186,4204,1982,25,14,11001,2822,8179
eee9c2ee821f337abd4510e1f80a587f,121,82,362248,86457,275791,149,96,367049,80594,286455
b2b80caa9d2e1c5081ef55caf74e03b2,39,34,20295,11142,9153,37,30,26787,10231,16556
2f3f847dfe4270b58b9aae10cad0ab01,91,76,185486,41570,143916,100,69,141948,40101,101847
b6c733f0d698a4df966a0626b3ae74a2,161,93,310712,61805,248907,116,70,234516,74575,159941
4c1882d70a289824027a8254973f3c23,67,58,69271,22206,47065,52,40,53890,18164,35726
014d560b06e81dba2b5253670454cbaa,172,129,651508,129438,522070,158,115,649160,142147,507013
962bfabc01ee5c381ede6331c3a9d6ea,22,21,6834,5138,1696,21,19,10275,3863,6412
9dbb3705dd80f6ab5d9b0d99060f35f4,63,64,120421,37458,82963,76,55,100230,34725,65505
234628378bbdcc3d4976b376d29add1e,132,108,227736,47949,179787,112,84,226183,43213,182970
a15c9dd5af65522f85943f3a9bdc828c,34,24,18729,9795,8934,32,27,23842,9547,14295
72605c9e468af6e4fe7f76a3aea3df61,72,63,139129,65059,74070,130,95,268937,55725,213212
39262699701d233daa2a628648542ee1,139,106,341398,71196,270202,120,81,193422,45352,148070
41ef7cf414211bd0739b3a6b9f6e4853,126,90,270401,56429,213972,72,57,174072,78391,95681
46931d617aa9e9ca9a2ca55779de9aaa,110,84,277131,65720,211411,115,90,277936,68972,208964
de45009e0ca6b793850727a09f207296,75,64,140618,42140,98478,81,64,154360,38281,116079
8313af76c8a35c135b2f7787959dd822,13,15,2063,1421,642,18,14,3271,935,2336
1834d91d61354abde69cc57469aeb9fa,106,65,120449,19550,100899,85,71,109882,36969,72913
2a0326962a06bee3f385c25f5ba32a3b,72,58,98018,37099,60919,63,39,133746,20133,113613
bcc14ce0e0d2515b3a072010838f3254,138,121,414044,105857,308187,151,115,480058,128210,351848
3005b8e0d0a8cbccb2fd5be7b5be9f30,46,38,53469,14157,39312,41,34,34592,9371,25221
01be10563f8da2899b59e9704d5791b1,159,132,477342,152467,324875,165,100,450539,121490,329049
b3d48fcc65c0d5a7b757f0220c841286,128,94,433886,119010,314876,174,132,697332,128409,568923
23d5fdfff519c56bbb899220bd1837b2,101,83,251179,63405,187774,94,79,216449,53201,163248
bef0215b1605bd18032ec19891e67e3b,127,100,398696,56198,342498,170,110,460626,34087,426539
e79b6829937016a60634afadfd7adf5d,181,138,540195,100161,440034,162,138,511945,97163,414782
351af0dca4716edbb7e7e53eadcf4bc4,39,23,24169,9054,15115,31,22,22181,9942,12239
ca74c9f7ff4f1febad9952a8f85a4bd5,95,82,152210,32923,119287,74,49,90319,34045,56274
b292e4508d14a10b2828879bbc65f0e4,61,54,85444,26731,58713,72,54,67110,23178,43932
f27de7098eab8b7b88ffddaaa84243ee,128,113,323541,98588,224953,197,141,560686,77363,483323
b2fdcdcb4478b72242c1fef5320ea119,52,40,49600,15352,34248,51,35,42782,10687,32095
523b47a92a18f5e9beeccf0463c99a28,97,76,167903,46784,121119,100,71,163657,32377,131280
d6d2bb39debe3e2c54e9319c8ee9e7cb,75,54,152674,47798,104876,112,75,223111,43319,179792
e91eb5fb8f8b5479d0490f3b30490c21,135,101,354319,62787,291532,139,121,392908,77306,315602
79d5cfaa43f04d4da890e54d9ba4fb42,6,4,800,605,195,4,6,605,800,-195
2c460971741e83e1252f8a3382401f31,136,104,366544,127947,238597,148,111,504869,105022,399847
fec137ef99d40b2948aacfafc0ebe2fd,44,42,45338,14935,30403,34,28,31617,9803,21814
606065b84db83923a58e2406245d3b0d,31,23,11977,3570,8407,25,22,7149,4728,2421
ae2ea3cc7d1fb96f60ca03e3897c0b11,47,40,46907,15527,31380,46,38,47337,17910,29427
3603e6ded1ae32a8ec78574a314e2f53,80,63,146379,41237,105142,99,83,182635,41507,141128
587405449685efb10c988a0848c5fc1f,146,91,287605,51551,236054,147,115,250602,60926,189676
9cd6ea0f1e8c054bd5d9d7a7d8cefcef,40,34,42246,17873,24373,45,33,46865,17310,29555
45615d6ee095f5bb4b8992bc475e2a07,84,57,92859,23578,69281,59,52,83085,21626,61459
e1d49a51f2310ac06d996abaa1ddfc6d,59,36,56352,14139,42213,50,43,46818,13305,33513
aab0506151349ba1e7db67ecebe743d9,144,115,566899,146876,420023,210,172,840257,121743,718514
bb047e7f01eadcda26766612ebe5d831,64,41,77880,17029,60851,68,51,79892,28320,51572
606ede52086f1030bd7837ec4ddd53f3,154,119,715879,220778,495101,186,157,726400,279276,447124
d5823eb0269744c34da3cc23bb07a242,121,98,374493,113114,261379,136,130,438430,98563,339867
87ae6a1318e13739245235319e354de6,67,57,102478,33677,68801,57,48,84872,28935,55937
075f65f9a6f8a73c3f04c6cd9e33f2fa,60,47,103770,35948,67822,61,50,103783,32509,71274
a2ba4129046c1d399569c6decad8f51e,116,95,284863,52726,232137,111,73,185061,41183,143878
2dbfa381484f7799c5d34f291287b9ff,58,38,90397,18408,71989,68,66,106070,22926,83144
5450430dd7219c87818b22fd7b00622b,98,77,149022,29180,119842,81,67,116367,33208,83159
23c7db2987916ca4c18d7c5abcc3ebf9,197,155,1177755,210374,967381,225,163,1154649,234641,920008
44e51fce5b322d7541f691e8b2c07221,11,10,2183,1473,710,6,7,787,1759,-972
8535b84336fec30c64271a160bbb732c,49,44,44851,18075,26776,48,35,48537,11986,36551
bde362ff4b59f9f6634d59a1f926ca3b,89,67,195677,53325,142352,117,89,275132,54194,220938
9037180b353febd6df8efa5b28317a68,26,18,8261,1690,6571,19,15,4073,2204,1869
089fa89399fa976f8d8ca9ce6137b3a7,132,112,259577,48620,210957,139,110,263673,60877,202796
839069d8076ac36a0a3748b7c455ff3c,100,68,207435,33113,174322,85,68,142015,50608,91407
7c73593eea3e58a9b34b9c567919e76b,139,104,281281,72023,209258,138,111,318199,52599,265600
0eb7877142bc042bb2bc6098a216184e,111,85,208785,58556,150229,88,73,183337,53679,129658
81af055ad6cff168f2259144459c5712,135,110,393863,91901,301962,143,108,376152,84082,292070
4df7c54011b778def4e5eea2cdcd2e23,129,98,282676,65365,217311,154,108,318420,70279,248141
77e14c711ca18f84b13c3e93f08a0db9,96,74,139301,35876,103425,97,86,181097,39617,141480
c638732d1721124a6c182425b9f50d8c,60,53,104320,31954,72366,64,52,40812,28353,12459
0437d2536a3e8e2d7f6f343e46edd948,32,22,11995,6997,4998,30,28,19086,6162,12924
d2c514239a1a5db4c379fb6ac37eeb3b,80,67,133120,63453,69667,99,86,224616,50000,174616
509f66dc9539f439e7f9447f8d0d2a45,77,66,107094,26506,80588,101,93,145603,35105,110498
4f0cdc64a9197018f920b1cb2cd5de52,65,46,92301,22790,69511,59,44,74917,29895,45022
64af95e7f7c04c9e0304a71b7449d7dd,40,30,46297,15336,30961,46,35,54637,17909,36728
5edbd83b46bb4f7bf031639bd85fbeb8,117,92,233703,52486,181217,103,75,229981,52028,177953
6ca22483009f8de5c7c1d7cbaa31d686,71,54,145729,39253,106476,73,51,185876,41918,143958
6225a44bef8a43cf10418aaacadeb500,123,99,221088,43940,177148,156,107,269773,45287,224486
8c5e37861b063459c381f4771417e0a3,143,102,372429,95301,277128,142,106,400154,75808,324346
3db9c693c41d3859f7b0e9e29850728b,91,87,159221,66477,92744,107,80,181289,58968,122321
308757005ce57efce7c8078ce15a8451,122,87,215096,46222,168874,153,112,312114,41635,270479
a92e8208f6cdbf5cce30c3fcdbddd71b,148,115,683442,130291,553151,145,118,646734,122165,524569
258e151f94fd9a02f674a7fb777e9dc4,2,6,107,121,-14,5,2,838,107,731
c20bcbf428b40b1c3d481ce3547c5a2c,145,118,468975,155968,313007,172,128,661154,109119,552035
57122d53e60b6a6b6ef7549cbb7d2245,123,100,275943,50001,225942,115,100,251107,62319,188788
faae80ed5d27dc47236b813796882f24,95,81,148575,58202,90373,108,78,209487,36743,172744
780e89dcfd6b67da5127852050cf0fe0,45,36,62892,41178,21714,49,39,92665,24513,68152
34499bbe6774c6ddd5196767e2357ca1,21,17,12316,6154,6162,27,18,16202,5729,10473
3da9fe3937ff33e6e7d1f45081a4dc8c,142,111,450319,110406,339913,188,153,427677,92740,334937
1feed895dc720e14bf1243fb9af478dc,31,24,19323,6159,13164,25,18,13165,4017,9148
10d975fd333fad119ddc572c41f93a11,39,33,34580,12258,22322,45,31,32134,11976,20158
3e5116a065b0923b3e6c300dfb5b4fce,96,70,154126,35583,118543,101,69,142122,40971,101151
aeb4074f0fd98997b15cec61568a7844,74,67,139733,45676,94057,67,56,123565,31270,92295
74e5bdf486a1cec138c250e1e6f8f829,126,95,367050,67374,299676,171,108,371895,77078,294817
d2a688ed5276bfeddcaea2473cdfa1a9,17,16,5033,1807,3226,19,8,6126,1571,4555
cedb0d7e160c47447409c2a6452e537c,102,74,258608,65077,193531,120,94,282592,83779,198813
c33bc1d522a91ed6bdeaa9aa68bb9053,88,63,171590,39882,131708,85,58,147808,48201,99607
5333dfd9d8d19ca4f3328ca26bda7887,24,22,10032,3560,6472,26,19,6550,3312,3238
d5dbcc27e9cc5fdebb26ee7bf71eb6df,115,93,255052,60464,194588,99,83,147167,58669,88498
7659b3564740f6b91754a76f3e0bbc5c,46,32,48836,12276,36560,42,35,20736,10732,10004
b0355750a384567eecdb409711e37240,17,16,3293,1883,1410,23,13,4533,1089,3444
f45b12cd41854e9b34e7666e78f9be5d,63,54,79617,38615,41002,72,58,94091,41458,52633
ed862513607f4db974c5209559760bd7,64,55,112376,26815,85561,72,58,97651,23381,74270
2dc8e4dc5f4c505d9f632c34b6e72334,53,46,91119,22263,68856,65,55,95522,28239,67283
c4c0a1b6367847a85c09dd514dad2311,51,35,50320,17157,33163,55,47,47463,16615,30848
765a387a02844c9d61b8d0f3a5f650de,129,115,409441,103543,305898,134,107,381722,91878,289844
3038e0fe6bb4a7e1a98e468d23bbaac6,149,104,461878,64948,396930,89,65,175091,79648,95443
581cf8a3d194e8860535c0a9fb82fec6,157,97,768444,187043,581401,249,179,918963,262138,656825
914db1d50fa956dbf0dad341da382ddd,112,66,181024,51221,129803,144,98,227834,52631,175203
ec3d30399bef8765a3f41da0f5470d0d,200,152,640588,103373,537215,191,137,622311,101995,520316
ab0aa811e33bc019d94de1095c6fae00,205,157,836713,105186,731527,197,152,771034,129681,641353
f06a728e14fff02a0947943fb81b5b7e,96,92,224615,94932,129683,154,101,369816,83749,286067
32333891cf41d3f454af24a6051141a3,93,70,154218,34166,120052,69,58,100259,37622,62637
0fd85c88513fe380bc2a20555d0484b3,76,55,125180,30282,94898,84,67,132565,40870,91695
55b7d5f0d7462546c6c273ea9d9b32db,58,45,74449,22070,52379,71,58,80531,18834,61697
6221df83801e98da7112ebde10b0d1ed,163,110,649278,88614,560664,147,112,542276,80784,461492
b3be4a2c15dad14290d46571dfd618f3,115,87,209434,34431,175003,139,117,261756,50700,211056
d569432ea087300996bf04d7f9ead732,23,15,5546,2167,3379,22,18,5623,2638,2985
4cff4240b6b8f7bb9ce24df18a2297ef,201,139,913114,126745,786369,228,160,670129,97998,572131
596d8f2f98575602c1b414e3ac67d939,97,80,151300,58445,92855,72,56,200175,43746,156429
e3b6db185302411f2b329ca21bf45d2a,40,25,40510,17438,23072,39,31,57550,18396,39154
7fb727a6514336ba2ca5bfa2a7932396,97,79,183205,66533,116672,94,80,190156,45714,144442
6cfad36edbeaf7d655f77e43f4b58d67,187,142,1321421,203315,1118106,261,173,905977,179103,726874
d2af945472e411243cabc9386e250d0c,76,56,85055,36371,48684,73,55,111077,35325,75752
b730d6c80cb14c6cb9624e332716127b,21,17,5699,2228,3471,20,15,4363,2310,2053
c32607da0f5ee7c15b651a7182195114,39,26,38614,10586,28028,48,37,50648,14888,35760
5e2d9a544f76e745b1219934e8964b32,102,66,124729,31700,93029,109,64,141542,19564,121978
8fe8e90cd0b00c0fef32eec48363d9a6,165,130,747665,188078,559587,149,112,713587,226221,487366
5aa61f6daf53e2fc47be2e016e99f1c3,138,101,291609,75620,215989,113,97,321519,87595,233924
b99750bf6e4d603d5e7e535808ea63c3,95,70,173435,58349,115086,118,94,211554,61478,150076
7c85fb604b422fe89837f91badc46b40,14,14,3137,1464,1673,15,8,2681,1979,702
1e22a8d90ddb3aeff1efecf539c09d7e,113,88,246471,62008,184463,107,91,195831,42380,153451
c222413fb2d2cb655133abb94da09f13,106,79,243645,47796,195849,95,72,226102,44933,181169
3e4555863f786024d74677ceaa0a9688,26,15,8995,2015,6980,16,14,5832,2261,3571
b07f29d2ca8a84e027dd19daaf35d31f,104,70,202488,44039,158449,88,76,173170,38001,135169
bc7a6939419b19d11be5e15158ed6377,55,45,69596,25134,44462,60,53,82645,24043,58602
6a269dde45d9c4503d53115562d22347,115,80,327071,49499,277572,94,57,229526,46353,183173
c1dea7b941fd44809baaa164c58b5dc7,108,79,221098,74594,146504,168,121,488457,82766,405691
f7a2a42713456ba414818a1575d2a3d7,78,63,119863,32079,87784,105,82,147162,24390,122772
3df63607316a1464bc89845079721b8c,90,72,135219,31822,103397,110,84,198714,29663,169051
4d1f6cb29eb75df223a18281871702df,105,85,241217,53469,187748,117,80,215233,50114,165119
f153b58dc5e90edc1b7de8c4dba7d6e7,213,133,1026575,134661,891914,176,118,877148,154472,722676
65172ece1fa08dd7d880bb4e0969ed8c,29,27,37466,17254,20212,30,24,31379,12770,18609
c8fada8a20fdc0c925b085af3325a07c,35,24,34017,8969,25048,51,32,50525,13236,37289
b9ef6126d7a10cc18de9d23591f61a18,222,128,1066768,144121,922647,245,163,961047,169718,791329
7aacb1ec761cd1477e4d74fa1a4729d8,147,113,463267,127752,335515,166,115,489425,109362,380063
2c780cb3f95c8ca13e4b0216b7bfd2c3,22,21,8050,5826,2224,31,20,16830,5172,11658
6f7986d56ba8d6180077e86b9b18dba5,40,32,30129,11393,18736,54,44,64792,17547,47245
098b933dbd92ac5446f0d308e07d93fc,145,101,514355,144304,370051,150,124,572144,105797,466347
44363b5b52d072e816c712a303ccf78d,41,30,37957,9802,28155,42,28,26842,10350,16492
795e5e65811b95ebe5327019614ecb84,23,17,7873,3782,4091,22,20,8925,3420,5505
a5797d8a795a744220fe637e64a4a1d0,151,114,367909,62304,305605,140,84,315019,37443,277576
661aceef844ad3a8effb82f887ef9026,130,100,246751,40087,206664,100,75,131527,63354,68173
316c2e932cb4cc9915778e5b85c3023d,31,21,24383,8841,15542,36,29,39080,12982,26098
ed904f7fded37cdc9972551da65dd461,26,20,7708,3260,4448,28,16,12322,2895,9427
5c800fe360217cef936f6aa88e4c2423,109,78,237506,44946,192560,159,104,338865,49975,288890
3f15154bcd2b998eca74319cdbe9e39c,163,132,483785,112484,371301,150,131,452804,128213,324591
a94d1f8de1462f3c40c2f5d0fea81e6e,54,43,45048,24710,20338,68,60,88666,22885,65781
0cef2ff7b8961790b0723c8c8012c1ab,24,19,12217,6139,6078,19,18,12062,4687,7375
90b94769959f40ce1b54718752e02a2c,74,58,156590,26878,129712,86,63,171923,31545,140378
e2cfd654374b586d42fffebe9e4a3144,62,55,90647,30744,59903,71,50,89070,31122,57948
d17bba9dd505bea2000c67ccbd7bb4aa,48,36,50835,14033,36802,59,51,57449,21979,35470
51677538fcdad8c78e7d96df0391845b,30,24,14824,7199,7625,26,23,15268,6772,8496
209b8abe153f1a6efe3c1dda8b324905,22,18,3776,1901,1875,20,18,3317,2538,779
cabab108fa523d42925e56ad2b119fd9,51,43,87782,16199,71583,63,51,98334,34190,64144
c753cdfce672519e30b0988da24c1f16,134,98,368888,93467,275421,116,94,271227,70213,201014
2796a1d8faea9f1c762e642490616524,142,106,341886,87849,254037,170,139,423823,75896,347927
09ea345f55897893db8eb160bc3dea55,142,122,242941,51011,191930,80,61,125588,44606,80982
89b9b6c094eee62bb38336b9a56dff92,29,21,19143,7638,11505,33,26,18885,7004,11881
99099fa0c919b99e911589cc78eb00ec,64,52,100330,33464,66866,95,73,154063,30049,124014
437cc523e3b35d8550fb0e69028fce8e,24,22,9351,4497,4854,28,21,12115,2990,9125
ffc8b08b81f56d41d63863dd6af5c095,152,124,558333,136182,422151,162,137,614268,124313,489955
d9dc64bcbd8a1ed39182f6881f96701d,112,75,191553,32703,158850,92,78,152166,44185,107981
7101c4ff8faf3b57f2ea6962b59eeca4,83,65,117228,37679,79549,123,81,256300,28265,228035
31509d770194500911e3bd8ba9b4e438,73,68,96383,30469,65914,59,44,83856,19980,63876
824a63e94df7ea4af1e9acfd1b6b7244,101,81,205094,58853,146241,114,86,291782,42550,249232
afbacb68150d24c40068697a2d7a54c4,22,20,9852,4045,5807,28,17,8331,2748,5583
29dbb4dcb6709bbcb51244df4197bbf9,74,53,112215,26094,86121,87,70,135500,34734,100766
a8be54e2977c8c69d0c4216dc7fa0440,31,23,18095,11171,6924,32,26,21874,8970,12904
af3fdd06a83b521b59b175c81a72dc72,43,39,52465,18813,33652,53,42,55549,19639,35910
611a095e82a28008fb3d915b22632883,57,43,67152,12903,54249,57,48,64591,15297,49294
2835bc978254d579e8fc06cecc3f0b40,51,43,31273,11448,19825,32,29,18114,6730,11384
240a597077152d626e6aa85a11cc4ede,120,81,239118,86646,152472,154,98,432644,67018,365626
176e268e47f756828108b42dcba9d339,76,51,102465,24753,77712,56,47,104238,26276,77962
2da42ee1e0fb164bcf00cb2e409c1d5e,148,118,391014,63502,327512,129,118,359773,77640,282133
e61bb16c1aaa3e65495ca46192630032,34,26,35637,10408,25229,38,30,28967,17178,11789
962e3dcdb42f4f42cd8bc0fa515c4116,43,36,39159,14628,24531,38,32,46106,12321,33785
85788495f487e3bfe0f5e26cadf0f199,136,102,327473,81903,245570,138,110,359196,93454,265742
e98fb31cc59d3c904787c190516fbbd4,48,49,58813,17795,41018,56,40,62324,21302,41022
9fd9a604b0a6c196fb78014c8285c552,46,42,67384,26167,41217,65,47,68801,21578,47223
ac06fd572554d9753fc5b2ae475b44cd,134,96,363366,132982,230384,129,109,353775,109988,243787
61ead6f6286068b666349fe26fd5672a,100,80,196980,52671,144309,125,115,299573,53512,246061
60bd6a5238cfe032c50eceb872b73221,24,20,8976,2718,6258,26,17,9016,2833,6183
2a0f9f99fc6235797e6d21aa01d4b384,58,47,58138,25860,32278,69,45,70891,17388,53503
c9c539bf1c2952a32444378a5eaf9e51,117,88,325079,68055,257024,106,88,264441,67243,197198
6a11a67bb621e66f6e2517ff32c2f83a,106,90,212902,41387,171515,86,79,179535,52700,126835
1cfc9281b5680dd51d97b4086771104e,33,27,36760,14479,22281,41,36,52141,13458,38683
90b9a44e888e14c1d20e06b8df31bc3d,30,28,21582,8574,13008,33,34,21208,9121,12087
2f6d85679624eeb9ee4309bc461fd7d4,161,132,394648,70254,324394,174,117,314375,52944,261431
be019ecf85206b34c6918127e2180e27,20,17,8108,2713,5395,19,20,4148,3683,465
fd1f135ca26564336cef659c2de18d03,196,136,630251,187596,442655,190,144,717390,122422,594968
d4efe5ed7479b613ebe38bb6500f319a,150,104,319014,98700,220314,152,127,424319,88054,336265
a904c78b6d00d8df26f3d63b0f1ec028,108,88,233261,62879,170382,142,113,267859,59786,208073
77182b66b2decb0fdfdbc07e58df786a,83,66,135895,38261,97634,121,107,191243,49640,141603
6fe46fe80b28dafde10d22e425be6b79,148,107,428142,52668,375474,132,109,389629,75471,314158
be7fcb170e282b5ab3b3cff736d87e83,84,53,99324,14429,84895,55,49,68059,17209,50850
885cc66a74c2aae3a1aacb27e74b1874,78,68,109596,28806,80790,61,49,85298,19977,65321
4d621203dd6fc75e456d3247a9139184,222,182,1253921,202139,1051782,198,156,1016714,223472,793242
e25beccc7ae6bec1bcc4c997a6cee912,56,46,84370,24449,59921,81,66,139515,25771,113744
3477103f1df654ef213e9e5a2860dc38,76,63,134687,60713,73974,76,52,159332,52535,106797
7950cdc7905b913ddcc9115b8a7ead55,51,45,68802,19042,49760,54,47,66877,20601,46276
d599b9e1efe08c9a2ed3602a90c58a48,49,48,54312,21460,32852,61,48,92151,18521,73630
8b424972905d05c7d61e385b646dd23a,56,44,57760,16098,41662,43,37,64498,10016,54482
5d41ed4751ac4e9a51bc3eee72ba8409,34,26,29493,12774,16719,35,30,31489,9115,22374
69a62d8144f6f49a2b365c97a359e463,39,34,43350,14065,29285,35,22,37122,9938,27184
7a71d646ecc42c24c859e9731f3d7525,10,8,1202,475,727,13,5,1184,234,950
6ba33e021fc03bb08202f536c835d9e4,110,84,254963,76213,178750,125,103,259012,77634,181378
ec16dc6ff708ed4070c0e6e7dc45743f,17,13,2444,912,1532,21,9,3507,741,2766
fb3ae4e52964c850c49366975c4bb842,67,53,92160,20869,71291,74,55,82282,24638,57644
9aea8037fcc123508d60bdfd67f59eb6,125,109,318350,77430,240920,80,67,188744,93276,95468
d1c1d4667f13313643a0684c2ac08a2d,47,33,55140,22054,33086,42,40,57852,19307,38545
cc41cf3e32a1f0423eb449dcf10899c4,176,121,425374,50121,375253,169,120,363553,68763,294790
6d222d23d0df58461c09bfdde50cbe51,61,42,86603,22259,64344,79,66,112259,19911,92348
938aaf5552ddea9c3589a3d44cc3abdd,46,36,52682,9930,42752,50,34,30528,16530,13998
43a81c60aad9222ef325cdd2e9582afd,103,78,210300,49525,160775,106,91,201636,56986,144650
59df6f2798335207c81d57e1b135d184,29,20,13291,6177,7114,30,27,13077,6922,6155
6944292a25680c2f8f58f64a6aafd37b,28,26,30975,10160,20815,35,25,31343,14560,16783
79573c7f4a08c9556dfd634621598f3a,27,14,11090,3504,7586,26,22,10150,5228,4922
4782a38022b8b9e9b47ba8f89c198604,29,23,22650,8700,13950,39,34,31816,9236,22580
13d529fefe8df08aeefcf35b24208633,41,30,28748,14711,14037,40,34,36396,17195,19201
39961dfed5251379d962c44ec2fdae26,185,111,586380,204883,381497,178,93,701130,205784,495346
31699928476470b644e518b836961d76,128,86,278017,61300,216717,86,68,144498,70607,73891
6cc0e107d3619504c7c4d47a72844ad1,109,73,216746,59635,157111,122,88,232206,61785,170421
a3961dd9a67aa2776ba889fc6096ddd9,28,16,10915,3056,7859,23,18,9597,4068,5529
a667a5f0c3be66ee22e52ac08b8a408d,36,24,33364,7069,26295,38,29,32044,7840,24204
e81811a6d89211d8bf6a6d73f523bdb6,108,72,180101,66681,113420,116,106,231192,44890,186302
7729347f054f657ccceed7cc8bf0fb18,37,34,26017,10630,15387,29,26,17368,11212,6156
2a57233873bff81d814939b8117f1043,109,84,193390,31537,161853,80,64,102356,30121,72235
1584e7549bf9dc2bcf09000058fa2a29,22,18,9795,3486,6309,21,15,6466,4136,2330
15a922e012b3f9b6d9953da8884df1a3,31,28,20031,8571,11460,33,25,25250,7059,18191
e6f853dc19e73df23282f800f5052042,138,101,375529,42348,333181,94,81,247369,85307,162062
690218734f358a45ea0723fb6309abc4,32,31,24034,10749,13285,35,24,29188,6536,22652
c8888649d20768f7f7decedba6daf1d2,29,25,13824,9009,4815,36,29,19427,9274,10153
24a48443fc8572124db1f2f0e4e26882,45,49,37894,14866,23028,39,27,29122,12960,16162
6c9900b74f5cd3e811072b126e579240,93,65,201393,57838,143555,109,88,241574,67148,174426
39467ae014a96677d0566590aee24ffa,66,49,108014,47707,60307,70,64,150447,50265,100182
b37d9950e8f13199bc1ca8939ade72ed,220,172,824207,103853,720354,170,120,590920,105789,485131
62d7786178e63581740fc065cc556df4,185,136,730998,236298,494700,181,135,730254,114120,616134
ae5effdf72cef4eeee9c66e1961175b7,22,17,6814,3808,3006,24,21,8305,4307,3998
830d4030c8905250a57f634dad70a30b,77,57,135649,50472,85177,121,98,270838,61213,209625
3963593d03bb35a4f2010598bb7c3dc1,67,50,70631,16327,54304,55,39,43928,18631,25297
5edc36051c772220b9627c62d71117c8,57,44,85607,25690,59917,70,53,90273,26673,63600
b46e12caf2e0d8a2631581da41fd3cfd,81,62,198927,60494,138433,131,114,345410,77706,267704
5242fc243ebb56954f1e47fceb543fc8,36,28,41535,14718,26817,38,32,40771,17933,22838
6f2e5048ab3d4415039903b5eea70e28,27,26,17310,10596,6714,53,42,49596,11087,38509
8af0323b9d03b5985a5c5d1e9d46c241,49,39,56258,25726,30532,83,69,128037,23847,104190
3349e8b8bcabe8a292e997e3905d36a1,120,82,207104,67467,139637,93,79,179089,75215,103874
9f7ec2f9d11220ab9473e741f0c6b072,88,68,150874,35138,115736,73,59,140945,38005,102940
ae818f6dc33034c3274c59110d6e1663,106,75,177894,37338,140556,66,50,88322,27705,60617
81a5e1837a1975dd3af5a60fc027a027,136,86,356149,64367,291782,143,124,300620,80477,220143
639d00388e3d5280b8084fc6922531d6,84,56,153652,47008,106644,87,70,126169,41139,85030
c2c42944203ff05704a77d1464d9c184,91,51,151623,47915,103708,58,48,119476,61708,57768
0c7bbdcce0ef5e17d4b9f8521c1adb71,33,28,20912,6132,14780,34,27,18332,8382,9950
fb46b367ae62ece21a1dd8c245182f78,120,91,227699,42838,184861,129,107,260877,48964,211913
f680cee6323a2c8fa7e073e133e13a82,94,70,151883,37682,114201,75,68,122633,43317,79316
2bfba40fec44463add722e0a5aed02d2,46,39,74235,20923,53312,70,44,87126,25918,61208
094886f90c39e3c52de3a8d0afb17364,95,75,235630,74668,160962,134,95,305742,48622,257120
81eac506289de8e24e26597536d1a849,215,147,903845,158384,745461,207,152,832219,168416,663803
fa7419aa44ac1486e122c2c36e396d0f,72,50,76250,17385,58865,53,42,45019,19111,25908
a623bfb82e6672294cc4df05688e1f22,119,87,306721,77875,228846,161,118,471511,94262,377249
61a2379d4bf1f03b849a99a1ea39b67e,53,45,86633,20734,65899,63,45,70696,22684,48012
89149c2655058e4a003ad170d7495b39,55,44,73169,16463,56706,48,31,58362,16610,41752
e9cba28b010b554eaafeb704e954409d,190,113,596243,77879,518364,216,151,859948,100740,759208
22090d923767677979d7abd1e73fcdcb,146,108,485164,105324,379840,128,98,345125,100240,244885
9aad96895ed7ddd1f766c01bd632858f,72,58,149261,80150,69111,135,104,310329,55480,254849
09816f5bb5eb114b176045d3c8ae2fee,126,103,226009,41702,184307,98,73,175580,52279,123301
ae93d38fbcc56928a77db930059cc5b4,149,132,882303,221245,661058,216,152,844046,174042,670004
a56ba005813f547ded576aabfcf495af,7,4,2400,519,1881,2,5,384,470,-86
3deb30786d9eb700f110476acb3ac6df,17,13,3848,1440,2408,19,18,3646,2242,1404
fbb5859c9e1b3362b3b4ea4de349a85c,146,109,335901,65536,270365,148,100,328743,80259,248484
86e533b46d14fc75a6f99e343d711448,46,37,61687,17456,44231,39,33,36707,20971,15736
917951c8b56511efac042ecfb2c9db73,192,133,511660,70403,441257,176,124,367576,67490,300086
f95de1f199d0b90eb47badd8ca758f3d,150,117,370979,54780,316199,106,93,295264,49514,245750
ef2a76066cadf9c3ebb203fcfa6ba25e,31,22,14897,3376,11521,26,19,8212,5577,2635
0e22d1e4707053547f01a953dfb6c025,41,33,36995,11272,25723,45,42,28577,13694,14883
4d2988c1cbfa0969b91d3dbb7e4cb6e4,206,157,1072415,182499,889916,177,138,759225,215652,543573
9e6e9cc8c4fb9d277bae9400f685b4b0,86,67,198844,86268,112576,132,84,224253,101143,123110
49667435640c26bab8bf16c5d9b33793,142,116,344382,51631,292751,109,95,213862,83609,130253
7b3acce752b6f5a7f2cad8d528a2ef8a,93,62,148995,31887,117108,115,89,201299,39617,161682
2e4757f49078b20e1fc3096d8f99e374,98,75,213021,71210,141811,153,102,305969,64650,241319
dc2554536388274a109e10b014966740,202,157,721098,124394,596704,197,150,733300,162228,571072
222377cc76b4af1067415aeb5936065b,3,2,299,78,221,1,3,52,209,-157
0df7e860409c5907e89f43352229f0e3,172,132,384514,80240,304274,146,111,459845,72866,386979
c3868e0a55b2509c54f679f97fb185b8,83,56,111882,18656,93226,94,77,156661,23837,132824
b51d61a72b1f5b3e5e2dc4d0c500903a,147,112,386448,64263,322185,132,107,312731,68256,244475
ad14096a57beeb7f03f8fb4723bac67b,64,55,85477,20626,64851,70,61,85614,29250,56364
7a9b441dada78383377dac7cdb884684,60,57,62798,18302,44496,46,34,43628,13155,30473
802b96c9f1fa1e421c593499bbacadc0,85,77,146944,51780,95164,114,86,234427,41301,193126
5226a2c0861c045791c70945952845b0,50,32,57148,13257,43891,54,43,58664,25022,33642
25a60ef95ef52d92bef3ecc6a03887ef,29,20,18875,6516,12359,29,23,25349,5787,19562
ab5f19a151e2297e7efa6ccd89b3f280,154,124,496623,131948,364675,151,109,450296,121677,328619
bd2b4f4ea4ce5c5f5e5c647036908f0a,150,127,456831,54359,402472,117,102,319218,93027,226191
e1c460b3f8d8b72432e2cfed63dd51d2,27,18,9923,3231,6692,18,17,7261,3214,4047
c74c93712c14c46cefd225349f2adfef,108,81,177075,45265,131810,93,59,113798,36339,77459
6f87cb5151f43794cbcb974bc0ba872a,15,12,3161,1238,1923,11,9,2925,1366,1559
2bed01f61adefc84a072badcedb3f7ed,92,55,204633,48293,156340,120,79,209740,61232,148508
52cbdc0673d123c81fb7805018238fa1,107,76,195122,28271,166851,76,68,112019,49956,62063
e03304fa3b2d0a324736ba1afab1b3f5,80,63,104053,50113,53940,84,72,166887,45954,120933
50e14669f2b70872bc8c0f18aa2349c6,118,95,263753,78438,185315,142,112,371119,79858,291261
7d44d165aae92aba270a7bf7884bd7d6,55,37,57840,12854,44986,46,35,53954,16166,37788
a6cc4cb0a328618977f92ae7e0c63109,101,79,147939,48500,99439,136,105,273451,52061,221390
fc55302f092897340ccb878831a12636,64,53,94798,29694,65104,79,73,109432,42069,67363
5b99e28e89fa0723e3313dc4f576537d,151,101,377084,64006,313078,138,104,364309,82154,282155
d66ff7dc6b49fbd06e71d00a4e63c1e0,35,26,40246,16669,23577,40,26,37007,16340,20667
c1be22f5c0cf16d24dfe6cb666d6cfd6,39,27,23401,6176,17225,34,30,22014,9153,12861
bcccb5aff4dfb4ac0158bc3d76f81f17,115,72,239942,55338,184604,107,67,208702,45675,163027
243dfde1d25f2e0ef1858200f81e61e9,37,24,30495,9961,20534,42,33,37018,11634,25384
771bf2e38d0746cc516f19a0261d13c4,171,147,626667,111831,514836,160,130,563955,107696,456259
a7916de9c81f24be1f5314dc56e9ca37,81,50,146907,21748,125159,78,64,132184,32780,99404
6ada6cba088992fa22d429943d99b08a,19,12,7521,3386,4135,17,14,6383,3052,3331
29137182f0a04389ea5ea1555550fecd,35,22,15219,4858,10361,21,22,9255,6333,2922
7b2bd0ecdeb963f2e1a680f793a830dd,128,85,264145,47777,216368,87,62,144518,71036,73482
fda47f504388e4be63a6ca623085bd4d,151,100,489590,83900,405690,200,140,558991,112602,446389
c646501977082fb0ee015cbfa5490d84,99,79,127777,45568,82209,111,93,150069,43608,106461
4d4617c1068699f092a9af9bd3061e5a,128,92,285842,80918,204924,167,111,297113,73519,223594
d403cb136bfe12b60c2a4356d44cb11a,171,118,497390,107462,389928,151,109,450134,156441,293693
0fa6fcffaf2e46683f72aa11b01119fa,41,38,53229,14664,38565,47,36,42399,15248,27151
1ca1255a6a11076f17f21e3fb6044c70,171,115,385417,55940,329477,189,159,521473,55550,465923
8b8902758d79aeaac79092188676e8e6,199,157,536552,96305,440247,154,127,489025,113036,375989
b700444d456d62bfc6ca3faf06a1c3d1,130,90,351512,87458,264054,152,124,473627,57797,415830
4c69bb00fd6b992424dbbf0ccafec339,25,28,18830,7000,11830,33,27,27269,8337,18932
852b16ca1d49598ae972a0b93a7b6c5b,49,35,80918,22885,58033,48,36,60582,22958,37624
59db8e56d46c2ad6188f1c457943f0c9,184,87,420836,60122,360714,115,103,283379,90218,193161
f2a88816bab7b8743f2a7b75aff41128,92,62,133225,32103,101122,89,56,134807,29777,105030
e7ef19da7f97d1677c0f5bda3f3f2eff,167,128,468456,155640,312816,148,102,336526,73001,263525
c8905daa30b81b1a78f4c867c9b4c67e,137,96,289732,49065,240667,116,104,199997,71878,128119
c4322ba0dfee44f12f86b96397a91b8d,76,53,113656,25345,88311,88,49,91813,31581,60232
73566cf08d0e34667739fad8c8c57c5b,154,145,411677,88591,323086,106,82,256724,86740,169984
df3e24df40ce595e51b3bad273ca1721,33,26,24318,7927,16391,30,24,17259,8589,8670
83e6fad1a1554d3c82ba353d1dfe0e7e,184,130,712855,96177,616678,192,139,685441,97891,587550
89ade3adcd2030c000fc7548fbfac55f,34,24,41236,11289,29947,40,22,45691,13574,32117
44b80e875761f5408f9731a63c12e4b8,142,101,331328,105733,225595,122,92,347619,82138,265481
ee20d8919aaa992863848de2e1821d4a,79,61,127567,42196,85371,53,43,76849,34262,42587
807884fa8b5ecd4aaccd6e82934d1df4,76,70,82883,29429,53454,86,75,170765,32181,138584
5688e647242c079c28119d915fbd6123,67,47,97727,26631,71096,67,57,78792,32188,46604
f8f683b216e9289878054d1d4a869c66,69,43,120508,35919,84589,72,49,93915,41679,52236
cedf5ca7e35656395d2f2c50da7e6f4e,30,18,17686,3175,14511,24,30,20111,5444,14667
5f37e2ff0322ee4ef8e8d70c36e382a8,7,4,1364,829,535,4,7,829,1364,-535
47d29515d299c034a8b08e7bbb82bf8e,98,79,155494,23163,132331,76,62,79412,26099,53313
14fcd52f3fa4a4b4670dd142d65e4883,69,54,65501,26088,39413,75,57,103178,22479,80699
dfff4b88bac04d6126f0be8f49d4a7fa,71,54,170848,36746,134102,91,74,194334,53720,140614
820ba664a3b4ba2d09183398ccca7103,101,84,263162,60173,202989,138,91,212078,51836,160242
17787d02b828d3a79bb9c38b2a815e62,29,18,16746,5888,10858,29,25,15999,6421,9578
a7330f5c60f392ed8c39bccb9bf715b6,20,23,4251,4406,-155,23,17,5079,2659,2420
6e608d1b84b350d82648ad3d99e58498,52,32,52728,14115,38613,46,31,44310,18845,25465
e1cd2ff31fb897c0e76c2c91fa81ed0a,35,28,38569,15197,23372,31,29,25780,13781,11999
4f8294789140e0c9e4b873138ea103d8,136,99,320254,55949,264305,118,104,230810,83042,147768
90e0539ffa9c046869c7f1527535d961,94,76,155719,38603,117116,107,91,129807,40334,89473
185a5e22f1673c2ea5f309c193512a28,57,54,66581,21580,45001,69,42,77075,22705,54370
e031c062873d12e12440e918844b2af1,59,44,56971,23190,33781,94,62,113370,30308,83062
382949a1f1ef317dbf01be106424ec2c,126,78,292527,40155,252372,127,98,295062,39899,255163
b28e9515640f55dbeb5865c60a9842e6,168,135,511225,87163,424062,134,102,384135,103685,280450
376b1d861e76fea6c1216c4828866f2a,26,21,24505,7972,16533,32,26,25000,11686,13314
ccccffe0da31c8281a85b56a70b904a5,27,18,8225,3547,4678,27,22,8945,3005,5940
6ebbb4824729f18877b15a619db49dc9,19,16,9315,2676,6639,14,14,5322,3422,1900
042fd977ef669f79c57ca9c9cbd9f013,106,65,472627,68924,403703,203,120,494197,71367,422830
789e3a0277dfdbd75cf8796c05aa494e,163,124,497416,77978,419438,176,161,479205,103600,375605
e5f0d3348073cb4d22eec115f9ef9818,19,15,7573,2038,5535,24,19,7865,3562,4303
eae377315f1a7c4e48038e2a3f6c9e93,38,29,28599,7115,21484,42,26,29925,10939,18986
59527bb94fad9bf0dc80aabb2aaa3753,74,61,100362,24422,75940,77,62,102855,35467,67388
19c16a9f1a24deef12779dafac0b3fdf,171,130,815271,111254,704017,163,124,659535,118531,541004
5377052caa5fe4f1d2d558d195aef667,60,49,107711,22075,85636,64,47,80981,24830,56151
7249aaea35ca455d7fa32908b6ed8879,25,15,10774,5861,4913,23,18,16135,3948,12187
a6cb273523e59e8c47d9a70f6ccfc90f,83,58,146045,39443,106602,50,44,82240,50211,32029
851ad1187b4f76303bdc407dea6f0af7,74,46,87160,23723,63437,69,51,91282,25115,66167
62f1c4da9ea77772ca6426c4452eb924,22,18,7583,2608,4975,27,19,5907,2751,3156
13471cac7989c74ad7c56ac33d4602b3,46,37,70477,17497,52980,69,43,66265,17724,48541
203c9b52ffd780ad7f99c5d0e253e738,102,82,131269,40563,90706,80,56,109377,29651,79726
7be11c6fb6e9c3907840053f46309100,133,95,414580,63614,350966,182,147,573192,112490,460702
1b9072805be5615ee383d42a6c622c72,153,116,604546,146381,458165,178,145,646956,173402,473554
8d483df64e151ef79dd8972d90bfb4a0,48,36,79499,44009,35490,71,60,140366,27224,113142
4fe30acc893d4d6474e71a3d43d2b13d,23,18,12714,5898,6816,25,28,8882,7871,1011
f725cd89a7a4ba8a988c7a2f37b40513,54,50,62271,23397,38874,56,34,46927,16382,30545
443f0dfee15ce06d132e736d564dddb2,56,50,78299,21780,56519,52,35,52712,20077,32635
cdb7217832862162f55ce6cca0d289b5,50,44,42108,21080,21028,52,44,56345,16661,39684
6b6fb47d843d51b44317191c1f715c91,59,50,54869,24729,30140,53,49,47878,18778,29100
2354bfa6f32a065f8ce5bae127935c38,104,88,214934,39379,175555,110,92,185640,51114,134526
8dc781d9438d63c1772baa6fe4e65b09,33,28,33098,10506,22592,32,22,27650,9355,18295
a42081fb23a39e2b736369ec4b37d72d,46,30,40001,15860,24141,55,54,81292,22665,58627
c533962dc75a98afa9853d97747312b8,98,81,396107,102123,293984,139,87,304956,75900,229056
c733891074a10ad1470f78e2947f8c83,2,4,144,173,-29,1,4,37,616,-579
829e503c630c483758a90e9c9230236d,240,155,1130357,201067,929290,215,149,932808,152321,780487
974c7d0ea4a53a238edc17c2dbcab2a9,190,145,666955,182772,484183,165,105,610391,130953,479438
e24b1a9d1becadceb185f987d6a049d0,43,28,31997,11033,20964,39,35,43837,15174,28663
0e20319cf0bb0fd51308d064ffed6e9b,99,82,160758,28543,132215,84,78,105754,54466,51288
c6f2378d2d59826d5575a5a2d2d0f078,90,59,134833,40041,94792,89,61,134472,41787,92685
5dffd54f1dcbc6aaea7451c33b6f99a2,82,58,107882,34381,73501,76,67,88304,28063,60241
213f23a5eead877456074aaffd3fa070,25,22,8171,4558,3613,31,19,12204,4023,8181
5ee5507e72d1d17b944cc3c53efb4bbb,71,51,142619,38378,104241,85,54,128689,43496,85193
4a9979d64c05bc6957de65797738f3d7,130,106,288264,95249,193015,156,111,323143,77573,245570
943f4328ab49ac77ced9a4be47b745a0,194,155,741578,142414,599164,231,145,711220,105780,605440
984a1117d4bb9839d0faadb997bca91a,101,81,193918,45638,148280,131,113,224202,47773,176429
57c490e1c294d86ba282348bb0604f4a,99,67,161938,40686,121252,108,69,198153,41190,156963
8646e76ceb6e0785d35b5c9adfa2ad84,120,99,311871,83571,228300,91,67,253905,77698,176207
830cb687bd21e46d0d3dec25d1d091a6,58,44,45487,16375,29112,51,44,38455,14685,23770
4c47e2f5c8a900853c045034ff215d71,45,34,77896,17297,60599,52,41,68275,29835,38440
31fe131fca180351f8659faa14c5701c,0,0,0,0,0,0,0,0,0,0
12d7c69102301ad6e664a8f5dbc24e96,124,98,244731,51585,193146,108,95,208989,58606,150383
d1d5aee258edf6fa475e9839d7a946e9,104,85,242919,62738,180181,120,97,261548,51879,209669
4d454d498dbeaa601b1881d74d413a88,86,66,165745,48810,116935,95,71,148991,36995,111996
2d2f5225992ee6a5d23dafa8016742f2,46,26,26574,8265,18309,35,29,23054,12669,10385
d9ab301b70d4de56d5778a5bab4aa2f2,126,100,294410,75314,219096,130,105,329390,74701,254689
d9881c5311c8cf3cae4a2274253577f7,152,111,622542,183313,439229,147,107,586448,148401,438047
91e43c048a86cc2c311642f7b4158430,72,61,111956,33371,78585,67,38,76575,32562,44013
264de689f30a812229993efcd6693c49,195,135,726765,61992,664773,132,106,433916,92807,341109
f385bc5c5b70ba732bd639aab52a93c8,147,98,373657,65517,308140,102,82,243281,79078,164203
d20efb9a132e303f5045afc762c1c03c,134,107,369201,61955,307246,147,124,391304,85543,305761
23c478e830e40d3b81b9513bd2779464,89,72,237494,57869,179625,134,93,263233,54416,208817
186f93b76d135cce8ebd3a237ea3cc57,71,50,136850,28893,107957,70,59,125442,42652,82790
d64acd67b6d79e69ffc3667244e61be8,104,86,157977,37456,120521,117,86,167034,42796,124238
002ae9db3ec90aef2aa95c7a20ab86c0,31,27,41859,14304,27555,52,41,58706,19610,39096
84221a5ece7ff880d2fb640deecadf8c,15,9,1553,1353,200,14,9,3220,824,2396
7d7b956ebdd0c7f1e98140d5ad7c16d2,142,114,416708,161300,255408,144,98,473167,95150,378017
4f877fe690c81ebd78c58d0b9fa3523f,132,86,215302,42043,173259,83,63,146572,65107,81465
e808792aec3ac65863eb9444186e2e63,62,52,76104,23506,52598,50,40,73068,21499,51569
dd6eac113e4940b40e8301d69f845830,179,110,480828,92347,388481,162,119,478333,106129,372204
e95b3ca9c8093e7e0c5eb94acae962c9,73,52,115339,36777,78562,86,68,104798,32918,71880
fe5872a8efa63207e73d008bca40f06c,148,100,426093,103756,322337,167,98,509602,104734,404868
928cbd095aceda85529f5cfb61348c75,124,90,259923,47580,212343,117,82,275625,63248,212377
44cc62c63d6b275100d83aef6623a36d,158,111,555624,139497,416127,173,147,552105,122977,429128
1d0838e2d55e3022a8391ec7f0498398,141,109,240887,63370,177517,109,81,181350,65071,116279
9fff827407e44d2601c5f7940392bc75,69,52,68272,23033,45239,62,40,56515,19991,36524
98a4374110d0dc91bbc21d7d518080a5,99,89,170649,35805,134844,45,39,61187,24380,36807
c59ebebaa62b519f3aea0324abd0c0e0,134,109,333340,52276,281064,120,100,242274,52943,189331
8e9a9051cb01d25a798840a03cd029d4,43,35,25648,10942,14706,45,30,27441,11508,15933
fd11760745a11e7975d0f9706133ae09,42,27,61196,10620,50576,41,29,29623,12819,16804
591fb3b834b71f84b2cbc7765792d839,101,80,143382,44003,99379,93,78,165575,45826,119749
4cf089aaabcd963123f32676eb2ee12c,32,28,26339,7031,19308,33,28,29918,11301,18617
31840b0d3c582a5647560b0d8a8f297e,57,43,102208,27530,74678,83,53,110420,28043,82377
7b52daa38cecb328e3da125be1d9a0ae,29,24,7298,4416,2882,28,22,8266,4099,4167
7b6897bc33066fec1cfad6a0e58567a7,84,59,153811,49711,104100,88,62,171926,47665,124261
a3bbae0c6f73747232bbe40ea804faf1,22,19,7744,4789,2955,29,20,8456,4372,4084
052098e37b9c7b7cacd80e6d675aed28,124,71,166272,49656,116616,63,51,84062,58211,25851
f74d888ab22fe14bd466126b06aac56e,108,85,246226,67271,178955,106,83,222379,81045,141334
3f2154d1211fbeda4584f85ca193d56d,52,39,70468,19269,51199,58,45,66518,21466,45052
9b8becaa1baaf19a2ba20003ec2f5a0f,26,22,11110,4192,6918,26,20,14890,5644,9246
90f8c78ed03c3ccdd614dd7adcc4d042,84,69,132862,33775,99087,85,62,137689,37732,99957
05bd4c11b69493ad7592b6e9a78a1cfa,108,82,196107,46153,149954,88,70,166088,38431,127657
090a7da7bc38ff0d987e8164b8334e04,82,62,140587,36748,103839,88,58,145554,23793,121761
ec619a3d644d43fafa2ec7e0df2de768,49,33,49013,10465,38548,42,47,32790,17481,15309
29a71c7a7969cbbba9e677f004d6f0a9,198,143,622744,122528,500216,179,135,643486,148019,495467
3fe765117f91875c7b37249efc448823,4,6,1295,483,812,7,2,637,228,409
3464d82eaa63ab1d7f9271cda74760f6,77,65,127618,36121,91497,105,63,174867,28840,146027
dc832fbf7c9be49257b0d3f4bfe1d853,14,10,2127,1268,859,18,11,3709,944,2765
2ce1d64cd3624c9154c27dd1f213115c,183,132,1166578,214129,952449,139,107,955325,179149,776176
7a95076f71068b3231d1b367b4ecb93e,44,30,44694,15526,29168,41,27,36845,17173,19672
3d32343a767bf70a40024f65c44a5c59,98,81,124492,52025,72467,150,97,209574,45031,164543
40d98771e0ec8e66c8e374e735de72da,0,1,0,39,-39,1,0,39,0,39
981e22a09a6c7bcf10374074e28beeba,247,167,1338424,218682,1119742,208,153,1293231,253946,1039285
bca07c35f8709e9ff6ba3a4584a53e73,175,120,1063498,172291,891207,199,158,716502,150058,566444
e6a4686d43dc6b28e142511d8e40980c,44,31,38931,10572,28359,43,32,31527,11242,20285
2b5aa17b1040335bc3baaddd5c32378d,31,22,12283,4672,7611,27,21,12498,3397,9101
e3e89960439c316cc150e0637de098a6,32,28,38882,13120,25762,44,32,47773,18778,28995
14df9f7c822a136d54c828f53fc7029a,191,117,633981,77492,556489,153,105,492528,65524,427004
0f4c36b94acd80f92456425bfe253f1d,73,49,95128,23573,71555,81,59,108091,36519,71572
16c0106975f7872a15a7e4dcf39a5882,56,47,76283,28702,47581,73,52,105089,30938,74151
427037fbdb31783173f4d0c17edb1e87,25,16,17086,4552,12534,32,31,35393,9308,26085
e7795797b528bb340321d792e2cad6a1,130,102,338305,96039,242266,195,153,575098,87076,488022
eab2f3dd81748bd5179ad9db7420381f,117,86,411453,91071,320382,115,92,352753,101903,250850
8b2d03db5f6cece6dad6e8463b645e27,60,49,81054,29537,51517,72,54,120523,33047,87476
411fa5f2a43f22aa0f027cab5c70d3c5,28,24,22676,7581,15095,39,28,26126,10150,15976
7c54e703803288edb1e408ddaa06da17,47,39,40600,23856,16744,45,40,71143,17208,53935
18a6ebedfe69ce2a8c3585ce83f619f4,67,61,133602,43683,89919,74,57,98437,26465,71972
c10cbb3e37e7b5558d71f0c3a3447556,38,22,33148,6037,27111,26,21,15621,6315,9306
e73cf761650321b83ff84b4a47f9561c,197,151,615936,123866,492070,186,140,762118,126786,635332
b52c421bbe0bdea920f7ab81c763bad8,66,50,87010,24391,62619,51,40,60426,23482,36944
e08a583f2037c86647b0d77ce0cbc29e,107,81,156783,46494,110289,129,95,258686,47492,211194
862bb1da0f78ddf8646ec276d9d4906a,131,102,257897,34728,223169,100,83,165495,51376,114119
16460cb52542593a45ff71bbd3e18913,0,1,0,54,-54,1,0,54,0,54
be23362f2d4dfb5561b52fd6b3d4d5e6,37,36,28191,13679,14512,43,36,46154,16016,30138
0a72d6d3f0c1d7ba64718c6d5a7f59a5,28,19,9893,3897,5996,31,23,8851,4068,4783
7d6a7585645fc3219b960311174ed127,126,97,362723,72465,290258,132,104,300299,96632,203667
d3a4c27ee8c02ab5b7471834e36e5dc7,148,110,496511,83906,412605,189,122,433733,112299,321434
ef159a92629a41d7f63105ce35d79066,142,111,476518,150151,326367,125,110,418942,106506,312436
8a3bc855e557b412c9eae0ba09ab5b40,196,150,846175,222470,623705,177,136,805633,172328,633305
bf6c05af295f5496a321130afe4a42ad,65,53,116554,25591,90963,92,68,140178,32446,107732
7dbfa8107ae384209708e071ab5deeb6,42,29,60711,22535,38176,46,38,64016,24612,39404
8e18d3c1811fffcc7917ad759887258c,40,33,65482,21237,44245,60,57,106036,27788,78248
e9de413e7616f401f175f9020b411e8b,57,37,53629,16294,37335,55,50,45205,20635,24570
6624f4242420ab7a1bf6a03e0a892521,40,35,47305,13179,34126,53,41,47975,17137,30838
95c1364840747d6c3fb6fef87b6bfc61,128,91,454852,103657,351195,169,127,504698,113052,391646
271784783c0b83df53ec1a32c23b0143,32,23,21203,9890,11313,35,31,26718,8259,18459
2fc942df68e43d02a7c31a8c4dee2c62,107,76,211502,69485,142017,141,105,325826,76949,248877
b94b47b1b428040002d35edd8c620787,23,20,21263,7837,13426,27,21,15961,7695,8266
12e4b062225bc544f9b87440d3631dda,58,53,78323,21140,57183,89,68,121801,21766,100035
396c18cc4d0d6c7690d9c89ada17374e,42,33,32901,13724,19177,37,29,38045,11665,26380
a0cc9ea06a48ac98eee672c8c7d31221,141,104,310673,61142,249531,122,105,383009,47104,335905
6a1acb4a4f354e3ee9ee06bacfe3ca54,142,119,369739,97851,271888,143,101,410773,74490,336283
c73d0f4cd87436460481d3ddd1867f6f,121,92,321836,68078,253758,145,121,420818,62658,358160
46103b2a51159f1151777f99dc67dd54,136,109,354626,80192,274434,138,80,265912,72927,192985
cb3fbb9053988ebdf07cd465090bef92,203,132,580780,113849,466931,155,112,533614,127782,405832
1f0af7b2b7c57ee5100f44efd97024ac,49,41,38383,12738,25645,51,39,40473,14382,26091
1b4e1ad20c3963b081753359029ec608,78,62,130023,49447,80576,87,64,137363,36813,100550
f94e8803a2e09dc017ab6cfbaf40e965,53,45,65493,30601,34892,74,60,83286,36418,46868
de16a2a14000c3ad64b33ecd0490a158,15,12,3627,1104,2523,20,11,4032,761,3271
9001c9128184cf46f720f87a08d7ac06,24,23,14620,7173,7447,31,22,16079,6149,9930
940840a9bf6a4cedff34e19d8fd8d4b6,128,92,302445,76563,225882,114,103,310338,99171,211167
7324f0e57677716f5f689ddc77857b57,91,51,107560,41296,66264,119,75,162681,35252,127429
71ca95359560e7a83d26d6355b582169,84,75,135479,53011,82468,98,84,179190,41773,137417
580faa00b78bb8bb65a5583968858e1d,42,38,41958,10385,31573,54,36,41168,11465,29703
7be72f9237005c7dfe8fafe5f32bac20,182,133,816862,130384,686478,176,139,798003,166008,631995
4fe3bd004659ac740499a02e55d2318d,81,71,142248,23936,118312,74,58,84032,38816,45216
3f5cba274b717267d70a2640270f74a8,89,71,134386,36661,97725,100,84,169228,37480,131748
6fb8b8e914a344217974714ad75591a3,128,111,441810,143185,298625,169,143,613858,103399,510459
58745e407d60628494ed16435feec8cf,30,26,10636,8450,2186,30,24,21766,3591,18175
7c8c754a8b1500af93b318ae3f4356d7,41,30,44725,11938,32787,41,36,37567,16340,21227
85af09aeab64bfab3b1cd3ab201f835c,137,100,427039,116713,310326,175,151,687787,132730,555057
9d1c92d0546c330c9f840d660b688ab0,55,42,74724,22257,52467,60,52,82866,28629,54237
baaffd3b87b02885487bb56c39ec1c9d,109,82,216475,54267,162208,132,94,280645,66776,213869
d7e4fe7514dd86d854ed27647de972f4,145,117,289641,61113,228528,101,87,222501,54292,168209
0f559de1e9c8748ae2abf4a1d77608b3,67,43,93218,28596,64622,58,44,88599,28831,59768
00debb17f28efc7dafb1d617777c6db5,123,103,309956,71071,238885,148,111,333983,62062,271921
fafa9d32cd54061b0e799a681216b8b3,148,105,553541,78635,474906,163,131,409512,94739,314773
2ddbc9b4fe2ee1abeca87841ed059b88,99,81,206990,61218,145772,110,94,248643,44790,203853
5771d41ea1bf33ec927132f24eb7e049,148,119,348799,116897,231902,160,104,458343,107174,351169
9de4730001f9a2d58c6ab878daef0875,176,131,560282,86580,473702,165,105,499306,103558,395748
c975b3791986b5e5038eaa8c2ce04648,122,97,246342,50117,196225,78,51,101562,61381,40181
a311b9ba48dab39308a254eacb21352a,112,99,287804,71978,215826,124,80,238654,80135,158519
2712daf62a8d5f2a55729a20e534aa0d,124,108,387169,104197,282972,160,129,453222,104493,348729
2cb21292f0106c74646f401a73113ca9,34,25,7833,4769,3064,26,20,14867,3472,11395
326a6f0eadd316846f5aaca376066265,169,146,524899,89341,435558,130,89,316044,69775,246269
f6269aa4e24e824765d1be8a7ecf83ba,124,95,215241,41377,173864,79,67,140383,45728,94655
a42256fab366cedb6d64a96891b4e88f,27,24,12622,8015,4607,23,22,13225,7730,5495
1d741f7e10022ac75462eb563ac1fc67,111,93,217191,86433,130758,159,103,321344,55672,265672
29069b03a6f884ea883782df513fe165,59,45,65418,20396,45022,69,53,86519,20124,66395
659dc5e53ab2a3afc39b56bb6677d054,184,138,636009,92661,543348,164,134,567515,94666,472849
b3a1721c245bd892aeb0fc38fc6062ed,62,59,64280,18059,46221,48,35,49524,12026,37498
6381ffe4212d859b5a8dec74c0c45b10,175,130,795869,141415,654454,157,125,739591,182014,557577
737e0dd248533571c941641754dcf925,81,58,138060,28902,109158,104,74,165703,26264,139439
1c010d35ce922528e8ce93713cd5ab25,26,19,14666,4762,9904,26,18,9780,6754,3026
fefe103b2315f7a659b38bdade9fdd8e,38,30,22937,11370,11567,41,30,24330,11650,12680
e6e991ea6f59ac5545ca4abf75957f45,73,57,257395,60035,197360,87,73,262909,82406,180503
1764ab6b40154aebb920334d34f69efb,162,119,770642,197607,573035,228,150,792717,191950,600767
b8b31c29f99dfac3ec6e4f9f2eda263e,66,47,102766,26249,76517,70,64,90246,33578,56668
a2661c5936de9f33c8305ac56ce07be3,92,65,106300,27859,78441,108,70,123481,23145,100336
1e5e4ff087aca599b62a58e695dc9096,63,53,99965,25168,74797,80,57,80226,27159,53067
160335fd0725c0c139c20e70225519a1,42,32,43941,13099,30842,39,35,45001,9954,35047
1cd9f8001c3f2a59e2e50c1912485e8e,27,28,14537,8547,5990,37,22,20677,5794,14883
d6ef260213cfd6e25215d287c2514c7d,57,42,77164,47555,29609,101,59,189839,43784,146055
209629aeef2758303da222b00f3b8172,1,1,46,85,-39,2,0,181,0,181
2c09ec8181a11aae0272dcca71e7d4af,199,136,592426,74437,517989,173,148,552887,93112,459775
b4846053f1ad08068ca35f2b91dceb20,162,129,428690,102373,326317,183,113,460943,97539,363404
0bb11d257e4d9a05d00272c70970761e,43,32,39708,10961,28747,50,36,39640,12804,26836
2eb107c8f499fdf5e3deeda0dc34569a,169,110,723687,198851,524836,187,144,621108,108644,512464
52624c2978cb2b9047d1a08a30cdbcf8,117,82,264467,86846,177621,133,92,395798,93945,301853
57d01c8dc3fc8fdc641e6bc6bfb45776,119,83,212288,49878,162410,141,91,229644,35667,193977
a86255d3e86f78f1203253743d6f0f06,174,106,546037,63209,482828,137,100,425559,70687,354872
8c5992c95551cf69d31ff05039feec5a,46,31,41562,11062,30500,43,38,39211,11961,27250
2fc659750e86633bbcbd57b8ed45c54f,103,65,178244,44973,133271,88,61,142794,60583,82211
ff28d5cece569b01b0675d6095a16222,37,31,22877,9676,13201,31,25,22922,10473,12449
bc9729cab963d4d0883274c433bc7dce,20,15,4191,2004,2187,20,16,4246,2361,1885
04fae4d23fbbd91ccd5054717f028221,130,93,214178,71272,142906,119,90,252253,44724,207529
f48fbc0d7ef15c9e9ff244c4eec146db,35,31,39233,17940,21293,37,25,35614,16798,18816
4da255e10e298329b09ec247606e4ada,90,70,173142,60386,112756,90,74,185181,60326,124855
2f64ef53a5a0b8a0c5fd6644aefe69ce,122,93,242267,54922,187345,134,97,265827,50253,215574
9b1dcb474897234173c0dd146232f056,36,33,34346,15855,18491,40,31,40101,14664,25437
0467e66cb372cb17ccfaf6365cd30c6d,155,127,334662,99929,234733,136,90,336712,70750,265962
c2d0f762c1c035d4db5ad18e5f856bbf,26,22,14635,6256,8379,30,23,14713,6746,7967
6304fb5173b5f9405c1344f490490491,148,100,407757,66732,341025,148,113,392017,120498,271519
193f8f1cd7d60e6ca75ed9e73d5f7480,85,72,113179,22896,90283,77,49,90396,15383,75013
ebfad11ed5902fb6c7256444c156ba9b,5,8,420,805,-385,7,4,830,208,622
b43db915b12f06aca55e744cd95381f1,40,32,36607,16912,19695,42,33,46696,15648,31048
263b9873595f788303df466c66e19c0a,68,55,78329,25103,53226,42,33,44710,20326,24384
1e9349b3286c541f42e9a3649f6319bc,2,5,58,466,-408,4,1,450,42,408
a9b495ed9ff4de137151028536623e97,106,73,178151,30902,147249,89,66,132837,40288,92549
b9b6819efb7bf9937ad37374fc967d4f,83,57,160770,34788,125982,94,86,231429,41794,189635
d9d089c21e506f892c23b8cb553daed1,159,97,569143,112867,456276,177,130,562139,102088,460051
a3d67fffa22982220330af1048878919,99,76,215366,56624,158742,125,103,211689,59403,152286
c4cc89d426b59d46229ed92558062bc9,20,18,6356,2957,3399,25,17,6456,2142,4314
816f9e2a2a6947b6eacf8110632ef298,126,97,260468,78619,181849,120,105,276279,81779,194500
1238194fbef6f2104f0ef6ae81a0c25f,52,43,52114,17449,34665,45,35,58844,16415,42429
34d7106862770cc9eb0c53f2e2645246,35,27,23732,8068,15664,39,31,28092,11964,16128
b307f888cfc81c4adce3e8c7beb73ca4,57,45,67745,18165,49580,47,31,44515,18417,26098
545394b51f6f28d362272cc3af7844ef,80,77,146050,30498,115552,105,79,171132,21866,149266
c1cbabf74da509f52551e10b66fe046d,35,29,30035,13201,16834,37,28,43530,12914,30616
1fb9639d9c8058894583d72a15d3451d,69,56,85503,37757,47746,81,64,133539,27744,105795
7789e36e6669dbc2a3fa2f8a924ec9ec,2,2,683,273,410,2,2,273,683,-410
96107c4f8e7214edf004e05013bd6065,41,40,22168,12862,9306,55,39,45896,9090,36806
286470d4d2b68168fa766eb1613b1b3b,141,105,381205,69605,311600,143,102,327256,72144,255112
9037253a6b54a76b54a5d86406e7d6dd,54,47,70874,18495,52379,34,33,42255,18699,23556
e69727e04141ae7d7d19d0d03c75b7d0,32,22,19392,5728,13664,23,19,16404,6244,10160
88f9acfb576d77461cbcbecd3c262360,167,138,526165,101839,424326,151,112,510152,110916,399236
cd0e472ffefeb4c06b20613728137465,51,38,61943,10465,51478,44,38,52380,17062,35318
7687a9495112f0d655de6b0c4f8ab3d6,36,31,39418,17289,22129,32,29,27719,17455,10264
0ef762d00b783b5bcca4b6c72c38ea22,162,128,463354,89482,373872,180,130,497518,113317,384201
7f857ac481bb5e91efeff50cd6cebc89,67,53,120064,42223,77841,83,64,145452,35500,109952
df9fc818aa59f447fbd96b330bb0734e,74,59,95138,22172,72966,64,60,74832,26426,48406
9b0a3cf61f882b3566221e297b3fbb8a,126,102,348971,84703,264268,126,85,350644,70445,280199
ab611a7fdcdded281f017244df02e6a2,7,4,477,157,320,8,3,642,169,473
c1bc5df566897cba9d1786d57ad1b92a,63,54,81068,28411,52657,64,37,92508,20067,72441
202017fad0f2774a7ac143afc04d6658,94,78,164023,33281,130742,102,84,156335,50317,106018
e5f05b670fd10c532096296097c3c1e1,48,39,61997,32416,29581,56,36,90302,22849,67453
84db7e6007bdfeed5064286e6da57d6a,94,75,128461,41421,87040,84,75,146766,38135,108631
dc67006bd4257d209ecb5e34ac81f7a0,14,12,1674,1316,358,14,14,2810,920,1890
30afe524fed8f25703c103c33c610a9d,4,4,619,630,-11,4,4,630,619,11
fa9ac01b9c5444046238a9a6b96aeea7,81,54,129559,30415,99144,104,89,133754,29952,103802
602d3244004e0f8c3f5f9f8343b05672,85,74,105366,35564,69802,60,47,82969,18658,64311
399979e291f48dd784867d42818981e5,125,110,469420,142127,327293,114,84,402854,116785,286069
ad430f08c0a5569aa73698408b7373da,122,95,250966,61998,188968,115,76,218480,32912,185568
9b961e1e4c1dbe99264837be36eda4d2,191,125,445870,84130,361740,170,133,387949,77230,310719
d42c020a2307af9623b368fc7ed26b04,159,112,314780,74903,239877,145,112,350662,71042,279620
83dd3e38c5bc4282c28995fcf65979c3,170,135,659834,125297,534537,184,149,668565,104942,563623
1a8d761981ef6765ac824ececaff0f2d,3,4,385,324,61,4,3,324,385,-61
84ffa57a41eb67ebf6e4938d9b5fadc1,4,4,1064,730,334,4,4,730,1064,-334
3e875a01b7511c74448d697c29103054,159,99,508656,136972,371684,214,125,664091,121800,542291
2165fe82a47454d1c5678e14b0fbffed,32,21,10667,3400,7267,26,20,6243,3421,2822
64dc921cc341ca1242c4ca5afa7dbb41,70,62,114809,28478,86331,62,46,107953,31617,76336
e377ced76c3c88ace135fba1a46df904,36,27,38568,12289,26279,44,29,38885,10952,27933
a160052fa820c7840034bde7c41905a6,123,101,308519,47142,261377,104,71,179695,59250,120445
e497ce8545c7f5a3430028805a5d459c,36,27,25693,12235,13458,36,22,34478,7211,27267
a6ff3899ec3cf0b02100f67347c9c622,31,24,30971,9856,21115,34,26,20394,11392,9002
eef6f9bcdf1b1ce9ff03a02ab99b3461,29,24,12925,5484,7441,29,21,11247,5962,5285
4b17510693f7ce2b3fdf170e0d0b989f,27,23,19256,5982,13274,27,20,22531,6583,15948
f28734c92a135d798f5fd52d2001ce68,25,18,6430,3060,3370,19,19,4479,3290,1189
c2f018ec8ea77e5affc5fd62b1ca9121,23,17,7208,3100,4108,21,16,8395,3200,5195
070169f048233047a32387a2d421ec69,80,59,113547,39865,73682,94,59,125296,24509,100787
009b131353e324ef37aa6dd8ee9e46b0,149,128,387291,63577,323714,158,114,390859,56609,334250
6e1d7b73a152e4e614d46a2b83cd8ff2,93,65,148151,27315,120836,71,54,85436,33155,52281
1a55de7e0bceb39b739cf2c2717cf35e,156,109,1141716,192395,949321,162,105,494151,172930,321221
d11da358032c87f971eef96ff62cbcf5,41,28,30687,10267,20420,33,31,36261,10189,26072
4a176c428c09449d07f3eab860fa97eb,124,97,374327,74812,299515,106,84,259906,86617,173289
af9cfed1742a70b45d09ed21c78090c4,126,92,302593,67491,235102,128,109,288002,80151,207851
6cf22940341c7a57485061436f7d5833,150,110,380263,57626,322637,144,128,313115,74712,238403
b341092197780106e80fa551f62db2b3,152,119,459712,70684,389028,164,133,412340,83446,328894
1c975e6913868c4a4156724a2fb3b567,86,65,156295,40938,115357,137,105,296022,45216,250806
9294ee53418ac6e12a9f7bd7e8770e81,38,32,53040,23444,29596,67,49,89900,25138,64762
a5c7c5a63df68596bc314f3ad1e9cec4,142,106,361926,86641,275285,179,131,438806,72135,366671
8b88f41eb5561ca459d9f23002d39ff8,54,39,73269,26609,46660,62,49,95537,30848,64689
c1941d8738d7cd92cc2cc0d9505ec2ed,19,12,5033,1985,3048,17,17,3787,2855,932
eae6b55146e58973269f8dfe057b9022,195,125,678329,147286,531043,217,158,869820,122074,747746
f620e752b903e0b4ed0fb72c1b555c3d,85,76,233514,50796,182718,117,107,291797,79630,212167
05a22edf5c686d1d3be4ffdffb9aae14,144,117,347830,89629,258201,152,124,324139,94454,229685
f00896507d30ac2a362ad71be8b960c3,161,119,548820,111238,437582,190,136,629350,161013,468337
3bc1d60b7c7b5ea2b8d8dfcfd3bd4503,120,112,212455,53747,158708,99,89,211415,33292,178123
8df594f302cc7e81f5a0d437dabb93f9,80,60,119404,28308,91096,65,49,97245,28291,68954
9a706e0d6eb3b73521d133a39cdf6187,92,70,134132,29299,104833,103,83,86732,44135,42597
ed0d46b9703434b9e7918aae7c70d784,77,58,131029,38053,92976,99,76,133511,43954,89557
7288073322fb6a5ad159239a19f066b1,44,40,44703,9861,34842,42,26,41101,9933,31168
d6044f572b40a88430029f3758e0ffcf,28,25,14500,4931,9569,34,32,16977,7697,9280
4858dfe1a300bbd203bdd960dc0df4ad,26,16,10632,2010,8622,24,18,7570,3363,4207
79652af59b5499d8bf11ad8de0b49efa,60,40,45142,16510,28632,53,43,59120,12641,46479
535ba26e53c3f59d330ffc28edeb1c80,12,8,1220,697,523,14,8,1429,662,767
93d98181fe25580f18fbc4004b05c1c9,144,103,347677,89634,258043,126,100,254570,105392,149178
bc3de2e127dc62548d5193f92f3f5ee4,31,23,18904,5984,12920,28,21,18163,8477,9686
44b416b935a8921e4b763d22898a5250,74,61,107215,24789,82426,59,39,77423,12019,65404
17e3e88685726f2dbcf087cbdd5dee21,97,72,182819,37922,144897,124,73,202437,34742,167695
a556f65c4dbd6e721040941650732215,150,129,427664,81632,346032,145,108,355883,81770,274113
9cf982e922d4b82afdbe2c8e7cac1abf,48,38,68725,17527,51198,42,36,62563,17618,44945
7bb2eab4dbe20d714c3b808193516cc3,26,21,9166,6030,3136,26,22,10196,4059,6137
d9807096914e7392d077a39fb42b1bb1,54,50,47696,18240,29456,55,41,47274,17260,30014
8993fde347ec39de5e9a8804ca1534be,154,100,513540,168297,345243,182,103,674819,122018,552801
886dace2d7a701a66b33e8b9868d61a4,16,14,5283,1762,3521,13,9,3558,1750,1808
9bd98636346c3cb2e48d5d00e29a6094,148,123,676773,117533,559240,180,135,545278,96110,449168
ac8556a97dbfc4a6659153d60225b96e,3,1,237,177,60,2,4,193,253,-60
593b68b7bdb74b19a8210e368e865d0b,140,108,327219,76051,251168,141,113,421212,119663,301549
3d7728a867ce16ce1829f8850cd94198,125,94,332774,70188,262586,162,125,414009,57835,356174
60ba33ab3844714f8142aad5307f3316,118,99,389352,104070,285282,134,91,353696,85668,268028
e071f299f5294b5deff9c6b9bee18f2e,79,62,154804,39357,115447,70,50,148041,40726,107315
acdaa6fa65e14cb04dde62adf1f4840f,9,8,826,619,207,11,5,907,388,519
32e5bd17a4cd390a7e49ed29488b7e53,95,79,240215,65614,174601,128,94,280115,56403,223712
9fbd27efe200c8d489544ef8cd4b19f0,101,94,130585,46610,83975,106,76,138774,22169,116605
fac5d38e6532dcbee6049ce3f4313b27,146,119,340691,56554,284137,102,80,220054,57361,162693
8705011eca4b8993bb7d6e9c15d2e818,22,16,9906,1457,8449,23,14,6190,2373,3817
e50fb69f5b722e4ae418e89191bae54a,60,47,94997,28961,66036,52,46,84109,26437,57672
1cdddb95332a0bdd196302b94f0a5928,50,34,96496,27849,68647,90,65,117578,35053,82525
cedaf8a0e7325059b458ff346c4a7ccf,40,28,43196,18381,24815,46,40,52604,15929,36675
011d7d59d2426a6276297b3e2b2504b5,212,146,763829,116699,647130,240,184,826265,165072,661193
edb359a4541ba12a2a5753aae860bc78,25,18,6885,3430,3455,20,20,6073,2549,3524
1d0a57c5c61824ca6adc67c9facfd69a,110,81,296439,99012,197427,166,113,426212,79424,346788
146ce82591e4728c2ca04be39315531d,124,96,291485,53548,237937,129,95,322657,80003,242654
0ebe40c4f754e6611f862cbbe10de003,72,53,58607,23600,35007,58,50,58378,22308,36070
313e96ba7f8903a50986bc8741ef0030,69,52,74696,12696,62000,95,61,85285,19112,66173
0a15187f42d202eb54665250e0bf3d16,119,89,279822,100175,179647,180,149,449460,106373,343087
7251b1cf7f64cac03de7b449a38ff261,13,8,5329,1401,3928,14,7,4977,1583,3394
9bb51704e1d3baad5359e6d0abb246ce,53,47,68474,26064,42410,56,42,73497,23646,49851
250fb3755fd82f9fbba75e3a497d42ff,51,46,65400,21927,43473,69,54,62753,22904,39849
a99a08e1b841bf528fbc5131492fc1f3,45,34,48650,14637,34013,50,41,29057,15682,13375
c702c34c81f97dd5e14039184f75b712,72,49,174586,39699,134887,58,52,120199,52309,67890
c1e9d9fc1fc022ec0443a7a6d60d4950,125,90,200788,48277,152511,129,92,278502,48364,230138
dd8be3edcdd2aec7646f67a1911194e9,110,83,210978,43513,167465,150,81,315159,44378,270781
e4e34fa8ed680dcf36fa27903deb30eb,106,74,234304,49764,184540,120,91,258848,52794,206054
f417a51e3b829c413fe8dcb72d8eb415,116,80,287209,65534,221675,157,134,347110,70093,277017
a850e56371112949f60117c966dcc17c,26,17,6148,3596,2552,22,19,6641,3971,2670
65ad951fa7206e4d449121c488b9bc63,128,96,259820,65148,194672,121,103,335344,65369,269975
32c43e9fe2dff9cc132395c6de3c8042,93,76,167925,28565,139360,82,53,93883,39833,54050
b4e351cfeb9103f954971d7774beecd8,50,34,31907,8941,22966,37,29,21705,8858,12847
a04c349b2638eb382e6671cf604404e0,57,50,76547,27381,49166,48,43,86131,20003,66128
4c485a7f42cd548f3d1737973d1de607,151,99,437556,90067,347489,142,113,367062,95755,271307
a13717069da60b487262d768a03c52c9,151,129,592113,111038,481075,164,127,722883,119324,603559
e740c08ead7b1a3ee6c0207098b22703,153,111,344512,65267,279245,136,118,314839,81933,232906
7e1fb11d8359c020b33b12a24888ca0e,22,14,7158,2090,5068,20,19,4738,2582,2156
95c6cd1bb0d5c1182f943bffaa760d15,212,140,1554268,240017,1314251,251,190,1440378,228282,1212096
698dee7f27086dcae3e5ccd8f0b8402d,208,152,788073,118771,669302,209,161,790849,164937,625912
a9389f0a39d8dfb8de4bdbf09a28668c,181,132,495605,105033,390572,184,114,481885,109129,372756
5369e19403c41ef7f783882180df4c45,113,96,300646,50579,250067,116,91,309593,61437,248156
0b7308dfea37d02743f27005f3fb7299,66,52,96471,26695,69776,64,54,108838,34080,74758
bade6ffdb5165c76d23334e68f276a18,172,116,559432,117006,442426,127,90,435391,84419,350972
19f50ea7c340f3cc2686314909f09e0f,23,16,5871,3028,2843,27,17,7851,2471,5380
454511de7870ef928074f227eefae910,48,36,30745,10211,20534,35,28,23155,13302,9853
80e1c0902ff2f82277d5d731cd55ad23,123,85,313130,68365,244765,124,100,283763,72116,211647
09012c508255c96d3bcf1f454cd3e6c5,66,55,129885,40303,89582,80,71,130535,36525,94010
677d239dd4538f0a21d6e0bcbebc4063,180,139,456805,79632,377173,156,126,374086,116035,258051
e16b2e9596219b43ba69387c3297791e,36,29,44044,16320,27724,42,26,41116,17023,24093
7f545ec9fd5e13526020ad15f2f480f3,113,76,129354,34600,94754,98,75,128368,34395,93973
e09348a8a9eb960430c473f799ac00c4,55,47,52562,18127,34435,57,41,54778,17516,37262
1b5d8a93a584a1eef737a11f9a5283c1,127,99,371299,88384,282915,145,110,421302,84943,336359
7d72f2a2eed1dd12c3fbe4ce24d5607b,30,25,29961,9636,20325,34,24,28012,10496,17516
1d0cc3f9e7f261706cecff4e99216d34,58,46,64951,19594,45357,64,52,56085,20293,35792
01bad6934ee2fa27194102e7fd5eedce,156,116,441906,80171,361735,128,102,483310,108833,374477
808df8b64143fcdad4007ad94e18288f,166,124,641413,195707,445706,202,136,594041,148185,445856
f97dc2f0dc7c73c1437e9b8ff9b90915,180,126,710110,120898,589212,195,144,737295,121686,615609
0c9c698caca6693d884c7acc80b08ac7,60,47,77153,21091,56062,38,32,29494,25493,4001
d379a6ec38d5819d22ef39badd9ec268,161,106,340748,63318,277430,112,84,285041,81232,203809
ce08a809bfb8baf86c898feeb8bd0c20,39,29,44104,12426,31678,47,43,50433,14910,35523
382f822c6379840f08780859a3860994,30,26,13426,9681,3745,37,29,30454,9229,21225
9f5a7daa02746e7ac4944579450cd8dc,103,89,185232,37799,147433,92,72,138712,37661,101051
ca1fd60de1518c024869229d2c488d81,16,12,3663,1636,2027,14,10,4644,875,3769
9fc76415937fbcb4109467ae459a673c,161,118,498452,108328,390124,174,113,480044,119020,361024
3ba707f6ca105b5f7c954dd80dbaa12d,71,37,64186,20032,44154,72,59,61719,30499,31220
25af779e29ca80fb98aa089dc02c2ffa,71,59,105479,33854,71625,63,60,89175,33385,55790
2adc39654f8f28034dfdba8ca1e0efa5,23,22,21033,9615,11418,26,21,20601,9874,10727
3e417b8ee14e1d4567bbf8c20a90269b,39,29,21584,14188,7396,37,37,30843,10542,20301
dd97b87d0a9129c81c1ecb8d154395bd,57,43,56726,20126,36600,57,43,70185,18360,51825
4b15ac8c1cdac512f85614579cb38556,121,99,250283,83688,166595,134,92,283337,55212,228125
57e9ad5fc1d06de255a6e28050716936,45,34,37737,16664,21073,35,29,43692,15148,28544
f651cbce5d88b183baeb508aeb736a69,67,48,63372,16241,47131,58,51,87153,16596,70557
5ae6762dd4c5cb5233794e29c6c16997,46,44,46701,39324,7377,71,61,133200,33417,99783
7d067d79377f6a011557c6296ff5620b,56,47,44625,21645,22980,39,35,52574,14291,38283
17557e4c893737c7336f8ebc7d3d0f2c,66,42,46156,17118,29038,69,44,63832,18443,45389
09436a4e81b3dc44f2abd958b53e2878,107,95,432295,109024,323271,141,96,463889,79660,384229
5b645c6c51d298bb8fe384cf11d85754,42,28,32952,14307,18645,66,47,74583,12828,61755
74f5d1e0dfeca62cf5ca206662ea1263,164,83,400490,84939,315551,146,123,392831,79299,313532
532f79c24a4b714df80a3bd9eefff95a,48,39,49460,12304,37156,44,33,52444,18904,33540
9847d8ea312506b54c0a16624d640164,24,17,9357,3947,5410,29,21,15671,3669,12002
e60172e00c01d05fa80b3031dac35a4e,47,45,80358,33603,46755,45,35,62221,25369,36852
cb92f62db64befcf8cc0b6af714c3648,153,125,403898,86168,317730,174,119,436931,70354,366577
e1e0c446db89e4fe7fa06eb16a7b0ff4,130,95,280886,52903,227983,113,88,199854,49847,150007
c94d75a82fe9a883c8bb1a7c330fd7c3,26,16,10473,3455,7018,17,18,8854,4510,4344
72524de2c3384dbea122c4ba640d93e6,56,29,56807,16547,40260,62,46,71743,20900,50843
ba71e9898b4e66fb56dc4c69505bd4df,136,92,354302,88104,266198,218,139,592587,119770,472817
7e753ab26cbfe32b3280c0780a611948,55,42,55838,17215,38623,46,36,36253,18671,17582
d54bba54e947252a0564c62b788403f7,95,80,235138,66314,168824,118,91,231509,52149,179360
42749be6f027cf545c5126aa0ac53d02,25,20,19157,5744,13413,28,18,16545,6470,10075
439ef74bade330150d19da89e53405e2,26,22,14616,4745,9871,22,23,9202,6335,2867
9b03484538ed0ee84396c2b62b1df7af,113,96,192870,39548,153322,115,99,168148,43624,124524
d4be68728cb97f17053d1041483556cf,37,28,58523,21074,37449,58,37,72019,20801,51218
6e499b4cebfab061ebe742e998a6438c,48,33,64138,29339,34799,49,40,84047,21866,62181
5bdbdfa0eead96787902990aeab3b99f,97,84,135128,50558,84570,141,82,210916,35012,175904
c45d7469c1d35de5f268b906a90e3cfb,174,116,593178,117013,476165,168,144,581973,154170,427803
e6a540557c4fa20b80025da01abd1445,201,152,697535,136401,561134,202,163,641788,144237,497551
35c64ad4808aa7d00c251ca7a3598759,20,19,8557,4830,3727,26,16,8097,4384,3713
1ba4eb941700059b480de8c73bca4f2e,119,93,300005,69859,230146,128,90,331200,56153,275047
533ddd98cc9376bc1d6823652e8d6d68,169,124,501884,91123,410761,174,125,666791,91987,574804
073077abd0cabc89b83d0760870b0bcc,168,100,524884,58130,466754,135,102,376593,88450,288143
48481cac834578b67c2380752aee52b4,158,121,422515,94981,327534,198,153,848366,128196,720170
20c4bd65d0fbfc51ca722636eb5e540c,138,109,338055,107700,230355,187,136,510501,57335,453166
9e9f0570fec6d990f58f643415227091,61,51,67488,26061,41427,52,45,44877,16383,28494
f142edd8f232b1116c867a0561e4d6b5,121,107,346901,70505,276396,160,117,402283,69699,332584
1146e730e177845df986fc5fba246731,34,26,30669,11305,19364,34,24,22107,12358,9749
c0fb7d15fc9878bfac1daf77efd82747,82,64,221775,92502,129273,98,81,276039,80107,195932
a564e977f8a82a14afb1d11753385e40,167,96,309999,49241,260758,136,88,235650,44781,190869
8a67cb9336b709dba35832e314256c9e,115,81,311342,77741,233601,122,85,343985,80686,263299
4d35b1dc86d978a35290ae2dc3c52ea1,142,95,335832,70612,265220,127,105,343504,81533,261971
6ceb32e972bd3550cbcdface95ac0482,168,133,641874,187582,454292,186,152,854609,184846,669763
cf432e9d033f3fa0d6232daf57449849,117,89,263127,67271,195856,97,79,211518,60937,150581
d9bfc0b2542edc91e548bc65dd6bccdf,82,68,142081,48010,94071,105,75,226817,44644,182173
1e9869a33f66b9ff8ce7c84e6dd667e1,141,92,309321,60325,248996,120,91,249378,77313,172065
7b6d232c93edd2320fe5bec66d577f1b,87,73,176538,42964,133574,96,74,191624,50423,141201
1dd26c08fc5088be3bca3b401097a0e0,34,25,27038,12935,14103,45,32,41358,9828,31530
9f013d0940fef848e6c0ea6dafffd78c,42,29,44333,14610,29723,40,37,42285,13675,28610
05c10098faca4920d304a3a42982503a,73,59,139584,16605,122979,84,73,118443,31143,87300
401b6ed586242c43657725384361c556,102,74,137091,40748,96343,107,86,169570,41445,128125
a601e8e4d588b73c55246c6b31a83008,53,50,68134,27545,40589,57,41,70293,21415,48878
ca8401c5017833f226f94cf123d9818c,69,70,98370,36728,61642,79,70,150366,51002,99364
46facd9ab9e0787136a475c87166f5ec,68,47,57272,18109,39163,65,55,44666,20120,24546
f84bd5ea926bb7bb0b243496dbab33a0,67,53,79196,18261,60935,53,38,47430,16795,30635
0df6e4b37e84298d6ba7a56da525c12b,79,54,104093,14504,89589,72,64,87357,27185,60172
a1f9ec942020871c84b49f9e14f8cb0d,164,105,489842,65333,424509,123,96,356186,114206,241980
d54ecc5d07dd93c3d9e36220041c606a,57,46,43700,21163,22537,53,49,64678,20237,44441
84ad6a3eecbb0def16af2dd2b3635c1d,35,34,24005,9906,14099,48,37,48835,11306,37529
cfcf1c8e2f3c3717faa63225a9eb0fb3,65,47,119933,35036,84897,58,45,103066,30878,72188
8987295ef5114f672216a7353cb06b3f,14,9,1892,788,1104,12,7,1804,390,1414
7d7e097a29d206837c76cf64b115bd50,160,102,367499,69631,297868,144,121,323447,86095,237352
b2d323f91bd141d0f14dc4056713cfdd,83,69,105820,26787,79033,56,51,68423,28492,39931
b0995c7aacdad41af3d5647ac3ab0624,43,37,36974,13449,23525,42,30,32092,11029,21063
fa120eb0111408c11b29e4d0e3f018ca,146,102,304970,55724,249246,110,76,279038,50674,228364
646b713980c0a9beb29a10db72eb1b13,33,30,32897,16200,16697,43,29,52232,16024,36208
e8d50c30fcd78e9a08caa807abdb2c13,29,23,18306,7832,10474,32,27,30544,9705,20839
204b0116860b61aed76d27e7c2ac1a3c,18,19,5147,4104,1043,23,16,7852,1978,5874
347992ab3cce082f061685c3b586f78e,66,68,128115,57781,70334,71,60,137745,43791,93954
6c56db22346a6b72d8dff95fb3daec3d,223,152,889086,138946,750140,186,116,587835,170173,417662
7738d2a49327b275c4f7e96e3fa77c05,42,31,54540,22785,31755,60,41,95088,19681,75407
1a7e8b6326cb4f6817a86212dd6d5641,122,94,414725,99158,315567,165,138,487743,130151,357592
11363c319979deab8638c1bc09ff65e5,174,139,521835,78054,443781,135,98,340639,69553,271086
4e80d7679254f8edd602dbe87e281f77,82,63,184732,55241,129491,134,106,366907,49740,317167
1d49ed02ca3344756733588abb8a1370,118,92,351760,98814,252946,139,110,343546,83397,260149
ecc6b2af1977aa8ca20228e8f3129800,90,75,161467,49935,111532,86,75,132588,41109,91479
7d1e8cd6a965083fb0fbe1820918c2f6,56,54,86902,27683,59219,69,56,90744,28457,62287
32f56f2c825e276430c3b1d492dead33,72,56,83560,25786,57774,88,71,122760,23323,99437
16dce0fd6cb9470cb8ebf07a9421c707,118,85,333647,99343,234304,126,116,358438,108027,250411
c853e9bf39f31b5e83a302e8db25ea07,30,25,14791,5985,8806,32,25,18199,5773,12426
07f58022460b35c6f54a6ea9eb32bcba,64,50,101543,16738,84805,47,32,51734,16617,35117
762aedcc04e4878f094a5c075027a2d8,115,82,275991,109676,166315,164,122,436179,71368,364811
dbf67ea91950af41ececd1248f73c2ca,144,122,440902,68641,372261,145,120,380467,89603,290864
5c088d8aca2df4032543096edbe5f58e,153,113,523668,85047,438621,162,108,602122,112322,489800
179e6680b22d8371e5834c1f9b025a73,201,145,733999,193810,540189,197,149,661505,157268,504237
c0c1b4c638d53cce3e3acdfdd16eff9e,156,134,846277,94954,751323,192,142,591593,88640,502953
b522033feae24c57d0e0f9ac5770df2e,136,117,476016,104327,371689,131,91,388507,98011,290496
d7f7f4e75d24720c8275ac0ec58241a8,149,87,320829,56383,264446,135,98,312608,66579,246029
803e98eb696d938018ed4c0bd7b54dbd,30,22,7733,2894,4839,23,28,9275,4153,5122
9ba000c1734f6141188d3e427e32c1de,151,113,384463,68373,316090,110,80,243556,91693,151863
3c4cb2037c6af6117e5f72e915dd818b,15,13,3004,1627,1377,12,9,2524,1393,1131
4090eb4cdb4d67dbe0b12dcbf15e4361,30,26,13104,5892,7212,31,22,11195,4471,6724
c5fa82144f63a37809b35447665bf375,0,0,0,0,0,0,0,0,0,0
ca076ba198672eadfbf72b4c6923103c,84,60,81321,25867,55454,84,64,97033,26342,70691
37ea6aeea98a541f8b0161073ab5fa70,103,93,213222,61140,152082,98,71,185952,50726,135226
4d7d04d437a806450f81749c3fe56123,159,123,421087,95272,325815,123,101,334616,70151,264465
bb158b519749c8789db84cfd9498884a,164,103,390783,63319,327464,134,113,334430,97843,236587
9ae91063c9f907d37d56f9ba55a7c6b4,107,63,268220,75829,192391,187,106,452077,71619,380458
b1c6dce8f0bf1e15e5fe5eaed5799ea0,129,98,367152,86509,280643,97,83,325554,87246,238308
6124ca9a313478b08230dfa5eb7d155b,33,27,31021,16182,14839,48,37,46378,16246,30132
27dfcd80807fddd56ceed6272c7a86ce,128,94,262927,34844,228083,107,82,170331,37046,133285
3772af32fcc3ce1044e51600a2661e9b,53,52,48279,23523,24756,55,41,86979,18286,68693
abf73dc484981ac25b56b35f26bd7c1e,25,23,11166,5147,6019,26,21,10849,4703,6146
c7343c8b2f2ccf3ad0741417e40bbb46,32,25,18327,8432,9895,31,25,25252,8548,16704
02f3d9b4848e36b5d2264abc53546fc8,88,69,141169,31565,109604,110,65,157037,21625,135412
d968ef33ac11c824b6699081c3287591,149,116,312071,72122,239949,117,96,227962,80009,147953
ef0bde9bb63503c17b167cfab4f4face,89,72,209396,38678,170718,105,90,193285,40679,152606
85f66478a98973cd44541824e6991c70,157,113,344982,95141,249841,165,107,351417,67740,283677
e255b8fd480d920f5d92fd99323a7d4f,118,98,385028,119854,265174,124,98,398517,115755,282762
084ee55d69b660d02f54b6048b2dde51,165,131,451600,84390,367210,122,102,314114,113083,201031
f01dca01aa71be3fc95e4bf93ab29c2c,104,93,215455,42559,172896,111,85,201753,43490,158263
eae189b228bae85160f0249e175180e5,60,50,76755,16160,60595,43,34,36971,18763,18208
6cb54741a911f1c1a18a6344cb94da8a,57,47,111981,39876,72105,62,48,143117,24326,118791
87226bb1a53a0897f1ffd7c2f0c2156e,95,58,177433,25996,151437,67,62,104683,44673,60010
f1226abb55ef73a7b46d5eda74cc0bb2,126,88,364121,94704,269417,135,109,408094,91816,316278
f274724e4964def4f754a0672bd0463b,76,53,116012,31139,84873,66,54,88733,30538,58195
68a025fb268bf18f2dbd11bb17db994f,37,31,34791,18488,16303,37,28,43080,15324,27756
03a28e77667a7a0da151c0f6a8b437b5,20,15,5685,2354,3331,17,17,4342,2659,1683
e69dd488198427daf4e8742c9f157639,141,116,494350,118526,375824,157,111,701781,84366,617415
8ec2ceefa95adba33d777d3cecccc9d9,72,47,102351,32680,69671,70,54,82097,33383,48714
c3bf0fad8e5f12aaa6b6c00a772c588f,31,28,22738,8253,14485,25,21,20393,6813,13580
2f715b045cf004da4d728ff6fd5003e7,140,104,525073,104410,420663,142,115,410776,72158,338618
f13a5ecf96bc1a16e8552a79281e58b9,124,73,196388,45974,150414,106,67,208054,51100,156954
9159c3e7b546db23deed43c891da89ec,33,29,11604,6788,4816,32,27,29252,5800,23452
e50a357d26573cded66b840fb01b1f48,75,59,90048,27618,62430,70,53,101810,28451,73359
9c9581820e1c5ddec2733159a69732af,28,22,13176,6370,6806,34,22,19499,5030,14469
b6119ed5441e725aa5972075bd6077b1,18,11,4502,615,3887,19,13,5526,1834,3692
306622633dee99a46849b1af8154efd5,133,115,372326,74999,297327,150,132,452532,90724,361808
5fdd08d6da8dd8e42852ac22ecbb4bc7,155,104,309411,59016,250395,138,90,301253,57457,243796
a55b125ab2dd8657c6e115a1f4303fa7,145,101,337294,86749,250545,154,92,298828,87264,211564
ce75bdc0e47225ed82762224ccfe9387,77,68,207757,51055,156702,59,44,168241,45671,122570
4a2f85a812b41e4fc901a520465e0b20,47,32,47559,12616,34943,42,29,33736,15655,18081
03cbf51350e81a5fa3fb756686f55532,99,72,193356,58230,135126,89,71,153895,61437,92458
686c436edab4eb228902deac962fe2b9,189,146,844437,184140,660297,210,164,778733,186014,592719
a35a4626315d912615c2d0b7adaeb5ce,39,32,49917,11511,38406,35,33,25598,13065,12533
ebca4dd7083e348cadb48d815b055345,86,54,127179,32995,94184,91,65,159294,32248,127046
10c4f687550a055f6a83057193a29c70,1,2,180,212,-32,2,2,212,182,30
dbaf826e8c6d19b1d352e70cb2d3e098,107,96,231855,56050,175805,105,80,217927,40862,177065
4d69c03d28546368867c2b4e5c1c45aa,35,29,37229,13712,23517,34,29,28704,17168,11536
72fe906722aed2e6eba1b83276e30e0f,123,93,297778,54282,243496,112,83,212160,48998,163162
e2640e5a29f30c059631a1766fa37313,36,27,33384,8827,24557,32,24,23676,9723,13953
8832d46d58be58ea1a34590d9b58ccf5,91,75,191694,77222,114472,174,132,356492,83630,272862
71f96a4c3e27ee75259656fb5ae69df7,30,30,29069,11441,17628,38,25,28586,10975,17611
8279f144b2b487758908e51f1893929b,21,16,7241,4615,2626,23,19,6780,3347,3433
ce10868fad9bde2b56a9bd8e5f0ee4f5,206,130,567825,148050,419775,152,109,482815,164504,318311
7fa7d158b850829e137dbcafb2e99d9b,42,34,25449,12208,13241,32,32,25448,11452,13996
a7f538018b2ea4c43decfed25116fbd1,180,104,396419,65341,331078,120,91,333792,60074,273718
454253a91ee6486a8aae57ab4658e2ba,143,91,363696,145908,217788,144,100,501257,109008,392249
dc647c885f65e68e77305d025523a37a,106,80,189203,37886,151317,87,59,130597,33796,96801
e88665d1c540fe1c98e34c374eb5382b,30,23,19125,9094,10031,36,29,20856,8984,11872
2869aa555894b1e7ce99244a03bf933d,31,29,24041,9938,14103,39,27,42792,9987,32805
9c7a4a4789e54cf087f441d24337712c,36,34,45565,14860,30705,38,25,29726,8921,20805
8b29cc19cb5f8275adc856a4339cb1d5,57,46,132278,34694,97584,72,55,161139,35543,125596
e87d4b22842f0c63f18602feecce3a90,23,19,20362,5612,14750,25,24,15563,6629,8934
4cc3dc796769b6fbba9f2eb99c93579b,66,57,106197,32724,73473,92,68,136223,41750,94473
549580ddfd1b8d300d92c167b4fcb7b0,63,44,103388,23932,79456,53,44,80784,26731,54053
244122c1697416e99b27788e6d87e997,21,20,6053,4637,1416,18,20,6417,3436,2981
84dd85385778bf9aeaca4f2aa21e23b7,22,23,6794,3189,3605,25,22,3993,4396,-403
d38727e4417aee9d9fb80461bb9a084e,125,108,237791,54875,182916,173,127,390841,40210,350631
223376e38d3bb2ec6a6e209ac14523a8,89,65,169705,52368,117337,142,107,333816,62084,271732
fcc8be8459290e90e2eeb4097413a732,132,108,358590,150043,208547,174,134,488368,112414,375954
efa10b766b81911a988103912298774a,90,63,125073,24789,100284,131,106,190842,44799,146043
4a3a93ce4403f0f4657e437887c6c50c,35,31,30910,10150,20760,36,33,37108,8539,28569
3e5dd429c4e5058a3defd88e4cab4ed6,106,74,272560,47300,225260,127,92,292116,48721,243395
dbf09be47769a5df14e2f8ea6ae251ca,72,63,120467,51661,68806,90,66,137543,49296,88247
2abeb9b2875d45295dbf9d2f161cbc84,36,24,28623,12714,15909,41,33,40404,13135,27269
b20ea846fe5736e96d16cc940431349a,55,46,55203,37363,17840,57,41,95807,22985,72822
61e99dbd47aa30a2db7432845bf72101,25,18,6842,3192,3650,28,21,9787,3631,6156
61d6dab98f1894041fe3a6937e29b1bd,97,80,211288,60841,150447,104,92,181562,48001,133561
af45912d2b27cc504f58bd5537fb784b,80,71,157012,58331,98681,121,110,241303,52936,188367
7deb93f8208436089d2639c5e3394b0c,148,117,575727,139422,436305,144,114,487715,99350,388365
fccec9130a1d333c87469ac5a0736faa,27,24,12912,9238,3674,32,29,19607,7541,12066
95447d3d2e85f68980a67647aa7926f5,83,69,132714,34588,98126,77,55,121513,30233,91280
bb5ee3299601687bd9b72a128b2263a9,134,106,377936,50418,327518,120,99,318308,61542,256766
936dbc48f5d9dfe200a09b586da62461,184,139,678715,142950,535765,128,86,589622,148611,441011
150395ade52718a1ff2edd768cd87ec5,56,47,85886,25436,60450,47,42,59393,29534,29859
20f620a415378647665068a57a3bb0c1,79,53,124887,31490,93397,66,59,80338,47599,32739
9fbea8afac1f9fec23421523606c8714,126,109,313630,60622,253008,157,129,341240,72810,268430
10d6e7d02a7399a75e777f96dd90bc9a,89,69,124258,28618,95640,98,61,138252,22151,116101
94acc81b5abc899545c45105805b8f1c,73,56,99567,46605,52962,113,57,164794,41625,123169
da4d33ba393b41d69cd889726ef2d496,23,18,12314,6260,6054,33,21,18912,6840,12072
9f3a4081e0c6791b777d8b8b09f83d74,9,7,1452,341,1111,10,5,665,431,234
d6a5d871721304ec81a73b6e1fc8b363,154,115,356984,98670,258314,131,97,348205,125260,222945
6b2b914fedbbd5451bf2c5a64396892e,38,28,61344,8361,52983,41,34,36695,11978,24717
db4f1857874ee904eaa4b9bb398456fa,67,55,94060,29599,64461,59,52,97051,31251,65800
a763b02f7c829ac092312e3d34a9ed66,67,52,101195,21754,79441,42,38,45506,23935,21571
b00dc1800b0587294483b3c84228ec9f,61,50,92763,30276,62487,66,50,90295,31910,58385
44eb1735c147b9d6669c0001aefd910f,149,106,317005,67384,249621,113,103,289490,83324,206166
5cf609eaaed5deca8f4d344932fa72e5,121,82,194884,29126,165758,104,93,190189,36649,153540
24b928beff9cd8fa00ea00e5ef2a65a3,148,124,392270,52880,339390,121,102,303391,57762,245629
18a47df497a0cdc3806d15de5318bb4b,115,88,256358,99433,156925,182,124,386808,77773,309035
a482a1ec5211cf241ae85dc48d2d3bec,154,109,406750,65282,341468,140,108,415692,64663,351029
18dc07a2b546dd0fee770f2a2a672236,100,75,125705,38169,87536,99,61,107665,28428,79237
36e5d1bd5d1c57c343bd2af7da69d64f,2,2,124,111,13,2,1,250,79,171
10610ea80994a288fe14ba9f760b7354,41,38,76070,19264,56806,59,42,63209,22214,40995
96ccbc480231b1a9d405b8511e1cd368,65,54,62098,19547,42551,68,51,61806,16612,45194
d355ac3bba7cd2e6291ebc4442f29de5,134,110,324295,84888,239407,131,99,320847,74234,246613
3807e078cbc0de68c6b1a82b7d76a08c,101,75,176402,42630,133772,105,96,225178,52683,172495
aca8a6a0e7f7dd74f43eb23dd708430f,35,28,32435,11190,21245,44,23,32779,7236,25543
316731e18f6e33201b882442ccdb901d,87,73,195497,75807,119690,141,113,325051,75705,249346
62130dec66934405175a8780765fbd1d,218,171,870762,116867,753895,172,132,853797,127367,726430
11d30fe0cbff5e7752be0395cf1218e6,143,98,357112,78149,278963,140,107,372813,91955,280858
fcabe0f0669aab10e90d06af81df41e0,115,95,272729,78934,193795,91,80,234794,61390,173404
f58d1c590bd24499b5cce20ececaf6be,21,14,8573,1142,7431,24,22,8414,3284,5130
c3e6803f50d845f1110a0281e439a9ad,179,117,731295,174497,556798,210,151,954712,159645,795067
039dbff6c0fa15962791e31bfac5e9cb,98,74,141619,43155,98464,129,100,204208,38610,165598
d281376ad1b0fdf77a36df8822ad5637,129,105,368666,108885,259781,165,129,446141,100456,345685
4aba6c7ec40de9c4d0c1fd7e55e2257b,18,12,2350,1300,1050,17,16,1992,1551,441
8def8f0234c8fb492b4793f642b605e5,165,114,405717,102036,303681,121,82,339524,76207,263317
7a267067538c3bd9d9324d16e595bfc0,33,22,24226,7545,16681,31,29,24668,9851,14817
0019af96151d71fc99c8c2f310fe25c7,40,24,30153,7876,22277,49,35,37531,11576,25955
7efdd0e86664e2e0c1b23d4de4a1523f,150,79,346468,37912,308556,99,81,190570,53690,136880
bb0b5908f523305e1d6cbb2bd53d8f7a,4,3,298,219,79,2,2,189,222,-33
9af1403a821c8b895dd76c2252b0b88c,1,1,51,44,7,1,3,44,120,-76
39b2f70b92598919910bf728b55cd352,93,83,209424,53479,155945,110,90,253313,53409,199904
ffedac75c3c17a654b9a460e2a01f37b,141,108,375695,84723,290972,142,79,357965,88945,269020
0e521f529e535952df71b5379a07ee45,164,124,479167,102403,376764,146,122,419686,121094,298592
d81df23582a62842d5ac0c55a4087959,1,2,227,183,44,2,1,183,227,-44
79b7dee5bc9ba38462aca49df5cdd698,163,99,454114,92525,361589,172,116,534188,126121,408067
34c17f300258d9b4ab8b7738361ca960,119,101,337013,82835,254178,127,82,277929,58080,219849
92423c4cfb4c3cbf487a8b766f812882,45,44,62421,18138,44283,69,54,52038,24620,27418
e23527e10534548de4731053e5237dce,48,41,48357,16257,32100,51,35,37892,14813,23079
10dca8a14dd211f242f4803e16a5e97f,173,122,505338,92623,412715,173,143,530125,116041,414084
96f91c084cf16560af6f578eb4a73f0c,171,117,421338,69293,352045,162,114,442146,59345,382801
298360896ab67a638b4b14452a62088c,22,18,6361,3421,2940,24,19,6944,2681,4263
a6703dd5376a69bd1e72e59c5dd13f5c,18,18,7036,2832,4204,29,21,10160,4087,6073
5784b9a33c6971dfdb4522fdd902428e,24,24,14275,8128,6147,28,24,18236,9264,8972
00324f0b893809351c703ccdfa809c3c,57,35,40968,12367,28601,56,43,60223,14239,45984
2041beada483e4f60a00adc4566cc2a0,37,28,26361,7396,18965,30,24,13261,9874,3387
97348ca661c7162b55dbe1c43740f751,132,108,279395,70822,208573,146,116,348885,70951,277934
f337cb3ad3bb4493ffc36cf536e2c8b7,41,30,58478,17586,40892,40,27,47539,16359,31180
0cc83ef2faed245845f126364e3dec1e,96,61,147289,29367,117922,74,61,95783,33305,62478
077e5402cb85dbcdd8269c50cd2742fa,219,151,1058029,193907,864122,170,96,875010,121467,753543
fa031411a73182e1a8a6cfd20da1257e,30,24,23182,8771,14411,31,23,21525,9910,11615
efcad8a5d1db29354d35974ff23721b1,35,29,27834,12506,15328,38,29,24868,9898,14970
fef156637e871f50502e27f6c53bae87,43,40,38377,11716,26661,34,33,35844,12725,23119
e086e5a046c8f917118a339d6ca4fb48,61,45,76404,16198,60206,45,39,45912,21959,23953
a8b8f8be0bf059ff087d90da00b1d49d,27,19,15484,3708,11776,30,23,17216,3639,13577
ef82cb66d18b6f6b25da04e5e1076f36,149,98,455794,115086,340708,144,106,479234,115598,363636
ec1a04b2dd696799e5a20b9535d11dbd,155,116,453216,149126,304090,186,117,530294,111937,418357
5a4bd9abfa99ca6b091d90d4dcaa14e4,113,87,185106,44147,140959,105,77,215003,43373,171630
eeedc7a64c467fb85169e7a7742a95a7,28,22,14755,3999,10756,32,24,19272,5151,14121
8f7c85ef9df31ce6a80e93bba55568e5,20,22,5866,3912,1954,23,14,10028,3036,6992
408527d32666f47e9c8ebea06b5b800d,81,65,114536,26337,88199,75,51,139553,27962,111591
2728fb1824411995eea723302689d46f,65,49,87312,25444,61868,67,57,86776,32706,54070
a2687c1a9f4f7bc029051019ac4b7ad3,76,64,112729,33743,78986,72,54,110351,32147,78204
440c0194146a0fc3f0fdc6963003da34,162,136,532780,115769,417011,130,102,468489,112356,356133
3cb1a55e2409872182a679c705b35478,133,100,309032,78445,230587,116,98,269367,73024,196343
bb75744ae7aa5512b3899a942c01864c,89,79,157750,41759,115991,105,79,164765,26218,138547
2cab18fca0566b927d29d94d1291b40a,52,36,97183,18031,79152,70,61,94020,27616,66404
14aca1dc09d9014719fedd126c880722,100,76,185850,35617,150233,89,68,154475,45160,109315
2d4d54bdd4bc15ea5a9985e694a4f6dc,123,115,378958,69465,309493,132,114,291732,58615,233117
55484ad6d021b36d0594659f44ec1173,30,22,21347,6970,14377,26,18,14434,7696,6738
e2732e1744cd0b690546003c9b8b0c73,157,119,400464,85049,315415,149,97,333675,82959,250716
32dada82c6bb49225790b35756f77576,103,82,259889,57438,202451,55,42,130232,66709,63523
7be5dde57335b8f660d1551ebf170a9e,64,55,110930,29806,81124,85,70,122222,36067,86155
df7b3bb9fea8140674e6bd90038f153d,80,61,100439,23185,77254,76,49,89195,27821,61374
a8271bb212a4f5d27bde5c0bfae37836,86,73,324992,101828,223164,120,91,292735,78377,214358
ad25d225aa960e34ceb062905d99755b,161,136,616883,143492,473391,167,138,574647,155251,419396
33e6bb81563bd393ed5f1d13d211b77b,24,16,5915,2819,3096,19,20,6995,2170,4825
38ed0c7939756be4a0ca80824537313a,53,49,65773,27356,38417,60,48,126306,20714,105592
2060928403eee6e791a72add2cb1fc3d,41,36,33962,19061,14901,45,31,59280,13453,45827
a1eb42abe3bf4341f9c553bb92540fab,202,119,758170,140061,618109,259,123,809220,161390,647830
2a64d9502cf6b8d8b83fa290484faf9c,129,97,300746,54555,246191,97,55,186252,58970,127282
1bf56d323d59af47bb2cbc024a4b92d6,0,0,0,0,0,0,0,0,0,0
fb4f84455bf81d37a7914977b7fc6c08,145,110,250646,62304,188342,124,95,282685,75293,207392
7a300e778f4bf5859a362864dd4d6fce,69,41,116609,25065,91544,66,53,90479,34038,56441
0216828a18a80202efe076c6d940d94c,137,84,303103,62027,241076,134,90,247635,54099,193536
114fb3715545877639652217fd5d570e,132,98,287273,40307,246966,79,60,140495,47725,92770
ed8c4d3c6c33fb99996828529555d8d9,34,26,21927,11193,10734,36,28,20111,12699,7412
dca60c8dc0bc7d648f204feb6e02c16d,154,114,317481,67117,250364,99,80,187678,61087,126591
7653a614d571d8307fea8c74bea99189,35,27,30314,7246,23068,32,28,18029,9178,8851
1b5b427bdf8a1ea15a94fe53682f8ee2,82,66,124530,49558,74972,108,88,196024,40099,155925
6dedead69c986da6f2f705cef15fa30e,90,67,170747,51056,119691,84,78,178222,44367,133855
5aa1fd075271a7380b83c304f8e1941f,139,97,353262,109588,243674,147,109,452808,68214,384594
d682e99bfb8d9221ac857fbd3cc2ea8f,123,103,278073,79302,198771,154,130,393997,76956,317041
13dd9d4318f84da2ccd8bc481c24693e,199,132,1081787,254634,827153,216,146,1197044,209240,987804
44daeb97ff4522055d43159e7a33bd56,124,83,443091,128619,314472,156,115,471884,108023,363861
042f7dc3946cb0a5ae5ed625703f78f3,96,81,136401,48311,88090,115,94,225528,48203,177325
953f3f584d5609ba00b2a66fe14fd76a,28,22,16597,6157,10440,36,28,26049,6191,19858
9c1ab1af5a3f191309534ad8269f99e4,148,88,311029,52544,258485,102,83,212767,84477,128290
2e5ec33639e1147bb79597504ece078a,148,129,343003,99847,243156,185,138,494299,76569,417730
71bb6358c46c28d9bce4febceaa10962,109,79,219599,35523,184076,121,103,259259,39362,219897
fc54fbb7a5ff4a48c0f12eadbdc6564c,121,91,250583,68339,182244,148,125,312533,71136,241397
d2a280c2aa6a84d8c8f37e6930098297,25,22,19221,6895,12326,32,30,21384,8697,12687
128d4c794268986d08b8a4cee0cb4861,152,118,467060,119076,347984,181,148,539222,87498,451724
04e60b6b8b415e0cdcf8b46dfdeac559,75,61,122171,46177,75994,96,68,209875,56809,153066
e09d132a79518a14b90ead028c295f60,104,82,169462,34831,134631,112,70,192986,30638,162348
a9b8b684eeda48a913aaf15e371fcdd2,180,133,529186,114230,414956,151,124,510710,105597,405113
cc4c307cb93d48942a056b89371997c3,6,6,940,449,491,5,4,378,812,-434
443c24b7158b4c590a3509dc04b836fe,148,111,579207,134732,444475,135,108,384694,140563,244131
bd162ddbb3ebc1326fd49f167eebafa4,8,12,1203,885,318,10,12,775,899,-124
51fdff47e49217dfd4c31c3c4a0d89e8,24,15,5976,2010,3966,19,15,3859,2094,1765
3ba8059ab074ab03850376e064c961e2,162,108,422020,87380,334640,135,111,283299,105050,178249
811f7215b74dcf3cf2002debbe15cfaf,97,76,194261,41705,152556,66,57,112296,27641,84655
67e6b4f6fb363a19cdb8b597abb513d6,48,33,38701,11401,27300,37,34,27910,12176,15734
43ccc074fb756de17b5266eae5adc927,44,34,46204,14323,31881,37,30,38698,17054,21644
0c457efe681967b1cfd286e28abb5dc3,84,56,104999,22356,82643,69,65,74442,30703,43739
1bd2b033c97c4fe6d217ec34f0fff6f2,115,97,258493,91509,166984,154,141,439561,81863,357698
d477d5713b87fe722038b00a13dfdb71,44,36,35715,11951,23764,48,42,28570,16977,11593
48ad8f39474ecec7176f65dd96e56da5,40,26,25275,7568,17707,31,23,22937,8462,14475
1a6be86cdf420d53bd8fadbb6647705c,68,55,90963,30546,60417,77,70,112595,27992,84603
95a1d35a1e13d8a5b124a13ff9759f57,130,102,308522,59094,249428,130,92,307704,64558,243146
4d5a782161174fd887b7a1482399eb81,157,103,284661,45112,239549,76,64,174134,56485,117649
fdea712f328ca56a1256462400528fc0,111,82,169546,34986,134560,85,71,97833,28968,68865
58f46c32bc32de3ebff5f4697cab63c5,143,95,290800,37306,253494,72,57,117651,43336,74315
e92385ec820cfb0a2b535d9e1352bead,89,68,128242,49495,78747,130,97,235368,51734,183634
6d6dd5a8a99be668500e077342984a71,40,42,57327,23390,33937,37,28,60199,19188,41011
1b75d7eb404e78320c2bdc21250634a7,8,4,1278,431,847,7,5,1045,902,143
4785709fb421154287b73f535151e7fd,146,96,346534,106863,239671,142,90,392496,63389,329107
65063dde42e63a7477cbf47536349d73,140,109,303516,48797,254719,92,56,156715,61517,95198
44a683f52360f349d2ce78f94c703eed,111,89,543133,104956,438177,189,140,499983,131089,368894
f08b98dc1e552184f310b02d135ed39f,81,73,146056,42600,103456,87,73,169841,40080,129761
f35b3dfa5c9c86b45b62f7efc7d86098,177,132,483907,65527,418380,153,127,460113,85659,374454
510481d5fa3b060ff442f6a6274eb5b4,46,30,28211,9938,18273,25,22,19235,9006,10229
cedb56ea1e31f3570a481bbe86c49bfb,19,13,16048,6173,9875,16,15,14871,6009,8862
a1cc30f88eaba382dac0348b44d628c1,120,67,166567,24190,142377,125,81,259881,28960,230921
fc56bc74965b6dd4e5fe5290b3e49dea,118,88,307604,83486,224118,202,128,450146,125750,324396
6fce3e47a1a60748494941b6db6caac9,171,117,494503,85939,408564,111,92,354122,82965,271157
ccd364d10e685e6aff290c61bc03fed0,72,61,139538,31821,107717,62,56,103350,28279,75071
83986c4dee950f16b3584661d909c1ab,109,89,205530,59325,146205,114,94,203949,59202,144747
554f6cc38f2bf1738d4e8b21a9550be9,62,39,64025,16006,48019,60,47,68044,16011,52033
6f899ac39c481df8d7ca531dd3a68654,173,108,354990,91059,263931,168,124,460378,91905,368473
bba72ddeb531cd6e58eb878d216f45cc,40,32,39783,13786,25997,50,32,35106,19037,16069
827986e94177010449889f53d95c355b,38,32,47673,15008,32665,32,28,36245,12389,23856
f942b1effd8e5304b8076e6e1bdc3183,65,54,153042,72049,80993,142,83,308452,93689,214763
d5d4ca6e3f086fa228b9122a0195a38f,24,16,15818,2514,13304,21,19,8334,4841,3493
20b97e3581d847369c7d538d3fef50e1,85,79,161034,63055,97979,86,68,140368,38300,102068
1e851bd95c49567fb867f41c39911be0,36,25,34509,11255,23254,33,25,28736,10588,18148
4290f24b4f5eb9319a9579dbe790383b,99,64,150982,33350,117632,73,49,101772,33638,68134
8dd5421784478506f72b9875cff92000,7,3,915,299,616,11,6,1227,519,708
00886d19029ae123364f6242805d2d4e,21,19,7888,3833,4055,27,21,11691,3892,7799
b55314e3a91b37f28f738ae7c103bde1,56,43,63852,20263,43589,52,41,49423,16856,32567
0e849a414218472a8cc46c75beaafaa2,14,12,3317,722,2595,15,13,2405,1675,730
a2a59e3ac5e9d241fe692cdf7cad798a,91,43,126116,32287,93829,109,71,196304,42207,154097
27bfefc31abb4459e6434ae06a62a81a,74,58,107311,27937,79374,55,53,78444,30134,48310
c72edd07fc3553030459dce7fd9b31d6,126,85,312873,56449,256424,109,96,226707,79852,146855
5a9a2db5257c92c8415f1193d5ad62c4,186,158,818529,134506,684023,208,176,811928,191888,620040
b7eaad8cb9eb6979402912b3be1f6e3a,42,33,49971,15305,34666,46,26,51039,11651,39388
66ac809ce89504fa268e8f1eca785633,134,97,383812,57081,326731,131,102,377174,77905,299269
2783cf28a13b85f70b4fb8d158213b74,60,50,69697,24981,44716,92,65,151212,28393,122819
4817b5330a3bd679502cf9f27c692dcb,103,52,207595,56183,151412,117,76,196240,60297,135943
de53b0e791ab8aa9799c375cb30054a1,55,43,49559,11501,38058,53,33,37435,11013,26422
5cbfaa948daa4bd1820e0cc17aff2c60,32,28,24355,7620,16735,37,24,23235,10920,12315
d107169ce4c2779ce1bd414bf168283c,64,56,97112,19766,77346,92,68,97653,22858,74795
3a83cd05abfcfcfc112de30c8b029f01,45,36,43865,17012,26853,43,40,38189,16239,21950
cdf4a0c8d27030cb75a0eed415f8978c,42,34,35741,11054,24687,32,31,28757,11746,17011
7a9342d90afb85e79fac068af1f4eafb,84,59,113541,42141,71400,57,41,83717,34296,49421
120010dda835c6bcda120a83d0a11657,48,38,42581,16004,26577,46,38,39088,14382,24706
698d19da41875131f44f217afcc63b06,182,121,1038932,183063,855869,217,146,1074109,167902,906207
6878f95f6922d2186361ec34c17031f5,109,83,343932,86068,257864,145,114,450405,83950,366455
347e41f71dcae082890afe66ae75cda3,38,38,45277,20176,25101,67,55,91246,27385,63861
929c0ea1e5e86790966939351f44f00d,46,46,45345,16917,28428,37,35,31324,15156,16168
c9e7cb44252473d3c4b91b928fd4b7d2,173,132,745490,133054,612436,208,143,935774,108820,826954
9a44147faeb695c4e054cd57803d2140,93,82,247456,63708,183748,138,111,300321,92712,207609
2d5c7ec8d9438713341dbf0c83d9f999,154,128,465562,110537,355025,167,132,454620,103182,351438
152c51270490477a24370c0fe09d07a3,48,36,98893,32238,66655,52,38,108906,31884,77022
5cffffe9660af75ad7403cb56fe58af4,113,90,298835,73710,225125,137,124,448164,69962,378202
826be545e80552a6972d86023f7c97c7,132,101,313696,67286,246410,125,118,264203,80181,184022
7d20dba214d30ddb5676631ad270179b,41,22,61936,18706,43230,37,26,58283,18287,39996
a4cdecc1bc5e300a01477ffe9d795090,122,84,321179,60814,260365,143,99,330068,96078,233990
bc28d712433bf8f841db3f33fdda367d,107,93,271636,55392,216244,139,104,333695,49609,284086
ecb947d66a71780f3932dbc0e756ae37,179,124,441907,100413,341494,150,121,392031,71358,320673
5f9475e0f85e692e59df172ce084ea26,110,85,182946,60014,122932,121,93,210933,38273,172660
de4bcc0beb4dffccfb4315af9f0ac4ff,37,32,45474,15442,30032,37,26,23810,13570,10240
c4ac1900e5a3887ee27a0e2613cdf8b4,92,68,137765,30262,107503,67,48,62835,30314,32521
59ce1add2b7aa9826f86d4d3ceccc361,121,93,251439,68708,182731,120,90,265371,63287,202084
ade18e8a000b7da48951133888f8950b,23,17,17180,5233,11947,34,26,21991,7882,14109
215972f07c271bf87dd51ad711c78fe6,77,59,117001,37479,79522,88,79,177005,44658,132347
b7ae87679afc96a532b5e73bcee4a31d,95,87,147319,43382,103937,123,95,211976,44361,167615
6c0d8f86d4ff323cb3cd02c48b9fe440,144,90,428455,66585,361870,184,158,681895,89854,592041
c417f68b7c2b4cdf04a6172dc9695b8f,200,127,933943,160355,773588,240,189,1608388,211933,1396455
34fc6cd2d7b53b96a8ecbf074203a84d,195,124,405886,52636,353250,92,73,189195,70942,118253
a7a0ae0c335ebaba91d9cd51c5592ef8,44,32,57642,24615,33027,57,47,76940,20306,56634
b87e83bfd5735b5722dcf10d5d5e2435,103,71,177355,33433,143922,76,56,133703,40069,93634
1a00e91da45d1dfd95963eb96158d44e,19,18,4531,2214,2317,19,14,3170,2432,738
a12196ca7fc29551fc75abf25f2f2015,41,29,30855,10900,19955,33,35,33408,12795,20613
5677fd001428e6a0f35da453b66202f6,201,118,422524,92195,330329,129,91,303387,102563,200824
1f74b73f89c1910d6005a9362bee178a,134,110,393537,70605,322932,136,104,337291,62836,274455
1e6e0a21e3398817ffa09c1318a80cb8,104,84,198225,83988,114237,132,89,304401,56724,247677
beae5ae47267e9a410bfcf2640e612b3,236,143,714297,147482,566815,189,133,753961,163053,590908
51972702522d85f77f2aba7dcc8ceaab,148,97,264221,57635,206586,127,98,258028,62494,195534
b6954f6da625e588bb88823d89396fb8,102,72,227963,66231,161732,89,82,228259,83521,144738
d4ca9f58c59daa7d2d344780a6f602f5,30,22,17997,6141,11856,25,20,18900,9405,9495
86cced00ee3c231b79b9d4172cfae0a1,39,30,42018,8313,33705,24,15,20065,4786,15279
4ebe56e66775df2760ec6705dee1026e,28,21,15650,5064,10586,22,17,10575,7129,3446
b97ec7b6288f193293702e5eb17ba9ea,70,49,71729,31539,40190,62,49,91427,16946,74481
7d927d1874ce86436ae8fd5aa56e9817,97,64,168553,29766,138787,104,76,151537,38694,112843
aed248f03374ccd31fc302d7468f1d30,69,59,164605,29709,134896,81,51,92860,37950,54910
337e47aa4eb0bac3f98475dac430dd5c,96,85,178353,46071,132282,65,51,149066,42663,106403
e02ed82556205155bc51a71fb1e9bc4e,153,91,373939,80658,293281,168,137,459004,100795,358209
febf45752786508daf7aa5ed0ba9f8ae,127,90,311776,82487,229289,166,118,393710,53211,340499
14aa80076dc2717089c0bfa2f584a4b9,189,130,468219,73284,394935,150,104,506152,90498,415654
25857d85ffd3e0d8162d3e0264179702,63,49,88258,25816,62442,63,57,71184,27311,43873
a14d6cadaf9751d4712d022eab093a48,87,64,197681,34846,162835,77,60,115440,29901,85539
e241673b102f9425f90b6c444bab574a,36,28,26987,13435,13552,34,28,31397,11695,19702
cc4be3597cfceb54836db296e78c5c5b,170,142,447056,105346,341710,161,134,458497,84490,374007
163b5c340fd81a780e143748096f451c,49,36,101848,30084,71764,83,69,169217,35755,133462
d0e70bb12926eeed024bac61284335cb,130,107,351810,57355,294455,146,110,363373,74596,288777
12844964eb3bf40964ec7f6387b71fcf,51,40,119749,40984,78765,63,52,128732,38724,90008
b02b8f49e728cfbd7ddc45cf2a5889ed,133,97,415779,124616,291163,163,138,558631,103436,455195
75d9cd079825b93ae84ee4b4a76c207f,99,90,162577,52477,110100,124,102,228837,43680,185157
b82ad34e151127887f490abd4940c1a7,27,23,25131,7528,17603,22,21,16629,8093,8536
01a518386ebd62ee348975e6cd303c6a,17,12,3984,1498,2486,20,14,4551,2214,2337
b357df89d87ffb604faf35415687f9a6,74,60,136343,29339,107004,64,52,87385,36477,50908
ad1e09e3b676a38e57cf3198b91009e5,26,14,9584,2771,6813,20,18,6946,3348,3598
275efc78b34694349ed5bdf3e876d94e,135,101,291535,53245,238290,115,89,249648,63913,185735
a520b79b5e0bf5f77edcb3424c846255,129,101,288307,61021,227286,81,69,143756,62874,80882
b0580898d3b0336609e5fe058a5d0c6c,86,69,175300,48321,126979,101,83,183798,63002,120796
d20e725571366ebefc6fed72d9463047,158,133,455893,117858,338035,102,87,394095,102760,291335
dfb89f446ff355913bffdcb1dd60e367,140,112,380966,88204,292762,163,115,399067,71936,327131
3e4a7d86b27c14ec389183bb77ba6b97,169,102,462274,87404,374870,135,104,419819,117699,302120
e301dd609499813fb502b75f5c50194e,64,57,88022,21378,66644,66,45,58621,18309,40312
5929805051846a8e941dbc3bbd49415b,113,87,185885,55365,130520,61,47,121411,39031,82380
1c223b27cf15f54b4c049dfaaf985957,139,100,319284,75744,243540,154,97,353834,63799,290035
2b196e8b4ac9e2546a67da36ff401c42,176,120,463001,123354,339647,177,119,583207,85175,498032
712016c26c310a9c713becc3a7d8fe66,170,118,375982,67618,308364,118,92,272046,60249,211797
1a0fa413a8451cf92117eccbb4853caf,46,35,57819,17546,40273,64,51,117611,20507,97104
342e4b6decb743defa9f7bf0ede17811,146,122,563153,137441,425712,152,114,678693,115151,563542
a6ce3424b76814a585b4d5908b8f8886,86,76,132211,48445,83766,105,89,197759,38313,159446
dc7bad7cddc47bc18a42f25d2a09270d,102,66,168865,43994,124871,101,87,150855,57832,93023
18b1eb77dd41372e124d807ffe3b2cbe,70,67,158260,51653,106607,67,54,154883,52379,102504
cefc7e367c7a9994c44a715c651bdfdf,76,61,131280,37886,93394,83,70,119362,38980,80382
59fb6d20ddfea4d5c5ad71c02ce52f81,130,101,338583,106174,232409,168,116,401519,91522,309997
61c32cf68e539df5c7f759f7e33d4c7f,62,58,164372,71831,92541,72,66,180990,64652,116338
e4c2185bd02fa5f987e5e245b09eb12a,167,131,449814,90472,359342,143,123,379958,105772,274186
872ef49e22a42851a3eeefca570682a4,118,59,171843,46068,125775,97,72,153468,45557,107911
978e3feda7322d3f19a15965b6566da6,39,34,42189,24257,17932,37,27,56596,14274,42322
c0f5490c14d4d944e0056312c25222e4,33,27,25352,9645,15707,31,28,21734,9137,12597
8c7f18d442da69b8a7c5995ecdc01e7a,73,63,144806,30677,114129,71,57,80009,26030,53979
11b32f3cb080242229a8a907110ebf1a,124,113,432904,143859,289045,118,90,325177,118138,207039
bb21785d78c66d34dfe18f996a930cdd,76,65,118942,26949,91993,39,34,59920,21350,38570
3760fc0144c240708de00614091af0ee,60,45,83716,25727,57989,72,55,94717,24074,70643
90094c42197cfbbd37dcb947d5aedc13,108,73,289816,72233,217583,112,95,305080,92848,212232
4abf44f2efe4143232f70ceba9be7274,36,32,34119,13131,20988,49,37,57725,12746,44979
c438f5b4163fcbb3c0c68f80da5d09c9,97,75,134988,40909,94079,107,60,166596,37020,129576
b58ecc2738a95e49e6175876daccdefe,188,157,756350,117428,638922,147,128,638435,120058,518377
d94e535bfc866d1284aab102eb602c94,195,164,648180,99916,548264,182,146,540553,99423,441130
6c17a0d82d335270ba38f0322dfab094,103,70,150632,33433,117199,103,94,186143,39707,146436
32e8c2c0cbb3eb71b5c9fe44acfbbee8,145,122,320180,75945,244235,137,107,269691,83995,185696
db00eb7391404d285e03964637675c15,58,38,81504,19532,61972,52,37,62751,24814,37937
6c2791fa67771de5ca8c7a06938b7829,105,77,209911,60098,149813,105,80,209138,57368,151770
7266da4b3ba3d5c67ee466804b198251,62,45,76707,25256,51451,92,58,126910,24521,102389
3a9bc493405a8528c95bbc2ade48f5dd,31,28,20672,6474,14198,30,24,16489,7035,9454
e49138fe3175855b0d7605b73ee5dbf0,21,9,6169,1703,4466,14,15,3156,1670,1486
7fae2680cab5a216080263fc2b71da1a,116,93,246893,60808,186085,91,67,203612,45979,157633
bb14cfe3b50dfd293c838f790ef5c1ef,51,39,55427,17902,37525,47,36,55810,19019,36791
14f161cd920c8ccce52629e5ab473efd,213,162,753709,140333,613376,163,115,712419,139192,573227
0d3e877cf21ffa1fd557360c00b5539c,102,74,253026,92951,160075,152,104,354209,109484,244725
ea4bd287f669c433faf6d857c3780620,28,23,17067,3676,13391,27,21,10540,4804,5736
75edcbdd7a676282e3ccb946f9cd7ced,121,93,208168,27301,180867,109,86,183549,35220,148329
98b272ff92a7121714703ec6acc7ec4d,82,71,168790,45293,123497,113,102,189323,54769,134554
431ee56c3837110cc9bcb0fa6cfd6c0d,90,67,165554,47358,118196,138,109,258009,39335,218674
e2ddf688770bb094c57f5c82ba1b1749,17,13,3876,925,2951,13,11,1921,470,1451
f779843dd251d98fc502e37a82f72111,33,20,36626,7735,28891,42,36,37618,12528,25090
78551d131df184231f994d07eb26fb85,76,45,103669,9794,93875,71,53,77384,20208,57176
75a929a1a1a3c6d5c01cea3a9fdcb534,99,73,187356,75819,111537,117,77,291291,94355,196936
e41573b038682f6f1f3a7b14ca59ce0a,12,7,1399,432,967,8,10,1280,713,567
b95b33b10e718f985e4776c2b6747fc4,177,140,490115,68455,421660,146,128,346648,90304,256344
5597c87654b4e93f129b436972f09075,82,62,211897,64186,147711,108,80,255692,62897,192795
16857c98f20cb5633c0ccce5028d6a6a,80,50,73451,22532,50919,61,48,87322,20849,66473
4f24ffc74e745d3c1ad9b61fed46a696,19,13,4132,1210,2922,15,13,3686,1736,1950
eccb3fcf75b7f5d25a93de5e91ffdf61,130,84,334258,63777,270481,115,84,212515,90840,121675
0bc68b55cf53b0a19fefa66fac4beb02,83,66,130433,34826,95607,73,60,118311,25537,92774
6c85bf3935c4d746b67abeb140c2de91,140,124,371462,101821,269641,132,102,313549,73115,240434
fe1355d24fc5fa91e4cd2df4bf0effcf,146,101,390295,63994,326301,81,59,228929,66696,162233
278e475b644da50b73e87d2f4784d8c2,59,51,130072,58794,71278,79,75,174283,45594,128689
3733cf874df13fa46f90d17f8ef4f079,163,133,494268,139896,354372,151,108,422074,98331,323743
536d1e3e290518f9acd79dcf31e9039f,113,66,274402,34173,240229,118,87,240819,64278,176541
ccbd93b89f61d73a8492f8aa1f861f19,25,18,17112,5029,12083,23,23,9363,5123,4240
85a8778f02e064429ba7d6b911b7d59e,49,34,50382,11052,39330,43,38,30229,16231,13998
df5cfe4aad2a53509a926da7e5fa6d9d,59,45,67776,18250,49526,49,38,31810,10250,21560
438e52dc702f0d19bc3671ef06d15168,75,55,161398,33315,128083,83,72,117541,39691,77850
753533c1fa54a1129a0070ae6c8d3e6c,114,92,351268,106034,245234,136,116,395796,77570,318226
3389555a29a9513880c62622edc4bfa2,71,64,130032,55470,74562,67,44,114620,43130,71490
baf4e510246202082aa0e624c4f45747,219,160,764779,134432,630347,210,137,684088,121480,562608
828e5266843773afe47d3eae8ed0e6fc,27,24,10020,5095,4925,27,23,7756,5587,2169
b3daef165f6b3ab917ed84645fb02709,0,1,0,52,-52,0,0,0,0,0
542390dea06764e908fdbf2b25f9672b,35,32,32197,10570,21627,40,26,33037,7823,25214
a2f3e441a227c7578935015254c82090,44,35,52372,11095,41277,34,20,25534,8292,17242
e020ea779a50f972cd03b7cd802bf7aa,86,68,96968,34184,62784,80,58,119371,28782,90589
e2ee1eb73885ec86600aa2c7ea49ec61,130,104,304102,63733,240369,118,94,279579,78068,201511
9b7cbb1125bbcc128e6c33e76a637709,56,44,73480,28649,44831,67,51,83193,30531,52662
4d561bc66398b3381010b8498158b83a,130,105,643707,156108,487599,174,130,715849,171043,544806
e8713cb4b94de197d57a8b217259f71f,95,67,151329,44732,106597,83,60,171210,49527,121683
4c94d79bed92be8acc23e39831855ec4,74,61,143448,31669,111779,80,69,128648,49909,78739
04d423da7f6fdec0f8955ca501bfe67c,36,23,28031,8283,19748,38,33,21329,8099,13230
9a8605c24a1f0793e62fb271e537680b,116,90,277271,38355,238916,110,95,221548,48935,172613
5489af709ef0438484f4863f925a1c4a,103,82,224156,60765,163391,150,125,405595,58121,347474
ef152d3ab25eff6922da02db188e9506,166,142,745673,145530,600143,193,144,766716,175144,591572
bfa26b243bdaa7e31329615d7f623e9d,69,54,83502,20780,62722,53,36,65139,28537,36602
962762a314dd9186e8750f818d8ab5a8,145,126,409136,81071,328065,127,81,253477,61426,192051
4c642ced71c045c6ba489b54d0e7c139,37,24,24978,10339,14639,37,31,26437,12547,13890
9a03db9520e4a815b94c0755bb6fc44c,98,69,130592,30254,100338,124,73,138909,27935,110974
c2f7d82e8a96e45be7e62bc0cea6e723,129,109,260923,54034,206889,101,84,166311,49582,116729
3529b3f14fe513fa41e9c1131c1e3b28,75,48,143032,24543,118489,86,57,129657,33279,96378
dfa32df259fc3f05d10f114e010f8192,114,92,204535,44835,159700,125,75,171219,43990,127229
f3224731ed6607118f0f3af892ba7f78,33,31,39210,21543,17667,34,28,42306,19344,22962
232674d7a74d857fd0c18cba9665d24b,136,112,346448,89128,257320,116,84,235891,76465,159426
f9ae92f3338badf739e0a1e40d0bbacb,65,39,71515,14285,57230,46,37,52357,21290,31067
0337752945e214d6117c80d85419277f,158,122,525999,135565,390434,161,119,492832,101677,391155
00c6b23d70f81b9063a0565cd24212f6,26,12,5948,1849,4099,24,17,4931,2490,2441
f0cfcbf93fb90b37a09e03726d56beed,13,15,5010,3409,1601,22,13,5286,3347,1939
372f830ef7d686193559d31211cb1b55,43,31,77573,15567,62006,42,36,76382,32527,43855
66072ade760e3986d4b374d8c45f5851,106,78,311512,113939,197573,160,126,458482,83416,375066
8a2ae28fb9314bd7c7fa43a35b1fb773,130,104,237493,75469,162024,105,68,236157,67645,168512
5610828271256400d8f16dcb8a541e78,155,113,376687,72005,304682,124,112,331007,79148,251859
84c06d202c4159dd06f677f2d1e1a234,65,50,130503,52361,78142,76,78,165179,64634,100545
2318bb50ea514750850498d5a16e0e9c,123,91,204234,57293,146941,114,82,241038,42035,199003
ef0e638e7347211a321737f39f787b8e,93,75,159976,41025,118951,96,82,169715,42838,126877
8296d067a06f4de18cfd011dab8a4df1,196,119,466497,116903,349594,142,103,358149,121445,236704
f6cbb2b63a20cae576a3d1edc1c4d659,143,97,412063,117364,294699,165,123,648850,129749,519101
4cce149e8314af34f4305d00c08cea5b,22,14,7309,2743,4566,19,19,5477,2808,2669
701f748a1221f921da5e35c99ae76e4b,33,38,48593,19799,28794,52,36,50044,16412,33632
c2c7495db75931b39f775c8bfc3c8032,78,62,156997,58508,98489,131,80,244423,45529,198894
176a470d767bd6c219aa14c7bbd1ded6,135,108,343786,104840,238946,181,142,524072,102911,421161
6b6a9a8e64f536d35e8f430c7bf4347b,35,25,28108,14773,13335,60,41,70271,14010,56261
58ee8c4351a6f5557ef8af13968f960e,213,156,728209,177830,550379,171,104,545760,125853,419907
1aaa2936f9d0b8ad66cc8db73bc0a341,182,128,540939,151292,389647,146,118,721474,144798,576676
db6b0add308323b36539aad1213a0a5f,116,68,210557,35209,175348,84,65,117129,63970,53159
1eaf17988c648b2ee0fc12318dd3bfa5,87,70,156541,43915,112626,124,105,265673,57132,208541
2d1b90e7054819391a31fc37671b6e77,64,44,95592,33701,61891,78,65,103985,33967,70018
9a08de4071c36a7360832e5cfad4eb3f,33,30,16678,7978,8700,27,22,13542,7527,6015
c44eb3a68403fa370b8007a9d1380ec1,129,92,469690,104569,365121,195,148,783998,134207,649791
cdc653fef7c2778f72bb0c5898636e2a,30,15,7769,2817,4952,17,21,5720,3260,2460
9a752c8bb2003b469a21c5e698b93df9,50,45,76592,24946,51646,77,62,111509,32596,78913
8fa7d63db7de510171a1edfe9729f785,125,99,468412,119352,349060,126,88,494630,112346,382284
0750fb68ed86bf25ce174f82a1f8ecc8,108,81,225615,40994,184621,91,66,206236,37346,168890
a22f15f6f88697342082d52bd95bcde7,117,91,229745,66949,162796,107,67,211957,62403,149554
b38435533f728232044369eed4506648,150,120,400623,106873,293750,175,124,443962,118579,325383
9383aef18c9f191fd19d4daa08f7b3f3,37,35,53864,34721,19143,56,43,113878,21497,92381
630523020efa64931b734a53ba4b1100,142,114,308573,61125,247448,142,102,247696,68487,179209
39fd29e6ca1da2a23bb119835f4b95e6,146,105,502726,99338,403388,156,139,467633,81874,385759
b6cb637391c40d83c1c4755bf5683291,142,111,547779,134374,413405,200,163,994625,142430,852195
aad353c5683085eebb4b2389432ed83c,69,67,104144,36896,67248,64,40,106742,19302,87440
84ee7f474251caf38733a3a00b51351f,4,2,788,162,626,2,4,162,788,-626
4ebfa693e19f2e1397aa85d4a73195e9,28,24,20378,7020,13358,32,26,20360,10961,9399
8f15529ecb4ea7cc52c8bb73826efa2a,84,60,130487,32299,98188,98,68,144981,32549,112432
48bdc08709893bc0519e5ed54d220d28,36,32,23787,9131,14656,31,25,23043,11123,11920
fa3cb1fdc48a49cbb3b3fc12d96d1de1,146,118,338469,56865,281604,94,79,196221,71040,125181
15430bc60e9b86c16bd252c6d2a5302e,49,44,53966,21994,31972,54,38,56379,22470,33909
6baf1b3e96528d6b5b5137c339cf5657,85,51,136400,39910,96490,93,77,168883,43465,125418
8ee96b56f17fe2ff1512a83d5d9d5b71,136,110,345150,67948,277202,152,125,428186,86707,341479
91f76b184d2a11de66f5acdd48a8781c,98,81,228228,122339,105889,142,102,483063,102691,380372
9ca09a44ac318e79bab31462762efaab,128,101,425224,76389,348835,131,110,364147,81902,282245
07fa8dd47aeeaaadd86d52be90c410d3,152,114,490809,147444,343365,182,99,453096,98374,354722
8b8df11309e6d7433fd246df807acbb3,86,62,254676,86768,167908,125,88,401505,72025,329480
e396a557da2d66ccdb6d3235bbc548a5,0,0,0,0,0,0,0,0,0,0
fc7c5216ca00f168acba2d48f00b6dcb,15,10,2927,831,2096,12,9,1561,1231,330
31f74cbcd8930d70a8924773a5aa3ea5,29,20,13163,6555,6608,25,23,10501,7236,3265
d225d49edde826cfdcaf21657625db86,43,37,29240,13276,15964,29,24,21367,7899,13468
1761a826260b15c9288155c7f0656b77,120,93,276632,70655,205977,115,93,269548,61760,207788
68ca487b9babed189717ed8d7b4f4027,132,106,449919,82338,367581,127,91,345125,64571,280554
a8addf039a27a51722564ade26f7f949,35,22,20607,8108,12499,31,27,15805,9426,6379
f9ee17f972ab42f61dd980d1cdad0c96,171,123,433286,90055,343231,141,89,527438,108921,418517
7068f937cbd11a9706893942af8a5eed,96,81,315637,99058,216579,159,120,393672,94242,299430
9009f0a5380ac240c8cac43d676914c5,41,35,44420,12770,31650,37,25,37693,6164,31529
00e55f5329470e9e0ec819ebcfbfe217,45,39,56872,8490,48382,44,35,28724,11710,17014
abdbf18b29861f1f44a5bdd21dfa21e0,132,89,293164,80035,213129,89,60,222709,80559,142150
5006b8e030934a03db52c2f27906414a,46,41,33683,10413,23270,43,31,23806,12298,11508
53b8d074728963af17ebbe789588299c,63,52,82680,22260,60420,53,36,59383,19507,39876
de931134b98a07a3c3e86c7a1160f573,137,95,461819,94627,367192,187,153,640196,106159,534037
bb71d89df100d030fdaa0c169df088c1,72,66,96363,26425,69938,65,67,91514,28967,62547
71327752d582f1e2088f6db33f50670b,77,64,170945,35932,135013,128,96,242382,42876,199506
f3bc16a70b44a0a5733d1899db1bbdd9,156,118,534745,118484,416261,97,70,234082,70945,163137
a847458d4707a5a4377f04754d76240d,68,54,61385,14436,46949,73,54,83773,16470,67303
2fd8490d22a2e6dc1400a4ad3906001f,42,32,44230,17153,27077,58,55,64085,18575,45510
dd56bb30bd64149b9643b9b03ad77f62,51,44,58077,26075,32002,46,36,53160,22720,30440
7f4ec1fed72790c4b92077951aa8a1bb,60,53,81681,24161,57520,80,54,99241,24596,74645
1ea91aa389bf08b0040708b417c72ec8,95,66,181560,62184,119376,107,92,255138,74770,180368
c66f46a8de26b18df03e97790baf95c6,68,52,146970,39232,107738,62,51,127133,41160,85973
fd81c50f3df3542f18efcbdea49ac798,112,82,222561,47617,174944,147,103,250165,46816,203349
5d579207895e74c8bbcc51769c05677e,170,117,499537,97618,401919,157,125,398538,117294,281244
9bffdefa6b11c8bc2e55d56eda772612,36,35,60949,20767,40182,36,26,53875,18378,35497
3f2400e27ddbcf122c8b7a13bf46c520,96,81,215312,74284,141028,134,98,298899,77875,221024
202005dc1983f53dfd0e342d8a2a5237,71,56,88288,35064,53224,75,46,102670,26004,76666
81891f863159e298b78a5aa1d81edda7,37,32,35863,10284,25579,45,28,30488,9361,21127
17a24321a48027b26e09350d81622f24,37,34,29257,12429,16828,32,22,23015,12249,10766
8fe723a38dbda4e82be7e9150f84b1b8,101,78,159391,52686,106705,97,84,178949,48626,130323
353dd85d27f420369da335ce3d1cd328,42,33,35777,12866,22911,31,23,25409,10842,14567
01c5253b37e40504541cb80d67215df8,181,103,446064,63427,382637,132,108,374663,81490,293173
cd8df7e8aff8ec9ac341b9b754ad7898,126,95,254729,65542,189187,103,72,184994,77973,107021
04cc5d7dbbeae048909f7ae2affba104,106,78,163444,52288,111156,112,99,200627,60249,140378
c5ff0013d2f211e751d08c1cd3466bdc,24,16,13405,6009,7396,27,18,18362,5682,12680
fca4fddc092d6c29bfebe022ff81467c,92,71,198462,33785,164677,88,64,164036,43114,120922
2f5ae892d9a241dee07894ac224f6730,91,54,155984,20016,135968,64,57,63798,28283,35515
5cfc6aa15f89f5fed9700d32c895d9bf,36,33,32226,11601,20625,33,26,24031,11716,12315
e5027f735f73178f468b0f4a5e535a58,40,24,25043,7681,17362,36,27,14480,8944,5536
532df5291f26a6e088af3a1f243dea6e,214,149,868401,127601,740800,174,120,601268,175130,426138
b411107194583faf846cd6f1c49bea77,43,32,31311,10316,20995,26,23,18197,9614,8583
7de5e76131cb2ed5e76fc19e57050e32,202,146,1223045,235246,987799,229,166,942545,226380,716165
327ddea0642dec526caf31ed9694da94,106,79,277520,75173,202347,117,103,292479,101545,190934
9032c012e24f65110235f93adb2a70c4,103,79,224436,44032,180404,125,93,303045,41698,261347
8695094f9ed0114c3464ae5b051487e5,74,60,137337,49169,88168,101,66,178515,37335,141180
d686655bc6aac91b6328a259cb040248,93,68,162505,34361,128144,98,73,148286,42744,105542
32cccdf03de46b43a49a07d413d7f876,19,18,5544,1463,4081,15,14,5332,1595,3737
7f7200a6127a0ac11b021086acebe56e,57,41,69445,19921,49524,48,35,53186,19127,34059
eac2ab8ef157ff0a4b2225f789a3cca1,160,120,730834,75951,654883,189,163,695615,138478,557137
27a66fcb6f6ba7dd412d4183e3991289,49,34,47368,8775,38593,41,33,28909,7811,21098
404f9bcf4bdde74e818ad4de7fed6f09,194,155,702070,50964,651106,148,114,455727,66332,389395
e7b47cf896fb4717e9ba2823fbccabd8,91,64,153746,38141,115605,93,83,196274,39999,156275
cea2f2d38c33904f1860e76c3c519122,161,122,894872,151546,743326,171,139,781305,200581,580724
083ebd27857d757bd7e8af4bc35745b4,98,76,185407,55547,129860,103,62,142360,61242,81118
447f5c0c3849453d10a5405062cd9ad6,96,70,122926,48354,74572,93,61,110032,43280,66752
ec52ca3c2edb9af1a7ebd0a569a7a496,175,112,662656,101255,561401,220,191,707152,170167,536985
399fac81dff4af22dbefb635a585b7fb,140,102,372932,62292,310640,118,95,292219,67256,224963
bcd4c8c82a0c7f312dc9961aa4d94954,102,71,167074,38641,128433,100,66,153242,38015,115227
3458dee989a3bb1a37de87049a737594,21,15,14858,3066,11792,31,23,25832,7177,18655
89fe4d317dd8f863b6a381900f963a30,48,31,42438,13015,29423,34,26,33723,11590,22133
4f38d46c4b708e591be34f718b1f370c,43,29,31499,9915,21584,50,35,40595,11894,28701
54531c0844d84fde6edefe32f9e584db,121,83,179937,34514,145423,72,64,101308,52541,48767
a54e21c32caaa58a4664bdd9f0e93f0b,139,106,550926,106735,444191,191,151,598910,88690,510220
c1f341c15693e159ac29651a3dc6d359,23,15,5957,2445,3512,19,14,6619,2481,4138
e19293d1572cf8fd37f600fa651de9ff,126,100,224747,70342,154405,115,91,220074,68109,151965
55e07763d42fca9fb433de347d164605,5,2,616,394,222,7,1,1088,53,1035
bb52c5f43b90f769cca9d1e66b302386,26,20,22384,6319,16065,32,23,22460,7254,15206
28ca046a3d306c3b07dc0c7ff2370324,90,77,317738,107714,210024,139,105,296583,87166,209417
c886db194406622329428a240a0a8577,71,58,101137,34178,66959,63,56,89843,38953,50890
0a285bd0ec545f1ad528facc5f66d1d7,138,112,332195,74700,257495,102,99,225131,75467,149664
c1b3b62948e64c8990194bb83c6cff64,96,69,247120,78482,168638,132,101,385505,67570,317935
d5f0a8ffc7f5bebac501cb6edfad8636,152,139,448922,138036,310886,140,118,474358,95940,378418
33d2b1bcfc05e30514453f92f71a6f30,153,130,484882,129974,354908,168,147,513577,156766,356811
7ca2d614d5b60cb15ae554d3701e7056,181,114,798479,127899,670580,201,138,535914,126949,408965
0f37553ff96b8ed7289f275fdd1b3aa5,125,94,266643,74960,191683,163,117,351012,91658,259354
6c91ec273455587cfe7360420e1a12ac,57,40,61992,16810,45182,50,45,48944,18342,30602
2e91609a17b4e1cd56ce26df4600d8c3,39,32,60689,19606,41083,34,32,40531,20517,20014
498bf8e75aee3ed1ff987d43bab316c1,79,61,183158,64736,118422,134,107,346363,64118,282245
98d293d5092f0d0cb2112eb588121065,9,10,1989,1382,607,8,11,1521,1625,-104
203c52e23d346a98e41bdf71b74beafd,142,106,344632,53542,291090,135,109,312525,72100,240425
bcee498d4770d9442865f1aecd673839,49,36,63530,12968,50562,39,33,40705,11361,29344
4c532e8c5aae704c7f6a84ae77ddd220,64,46,62611,36578,26033,65,53,76652,29532,47120
66f27e99452b1c7ec7d78747d2f609da,23,15,12017,3441,8576,24,16,10785,3070,7715
708d47cb75b48ec5967c3834963c345d,158,115,355517,122527,232990,167,129,452365,119581,332784
6ba7d987d323d11fa22edfb1ae36ebf1,31,20,15370,7354,8016,23,20,12772,7073,5699
e5654c91be968f3285a23c2a8e075e69,122,96,280714,67644,213070,121,97,296543,79381,217162
c4844c6629e8cbe2820150b50b2f95ea,150,129,561804,127433,434371,178,124,621595,109882,511713
65f4ad76b0fb6d026a5a5979b9f1be99,92,71,178384,29142,149242,71,64,80897,31791,49106
32cf93941b4cdfbea08355c824c084ed,217,142,683144,156474,526670,139,114,676914,155872,521042
994abde836215e99f752c0f1297270f5,34,23,25478,7955,17523,30,21,27729,6729,21000
d70dee1d296efdb8b68ee61d061ceaf4,155,112,346769,85560,261209,134,99,291345,91468,199877
ec7c12cd5c3a484b9946cf83eafc7cea,174,112,664637,126695,537942,163,108,695511,143796,551715
85739692d72079da0da40f6dd51763ed,86,71,217073,51469,165604,111,88,323892,68374,255518
599b19925611fd8942bd8920e3c2b8d7,92,79,110456,27907,82549,86,73,108509,27051,81458
4b54eb98b9775969688bb2e57172d0ad,186,130,519521,111061,408460,136,111,384571,150530,234041
07852f122d7ef9d6f08efa0628bc20d4,111,95,220747,41379,179368,92,71,162869,53469,109400
489c5be0a1a2e9b4b494569355c13499,93,77,188317,48608,139709,125,107,284026,88660,195366
0f09e0500f417c0a24a1a8e04f695e71,61,50,84882,17357,67525,67,50,103110,21748,81362
9e9173a224f0651137e17265fa2abdaa,66,48,99670,27427,72243,79,64,97397,36469,60928
fe3d9084e1a6733e06bcf9459b63d80f,68,54,97267,23654,73613,70,57,80796,25383,55413
38c1d1d8eda87a6d4b0e69196b7839f9,134,99,375428,116360,259068,125,108,342800,99288,243512
3b0bae86ea0a566308fa474fdaff8eb1,77,60,147848,30727,117121,100,64,169789,27353,142436
56076e4c98cbee937edae0910b23441b,115,75,183816,32608,151208,72,57,116415,37496,78919
d08fa4e3f53546f0a1d0f8599602fcdc,81,60,119451,35001,84450,75,59,105757,32664,73093
c909a9b3d356f062443e61ec8a3c2b94,116,81,237531,42187,195344,124,117,307645,77920,229725
51d847129883cbb7c1a2591fa75c245d,106,82,224997,71586,153411,88,72,215674,50476,165198
5f1059b8cfcf836d44cada655a7e37f8,172,124,668474,147964,520510,172,111,529340,111014,418326
9c524a51c3127b9429b220ff8dc59482,50,39,70232,17067,53165,40,27,39967,11723,28244
5536c1e66e0757251f7dfd1f203e11dd,75,47,87645,21291,66354,83,68,88628,34779,53849
115b3fd8db4e227104364e39f5c58dfe,13,6,1416,526,890,13,10,1365,579,786
5826432d35d2ebaf71c499a3522379ef,93,61,134369,39513,94856,107,99,179114,35402,143712
3e3194eefbbb1fefa42621dc899f5973,27,23,15794,7490,8304,24,16,20734,3959,16775
828d6b7cf99e57dcd5d43526fd3fdd59,131,101,295064,58866,236198,126,98,280055,68061,211994
9c9ca7d2922603a4765a6e6ca19cace0,187,134,788338,157564,630774,201,146,937597,145268,792329
0f6655e15de9b5e3e7fd926d316e5cef,163,122,788594,151702,636892,170,133,676358,177257,499101
b914c6d5aba0a53613314ece74f2d13c,21,9,5086,752,4334,19,17,3284,1680,1604
020a158ab1aa88c3c87b1c6c645e950a,222,152,765348,202740,562608,174,129,946659,117143,829516
8619fe065793ec55a1a816e151b0e331,95,67,164616,43424,121192,83,60,161398,50290,111108
a19380e78e0bea6b4fdd4063a7d48355,63,48,59496,30091,29405,70,45,68189,28571,39618
b682d90d3d31428164a8436754c8b403,150,95,285400,54091,231309,110,89,231187,73059,158128
858d2d43c6e8e21fd4e34a46a06d7813,17,15,3352,1342,2010,14,10,3033,1008,2025
12b218f945fcc9701f3c2aba622c079d,40,28,37252,13694,23558,43,26,42347,9783,32564
de709afe7aecdae3f4f5011de7a2cada,56,46,71215,27765,43450,59,49,99228,23377,75851
0ff1f5e42ad13ca5bee8a4968814d80d,27,23,17597,6205,11392,31,28,17409,10594,6815
e0a9e218e402f4e36cb073ea9b4e3190,21,19,8204,3744,4460,24,20,9504,3755,5749
f2ff26552ba1932aa7638a330c4999ea,126,86,314220,77276,236944,132,73,345109,97755,247354
37df8490fe7d86dcf8a988a50f53af8c,52,44,65687,20424,45263,51,50,53127,21508,31619
6164f3ca1c97e1ba9fd2345404cb4724,132,111,398998,79488,319510,143,129,417792,103699,314093
2c3c3e029f616794b29f6d8d231251ee,50,42,52117,18121,33996,50,34,51126,19604,31522
cc6d69604807b9160519de06bb3b345d,160,118,413248,70850,342398,113,72,260922,92554,168368
f83b007553efd47ab75149377bd9c9d7,101,85,204767,42768,161999,102,76,163417,58267,105150
ad6dfdd787f7f23c5132e069963b5a67,112,80,281928,56186,225742,136,118,375749,81558,294191
018e2290086f0436c5e01ad8a4610ca6,98,78,273783,63363,210420,129,97,315620,83518,232102
6a97887e0d8db6d188f7fde890b47f13,79,64,162225,62048,100177,94,82,150871,56387,94484
b49b52b105bec2e1e43642384a232cb6,146,125,481148,95991,385157,116,93,327504,115494,212010
62c352ee2ccb38512cce6e07aa41b219,139,112,428594,130148,298446,159,121,518983,93664,425319
793a68c7bcd1eeedc6d85e08b1419b1c,163,113,543510,50583,492927,175,129,522293,76941,445352
6cc8f530a71fdecb9fa9cb44f1526058,40,28,34820,13944,20876,52,40,51313,13730,37583
04c834d865e0532cfbd92b31afa92a18,104,69,211114,63112,148002,94,75,193988,65784,128204
e875e8cfc921936ab1292fc58f953d27,53,34,74941,21571,53370,37,35,53555,25037,28518
4409d4c521539d641be158e5a690cf21,159,115,814357,116947,697410,217,169,928069,152581,775488
30533dbcba4571af0d5e93a6c1eef128,74,44,112167,26481,85686,60,46,70728,42123,28605
95298405365359f31d38c185f134bdc5,54,34,48339,13811,34528,60,40,90494,14217,76277
f1cd6d6421fdd3828e26977035f03344,134,87,266982,51487,215495,119,94,244014,72591,171423
00e9eb2f1ab76f81643c18fd30cd5ff0,28,23,18916,7503,11413,27,20,16735,5122,11613
8a78639391f257a031d273a0d0c1e272,80,65,117268,57160,60108,105,96,216037,48054,167983
8a6f047e3f5f2894fb140ea042256576,46,37,31391,14176,17215,60,48,64720,12240,52480
997652b36a8a6d25e3b697d6468ab139,82,68,132020,36310,95710,73,55,115180,40032,75148
a9cd19a6d3491cad55053973b111d174,117,86,354096,89628,264468,179,149,566531,97089,469442
4378794016077bd9f9afd83385cce88b,76,60,138842,41600,97242,80,63,131595,39839,91756
b62afcc79055b035a8efd9a8912882fe,136,108,413759,104403,309356,172,139,517454,100497,416957
71d0255a4ff43fbf4f258ce9585bfe0e,131,104,320374,54018,266356,145,116,356257,55223,301034
41c2f0b2c7729573ac9bcc8313d1e8e6,183,121,706466,142434,564032,179,146,598460,182000,416460
f756ba4a4980bbafe6801b90378a31b0,184,138,711818,145561,566257,162,145,583476,147886,435590
749d6ffb521521df07f2912ea06fcd9e,59,47,81146,43724,37422,92,62,169359,39655,129704
5f2ca328605a5d6e67aca34fa150ad93,180,147,762592,134856,627736,223,157,760439,143264,617175
e188c7a5fe668125867908c178485bf3,127,87,369161,77803,291358,118,100,357469,63817,293652
8fea8e9c3eaf81e48838d8f293179820,42,38,45709,19009,26700,62,38,52376,16360,36016
b9412ab31174e583b43b543b88d7a16e,150,136,494173,107342,386831,147,112,539640,92176,447464
e7f5601b86e5b02928de5d45b4188d17,23,20,6211,3478,2733,27,17,9677,3782,5895
4327012856e2f4dd291c408ef4bcc67f,39,23,45830,9395,36435,32,21,39062,7159,31903
ef6c22f828f2eb05ae814e1b1222e487,102,68,205684,71019,134665,143,89,314027,58211,255816
cb061db0e709994db2222a49130bed86,140,91,240957,70929,170028,121,87,267450,41615,225835
3a2a47e7b8cc069929575a0c4bd14354,128,118,248864,65260,183604,137,95,310912,52079,258833
38ccde54383e80919687f65154ed9f32,136,108,353212,48908,304304,156,112,399341,63895,335446
0c0469e7aa836c30f0b21e1cdd602820,39,28,32424,13354,19070,37,30,33022,12767,20255
f08c159894c08b2c5a9aaf0f2d437cb7,42,34,69887,24891,44996,80,64,152236,28099,124137
7c7a923ead47da5d4316e15c605a870b,168,105,418999,89076,329923,116,83,323072,87395,235677
b8b2a4b4ca5c7812789036f02ac99d61,87,69,104399,36369,68030,77,53,98106,24339,73767
c0ebcadd99f0f984c7c039dc030aad68,179,138,669627,186000,483627,202,139,808159,151274,656885
d59ae905c47c50d2f66c6650c593ee95,138,108,378522,130656,247866,119,99,354060,92897,261163
976de16aecaaa742cf4a80eeb34ca7e2,144,115,316537,87440,229097,155,108,398646,105322,293324
b9b66aa2c519b243e863107b7f618d97,150,107,524877,82357,442520,178,129,539795,70569,469226
9d30895c3742631e2e2ac98d61051b45,121,101,305722,55612,250110,145,110,327873,52939,274934
f4fe62d073f8801d3a8076fd07e2b118,200,150,977572,174828,802744,196,136,671738,174090,497648
96460228a6d43757b8e33b4e08d9e5b9,51,35,55791,11660,44131,37,22,30584,11111,19473
df0d6141d9560078411d0d3eaf53a756,20,14,5283,2796,2487,24,23,4951,2609,2342
93bf032a62e39293293d1ecd462b7dac,182,136,552206,62551,489655,147,94,385663,55711,329952
98026ee5d67ae0c88440719ac35be8ca,36,37,30620,21288,9332,47,30,47777,10486,37291
b8a264d5f8f6eba38fed87830bf9d49a,24,23,16958,6223,10735,33,23,23842,4275,19567
8a4015334a956449f3bade472a1af898,137,107,352423,71227,281196,82,65,322100,59887,262213
29a6d52ab1f14503f801583e38225347,94,71,198988,55489,143499,85,64,194034,52948,141086
b633a81772c1c9ab5479f95d8daa5e39,62,47,63976,16668,47308,59,50,60373,17472,42901
badf53495d41d1c074178ef3f5829a1d,126,107,357393,87644,269749,153,117,347968,80911,267057
4e9062f7ff2bb779dfe7d065a6c8b4b8,156,105,350413,87961,262452,140,125,446952,76632,370320
eacf7c1682c65ae862eaa9a7b4f34fc0,56,40,102082,46397,55685,67,60,103822,45574,58248
e591cd87ad8eb30091199572526b13aa,2,0,298,0,298,1,3,43,312,-269
bbfeca7e991e56527ce759f99ec8550b,16,13,2575,1514,1061,17,12,3081,863,2218
06f0ab0f51a5f04e6974c53e6a6abfde,27,23,21933,5434,16499,34,29,23347,7074,16273
59a35edc36674d2043a873fbd7c73893,44,37,46728,10688,36040,36,23,27098,14639,12459
9907f197047006ad0b2f9f2d27609566,51,35,35039,13524,21515,38,32,33184,11945,21239
2065793351578f44390554fe6e0effcf,29,25,16295,7228,9067,30,28,20322,8149,12173
b0cb69409f9b2db2f165e27f033eda40,97,79,214300,51725,162575,89,75,178759,53430,125329
0378ff5698da74ef589ff942fbd51e36,162,120,475981,112603,363378,152,129,489563,132190,357373
b7d88a33882207661cbff0691617daa1,154,99,384440,57457,326983,142,108,305152,62727,242425
a2d641356f72a611698df97503baac6d,39,40,29985,10871,19114,45,29,26247,9175,17072
16fdf8e1896fd6545209454b9df9471a,149,97,265172,45511,219661,56,45,146349,47954,98395
176e2cc185c9929173048fe1b1c72df5,80,63,145137,38068,107069,87,65,134991,38392,96599
60ab10ce65a88b1b9117e46ad69fe266,58,44,212053,55998,156055,96,60,252832,46307,206525
804ee7b7cd3ee3952922255fd07d31c1,41,29,45301,18695,26606,34,23,39941,14855,25086
310ff3435e764796a8b7edf66fa52516,102,89,199378,41734,157644,121,84,218453,42985,175468
ecd7d0bc128ccab55b51d60e70ad158c,168,136,866572,133243,733329,169,157,556943,116938,440005
4528c7b25ecad29dbb30259f73ce1736,43,33,39117,23108,16009,43,35,48542,21617,26925
219d27d63eca99e7b486155659f22291,28,20,15403,4445,10958,29,27,9893,6055,3838
110d2689ceaa316e33c068ef5288c312,13,12,1530,1126,404,17,12,1913,1283,630
b2b84bf212fb1146e9f74a328eccf15e,46,29,30408,12102,18306,54,34,39918,13054,26864
8c82cd2b3880d115f4a6af9088a3686b,132,94,280674,84813,195861,160,135,322453,86987,235466
c59ae133b436a96ea9ae84a710da530e,32,26,37025,15257,21768,40,27,27627,13250,14377
f58b56e94abcadaa08b152c9798e5096,60,42,65073,18677,46396,63,46,75268,22546,52722
78dff7b447a017ab03847bc33bc00e7b,58,50,73589,31108,42481,72,65,102498,29709,72789
24ad6b75a178ad2dbf34d579008fdc16,16,10,2575,1105,1470,15,15,2419,2107,312
f5482ac935b0629f41731630513f7939,151,101,414282,82395,331887,175,131,484617,79854,404763
e0f6790de70631c2e5f213b505a44451,158,113,330992,87139,243853,172,132,490315,80128,410187
fa7bd9b248895477ad7d02ea5b0d9906,91,65,156363,47244,109119,93,73,157923,40103,117820
e2ae819576e1e9ac3125c611195a728e,50,41,53018,16028,36990,55,35,70142,12399,57743
6d8393b647bc1f50cf74ae04f34aea1b,125,99,332102,73267,258835,131,111,409390,69421,339969
ba2758ab165f2d1af91fa376d1c24d8a,60,49,108385,26092,82293,82,73,122086,38157,83929
0efee0d749afb62607f08f7ac9093b2b,24,17,8839,2086,6753,24,22,6163,3582,2581
5b9f69ad38b6c08ae7cb1d0120438b25,105,79,213144,37049,176095,127,104,313102,56491,256611
a5a0e999851c63ecf10f0dc43b53e271,163,133,671027,187213,483814,192,167,778941,187358,591583
e6e270d63fdeae543b657b85561bd776,138,88,350528,74268,276260,150,102,399208,56828,342380
f37299bc08e6a66a2eb2c4e108daee8a,66,56,123755,35260,88495,64,49,139278,32526,106752
1650c6866acc7aa41a062d4904244386,114,92,241177,56178,184999,120,92,268116,54155,213961
99bdda520a432851af439dfe0b722f85,191,137,812872,102285,710587,159,127,515888,119306,396582
5fe2b79be80f8ef6d390b3e95807575b,116,92,229519,51243,178276,101,76,187095,40411,146684
7a71253556e34baf4e39aa4b19a603a6,24,16,8024,2408,5616,19,19,6554,2739,3815
f3a29302a16bc42baf595f21264bdcfc,151,115,561879,137230,424649,197,156,1056315,120066,936249
26eddbdd92039ee2f291d050132ff2da,67,60,131273,39299,91974,68,48,127551,31652,95899
1f0781ac5b9aaa260b9168fd421088ef,100,80,176132,36155,139977,75,58,103426,33972,69454
4d9e04c130be80bd700da612b8fa7a85,44,32,24574,11680,12894,42,33,30197,8098,22099
bb03397ea80b4b3d7d8402563a0ee361,73,51,114638,27720,86918,87,75,110602,35310,75292
43f2a739a48197e9b1a5c3a5b5cc04cb,74,52,114892,32083,82809,64,54,110546,38025,72521
577afd60171fecd6aec942ee3c3d4a06,20,17,9320,3133,6187,31,23,7774,2010,5764
caf28a02ebe5a53bb4a48c85fc744442,15,18,3077,2051,1026,18,16,3127,2175,952
99f5ef7c2b342c15b79da62151d52f9f,38,35,20690,10225,10465,36,25,25160,5846,19314
4e1be10096361470219d24c40bee8690,97,91,174737,46332,128405,99,73,176135,37761,138374
124a2d5dc876cf34013ff9017a99eabc,68,54,93104,16442,76662,75,65,85085,24309,60776
b386c1c9afe8ad32669d04444cdfa954,92,64,253303,109631,143672,191,129,496427,93349,403078
2f4c6a11261a809fa797234e514f4a35,124,98,342922,114140,228782,123,95,343421,51553,291868
65af4eca6ba214875f3bb023806c25fd,68,64,88925,32434,56491,71,61,91898,30173,61725
b3c14aa469d6a6176c5f418d95f50c8a,79,59,156838,30015,126823,78,63,89961,45666,44295
492db97dc847365deb4e34bd36825e9f,102,78,184611,38112,146499,125,108,253131,36170,216961
5564fd25985430730fd2f2a54d005fc4,35,25,77230,14014,63216,42,25,63604,23830,39774
a897d6b7aa2a58ef404f32fcec7dbcbd,133,97,289953,68514,221439,143,100,279262,84447,194815
9af39d7eeebd00c172c0f5bb7987d46a,55,44,123292,34518,88774,76,68,144152,50048,94104
1846e566d2115fd29f1337bf8be80ff9,170,111,1011513,240208,771305,218,150,1033226,159588,873638
fca26bef2ca5d6d10e2549d2441c4700,69,51,117161,23095,94066,73,64,117519,34187,83332
1a316aab20bd896c4d812fb4244b77b4,112,83,282098,47076,235022,73,56,117707,53937,63770
3f79d53eeaf4b73a9dcb3c5d980c12a5,39,35,23433,8821,14612,43,26,21409,6699,14710
3186b6d108056458d4fd973650f80916,51,36,59592,18002,41590,44,34,46229,16719,29510
655f0025aeb9c77989ca9dda189560b5,174,133,596040,154283,441757,148,122,507741,152796,354945
284300c23c495e4f36b8df994bc686ef,92,73,134641,22440,112201,62,59,75229,26426,48803
e397b00e6bf8922150431cf0b63edd20,86,63,154701,25716,128985,67,54,91118,33665,57453
57a859d268855856183695a77a0663d9,66,47,113312,38882,74430,109,93,180094,49589,130505
7ebebff9eb8362a5a7eaf7cc48039edf,125,98,280778,75491,205287,168,125,390544,68953,321591
29097d53f9615cd9eedab208c0db6e62,30,23,14438,7284,7154,27,26,13841,5490,8351
defe8d7be6d107a6c1191e362a16188f,27,22,15976,5415,10561,32,22,15381,6007,9374
b493a2d7d266a9135e7f509bf780b96c,159,114,283127,77319,205808,107,69,249810,76322,173488
f82e4506e865564be31aaef4e707628c,140,105,247624,43831,203793,106,80,210293,38985,171308
14a3f25931d0b35af9593cce98300815,171,121,445130,87264,357866,129,103,326179,105491,220688
7165fea28c42ce79264f58e39b3a280f,166,131,462788,156846,305942,176,116,532334,137909,394425
3c8bf602dc2a3c901c63133a5cb1fc44,75,54,143071,29566,113505,97,86,163977,45436,118541
6585e7dea162c48d53fc4ba54c6ba17a,12,7,1270,503,767,10,8,1393,540,853
2447595d8a21d692455a70c756d40bcf,27,18,14870,3304,11566,29,24,10649,5358,5291
8628453d683b2ba114016bccc21aefdc,65,34,107425,15502,91923,55,36,82216,19025,63191
0acc7a548c7965942071e5530a7d9888,46,31,44844,12352,32492,52,45,65453,21937,43516
99bd62ad5e5f04f39575b0e801f15f5b,88,65,164594,41432,123162,105,88,196927,61866,135061
190c5a38215cf08785fea4a64893dce5,76,67,143600,49337,94263,110,91,195463,47922,147541
4c548d25b899868c688d38f7dd5b8693,29,18,8710,4803,3907,27,24,9114,6621,2493
674878b886b3b2e1edd60e4ff7a2864f,61,47,85897,23924,61973,73,59,103798,27904,75894
ea864f4de85affa7d5d2e804c655341f,38,27,36988,7503,29485,31,29,28258,11013,17245
1ef4b30d71a61573f27500909d78a206,106,88,179347,44393,134954,124,89,224029,54906,169123
e7b2206ef64573f488543f6bba36cd4a,66,50,92524,19342,73182,48,43,52496,26804,25692
84a29e05f4f26f95d517235025310f2d,59,52,87006,27019,59987,70,61,77862,20589,57273
abbaa5e5d98abd846e7ce7e2edb146cb,63,39,103222,13117,90105,91,72,115486,24272,91214
c3e8ed3e230b14038a2661a92343a24a,18,17,6189,2079,4110,21,22,5995,3126,2869
21feac4ecdb92d6b75cb828207ab9d7f,32,25,34861,10974,23887,36,24,41199,7635,33564
6d35ef3e3a2f6f2f07d78c8635ce6e2d,56,41,90866,16221,74645,48,41,58762,24061,34701
46d8f245db0c9f8e83654475308dfaab,96,73,191342,40750,150592,102,77,139010,46918,92092
bcaa22183472e4011feb13e102f6f096,25,19,10405,3820,6585,27,18,9659,4115,5544
e8b0202999de46349257cadca90d481a,38,33,39883,12907,26976,51,37,46307,15944,30363
73a0eced8c67e6af1eea28afa6d17593,28,21,27722,6634,21088,30,20,18591,7390,11201
6a6b1758a8197a51165900dbf5aaed78,44,29,47871,23393,24478,46,33,97626,18672,78954
58a638560b7b504af28341b5e76cd8ab,65,53,112853,36329,76524,76,71,166203,51043,115160
b8f9870e3277c79d7d12ec7d6a5afb44,148,138,723214,209909,513305,191,166,852707,161146,691561
dbcc8dc6e0b8c45de4046c8ad94a8eca,166,133,675385,140793,534592,173,133,684300,143385,540915
3b39b778323d4342aefa5edae5f6a736,32,25,22956,5003,17953,30,24,13822,8129,5693
9df951d7177427b6f1ac505907279ea3,42,39,57740,20257,37483,41,34,41527,22508,19019
4d22030f47f06dc97b8304783201ff56,133,105,315329,63957,251372,117,87,216275,52691,163584
645a6f6b1c124958bb0b67746ccaf560,16,13,2371,1072,1299,16,9,1903,886,1017
cc87e1bd31b900de130e519b73741ff4,193,147,596919,128674,468245,194,138,776401,90600,685801
c29234a2a7b60d9b22d485f70a27d717,39,34,42054,23721,18333,43,27,70884,15992,54892
1790dace7aa97a98ed6728ae44ab005b,163,145,601150,129648,471502,168,127,536716,135524,401192
1847faccff9bf640847f62aec5c03b71,93,78,167433,38567,128866,81,58,123776,38907,84869
4024380f0a1a65fd7f5a451e1dd1b91b,25,18,8104,2931,5173,25,17,13403,2078,11325
20171649c906a08da41f26eb2457ee80,208,150,703093,188572,514521,205,156,822551,167329,655222
4a2a0eff01f3f15baa657d09a3dfaafe,110,85,173795,37732,136063,121,70,169343,27461,141882
a1768fe85d2c87bf609b3d8a1f67874a,25,19,10511,4237,6274,26,22,14977,4239,10738
35f967c73ef47727256bbed02d17017a,160,93,446767,79232,367535,162,121,472577,108420,364157
3797ad6db5f4bebde887c5a6dbfccaba,125,99,231072,44260,186812,129,103,277904,52225,225679
3ec21100abebfc5a404c8ce48510d9bb,22,17,10907,3005,7902,20,15,8001,3886,4115
fc79a2a545960f13dd3a63dd83ba5794,108,84,214446,63021,151425,134,109,320289,52291,267998
13d4c3e1e3609be95516244d5a29451f,130,102,307338,51759,255579,139,102,246062,49398,196664
50d35bd14916ad340d7d73aebf435033,1,2,50,63,-13,2,1,63,50,13
75feb736856f96e0a6f9329dd5031e38,122,71,250481,52938,197543,137,77,307540,56370,251170
6ece1a49fb2866742d764afd11ba6840,155,133,404014,83779,320235,116,80,283216,75920,207296
2422e3d33a6d7a38708a6debf2524c72,36,32,34064,15603,18461,40,28,39150,12152,26998
d489245be31f9f69ef24c73f920e1eb9,144,113,442084,80351,361733,112,92,334179,83608,250571
5bad20d27a0f4b06c9577111baf01187,67,48,88670,34890,53780,63,53,120051,35701,84350
4189ea8448ed413d61e6143236f23a44,36,25,37220,9710,27510,30,33,38929,9606,29323
dd9fa7b72e37ec37f6f5d42c04bfe47a,43,32,59440,18319,41121,53,44,72842,18434,54408
e3c01cb7cd688135f45b432229643fc2,114,82,256023,44465,211558,90,75,223196,66410,156786
b6587968b5ab3d8c51ec17b376838fb7,18,14,4396,3031,1365,15,11,6865,1897,4968
4c2efaa5a42a008759418a38b509ea4c,61,48,95580,24375,71205,66,38,85606,22944,62662
6242c0828d5a9dfd95ee3d771a3e55dd,87,61,88263,29705,58558,79,71,105984,25330,80654
3c03850f8100e45246484bb75d883a56,59,49,57104,27077,30027,56,52,65425,27431,37994
c02a1be5fa5fda299c89902ab72723d2,105,97,238503,64376,174127,132,108,346149,51934,294215
1f15cbd97ac44a3a62fe2f06ab37b8dd,115,95,242558,49769,192789,75,64,148315,58288,90027
c0dbe449046c65aecd8f66b8ef82acfc,65,54,127141,44048,83093,63,40,100108,39732,60376
d9f3da58a07a92e0077d4b5105749754,17,16,3247,2039,1208,20,10,4045,1146,2899
70bf654493890830363625702fd3ffcf,37,38,32895,12468,20427,40,30,28011,9144,18867
ab91c0c165124be26cfa18fcd67f3450,75,56,89101,20958,68143,53,34,80398,17807,62591
72b688a231027a7d8166ea3a2054bcc2,67,56,140495,49829,90666,82,64,113647,46640,67007
f30587a57511b9642388b81373f172b8,57,49,84679,31828,52851,69,51,95033,29042,65991
048c2fcaa60b448f892e96f52a5fe771,194,151,1381947,383751,998196,225,157,925386,223345,702041
0ccfc0a05ebed8ae4ee946840058a1e3,92,67,168623,55569,113054,131,78,233915,57419,176496
bdd9b68e8b31525ec17325cef23b9fa0,141,122,358444,79698,278746,99,78,167026,82217,84809
883a9a4fcd44451d833f98922c0f6244,135,109,435214,116732,318482,161,125,547849,115873,431976
129649b5ec723cea2281d4c6635ac104,146,108,323567,66150,257417,115,88,248916,61407,187509
f1279ca5d22308bcb3c4596d340bd70f,29,27,16637,6473,10164,31,22,16382,4148,12234
11c0e9cc549eb32940ae7341245226f5,103,73,153510,30659,122851,67,57,102590,38265,64325
6e3200ddc4cc0f60996f66392d7967f9,69,57,93283,31958,61325,69,47,80474,36718,43756
a60bb821b8915ab4aae1d39566a79dc5,188,148,552218,78323,473895,99,67,285314,44480,240834
c41cc21a974779181787758013987fea,30,24,16344,5342,11002,28,21,14880,6435,8445
11a10da3efa1eac6d16c29b9c39df5fd,93,77,184037,47024,137013,71,64,122958,40145,82813
604e7aef04dd8d9de28f62636e59ea98,181,146,631109,95358,535751,147,100,512239,78219,434020
5215ea3309d8e7c9e2d3f8165f2d8514,40,29,28377,14158,14219,59,39,50418,13835,36583
11e88bf266db8d9fd295a7166301e07c,109,97,240377,55011,185366,78,75,175379,50485,124894
58676f88b9269ad0603308d8eb5520a4,93,86,201818,44815,157003,119,89,243982,50123,193859
c6d637699c3ab43543f7ae6d4d80f1fe,49,38,64100,19571,44529,37,33,48628,15154,33474
013cb57b41464a211a5b7fb8e5d0426d,82,55,99942,30640,69302,83,55,141924,24746,117178
685ef29461757b2564ebc330b9fd37fa,118,109,260271,91581,168690,115,72,226081,58288,167793
e9596ab039ce1988aa3964883099e05f,47,35,40477,12353,28124,41,28,35455,10626,24829
6beb4cb7a1e0519cd1073a8be233ee42,206,157,653980,127936,526044,205,162,885089,146683,738406
27f150fa067cd5f195dee9a2b86c69c0,44,27,49817,13987,35830,35,31,34061,13114,20947
562e5bd3ac47b421a1e8f5a1d7ee17b4,108,72,195832,33266,162566,109,99,210995,44054,166941
741bc2880efa7f4f5122cd02969211fb,20,17,4978,2744,2234,21,19,8677,2931,5746
cc69c56b22663f5903c158f1e0a252d7,67,61,85861,18262,67599,83,61,76541,28726,47815
9181cab037e225abcfac048f495c5627,114,93,354635,77631,277004,72,51,221003,68824,152179
a389018e97ac74cc87ce0cff4a59e26e,15,12,3449,704,2745,17,11,3532,664,2868
6312d336a362da0f74d32435cae762f8,152,99,336791,44538,292253,114,90,255869,73147,182722
fe7960077e94ee6f0c584a7fed4a04db,38,27,24618,11393,13225,42,36,40195,12989,27206
078347c5c5fef659747ebe13d8fa8cd7,121,89,203787,48547,155240,93,68,184101,46268,137833
60a5a0a13d7141c379221e42a6416a8e,36,36,28462,10965,17497,39,29,21471,8595,12876
17fbb017ae54a41b74f51727cdc6ad99,19,19,13953,6785,7168,24,20,10800,5743,5057
eabafa51dc5823335711a4b26c6c5fff,63,41,50866,15149,35717,49,34,54514,15374,39140
e2f42a0af7c8b4bad1e3e11bd44ef164,118,110,231983,42213,189770,130,110,244752,51448,193304
a8941ccd017fd891492606c04b6e2b3b,37,31,29953,16882,13071,35,27,42656,11054,31602
14f900c003346dbdb736b197644380b3,32,25,24761,6652,18109,38,28,19738,8970,10768
d980ba669fcbc51126002b507fd60a87,48,42,70127,16720,53407,67,56,73130,25351,47779
9d3a4b503c1ae01db1614d0aaa463109,27,24,12954,6722,6232,30,25,23811,5765,18046
fc4211dbb33c599582706d55c9ae3cc7,217,147,1082535,189788,892747,245,178,1183656,230475,953181
da8c348769c007511569b2659e1d7472,46,35,73356,19289,54067,39,31,40500,14866,25634
1125b37b5f915c99e8ae662a9c46bda0,41,30,35014,9479,25535,42,26,31081,11382,19699
3428dae89e734744af83efbfc9d04a7f,35,26,38005,9346,28659,38,27,27669,12182,15487
0590780a9e64716d801907df55e62d37,87,60,173318,55134,118184,81,61,166357,60643,105714
7f515bd07fec825862268b596b748803,105,86,195293,39890,155403,83,71,151117,53232,97885
17ac7c891bdcf2e3db9595bbd4821885,78,61,109528,25798,83730,77,69,96153,29641,66512
dbd02b21b9baf4062da8883b8966c100,130,96,324249,69957,254292,101,79,243876,81532,162344
87f6c23caeda7faa95746191ff1a2b60,44,36,38592,14639,23953,47,27,31962,13432,18530
85d2b3c472c931b0059642abc292bdff,93,80,113966,39030,74936,97,91,149092,34870,114222
3c2eec6be5b9833c3c1915863f6034cf,113,94,379899,98686,281213,147,115,564941,99505,465436
74d10fd66048296a175023ad8ec62343,3,2,466,859,-393,2,3,859,463,396
e134b2ac43fd439ab157452ce315631d,180,141,965412,209765,755647,200,153,926631,163927,762704
11b7ea2ede4bdf8e1415fa4c5c71ec93,152,133,390208,106622,283586,142,125,481384,110449,370935
e13d7819fdaeeba210436f93a4438e21,131,110,358155,103700,254455,151,106,348482,104669,243813
c17f1e13871bdb6c535d7d62117081c9,20,17,5127,1810,3317,15,11,3055,1754,1301
d6095f86b25ccdd8a2ad03f60c03b5bc,96,74,198805,37624,161181,127,103,247716,41167,206549
fa33fd0fe42465b0d441b7aedb005a0f,95,78,208808,39804,169004,93,82,180451,59139,121312
343cd7a9cf8caa0b800d8d9d46730cae,120,80,285150,50391,234759,122,98,245359,64214,181145
57fc8c012ac490099aa2913bfb55eb6e,82,62,230355,79473,150882,122,80,258509,66283,192226
666a147d923353982a66033bfdf58499,170,130,347225,89045,258180,145,111,343914,71052,272862
349817bb8999d0717f869367d22ea3ff,35,27,48376,8858,39518,34,27,20175,10660,9515
a2adc2035422409231b74f981b110d4c,70,46,123059,29891,93168,95,52,109189,37705,71484
24cdc4430e61aca334d5ab5dadb26596,127,88,276934,83288,193646,116,93,364049,76550,287499
ac8e78644686f0cdc9646d16cb8b02d0,87,60,192810,72748,120062,82,69,206113,58411,147702
09fdb16f66d948935ec437601fc29100,49,37,65667,20384,45283,54,35,54724,19801,34923
86059ab3a78486bed67cffa62b14d7f2,131,116,276766,58370,218396,111,92,195358,63118,132240
71cb86bed16d3f756ff48be846a33537,137,88,255990,50015,205975,121,97,270566,61689,208877
d223f7286ea1596b044d56a5db9e72b8,127,96,304188,72557,231631,140,123,393370,82441,310929
727ee0b8a05d6e1e0bf27e0110d7d2e0,32,27,36161,11290,24871,33,23,21796,11194,10602
dee19d4ebb9ac9bc77d4152582edcf83,123,101,225207,47707,177500,121,96,287688,44051,243637
a1af433a6e19d6986d763e5f6f7be83e,25,22,17058,8706,8352,30,25,21785,9125,12660
230ff0d3007165ae70db1c7f746eba91,138,94,253508,56549,196959,85,70,157658,56293,101365
f3aa5e2df3fcf3fc86a32712376398b7,76,58,92651,33792,58859,58,51,83697,24173,59524
56e9bbb0fb886c72436de6435d953f8e,107,90,218861,48849,170012,116,99,201184,36642,164542
efc473ce09e3e9d91297cc46301195cc,151,107,396265,82491,313774,141,107,387722,109773,277949
8a665eeef38d0d0528593bb80dd11fe7,130,109,352831,92009,260822,124,100,343032,96863,246169
08409e075b3216a0916a1874805cac78,41,26,47924,9402,38522,34,30,32973,10206,22767
6b65009d5cbead197bd5640518f92e2f,72,65,81080,26005,55075,55,41,64507,14652,49855
a423c06f8c74638343c97ffc5a3a6e6a,144,99,324052,65062,258990,126,80,272884,62407,210477
dec663a3d50ca95aca7217516cbb5856,7,5,903,565,338,8,4,1400,793,607
99ba8e4b322bf7174d3cc22227887d1e,152,111,409315,110524,298791,173,141,455217,98732,356485
5076023b18079064f1a89b4abe331db7,98,69,173108,48390,124718,150,97,275612,43307,232305
8690c16d8a2e35a4fae467bb57586a03,194,134,704874,108953,595921,153,118,588122,131637,456485
530686431177f8b5c63311c1507f3e4d,163,123,446808,118589,328219,161,124,518052,110693,407359
6f2085247af9999f7687f07c9d41a326,16,15,6603,4175,2428,25,15,7122,1891,5231
d4078075300aa359c98b6e39bec0d895,123,88,286835,55057,231778,126,94,284595,43291,241304
945ce9db055601102b2b1e4d8d28acb0,51,39,73041,24694,48347,60,47,69729,28715,41014
f4ceba20e9e672595e0138b1796f811e,145,104,293695,49482,244213,128,95,263580,41789,221791
b899fb38cad92c494713db5c59da75dc,143,102,325606,70901,254705,162,128,414471,69937,344534
146d387977e52e93732794bd4052cc32,99,92,139249,41270,97979,95,72,140511,32396,108115
4df4fbc73eafcccd3e16c7bd390eb5bc,172,124,513990,122731,391259,166,108,489002,134766,354236
6b763b68f0f5fd75ace8d25a80796404,28,19,11464,5201,6263,36,30,27490,6892,20598
8ef015eee7daea60e73e9566a56d88e8,66,59,106176,25279,80897,77,61,80453,28820,51633
628b69a8f081e1f501755137ba51f9e8,42,30,78998,16790,62208,44,42,38036,28251,9785
b3988118032d2bc6240e9851acd06b36,94,77,185314,44414,140900,94,88,168082,55609,112473
b0c0248990b0fda07fc422a003ae8a28,69,65,79669,21401,58268,66,53,69351,18975,50376
7e29bb493b2de50b1c6629fa44c90d55,162,125,377439,95723,281716,154,121,379460,68383,311077
1ac3c4d882020b0901b07c891755b226,57,42,59307,26950,32357,65,54,93217,25862,67355
68763497144e95e3630365e6372c1ab4,140,99,321041,47843,273198,104,79,268505,44706,223799
b9e554c1566ae8411f17e228e968f572,97,84,239839,65827,174012,108,81,225831,49509,176322
0d49e034b89b5ab05c041a3f25218156,94,77,212666,53168,159498,120,92,258409,52272,206137
a4ff087f9fd82a7ee8ef8a68ecc64277,39,29,31566,7855,23711,46,42,43498,13872,29626
c49fcbea3df5dd242ad8da78bdc9a485,0,0,0,0,0,0,0,0,0,0
601071e5620331755233a7f09a638a94,165,89,230313,53551,176762,113,77,164283,52673,111610
1a11888f5ef39e73a443349b08d00fd6,87,57,178299,33859,144440,83,67,133758,40776,92982
1f6e814d26c448c813b4b7425bbcc8fc,106,85,175247,48467,126780,87,69,152038,54332,97706
687b4d32f86be13cc8c4f99d1d49aa63,171,124,660876,169739,491137,213,154,872809,162792,710017
7ad007bc44dd18dbd5bd9b4c03732f78,85,66,168570,51331,117239,132,98,253692,61200,192492
1a613f255da11ad41214df18cb297f7f,30,24,18623,11705,6918,28,25,29696,9622,20074
d001ed06d356a8696d08a20d4019aad4,147,123,400373,63054,337319,140,114,412288,61905,350383
e908c84f2be09e83dc7ee5dcbae2f63d,52,42,93881,28116,65765,45,39,88807,25346,63461
476062039790ecce52b9de9c67e37303,70,44,95679,30386,65293,60,38,89542,28677,60865
2ca77a5438e58d21de39285e76173a42,27,20,18661,4065,14596,27,23,11404,5757,5647
bd04416f49f1e277c91c3d19f10d7947,4,5,904,864,40,2,4,557,904,-347
0227bc44bc6f80a7356d8a4bc24e07ff,24,17,8543,3355,5188,26,21,8012,2650,5362
a81fb6ef7230bbdf098437ff98f98b7a,137,106,316261,100477,215784,105,83,344828,75479,269349
1888084a8a41a577828c363fbae71c85,208,153,733039,75746,657293,119,85,353941,71986,281955
618fb1ab22ca6df37e904464cbc726bd,122,104,308916,69573,239343,88,84,246261,76967,169294
7374c23211cd9db16454b0cc1ecf1f6b,26,18,22057,6047,16010,25,25,12556,7727,4829
7997de3ca3d43b6e48c67a5d0cd7a0ed,87,64,108514,27906,80608,74,71,87723,29225,58498
567d0234654c8df66cad77e9cdb2b35c,30,28,12155,4742,7413,30,23,7973,6100,1873
e42d6596769d5dcbae2802f50915a324,75,62,125954,30952,95002,88,67,112573,46328,66245
80e45751298af9c3b6a59af5fe63aeba,201,146,687176,120473,566703,202,136,674457,131806,542651
66296a490f95d5b47288510a2cb66d83,32,23,24014,11014,13000,36,29,32734,9082,23652
a9d5075b20d2b59e2fdd7524b4e38eef,66,52,74360,17355,57005,56,46,59169,18363,40806
05086d9ae81b1804757303ba5d3671b4,114,85,264606,68065,196541,143,116,336254,85202,251052
c6c5073faba4959264d5594bf112d96b,35,20,23753,9045,14708,31,31,32192,7283,24909
fdb0735e4f4ed53eddd00e2d275f80c4,173,118,585327,99367,485960,192,140,519055,108328,410727
29c395039fe5eb1eb57ef46c704a9806,171,126,505272,97721,407551,128,97,366269,121213,245056
5cb24959dc70da9da9867c5f8a089e02,126,111,279662,95385,184277,139,113,405214,95689,309525
c157be949315e6e4c435764473c4571a,201,171,1123922,220862,903060,148,111,1306690,165432,1141258
3de6f0fada52e32eb260445e8f5660d9,115,80,209419,42492,166927,128,102,226424,52843,173581
a4ab6fe52e35f34710312ea26a99e7c5,79,54,93036,30499,62537,105,59,112399,30373,82026
7dae59f636787ec28cdf6a2ac229e572,123,100,283264,38905,244359,103,83,209197,37360,171837
9f5518fc5c9043d5d895d55315b47290,20,20,12306,4664,7642,32,21,13860,6923,6937
1715686f045be01fadff1e89b8209a2d,15,16,3271,1366,1905,16,14,2392,1284,1108
e7d92ecb2116e346e80173dc306d5e5f,216,141,1676992,220027,1456965,238,178,1336209,282817,1053392
ac155595995fab87332cdef2bd11c4bd,131,99,311340,58734,252606,125,110,267786,90179,177607
0042b563ead2b6a2f3b870f6ca7e7374,30,14,13083,3085,9998,20,20,8302,4112,4190
c067e17917c1d93a866805a71e7589e9,45,34,45081,13562,31519,32,24,31236,12407,18829
0da1ce329f981bf852f07b7900b3b634,90,61,183018,54332,128686,123,92,328434,54467,273967
fee3dce481f6c675c4a6b48b38ee23f6,55,36,67203,12458,54745,58,39,56000,15376,40624
4f6efb3b1f9b835649f5e1a7b98e0b49,152,105,411383,84216,327167,155,107,378269,63044,315225
9a6632ef6971f8a96404363e1d0fb2c7,61,46,111600,24451,87149,72,62,115723,34132,81591
cb31c90c18ec7d8cf38daa2c280aaa86,139,105,324043,112352,211691,154,106,388506,72953,315553
99f5de86dd43234d4a8d0b4d5bb2b772,122,100,312166,85666,226500,126,102,296852,91097,205755
fe6cf71f9cb4d2d1fa4c8789b4bce616,101,70,332928,46741,286187,150,122,411013,95464,315549
a0c7b2280a876ec572fa71b089a628ab,13,9,2717,924,1793,9,12,1704,2053,-349
116c523a415a34113387531abd228f5d,29,26,15102,4926,10176,23,17,13946,5983,7963
d90ef78248501c726ca07b76538ffe0f,69,51,102173,25985,76188,65,53,98633,23055,75578
f3acb79961a0c4488e31b368a48b47ce,190,150,565969,161020,404949,142,115,539644,130581,409063
355bfc583666424e0f9a7092c7e85eb4,159,144,374653,87985,286668,128,72,264652,68290,196362
2a0afc2032deb841e3fdb952ef909287,125,99,224772,51538,173234,95,76,150404,48457,101947
6e06de6f36f5cfa40ac95cdcff40ae70,139,101,306643,61594,245049,126,112,269204,89097,180107
cad6ab71a45034e74f0b4f17b23e9e81,79,68,154184,29916,124268,88,62,115003,30884,84119
430d05abcda34af64e29279c98f5d641,97,75,137040,45574,91466,141,93,327952,45427,282525
5599f5dda5860e250d47f8b3917b1464,108,88,241747,73598,168149,123,82,241582,60818,180764
5dc975d126b037d871a67ff54b640d3c,88,76,143786,35830,107956,70,56,119232,32945,86287
bc14ba4457bbea76295864c640df0a04,45,35,45178,13494,31684,36,33,27759,14453,13306
8eb2738036e586e3793cc3927622419f,110,86,264721,72280,192441,129,101,322249,70699,251550
d6fdb84982a6384ec3e0bade769aecb5,81,67,117662,42726,74936,60,48,95139,34304,60835
a8fb22f6fb10fa99c65f1e292d70a4c0,172,142,489997,103710,386287,141,124,385987,74503,311484
3240ffad4ccab09a26ed20e3eaa1d9e7,104,69,141754,35080,106674,89,79,173478,54431,119047
13d57aaf16ba588ca1f8e298b42a3ba6,48,35,55565,15385,40180,38,32,39505,16934,22571
fd05cf01d0637dbee0e32c5d4f8b69f3,128,84,259466,43693,215773,144,113,373002,52105,320897
f25dee7f1d45a7ad0acd9e6c6aaeaeaa,200,138,587177,101768,485409,122,85,533026,98204,434822
d1aae2c779a4470a5ea5d3bec632fbb2,166,117,518388,129083,389305,166,132,516333,124070,392263
221a9cf47b9fb779e55fd0b9f04b6077,92,57,161463,42435,119028,117,88,266311,45988,220323
fb327534f50c97cca59493ca407b8747,95,74,196941,69376,127565,99,74,211994,59055,152939
023d9c36607b2965eb016d4ea06fcb77,153,122,504639,143767,360872,117,80,360025,121825,238200
3358fc4e21e30593d406e32e40819fcb,30,24,12756,7431,5325,26,19,12918,5100,7818
8d6b5dc102c04ae5419f73c5fbec76f9,91,49,96419,43084,53335,101,77,155395,39953,115442
f38f4a0fd6a1b495815bb6b05ab759b3,192,132,490918,84706,406212,168,96,355357,93618,261739
135808e2195dc8d73588ba9ee9dac638,42,28,42022,12927,29095,41,34,33089,11126,21963
474f3dcef470758a8216e651c3b2f41a,84,64,173305,62750,110555,85,65,148567,51431,97136
106b817dc98c7507a5502a10758f5e88,113,66,262493,78726,183767,150,124,338100,137450,200650
9e47f616da41b853d486c98f9b61dba4,187,152,649836,129042,520794,134,106,593748,127341,466407
05ef66bec5ddd33982c5e8bccc7eff70,46,30,41171,14769,26402,46,36,31007,13562,17445
8179022bdcba39edd757d8e11725a544,130,87,237460,59186,178274,105,81,251812,72516,179296
d467f1ebb5961a02e38fbfa26077ca69,39,18,26337,6068,20269,30,20,21333,5850,15483
6c409369613ed78b2d972dfbf58996b6,48,37,37618,20631,16987,75,47,61737,20549,41188
b3134136bcfe22a4777ab8aee452e4a8,114,81,215432,63453,151979,116,109,246200,58491,187709
ef3fb63528953bd70712444e12243288,76,61,89882,18910,70972,82,54,112018,24027,87991
3d91835f3773c75f8381f84054ac979a,117,76,185111,29706,155405,74,63,113724,38600,75124
011d22f12f95cbe8193ee78c07d9ea84,102,73,187794,56090,131704,72,63,116880,54866,62014
20e3e7ba5750a61ddc3617d1017b09d3,215,145,629327,109135,520192,176,122,534713,90744,443969
18d7c21dedb1dcec6e94d7ad6f07c737,53,41,49398,25212,24186,73,56,95068,22234,72834
d6278e6ea072b617182bf1c2adab2a0b,59,51,141912,31203,110709,66,49,87834,35710,52124
d8d8d2d9519b6849a662163a060dfb4f,93,77,211291,53911,157380,99,85,232120,47243,184877
8ddb234b4726638667f303be47f503e4,130,106,288278,75824,212454,162,113,517746,69770,447976
f7722903f1f044636a0c14ffae77e9d9,38,36,19997,10802,9195,34,35,25610,9923,15687
0c4c2a7c8376e5be3a690df1c2f1f741,105,66,285832,49394,236438,153,99,348448,66016,282432
b06c7f59d24f160e6ffb758f870e1e0e,24,19,15453,4502,10951,32,22,19845,5358,14487
69ef2fd46d7a72d04b320ba4c9c6af5f,174,133,580503,126609,453894,180,123,534705,86885,447820
ffffb8ae551caf1e3b603082c3bda53c,105,74,196484,57050,139434,102,86,214535,80008,134527
60785340aee71dade8889ff15affb9fe,96,85,162173,33941,128232,105,75,159604,44936,114668
3b876d993fe5133bf6b44d47b0330039,39,28,31651,9403,22248,28,24,17936,6734,11202
449dc958d8bbd82301d4dcd04ee3e07b,219,149,1202391,208975,993416,196,139,967513,422899,544614
abd2aff9286316eda3c0b63c1f2022c6,128,99,315086,76760,238326,199,136,430064,88675,341389
c62ab0106c313702f160f02c059f116e,98,71,199747,53644,146103,153,112,349110,84676,264434
2a25e39361bdd22fcdf8d2b30d193505,101,71,260599,130266,130333,119,98,270013,82012,188001
30e8a418b07ea1e9749db7b679974eb6,175,141,602095,143030,459065,180,119,595153,140887,454266
1c702c88ab3c5f25c8bbde650fd764fd,29,24,11670,7901,3769,31,22,26999,5309,21690
43fda01b7d583711cff19511a7940026,39,28,32477,9419,23058,42,30,31227,11966,19261
b37bd23a77b610f9ea673097ac7ee9be,25,22,8106,5068,3038,32,24,12321,4668,7653
3083bd7d0a2479f437aea37390dda9ba,50,50,64217,17517,46700,53,40,55093,16538,38555
e4c98b7e6ec13811e1ad0e2feb12fec8,25,12,13257,2050,11207,28,19,15275,3373,11902
9d80f3b629038ddb3c8b589809bf7f1a,126,87,312464,85849,226615,140,108,403184,74760,328424
69439b67da8660e6075270a008ece221,124,80,290167,67910,222257,134,110,261566,81283,180283
33ab5bdf840cf23eef86525218ce7755,122,100,332270,90021,242249,131,122,306368,91005,215363
442561e2ad026483582a377f3c8783ff,103,77,180412,84859,95553,150,104,269679,56160,213519
435d1788bd1c59dd3b263e13ee022757,152,128,397457,77119,320338,143,114,373648,82122,291526
0d647c859bf127757f65fe943e5afe49,62,53,61199,23827,37372,66,51,67140,25960,41180
62cb4a8b5835ab48478e3ad7d77a16b8,24,18,8213,2875,5338,24,19,7717,3802,3915
5145175b0e0400734167d2017b07f593,143,95,199917,45545,154372,93,75,141773,44426,97347
5333b0d8908f5ddd3311b701a0fd1b3c,56,46,64387,28313,36074,87,58,117061,22989,94072
ec257ee9d20dc8cd47301540b79b5212,135,95,375348,72057,303291,156,100,336309,77019,259290
c80fb88b1622c7180f214ef0df442c22,26,21,11599,8502,3097,23,21,17089,6500,10589
8bed3dd107cb5cef69649b6c766afb16,23,18,12026,5754,6272,27,20,18951,5367,13584
2b4eeaebc4d806cfafe273d3388ae600,70,47,80168,28868,51300,94,78,149772,30717,119055
b1238e9a28f54c9915e926ccc57c8ec4,89,75,187737,75579,112158,81,75,156282,72475,83807
c14b7473ac1cd9b6f31fa215c70ad408,45,32,36992,11214,25778,31,31,39379,8531,30848
165f056e4a59215206a1fb446e63572b,17,14,5069,1566,3503,19,16,4070,1908,2162
039bd3dd61850b41c477fd7ea5545c41,196,128,516298,100924,415374,159,128,490835,107780,383055
ae8533876fe38a019ec0279190b37f36,64,56,97486,27741,69745,75,48,101935,18183,83752
6731dab3c65b1ca3d0049233f9128dfd,157,117,492304,138340,353964,182,146,682268,176714,505554
7b6a25301fb9dbedfabd4ddf1b6cff4f,64,49,62433,24559,37874,65,48,101818,24437,77381
6a74654d90894005e0acd67b6b36fc8b,60,50,82572,42287,40285,66,57,101367,35152,66215
5f3858093f424e95de85a8d52b905742,114,91,228933,50541,178392,132,109,213191,48513,164678
717e678a213ca503a6300062020de255,12,11,2254,1067,1187,13,9,2316,1778,538
71c8d54daf43e62459b984d910478be5,43,34,49444,14498,34946,37,31,49349,12264,37085
fff69be5313ed8bd12f7ddb963a9427b,92,70,143897,53256,90641,80,67,154079,36291,117788
ba6a6889211362ad16c5b618f6107db5,152,128,499672,129558,370114,156,129,515513,104131,411382
3433ac836e9551dc03bf8d7add5df158,152,124,494250,108213,386037,107,97,278579,93821,184758
7d491e67de1f5ce5d7232a770da0b822,90,76,167842,37542,130300,92,52,192073,31136,160937
d9e361cd7333a326fb7b7fa3fc3c4739,52,41,54698,18545,36153,39,34,33344,21125,12219
df5980d79c924eea7ecfe263cc9d288c,163,105,373524,75707,297817,196,129,397426,62366,335060
d7dc59310b5263a9ef2acf3300bd58b0,132,105,475114,96951,378163,121,88,354278,94465,259813
ea17647fc0cd928ec955cdd5aa2c31e0,68,53,68956,13966,54990,60,41,49818,16715,33103
b5445b79d9d2bb9295e7e76d6432a81f,74,47,109941,41445,68496,82,61,118469,36944,81525
d00bb1ed9b7868be14e4df6e7638c6cf,178,136,450625,65211,385414,103,85,310011,63311,246700
12e93e55fb155afdc94bda65b2183190,38,24,18522,6501,12021,31,26,17341,6028,11313
372400aaee231fd6a37e8275811655a0,126,114,417094,99875,317219,149,133,500255,94510,405745
bad7f0fa2df43741fbd8e9bd432a4a8b,85,63,150590,35355,115235,74,67,92261,32578,59683
e03b6be81c8a50971e8eafc8c4468d38,140,91,286067,59767,226300,110,94,297369,86898,210471
7a403fe94ae5c65456578ca93df543b4,180,119,474097,74149,399948,129,100,314506,82978,231528
7a850b528cfb7bba21351a4dca558802,21,19,11923,4974,6949,21,19,17401,3166,14235
65ab1bcb75f55eb89d9eb853855fe5dc,145,110,394155,69214,324941,132,107,357537,87206,270331
3a961ef80e2317ae503d1b5a205d066b,57,48,71498,27984,43514,50,40,60090,15687,44403
af18c5a0be13867744f57ce0f9853847,135,97,421352,60494,360858,108,72,226100,71997,154103
9a951ad24ad970d738283e3e68532824,104,75,152755,30387,122368,89,51,100498,39618,60880
7d531b4a28448f22bc3cf60df9801274,197,143,1064511,169274,895237,194,159,1064166,258601,805565
8aeeeb32275d141f4dec01f3bb92b16c,45,39,49375,20605,28770,46,36,64587,17103,47484
5602399dfc3cddfebf49e8e106b71fe5,79,59,145175,49413,95762,121,102,230949,43889,187060
186b4b280daea3577a2877fc521eff86,95,72,135812,25797,110015,106,82,113977,34092,79885
a8a6d91ea1ca2dc54272dd8809050072,36,24,31590,8795,22795,33,25,30602,12699,17903
24b46f306027cc7addb0838fb2d4d9d6,69,58,123677,42991,80686,90,74,151861,44339,107522
941ddc43950e10d1a85fcbf3fd89b7c8,123,106,292782,54313,238469,146,112,340879,52263,288616
9455cc7a6c98e9970d6c99e09935497c,23,19,17302,5848,11454,25,19,15016,4230,10786
9405154af873944d27ee0fdeca042edb,46,31,44458,14741,29717,38,27,37347,13943,23404
9234adb226442d83078e8068426c80c2,26,21,14120,5087,9033,29,20,14392,5523,8869
90ef35f369fe3e0543e9acfc80a7cc7e,60,40,64231,29337,34894,57,44,67378,20791,46587
4ba758b23852a05b3d45ce6cfd9bb26f,98,80,159634,43712,115922,87,82,170259,49694,120565
5f62bf75e84b7a6689137cc6328159e3,24,22,11524,3676,7848,33,20,7277,3914,3363
e14297c0f8266b2ac3c458f31b0efb5b,142,113,253608,50872,202736,99,84,155559,48892,106667
129d40abf10cfe68ea57538c0f3b8e98,139,97,500919,95265,405654,162,104,531684,111359,420325
1e42a8ce015b78e86e2ce7e97275be95,152,118,454300,89753,364547,167,144,364860,112806,252054
cff0968a0aa17ffbc9287b30d8a36fa5,137,105,343463,84646,258817,91,70,154942,79885,75057
38b3ba32ee36f5ed2cbb7de4b69ae1d4,104,84,179192,50158,129034,106,95,238137,39592,198545
2022be86f4275c0929961207ff517c91,49,40,40064,14067,25997,42,30,36403,11299,25104
0c98f7573c10627dc11d1ab7354fcac7,54,43,74096,23535,50561,51,43,59204,24579,34625
563a1ebb1079576b829930d237f914ab,20,16,11957,3241,8716,18,13,9945,2591,7354
3dca3deca7badc0a9580bba39fee3718,41,33,52707,11153,41554,64,48,92355,21391,70964
fc085fab3b7d58e55cec19a179eb9336,48,38,54126,15212,38914,69,70,83535,21028,62507
e70a52bb0643df2f503751806a1e1898,171,125,546406,170204,376202,224,165,688741,139113,549628
2d4867ca1b4757a9996d68971eb4e8bd,58,55,98022,35231,62791,89,64,134125,27869,106256
b4f5ad7d4f4a291621b98b80224c9843,53,38,65226,20433,44793,78,51,105558,21116,84442
a4ff7bda01f469950f26a7c6fdd1acb7,147,116,407519,62870,344649,156,127,328336,80244,248092
7cf2546e5a43e3305ba5b69d06d1780e,131,103,277949,56177,221772,127,91,241672,61726,179946
14059a8056677e18ac7ca2fff25c1ef3,175,123,589108,113807,475301,187,129,491931,82861,409070
40a4fb7fe4dca3d698b9c39e3e498c5f,46,42,52125,14916,37209,43,34,48526,12246,36280
c1ade37355b1d4a3805aa10d1b90b269,166,123,455001,119050,335951,146,103,499488,91008,408480
6067fe39ca81965f5a1b3dfd9168cfd8,48,34,40927,13472,27455,38,30,28508,15521,12987
ba8f8cbe11f96be75843be541d131604,42,33,52590,15246,37344,45,36,33331,18865,14466
7d1ef4168b1a60561803bfa4bec28dc2,60,47,84741,27959,56782,70,50,77351,31729,45622
3d736c26f778af86e0a391c6e9ed6f5f,32,22,15325,8282,7043,25,21,15687,6849,8838
3e382129b34cf27aeb5385eab93ef6b0,141,106,319055,73929,245126,150,117,308700,68141,240559
5929f62147d254195cf5a0e525b75385,154,116,753569,152034,601535,202,164,874048,181938,692110
5a372c85b6ff78c95d6c68e4f855fb97,104,76,155232,30773,124459,66,67,86361,39450,46911
526c5eadf12a38009904192a61f9b84f,18,15,3163,1551,1612,16,11,3595,1131,2464
e18f954d96d96a5cdb600886adcd1e41,32,20,19112,6704,12408,28,27,19904,6309,13595
9b2b3dae0d021152a79a8bf04809e22b,189,139,503296,103201,400095,129,100,360380,105940,254440
85ce778a2be0846870c02caf708ff41b,92,73,108341,31730,76611,70,59,106789,40110,66679
f219572b4e6af1ce73c1d9d06de73ebc,109,84,266948,76995,189953,165,123,420110,65152,354958
e8f586e97eab46af43df12b952b3f791,181,167,769652,124286,645366,220,147,651872,146433,505439
18c2d552cc749cd7c4204f5ca3baabbc,115,96,408808,151056,257752,102,82,355133,111452,243681
1b35085f79a7676eb484442355cb04b7,41,40,55002,17240,37762,44,30,52077,12902,39175
525c04bfba4d46050541e425480d7ed6,210,156,1294499,216319,1078180,196,155,1018124,212694,805430
4a243ac9a5e488b419e2c793c0942c11,92,76,125919,41954,83965,116,101,179433,30809,148624
7d1172c08121f76017783054b3dfd397,41,32,32653,10621,22032,39,30,25199,12720,12479
f85daf02b149880c0dba0ee9bda5bdd9,58,48,98634,19973,78661,38,33,34486,18498,15988
dda728b3055008abddb5ce706d4286b9,76,56,165059,40766,124293,88,79,152300,40796,111504
8fdc5a441473dc581f313cbff348a2a4,96,68,186829,46151,140678,127,103,268057,58737,209320
2561bdc61d0791c831d1f25478968e61,45,26,25104,12056,13048,47,36,43420,10369,33051
fc3c5bb629efcd8c9655349f7fd07e67,107,82,155164,57120,98044,107,70,203428,45794,157634
3ceb7da366e6ff3c9f24089bb4088119,30,27,22515,9840,12675,28,33,22305,10732,11573
48daf8bcc45a1c4196fe70f9dc4031a1,44,29,38024,13967,24057,39,32,44434,16387,28047
392ebef452f45557e04ab7a7d6616181,74,62,106902,36144,70758,69,54,111903,24566,87337
ffc20f4737f49b55983e71a2cc375fb9,82,60,84926,26795,58131,35,28,45609,11552,34057
557b62c198514e7149bf43b7d7ab20bb,151,105,316683,59085,257598,143,117,311909,58985,252924
ba8a9f49642849d80ca399ed452f1997,112,76,261714,49805,211909,97,87,209030,66368,142662
ad4f56214421250415655a768efd37ec,121,82,231386,49652,181734,78,58,169188,63333,105855
1331d1809534e8964b938b2d111ad6c3,167,114,561292,84978,476314,151,121,462143,103905,358238
130723f0e64f42a1c65aa4ad96841fd5,62,40,70149,22006,48143,61,40,75157,20555,54602
3b8827f1ad900e6240ea148cb0db4f60,89,71,164469,37766,126703,99,72,160782,39136,121646
2c3e8fc11fc6d504fdc492b87c28d56b,33,32,24384,10328,14056,36,24,24620,9917,14703
fad81e33cf9787f35dc82c3723307daa,120,74,221413,58066,163347,137,102,281265,55190,226075
c02ab8db22180da610dbed46cd1735c5,109,89,206677,59497,147180,110,102,200826,58755,142071
70ff2a0997edb5642eeab374dca134f6,77,60,98200,21649,76551,70,47,76923,28955,47968
3da494a902e3131cfdb2f15c907abe41,121,86,297526,81391,216135,108,88,234696,77793,156903
1860717864ea524852154b470ee88c72,24,19,8468,4357,4111,25,19,8558,3313,5245
3a51c9c20d9b7d169b88cd7525d78cb4,73,51,88730,29873,58857,104,90,137242,34177,103065
38dcaaa3ec454436c7d36a8edce21caf,73,62,205247,57751,147496,80,71,164749,74981,89768
9087b154dfba09d02340c73ef33cd400,99,56,209052,43443,165609,102,70,171068,41390,129678
c37b5301e40bee2c2f4a5e6f1614bece,123,84,210151,36473,173678,114,93,223840,35393,188447
63446d3089a8a51b7456868a5f27df72,54,46,84226,19208,65018,86,58,100506,32011,68495
40e61929ae7145178a4def302185a12f,148,97,329444,78538,250906,158,124,361945,90627,271318
29b890ff2c1bf1f0ee8565a98cda60b4,167,128,580943,131062,449881,187,160,735772,137760,598012
5cabf34cb3f9a1adca59c0870be9fcf5,84,58,123736,32026,91710,73,60,99514,27477,72037
887732a5bee8cd7f0ddd50b3f15adbb7,111,75,314527,66080,248447,101,72,233167,87376,145791
627511e7d1ca7af629be0a7a4a781509,101,79,322119,74523,247596,156,123,538889,84896,453993
667979fb3743f22b5c50c356a7465ab4,27,22,24074,5635,18439,26,24,11361,8826,2535
12e8d74028809dc1efdc16c80b114436,98,79,190911,43087,147824,79,79,152205,58112,94093
95518bc67b0780c0b255898fce3dce32,196,145,1219131,183330,1035801,225,148,882746,263962,618784
e27dce1bd2fe02a4a7f8d26f078000a2,91,72,158516,43597,114919,99,78,163934,41760,122174
f54478d339a848c2a4c9c46ec8c3cb46,105,89,189196,46077,143119,109,92,185898,45632,140266
86651f5ba5292d11e754146aa8931819,26,20,11374,4254,7120,30,22,10370,4853,5517
6fdee43f857739ea404927a71a0476b3,52,44,54060,18236,35824,41,33,53984,15435,38549
28a7394b24192a80cf162c0489fce49f,171,129,795806,184888,610918,176,164,737176,204068,533108
870fa20894fd77be5b7a4a0bddb4ed57,25,23,11395,5882,5513,23,18,8582,4655,3927
69ee9197c17f79c174662de3e92e5798,60,42,75296,15077,60219,69,52,99021,19596,79425
a5c7ed5c10a4c3fc44b221bb21cd7559,22,17,9407,3814,5593,22,22,12310,5333,6977
39d66978f205cce6869a7771ee93e9d6,83,68,167843,36517,131326,104,69,201570,48860,152710
f8ac9a1d7cd9aed9b0fa2a67ae07677d,64,49,134869,43265,91604,86,75,136337,54965,81372
a177e08d81417950039c72ce650ffb54,117,84,219626,58955,160671,123,101,223151,48236,174915
e32f99175a08fa6216508ab135c37d57,25,21,17620,9913,7707,28,21,21062,9331,11731
2b29c1bdbfc3e3c8b5eb1d6d6318321e,106,82,204095,51125,152970,110,78,231568,47831,183737
66d89b84f325ca191b3c0bad28a2499e,33,27,20253,8023,12230,30,22,13802,7646,6156
2d2732351284fac1868c937979bbf771,54,43,88027,21328,66699,58,51,69516,27943,41573
977fdc83981498bb978c9df037432c18,67,52,104862,26360,78502,59,53,111623,37858,73765
75d8ae47bb88ddd5e104bfedeb340840,80,47,125797,39196,86601,86,81,132042,54301,77741
c6aa4252f13414a52cc2d58b21163c40,38,21,30211,7215,22996,27,23,27827,13932,13895
83cc9fcdd624f57fb394dd2fa9386ecf,87,61,144242,45782,98460,63,51,102169,47333,54836
7f865299b474b0f1a07b690ad90321a9,140,115,374697,77671,297026,162,134,437739,84903,352836
72cae6e51ce5a8d6c4e1a75eab69199d,30,22,10676,4610,6066,26,21,8309,4097,4212
75984f70e14012746410091a05f734ae,162,140,435530,105400,330130,124,76,299095,55528,243567
ec647051238d43ed58ff41fe455759d1,110,72,316055,75092,240963,145,85,346714,95701,251013
92acbdc09d43626a1e84f0879d021526,83,59,117872,40854,77018,124,99,204006,48527,155479
5eb1b385167361540a01bdc4550540fd,32,20,23996,4413,19583,23,19,11933,5245,6688
e034b7a8b573cd92090ce810687530f5,19,12,4527,1019,3508,17,12,4450,2843,1607
67018ea4d8f8681ef9a5a14063e94bb1,62,53,90632,43994,46638,66,52,110826,30403,80423
12c458c92ec47dcf28a56c88053dd083,21,16,5420,2454,2966,24,18,5441,2242,3199
7255ba61045c5beec913f5ae9dafd1c3,101,85,240250,54774,185476,93,76,206898,60498,146400
34975ab8e7d61727ff223aaad6ac00c5,122,99,285381,68628,216753,144,115,419058,76521,342537
a690aff49187808f73f24dd3255b62f9,46,40,34618,12183,22435,46,28,33219,14032,19187
045a860d2280eaf23a508f42359fec77,54,47,68879,26359,42520,61,50,56355,22583,33772
00765716b6ed946b9cdbcdde510a0b11,103,86,201138,51683,149455,86,69,186564,66435,120129
d97a350926e1999c44bb821ba87b2277,79,69,124574,32390,92184,77,63,99593,29302,70291
db106511ab76afebb66760a8ecf4b82d,28,22,12814,3973,8841,28,22,10972,4084,6888
8176bef3b0c5e2c83047f53b78dbcb86,55,39,71205,19941,51264,62,52,84406,25983,58423
7687e136287227c5bb9a605d81814d43,46,44,57998,23221,34777,65,41,93268,12729,80539
b79f2860ed735b1640beb276061f71a4,58,46,64798,21036,43762,60,51,58855,24023,34832
db51075c5bd1a7b3281c08bf0037f237,71,55,136054,40784,95270,99,74,195009,44076,150933
09890cbe65e4947047d8696eb6db0f3d,23,18,3926,3455,471,24,17,8164,2360,5804
3d5dab49b23619b0e0f8512e3bdd3c95,180,141,496217,78039,418178,92,74,209196,86685,122511
c3015b025f0bae4d349205e773f12264,87,50,126778,26468,100310,73,53,105979,30566,75413
16ce918a3af97802067254621ebde81e,83,68,156290,27506,128784,109,60,192577,22322,170255
06ec8e67087fec1c646abbada03af419,154,130,506869,119635,387234,166,139,530655,91786,438869
db8c169d4a9e6a6d4f572f95a168de72,77,61,96591,48011,48580,122,83,194605,52869,141736
5737597e4f1e86f5b7cf6abd9d2162fa,156,119,484489,86571,397918,182,139,620785,100410,520375
d2495d38142d04297e8e5a0cdc2222ec,108,84,198678,39849,158829,97,72,180315,37866,142449
57ed31c76ae478be26a3e7c70f68ea5d,154,125,505228,71864,433364,161,122,413085,77409,335676
f183e6d4dfdbb4d16397aaaf0e7cfb22,70,53,102663,24946,77717,61,47,91483,19316,72167
a6f565127e07b026f8d4803b78a45c74,195,161,1015596,200128,815468,198,159,1308008,265995,1042013
a78275578c459a483dee92536f6ca804,195,115,541147,134934,406213,173,129,543566,128225,415341
ed903945802330c7e36b900ec99e9858,164,108,228324,56519,171805,103,81,146216,65727,80489
dd3331c032d5afdbfebc96215772e793,142,118,372384,89349,283035,108,75,223083,79955,143128
b7d62bc9e26ecb18df772a9b787b65f0,89,58,116151,54349,61802,107,88,205316,49910,155406
c9f8150521c2ec5447d4005fff9bfd76,19,14,5665,2265,3400,19,19,5796,3020,2776
6e3407b87b4894187ac303c1180bd2d6,27,22,13828,6216,7612,29,20,20684,6716,13968
7e75f2fbaf7f8245c379cfe2e275e958,152,114,370497,54889,315608,105,79,224080,55105,168975
7f7defe9586a75f3aa302907e47141ab,126,76,314734,63303,251431,100,77,174823,74422,100401
f8344f2b8bb022dbc3a081cc831b6880,120,91,318285,94622,223663,128,100,351394,99323,252071
7aa8c4b613b5a919c33ff95f5a056e4e,154,120,587408,95722,491686,189,128,719520,116956,602564
82c17ff9bac5b26f4d55adf071b9f6b4,109,76,222320,37670,184650,153,100,370446,37046,333400
1c3a3cda645ce8ba1eb890ec599b92ee,144,100,276398,60570,215828,87,75,148350,55925,92425
d92829cd5c00d91f48fce7417cd737cb,22,22,8755,3327,5428,20,17,6210,3400,2810
ef03b63bc9bc29e9dda47fdcdf577c36,59,41,77545,27107,50438,94,72,103090,21823,81267
593a0ca54556f298077d1e36a611a233,82,59,128979,31812,97167,78,44,146889,32646,114243
a3f775a3eb11e44e6e6b16a454fae756,98,80,146798,45661,101137,106,84,194289,43863,150426
1aaebc0254b37b59b8dc1a5505fc8aff,247,155,960785,134625,826160,137,107,525830,145324,380506
ee2bdf9fa2de8a23ccf361acd8460884,59,42,82022,36363,45659,67,52,99801,29808,69993
fdb00a38e8a1ef9fa38854c77675d083,101,78,201785,39420,162365,115,86,186120,36927,149193
c7aeabf7608630c0c90b26cf8f0f6659,109,99,274841,64543,210298,87,63,181431,62296,119135
6a0e310eaa92d0896f61375874743229,117,84,304413,91200,213213,140,109,397287,78918,318369
d9ab89e7df883cef95bd5f1006201e7e,135,108,316385,75855,240530,153,120,369395,77974,291421
95d4bd6e26448725488363dd63942431,127,110,282753,69491,213262,126,83,243394,40045,203349
d461b0ae6bb0bf278542a041ae81251e,88,78,161546,40061,121485,83,64,104998,44410,60588
1770279cfac3a2014a7661695133b6c8,93,71,148802,43225,105577,71,62,128363,43663,84700
261ddd99440a54c2ec9d79b380e7ca25,97,71,135165,50990,84175,129,104,301306,46693,254613
8f67480a5c6fd0803fee844fc8604f78,42,28,49031,22197,26834,36,28,48080,15049,33031
543746c0a4447e82a190a9384f6a2388,75,50,104135,20186,83949,66,59,99990,22738,77252
58ddf3ce9cedcae7ffbed0a150be1aea,95,78,170785,30269,140516,88,70,123958,42616,81342
c5e13f5765d70c71a67b91b603a30be0,188,139,610771,108538,502233,132,114,514157,114917,399240
c9e8024c2410572f1bc62d0fb172d5bb,136,93,670029,142520,527509,166,126,691270,133176,558094
5de729ca55d77fc7363760e39929ace0,120,91,261482,64564,196918,103,74,235223,66856,168367
1e319e816170e05dc25e819dbd0c4faf,58,45,79574,35129,44445,70,44,78006,26722,51284
6c2c544f1ed8748efe85bd93f70aa5b7,129,92,199744,82038,117706,75,63,168171,63841,104330
10d8b38f19383afb7c3b72e24a74761d,94,74,260124,87530,172594,109,62,308569,79465,229104
f88c303fb7078e7a652119fc8c7fae5c,116,100,248616,58855,189761,93,71,133359,67600,65759
6dd55994db1009f98005b1e93a656176,20,22,10039,4910,5129,27,23,11773,4388,7385
c257a425d820b6da90c3c73f831865c4,203,158,743993,140885,603108,160,132,692933,175545,517388
887effadba3d9e94b4535bab7e071d13,24,16,7661,4557,3104,21,20,11882,3640,8242
838e1b0f37b758a2210d516f3e4759d6,72,50,144580,41104,103476,66,51,109661,51602,58059
30fb44602515054c75530835fee1b0e0,92,70,191196,39214,151982,101,82,213734,45699,168035
dd65fa8a8b819cc37e5e4963fc4c27ba,34,20,37476,10090,27386,30,25,35621,12579,23042
f34d4dde222cb5050b4b3e899841eb8d,45,36,37395,18025,19370,40,35,45220,12121,33099
88f1f05d68d01da75231426455ce0379,42,35,42580,21143,21437,59,47,71675,19670,52005
daf99c4619d8997e36bd17811ed9c039,70,52,117472,39446,78026,111,81,197168,37985,159183
bfe0d58453bff6f1affd152299bf42fc,130,91,292717,69640,223077,139,104,341127,83099,258028
cd26152867f54228b25aff32fcfd917b,183,147,434711,106567,328144,163,116,420606,125180,295426
105db44157ae93c363810c409729e9d0,33,26,26175,11491,14684,38,30,35296,14223,21073
83733b0724d6918d0552228ed5c00cfb,15,10,1911,1375,536,8,8,1628,794,834
492571c5fcd8c62e782e03944d8fcfb7,29,17,17130,5308,11822,24,22,19215,5170,14045
ceafc247acc0f2a905867e4b2ce524f3,27,23,16056,5443,10613,27,23,9832,6119,3713
968d2c81b4cc05e7db237f18b1335ec3,121,65,184472,28716,155756,97,86,147673,44675,102998
9028478122adc7e425c5fc4b47dc3387,106,63,168698,48201,120497,133,94,186718,47755,138963
6aac1b7135e1d7d2627ab2aed081ff33,126,98,253042,52276,200766,129,90,265293,50457,214836
85bc0e5404a9d6a716e5b1cbf9820058,44,32,48365,15187,33178,50,37,57961,11412,46549
510303a19d2d8b929dbe60f1c53a5fe3,139,108,342635,77759,264876,199,136,662734,70278,592456
b4b33eed3e62029b92e660f1b23770cf,98,75,159217,31732,127485,90,82,113734,38402,75332
49cb4e3cf2bfd4015c29c877a963e2a6,32,28,18718,5967,12751,37,27,19659,7625,12034
82893426c129f3f782d4e3f5e9684f38,84,62,209459,81251,128208,119,96,261472,87043,174429
89ee71f574373e45a2b6bc6dff2d8645,181,137,550407,113936,436471,187,133,583875,111437,472438
15da2e5e60050aab471b614a6a2f1a87,140,116,331445,50484,280961,127,92,253123,94648,158475
91215480aebc8dca518329b741fa67c2,96,58,199240,39888,159352,133,91,222652,58838,163814
cb1a0fec8f10562a6c3e8753c51723da,71,55,147629,39479,108150,120,78,234825,39780,195045
753a2b89b77b5e0e58013fda6dac7a87,70,59,149756,54593,95163,94,81,174872,47491,127381
9c061ee7db321820784223a2ccaf1cdb,19,12,5946,1246,4700,16,14,5331,1639,3692
0963f7f551d8cedd27152bf6980bbe2a,76,72,128738,36466,92272,97,75,172627,36069,136558
dc240393fd67c7f8c2c8fdb0c59d6a06,150,89,411986,73319,338667,149,119,412704,78049,334655
e3d2e4ce95421ad36f5fffceba484a0e,103,78,196645,55459,141186,91,81,185718,51515,134203
3c4a0b03a5806cccdb375803745e6183,14,11,3018,1256,1762,22,12,3845,1215,2630
2934d2b3037aeba95bdd28b8d664eefe,45,36,41593,17161,24432,52,45,44507,22210,22297
fd0b4071aec6c16dd73e0f48bfa56428,91,78,225881,46954,178927,88,71,132769,45595,87174
bd6dddeb95969bfe0ebfa0a6595aa4da,61,49,130714,37064,93650,84,68,138098,41309,96789
f29e7f217c8cadeac21c9577add8126d,52,37,64397,23857,40540,45,35,56022,20546,35476
03cae72f6cc11ac578ac77698f2df3b7,147,108,255143,78438,176705,103,83,189567,80687,108880
bcf942251c0e6fdd7fc0b85819ef95c5,18,17,5415,3401,2014,22,14,6641,2821,3820
39deff4dedbeddadafb6f0532eea5228,43,37,67375,28108,39267,91,64,125140,19831,105309
aa23217737ce6bd3e1d3c58555c35e2c,221,161,926639,105628,821011,153,122,878180,179943,698237
ef86de32f33a3c0c5f1966a1c51e2746,28,20,21597,6043,15554,21,20,12544,5747,6797
2d7d2dc37b01143a6352597dba5a4aec,37,28,35868,13481,22387,38,29,30241,11001,19240
0d3a3d1acf7cc86bf8f753d9ace8f5c1,59,45,121083,27260,93823,93,55,121458,34738,86720
7305a99416a48636a74f27c6cc714abc,155,110,450558,145554,305004,155,121,557141,124826,432315
2e037a23b5ea12d994d461ba59481a1e,117,98,391619,106157,285462,184,143,514159,123799,390360
032b3f7953a8ea4a5307940540373991,154,104,514606,131352,383254,166,130,654896,159189,495707
465ea9c10fa0f38a4beb98031530f1ed,121,93,276362,57675,218687,100,81,290800,59915,230885
a56e624bfbf2ad16a787df8b148f0b48,98,84,202271,54284,147987,130,108,314497,50261,264236
7bbbc3b48e8e66ca36a6c87bef453054,141,113,405962,94872,311090,158,128,430311,90930,339381
46be4792a2a4c869b2cd82d939a742c7,96,81,261551,119141,142410,148,109,437157,102890,334267
a8f7414b2bc279573aad11e9e58e6359,96,83,209621,41094,168527,72,63,150830,32844,117986
beb76346b9d54ac3bcbba4be43f71539,25,22,14592,7335,7257,31,19,25816,4394,21422
4ef83e5ea6900f66ea25a8ff1d35f8b4,110,89,248297,66952,181345,111,99,303127,67183,235944
26a248dee784925fac952f95e11a3cb3,45,40,60910,23499,37411,39,36,55248,22195,33053
c8a95f766af1ebf646a10133af16412e,185,141,632089,166364,465725,156,127,492675,90089,402586
b4343ae0bd2c97a3b97db4b2f40b3a32,189,140,596559,128502,468057,139,105,432857,176129,256728
6bdb6a5cf768cba65128bc34d2f6c031,55,42,98242,34146,64096,55,51,75811,40801,35010
1e94849beadc320c746f2052c4331ef8,99,67,165797,39635,126162,93,62,145398,41986,103412
afe800ab76ce3305dfb2c35ddc102d3b,114,89,266019,77144,188875,163,121,408909,85614,323295
b1935664edbcda0c1f27527a7ec9876e,67,51,123981,31906,92075,82,69,157122,39426,117696
8a36eefd8403086689e345aeeb39eb59,55,42,50561,18442,32119,53,45,66253,20511,45742
a9d2b9dcf00c3993dedd79d478a08b54,165,102,343251,65472,277779,117,101,307255,67216,240039
bf1d88b4e751511ee255759502b2e6c1,53,51,103867,30128,73739,45,34,59758,17708,42050
8cf9b2d27002365e7130cd8390f209be,23,17,9554,1630,7924,20,19,3733,3926,-193
c8b16053839f788101b6b96f37110f2f,75,48,132328,31823,100505,110,70,195623,47695,147928
49c68bf9b7005202c21785667bf08ca1,109,90,202310,41306,161004,87,62,169779,35966,133813
8b50e7ac4e523dc5e0ac886bb2a759f6,45,36,43148,18195,24953,74,62,101295,19724,81571
a2563d205de355622a9fee46a74851b6,91,82,202075,75103,126972,126,90,265234,81846,183388
6983e354fdde693edaddeb90378a1591,26,22,10909,6469,4440,29,26,14975,6952,8023
d9431444b05455dad14caa053678c414,20,19,7764,3405,4359,23,22,8287,3344,4943
6ca36a303b5dd45800c8ae373d2f1c9f,97,74,167089,52364,114725,99,73,168491,45979,122512
d30b2c270393285528488dc1fb9f61f0,16,8,2438,778,1660,12,11,1735,1068,667
ac9c4cb7e2f880f9fa943419b545bce4,148,124,541623,120420,421203,174,147,545721,105482,440239
14d104c9d1140fffb739906b3656348a,128,77,185317,59034,126283,142,64,181063,39028,142035
00037ec850dcc946af2798a9f5036066,155,122,558759,86410,472349,155,116,502655,117828,384827
5dde1935d1877e9ffc1c80427afff6fb,133,103,385408,105677,279731,143,119,454506,99343,355163
75bdd6264180fe608d9d88948a7ae08f,15,11,1858,1196,662,14,12,2267,823,1444
7cffb6d7ac2448a6283cf8b6314a68ea,51,46,41822,17731,24091,54,38,51970,12534,39436
b677d6865cf7e53a5d646e8a20990f6e,32,24,15938,4344,11594,34,30,16433,6453,9980
e9ef969979db4e187c3730fdea567680,33,28,36264,16376,19888,41,39,52704,17263,35441
9374163659b2d7572740a725dd555118,54,39,48526,21607,26919,59,46,60332,16784,43548
99dc62cafa48de6e2942a3a226dd98dc,100,78,148499,53692,94807,125,101,275157,44068,231089
ae69975febb8efa0e90843493f587cd9,41,32,29776,12214,17562,43,36,34252,7622,26630
f283104f1ed144fc80e040b8aaeb530a,105,78,280272,59823,220449,102,91,232407,82155,150252
e4c7096a6ae220b2a8a5d6cbde5b8048,97,85,138994,41454,97540,75,63,158391,32005,126386
eb1a394074628f5d23c9ad726ae799e5,254,202,1567002,311888,1255114,219,143,1846709,276921,1569788
eb94f625598767e537060b9ede7077aa,3,1,658,216,442,1,3,216,658,-442
8c7305d1feaea0ea6fecef9039fcccd2,68,58,111611,32144,79467,69,56,107787,32783,75004
f8a599bdcb21d71cad4d0a062cff8195,52,55,50330,21701,28629,66,49,71404,23259,48145
b716905503449ba3d136a4a2469d16ce,47,32,74793,21776,53017,89,73,149791,28960,120831
30db4b325ba5e0ce7ebbfcdafb734fb4,42,29,50790,20266,30524,41,35,40401,19854,20547
28a7db9aad97f0d537b342a1c7a96bbb,77,68,177788,52255,125533,62,49,136889,67049,69840
c474c96271ef5b441fcba239b4f097bb,74,64,113881,30736,83145,83,64,154646,32935,121711
db27c505c6f03f66c35df26d86f58648,38,25,33523,8457,25066,33,24,21489,9001,12488
df55b9a9ff99c5bc8b1ce306927e893c,20,19,4502,2929,1573,18,15,4519,1960,2559
11a8bfd2ba36e08473c7ba3dbf8bb798,70,60,70998,17720,53278,43,33,40653,10795,29858
731a558bfca671d3941675c9b9090af7,90,71,163259,50911,112348,102,81,189841,49815,140026
b9ff7e504481d6b5be1aa9fddc732b56,191,141,687287,178614,508673,175,104,670369,153544,516825
6f68374fa219156508507aee3c028afe,85,68,192161,39635,152526,97,79,209508,41400,168108
8640ed52402d1c89ab7e0e9efde15fb1,72,50,157105,34747,122358,75,56,120685,45177,75508
463ef59b74d64f1b5018991c32507a3a,28,27,18592,8010,10582,27,21,13749,7784,5965
6b68a46b1d9293ba9bf34f071be2de0c,191,138,514230,111526,402704,136,87,388008,82471,305537
45b613fdd93567e2201d12b404a4d618,92,68,134491,29741,104750,88,73,134190,40067,94123
b608ce997c07959076c8e8c9776f16d2,124,85,240287,62071,178216,128,85,239815,46190,193625
799857ddc0d6f5ac0a72dc429937e532,68,63,85261,49533,35728,115,77,176312,35237,141075
4823f99a21df5c16122caacb1b591a5c,57,45,52330,28683,23647,66,56,96363,31464,64899
42989a413c9f1e698fcdc4ec05597a46,41,29,42663,18898,23765,46,34,44168,13489,30679
c35f36460c37168b1e5f23504c96781b,81,71,320991,115489,205502,119,91,402341,136947,265394
af34238b10367af01c1381bf9bb36cb5,138,98,337522,52787,284735,145,116,264178,73681,190497
83afec8c33a5e4d3b401dcfdc3d75c6b,28,23,9836,5420,4416,21,24,6309,5241,1068
f82e3be2bd537e678d41b7c89ccce7ba,59,43,104648,18817,85831,37,34,38652,23802,14850
8a888eb6b64e2fe1693e5bf71eb77f1a,100,84,199675,47039,152636,96,83,178051,64542,113509
790805a2a20c2bdaedd01cfb0a90e9cd,59,52,90153,26243,63910,68,56,93895,30556,63339
87488f775bd9568831646af39e3fe526,93,84,156083,42846,113237,110,79,243747,47987,195760
6fa5e2955cef5d41dddd71ec276dc517,67,55,85618,22867,62751,78,60,78640,25154,53486
ab6fd678bd380e2361ddcc7c5b87ba03,41,24,44620,14775,29845,33,35,42957,16253,26704
c3d900189d721f61351d28d278a6ed50,25,23,13873,7142,6731,32,24,19460,8197,11263
807b1ef0aa5fc355239c01c72f3794ed,46,35,33141,8453,24688,43,38,29356,11282,18074
6060139bf86cf8d4d5dcdc87b1c1cbb5,111,90,182785,54784,128001,120,92,196544,45847,150697
a64c387f2779c5a2796d94a9ef9a0bd0,161,130,363578,63967,299611,153,112,401295,61187,340108
909435f30ffcd9d02adff8c444f5d29d,60,55,111678,30334,81344,57,50,91563,24413,67150
511512491d10a153f2bc8764bc9958d0,30,29,19266,8195,11071,38,28,30826,8694,22132
3b1e11e2047e5aa7d1397f757cb13022,74,54,95557,28411,67146,85,82,119280,43328,75952
61b4144fe71e37a1afa0b3e67e07806c,149,122,476587,115444,361143,156,116,586720,86429,500291
c43eb96fa6da5435af56accfa2df4515,110,102,195257,38596,156661,92,73,151714,34805,116909
d6799ab951b813a4d8e4819098d9b2e5,20,21,10899,4883,6016,24,16,12159,4032,8127
a1defc3391566a996e3b35eb1fc24593,45,29,37770,12771,24999,44,35,35955,14455,21500
dc5915b3e63145692646a503bbc5b9ae,100,75,258894,91908,166986,128,116,330726,85068,245658
d539e708c7e2c91580cbceb0f970883c,43,36,33212,9389,23823,34,29,28363,9213,19150
d0f782e06c5369db7932eafd23908813,107,69,312720,45166,267554,121,89,296666,54997,241669
e3f7f3eda5699f5b814b6f07ec381b33,76,58,113707,41542,72165,73,53,115160,37735,77425
163a69549be5e9f9ae240cc1bc4e0f92,55,47,73318,22845,50473,47,39,77605,16666,60939
55d49811383ff75d7baf89e4741f57ec,138,108,318731,56773,261958,110,88,253721,71973,181748
ca043c2aac9aa2d664db33a37cda922d,80,68,134418,49507,84911,85,69,159569,50006,109563
f7c490047068ca85c228c7f498ca452e,148,105,260960,63090,197870,134,103,332594,58494,274100
37bffd3756cb6f41ac23f789d3928e2b,155,128,537137,97832,439305,78,60,314772,91345,223427
42827c77a1b7979162b374483ce5856c,66,45,119244,41749,77495,66,51,107806,38514,69292
1fbb5c047fa997e080cb03fbff641078,28,21,14011,7967,6044,22,22,14671,6284,8387
a3056146ed8923a868a7e52e2f776c63,127,93,303250,97420,205830,126,113,370628,112664,257964
8d7b4bc22da0e5f756e491aa52787741,67,47,80444,29306,51138,66,45,120018,28472,91546
bcf16e1d9a9da61717bf2f9b4585e44c,136,109,267427,62747,204680,96,83,241702,72483,169219
db578fae2cf17b7852e86a18cf62b42f,91,78,236043,60665,175378,96,76,239661,64526,175135
d58b963d108e7559fe3f8b91fb7b35cf,122,92,343315,50976,292339,177,147,566246,54084,512162
06729a63e9c2e45af214c755727c3d2d,153,116,525631,95699,429932,195,168,724558,124671,599887
93fedcc20aa55daa52273281c4310cd6,145,120,295288,53283,242005,94,77,161041,71421,89620
1f83a134fd6868bbb8be16038c03c3ba,183,139,460947,79576,381371,160,113,474919,88155,386764
6e2a15c42ad6a2cce3bb6e83ab73de6a,149,144,654101,136985,517116,178,148,759951,156545,603406
939789637b2f06aa650ccb518f02de9a,200,147,686655,246844,439811,206,146,930776,138811,791965
88fbcd767ff66896c8e6982b2de0c589,12,9,2192,1742,450,11,6,2597,1167,1430
21ec620c31140dbda9ff622cc49e8a30,60,39,60403,18488,41915,45,42,49686,24944,24742
eb03efc887e0ffa2d3df9c1c427e23aa,146,105,397162,65850,331312,184,147,506698,96815,409883
87a07bcb1b9ecfb102afa41ed3324ef9,28,17,8268,2863,5405,19,17,5109,3741,1368
af7554de49c5b4aa4d26a8762dd6ea72,57,40,73726,19707,54019,57,44,74031,24301,49730
e84378fa2898a9a319a9e5f38e731975,149,106,324419,71786,252633,153,123,416558,82318,334240
d0340c20365cc2b8ec62c068301d4c1f,81,56,129314,48112,81202,101,79,204731,42710,162021
aa5cd55a54e81aa1ce45734d8ccc9e19,156,103,339029,56257,282772,111,86,214987,61415,153572
3978752883bcf68cd6d353a447cc4206,136,97,382603,66356,316247,103,82,284027,75588,208439
a1a06388041062444103f115a976471e,130,86,375859,77622,298237,143,97,426265,99084,327181
d0cc054715e214a199211ee4c6418393,175,120,439171,70400,368771,130,113,338560,78934,259626
7b77b77d8e3644697ed3c41be537e63a,53,33,50247,11196,39051,45,31,48256,11549,36707
d3fd852cbb650fdf88273fd3a5763207,126,102,368153,64280,303873,161,135,436983,76774,360209
b8645f306eb9230525b84f8c8b9f3f43,86,70,172092,31190,140902,58,48,85475,28909,56566
50e465318df73681f93bcf78e8c78ac8,153,109,483259,111160,372099,163,120,513498,116560,396938
31e17a7e19ddd1e0bbdb3988e7238849,4,1,444,126,318,1,2,126,329,-203
82b54044fe1097597d6a7a0bb3554572,82,67,114556,58842,55714,103,78,184901,49131,135770
f28cd7852525c9e637c3842444e5c7dd,67,63,118916,62100,56816,129,88,197958,52096,145862
67d87e4fbbdbca25a4938169b5c9b994,114,84,215609,59614,155995,113,85,269143,44978,224165
df4996d9173aba6bbc8f083853117e6d,91,87,169704,46006,123698,112,85,184638,37356,147282
fb19364be46b2fa615d8ef4bcda1691f,149,104,488471,108420,380051,171,124,635339,145941,489398
0d800018f7db0af0af9923b57ccc175d,170,114,716161,108284,607877,151,113,441977,134478,307499
91bf6663cac0bda35b3e1fa8121bf12d,37,26,38292,9398,28894,40,28,26126,11103,15023
4ebd73acec8e608cca300b6956b0e020,173,134,413115,69380,343735,125,98,350352,82010,268342
3c9378d03649d4f3bc3e0c475e0e2af0,169,116,701267,164612,536655,208,162,893991,187395,706596
d4b16934b68b2b2ffd7ef317792a3421,124,100,520297,106911,413386,190,144,553834,122063,431771
33c0d88f8863f5ea4ae5fb64500e821e,61,50,65805,15009,50796,51,41,68986,18828,50158
59f3acfab608a280a17b8df96b00dc39,45,24,29902,12513,17389,43,31,35566,14581,20985
8ac389fd4991c704d32456a17332321c,169,130,627033,105971,521062,166,126,568963,92010,476953
70f88fa211a8494c9eafaacb6e670151,22,24,7026,5046,1980,25,19,9213,3868,5345
7a89faa2dbd3064a27f5fb4dc19e724c,126,107,381053,96906,284147,125,111,406203,81927,324276
c6c582006e595dcb89afccff7f64f76a,164,120,449152,77279,371873,109,95,283510,103193,180317
0c0786c91942955882487fbca84aea49,85,68,168520,30986,137534,68,50,143312,31876,111436
d9acbd7acb57e1ee8b336d82426bf862,121,94,266553,57658,208895,105,84,215768,54051,161717
f560223d149049e744fb779c7b57c109,53,45,81925,22476,59449,83,67,117136,35797,81339
0c78236f5504a3381eceb1c4c44a785a,80,44,108532,23924,84608,67,58,129675,30370,99305
d2687c48a95b55f25769c40cb65ce505,62,37,95248,22736,72512,54,46,88330,28399,59931
3b2bd4596249386ebd53c877cc01701e,45,33,49761,9633,40128,30,30,22242,7408,14834
4700a0c213547fba6a55521f02836c7b,88,74,155849,39662,116187,97,76,147310,39788,107522
434f14be6187e0852ada85e9c157e0aa,20,21,11103,4045,7058,27,17,9082,3524,5558
9d8eebac926fa496db00ce6ac0fa1a20,89,80,190408,59694,130714,83,60,158568,43060,115508
613d351fde68068a3ba835b08014771b,181,135,745378,165126,580252,207,154,832518,148685,683833
4b9c70bd1add28395e3e0e5030d73d85,131,100,350780,72053,278727,127,114,373132,89529,283603
56513f0ab5521eed8321158a5e085cb0,109,81,187206,35719,151487,81,62,136048,30859,105189
c18fff6a10e81f0478340560e41f7174,105,82,231913,60541,171372,128,89,299632,45648,253984
58c1bb11ea4323b1d3ba5fb8cf312898,208,142,780328,124953,655375,209,150,825895,188800,637095
e63f70ae4a9ba6ec8653898e1a74735f,89,78,196843,45545,151298,103,89,235698,66045,169653
8482ed92b15c791a240d053bfe638ff8,180,141,727295,182895,544400,188,133,759419,132524,626895
17cf5d72071db716294c3cdb845040d1,166,122,547072,95109,451963,159,115,613061,103095,509966
5a00a235c8a1b6c37f627d50f8c43e59,61,41,79653,19655,59998,49,38,51889,20904,30985
865fb4fde87a6a8f68b85729a6930883,68,54,106691,22814,83877,55,32,61646,26083,35563
ceabd4c9bbc3dc1ac1177bb96ddce06b,40,31,37793,11449,26344,43,36,37610,12306,25304
6f54a599a675385dfe6da7704c45fc28,1,2,55,147,-92,2,1,142,55,87
586fa842cfcb0785850731098a142ad3,69,57,182746,43805,138941,95,75,181253,70571,110682
091fdceafc0019b53c9a4fbaa1df1efa,40,31,54305,15662,38643,35,30,39224,14596,24628
bd4d48153b72fab3abc585e7e4c3e27e,207,157,859261,112526,746735,187,162,640546,133572,506974
84ba9ccf150b1573f54b743d31180760,205,134,1091352,164042,927310,171,133,834877,159495,675382
9400479109d283e86120b35ca417a3c3,87,64,203000,36353,166647,125,91,229019,43616,185403
c99ebc78a071b68aa66a556fd440231e,56,50,84899,36025,48874,99,77,140703,34343,106360
79426de8e890ba6850df7081eb3070ff,55,47,81481,41388,40093,94,73,141182,37989,103193
5555044250a5ef0f19ce9f3e31b7294d,153,125,470969,69564,401405,157,130,505025,93313,411712
0124e4f5edf36c3ec3964a55e6f517a0,22,19,5724,2245,3479,27,20,9864,2338,7526
0f7d451b3592e5e8d551c57494c620f4,89,58,154747,55968,98779,95,82,182612,63177,119435
a1967d44f836c9cb05cd61a5c8a87392,75,50,197365,41263,156102,60,44,88289,57311,30978
8c80608c9be291ce8def414d85a96c91,106,97,296839,110520,186319,139,105,336920,95032,241888
1dbb445a1f8138a1ea1d492c35aeb877,53,48,58327,30984,27343,48,40,80079,19124,60955
f51eb713b8378a9dc6d3e2c1649ddcc9,34,24,19185,4547,14638,32,22,11054,6636,4418
83ad467ade8173d96d2ef1232bad5f7f,29,22,16177,7083,9094,25,23,11728,8198,3530
63fdc132a0ae11cf95c8105c55fe617d,106,84,243691,72928,170763,136,104,307874,68072,239802
6f030de50e5b534bf9a6a7c5005bdcb9,126,81,286204,51483,234721,125,102,256263,56521,199742
7f8653930b6a8b1863149cfdbb12dfe2,0,1,0,83,-83,1,0,83,0,83
23773bd80561e19749f74c10ed0478b1,55,44,46672,13336,33336,42,33,40611,9028,31583
1443391ef7fe5e99f34c5e629d7b5a3e,79,66,152285,48386,103899,99,72,154868,53352,101516
692a09fc15e85949b2acf4d7c37b444d,22,19,10822,5676,5146,21,13,13808,2529,11279
b1ce9aa9a2267d8d8bee064b6de864fa,34,26,22363,7474,14889,31,27,16283,8690,7593
27621d9a1244293ce94a980fae07496e,30,19,15102,4612,10490,26,21,17692,5458,12234
375f08e7d1673f03139f7a297d07019e,184,126,623629,123745,499884,159,114,574536,115117,459419
a462cc3fb49fe484103b02fc4b5b37da,145,103,555267,102423,452844,191,146,626235,120241,505994
69e131ebfd246d723de2af75343e5c6d,184,138,541561,77159,464402,156,135,435573,60747,374826
489ba608a623be7753e6da79982809ff,190,145,754161,183837,570324,172,126,743222,138346,604876
8f577f33fb2cd3d5b96a73949ab3b053,76,58,131386,34411,96975,67,57,115797,47858,67939
143c0c43c9aefc54620f14a5c1ed2643,22,15,12761,3686,9075,27,22,11664,4712,6952
e97feeee1efc1bfefea95e31ece5a9b3,82,62,317345,70668,246677,125,104,354380,96282,258098
b1b4f926c37fa004c571902059c6546b,13,7,2212,917,1295,11,14,1462,1489,-27
fb083f9b24149b6757af2bdec3a15be8,40,30,31076,11153,19923,37,27,27102,12590,14512
9d68c9a5790de08e3d8462f912bdb25a,13,14,1613,2274,-661,19,12,3215,1269,1946
b2d6df0136fea02a5ecac364ba69c710,93,78,259170,62462,196708,112,76,238349,40743,197606
6f9f55a70cfad58d8b6df579a930df63,103,72,150811,34512,116299,96,60,139583,30354,109229
c8b2d58f65968fc2871c5b735a7b7f43,123,72,317538,47966,269572,134,113,308147,82732,225415
4503f9c83a70c3fdf1d8c0c3a53192e8,50,36,63307,11784,51523,41,34,39014,15773,23241
c3770e32cd06e02df0bd9cadb3cc7a31,124,96,232101,53316,178785,60,55,114857,60007,54850
e8625d9f67f9191d5612402aeab16723,73,59,94707,33666,61041,88,64,132763,22436,110327
926fb49d7372fb4bf05e4a9a115ad6d2,37,32,49318,18826,30492,40,31,53538,18412,35126
f273eceb684dffb3963cd8c9141aaa32,205,133,950180,139835,810345,217,155,928328,161616,766712
2958949791fd2df82c74f1f310680357,56,33,59662,18947,40715,50,35,46594,15157,31437
4c2d7017c9e550f0a1f465913832f22c,107,67,182229,33965,148264,104,70,160746,53319,107427
873594b549711e7c3798a73d6d4d4e9a,114,85,308014,75391,232623,112,89,344775,58109,286666
b2dd87d14dab1c563a9e4f4388d5ead9,25,19,7564,5338,2226,29,23,14228,4486,9742
2ad90c70e696458f0dfc93e77c9db41a,89,48,130968,30929,100039,94,66,108884,31189,77695
7259effe73f64e5ae75ef916f2055cae,137,103,403463,67199,336264,144,116,386282,83747,302535
cf94ee77b4c88b5dc40842082a86a739,88,71,139888,47507,92381,109,88,182165,44302,137863
17d401eefd38088561fcc527682eb804,43,35,36526,13150,23376,43,35,39513,12117,27396
7b4c9d3f2a164e8b52d45fc1b0fc5ebe,129,101,379735,63992,315743,186,146,453443,99705,353738
cbccd8e36c808e8be59496dc2941feea,147,87,260895,61951,198944,103,57,179543,49874,129669
ebb5f320ceb8ea0d687d8ee4963d93fa,122,84,310828,61358,249470,130,111,316004,66180,249824
d9e8676378a706e9f3f9a650a82ed649,48,35,48037,16942,31095,50,40,42227,18449,23778
08eed586c37fad8a2133c2fb365865a6,62,52,109303,21601,87702,76,49,98704,24079,74625
c2e41626586c3b02e9be65237744bdba,118,87,262401,59628,202773,160,133,401622,130867,270755
33f73d6ed2592f91f67baf1bbe0f376d,52,41,54152,15078,39074,41,38,40020,16575,23445
0034982c322fb3285836d4a761792f2d,168,128,624739,136754,487985,158,134,783816,143237,640579
ce9eef4546926fecf5426d65a37b9b15,138,109,315961,57888,258073,155,113,278342,52777,225565
30a1d631417fd84893862f1f89fc8f94,109,90,233844,43589,190255,98,82,137609,48741,88868
cd9fca4ef555a646ebee5c510323a1b8,154,113,377676,93439,284237,131,97,459042,75987,383055
4feae01a716bb912f514aa7717ac07ad,126,101,334794,133711,201083,156,133,453725,95897,357828
33abb52af45dcfff90626ec06eb2bceb,127,74,205339,46948,158391,148,85,312517,50689,261828
0e14226e236eaf4411b0399923c68f03,37,35,31694,13493,18201,50,34,41900,12189,29711
ead38f41768d99ab1536628f40156a46,74,62,120817,14340,106477,47,33,42722,15930,26792
b038d07cc878e35e09c539dd45469b13,95,65,190270,61773,128497,116,78,210413,46137,164276
75fa394366c398105bfea38c140b7af9,130,103,491461,90469,400992,153,119,523763,109880,413883
82b544e85a77c38f09ca815c1173efdd,44,33,39800,10001,29799,51,32,34298,14643,19655
e3308c132befc69ff255af5c44142600,22,19,12216,4280,7936,23,17,8772,5561,3211
33c01fffb09b1894d10c68c5e25ea2dd,138,114,421078,76796,344282,74,54,172694,56997,115697
e9bca1ac31530495f72190b02bb3528c,45,35,44856,11704,33152,37,30,34097,8964,25133
0852d75350357a26443a9a5640d05628,98,74,273275,45512,227763,132,89,240501,52037,188464
c313f54f7a593411b650812d46b6c038,68,58,132723,40360,92363,63,51,117002,39766,77236
834171de0b60f8406bd2f8f89b5e1560,149,126,513215,76552,436663,165,111,348704,72886,275818
eeadc55cf6b02ed99d24bc65a689c9d8,122,97,258056,44688,213368,118,97,244111,55117,188994
3da7389dec72119313914c4999d92ba0,43,30,49549,18201,31348,47,31,40292,17158,23134
0cdb0940df6f195dbf3e21f5743969b1,52,48,76723,24588,52135,49,32,52769,22903,29866
e05a24e1ed975339427c04cfaf500de3,82,66,130315,33977,96338,51,40,82367,23063,59304
c4f63b88a128557dcd4c39be4cd0f740,31,26,15983,6966,9017,28,23,15325,8176,7149
ff68465c145fa4b71be3840a4e76b15d,208,154,1626752,237034,1389718,204,136,1101626,140261,961365
a55b6bef2235e2e76779e8fa97bf6e69,137,104,354680,80210,274470,131,104,391264,94122,297142
419780b5229b44f93f744678443fcc34,58,41,58761,16738,42023,51,40,58114,13923,44191
b35f29af230bbacfb9d69d8a82de7270,166,130,571177,194371,376806,162,106,660116,185225,474891
489bb2f7b32760ecd937d34a4808834c,123,91,340228,91938,248290,171,146,629366,80386,548980
fd7de3cd69a9b18ae23c8753f6c0db5d,64,45,91780,31076,60704,81,70,133936,37984,95952
e6bbb20cb6f27232122f59bfd6c3a4e5,30,26,13946,5795,8151,26,24,17250,5214,12036
e92801ce513b4ad49b231f8c3a5ff5e6,66,57,97977,32926,65051,67,48,111948,21477,90471
31e08b3beaa0a1df34d94e0f23b68df5,36,28,57246,19241,38005,28,25,44475,19769,24706
1c17cfa4e88dd5b6af23e59a2c222e74,32,27,32911,11988,20923,29,27,27493,11235,16258
d352d10f8951a390bb2118357fa2be84,167,148,582161,113745,468416,141,108,503879,80053,423826
470f40676acf7048d79c9c56e172ad7e,36,29,47559,16756,30803,40,29,44622,16725,27897
d76d2fa6c488431c4abdffc4f37cb4b1,39,33,23264,8691,14573,43,32,28649,8098,20551
61011004c9df7b908d27a866a2e44886,108,75,244841,56389,188452,92,75,191861,60022,131839
6c4eb2f5ef5029e72cd52fcf77983789,83,70,185666,63550,122116,154,106,358951,62666,296285
c6517c67286c2a01c590547e6a34c99b,85,70,115835,55890,59945,76,54,142421,37017,105404
395bcd28ab3fe56e2bc7bdf38168723e,182,122,585965,139133,446832,222,188,1121456,170061,951395
9cc6d22c47d9dd0733cee24099429c67,111,87,166335,26164,140171,130,90,224628,31384,193244
eed31db2834a1ec69d45baccc80454b1,141,94,501892,117150,384742,176,129,501646,155303,346343
afd3a64912a1695e29074ead44864884,0,0,0,0,0,0,0,0,0,0
15a8b4c0594c0103bbb23cbc6147252a,51,41,71360,23336,48024,40,36,35290,19169,16121
3aa554facd36b1f60321ef8038bbe607,63,48,57475,31655,25820,53,42,56433,22735,33698
c97e620a598e08f4a8a23f9fe2373ebd,18,20,4314,2426,1888,21,13,7691,1889,5802
0ee3f8f51e5641cdbef3e4c5f4a65bff,63,42,108027,42666,65361,86,66,154907,44796,110111
00fa2acaf666d1b3861b33652c421513,109,78,229565,72028,157537,79,66,159951,63396,96555
75880c24c9376cba62e6f387594bf8e9,14,11,4078,1647,2431,20,10,6995,1547,5448
13343b1131a99c74d9c7c81d7a60e90f,45,32,51772,21182,30590,56,39,78111,15368,62743
65f19b7c4e6d05f4c841aafd38c07cba,57,53,75922,22463,53459,93,72,106564,27755,78809
3feee8bf9bd9642fbbfaf5c663b4397a,143,128,458988,79033,379955,128,97,315777,58412,257365
7c9bde950b63e0e6d73e32485320b53c,113,86,262181,68307,193874,147,113,333097,56008,277089
f47d73a68cca1cbe5714dbf9b7ebfcc6,34,30,28006,10433,17573,30,25,17449,9162,8287
674d182e0076decb8459df574a6be546,80,69,172862,26750,146112,72,62,100587,37217,63370
2b062431b97294fa4fad7bb7b535a62b,15,14,3748,2234,1514,17,8,4307,2147,2160
913d8fc21580dff9e9f61fa74f7f5dc9,107,87,274406,43304,231102,80,74,141724,62757,78967
2fe8ca91112e7a3eb3e87eec1e6ed659,184,160,717719,154128,563591,194,134,557625,131295,426330
68e3a1763b796ea2cef276e036ced3cf,70,54,82673,35732,46941,75,61,90396,29721,60675
a15bf68b6296675987e09049ba32b3a1,48,33,42393,11840,30553,60,39,59103,14353,44750
c1120619650277aea51c9a51d3ea18db,84,74,149397,44656,104741,75,62,128186,30731,97455
4c3fb52f2d87c738ce90fa9ba53bda2f,118,80,221499,53875,167624,128,87,233306,60873,172433
8fd6311eb593b5f1ee8f40a843378a31,66,53,163002,36318,126684,125,89,183613,42455,141158
b6869c93e91bace4e4dc81fff580ce29,90,77,190702,54860,135842,100,82,172258,53708,118550
474c28090a4fe646e8ed0830770ed646,82,64,129747,27184,102563,101,87,175217,35808,139409
787eca87a3739de19cadaf03b1c1c2e5,174,133,523016,112505,410511,169,93,505590,90019,415571
1755cffa8ebd1a40ce66659c025c0dd9,66,41,54404,20892,33512,60,41,76252,21264,54988
e6a8675da8b98ceb9ebe8ac37d45d28b,134,108,373967,91766,282201,91,88,246942,96983,149959
847604dd7ff86868a085cd8fc8b467f6,36,35,19921,11053,8868,49,40,26385,9175,17210
b5e36c573bb9a8679b87b6d54dee410c,76,59,154039,36957,117082,61,53,97396,45911,51485
6f86fb804af07e3cd5db448ea369858c,37,30,30506,11735,18771,36,32,26923,11139,15784
e39f7eb8429d6a187403d8bcf038b87f,216,156,668989,122035,546954,159,126,555725,125521,430204
86f3c8ca4ac031fb271a86033e93bb84,57,42,64248,21412,42836,66,48,76832,17180,59652
e0ea561cea5286696492ad75d9361cc4,10,5,1819,785,1034,6,6,837,1107,-270
c36d569c311fe6d323f9a6f13f4f2757,108,78,222594,61344,161250,130,102,253959,40371,213588
4865954aac3488e8f7b0037f2f281ae5,105,90,238350,44129,194221,110,81,224080,47556,176524
ec69f7ae51ae8beacd318774b5f4050b,56,45,90400,17755,72645,53,40,75827,24668,51159
fd6f287506f797839c55b643b9597a4f,157,124,415771,67055,348716,102,82,240727,95228,145499
8264928387dc2800928356d2dbac5801,125,101,319044,79331,239713,172,131,441108,93179,347929
770d3b2ef33787e6b2dbd9b2e2dbe6c4,66,49,136446,41395,95051,116,86,211227,39558,171669
df7a3949f4930280d563389fd0bea2d2,39,32,31182,12054,19128,44,34,24364,11381,12983
f88b92361c882f8e89988018ebe250be,65,47,83621,22200,61421,63,40,57981,19115,38866
d98d248077d488d820a9192400e15986,137,109,315303,55331,259972,116,97,206070,67592,138478
2dea77292ea301c530091c80e257632f,149,83,221282,52492,168790,68,61,121340,65834,55506
b9feb980d9e5bea7c51619e99b766f20,148,115,511449,148467,362982,159,135,638247,121425,516822
e46dcddb8bc455b6ab5528890e7076cf,105,90,238879,70633,168246,122,107,310022,81234,228788
cac2b4651c06215e3e31197fb1999173,77,59,156232,43366,112866,84,73,137229,49903,87326
0724c413baf67100ea8c393a7fbd571d,162,120,524157,116771,407386,162,115,567025,115366,451659
f3aa7d005de423263c3869f9bd0cf3b0,22,16,2949,1534,1415,20,13,2665,2032,633
2eb0d5552b08a44564cbcd8c42ec292a,84,50,104431,26441,77990,83,69,104910,26158,78752
d645e16efab98fa3a3bdf8693b74ecd3,53,35,47099,12536,34563,37,33,32610,15593,17017
022e879ffee29fb7e87d95555ec5bf32,90,73,266682,55626,211056,167,131,510472,53872,456600
3192e02b4f71b04b8db8e6e0766c8e51,100,77,200420,44753,155667,80,71,159218,55944,103274
066b78ed075807f1db9ec01eb5a5b199,48,31,58279,18048,40231,48,38,44912,21539,23373
a1dff476a06f952fb5690b0ad7b2de7d,117,111,442015,146487,295528,156,95,460749,128684,332065
68593a1bb818f162bdbd1f325a74ec13,171,118,504049,108325,395724,167,127,457330,108774,348556
e4600747fc45ee1f5c7ff10b4a589943,55,49,74270,31311,42959,62,47,113527,28758,84769
14b8a0f62111e5dcadf932c99e7fe665,145,99,419573,87806,331767,138,108,373907,141287,232620
6cf331dc0661ed28140a363e12c95c23,83,59,180713,41460,139253,100,89,199577,48910,150667
abc8f2444e92bce165caffb438f9228f,84,76,198529,70276,128253,141,111,354846,69723,285123
77c8c360ffc8cc32940e2b2eec332190,171,143,617538,122980,494558,203,143,574193,86159,488034
c2629e02674247dec06a859515302aad,69,53,112089,31654,80435,85,76,129225,30074,99151
bb2eee32f708a61b668c1d85c655396e,195,122,579296,100694,478602,163,114,600422,151219,449203
10930de7ba9ea8ff5211411269d06bd7,99,79,148132,42035,106097,89,69,172500,41970,130530
8ae65895987da44e1d66d5787bffa854,68,55,140205,41245,98960,78,77,150072,56582,93490
e0c898a274fc9811a4f76e5667728d4d,123,104,298885,60745,238140,125,106,287955,67829,220126
6d80300a0ee4b6ca000429a7f8f7fc60,113,75,220629,57168,163461,103,81,238759,64109,174650
88aa68102d7e89c68a7dbc5163819c43,97,75,201507,44187,157320,88,64,161134,44095,117039
608392ccae5d90dac184f23a05e0f687,28,23,12932,4056,8876,34,26,25959,7309,18650
e81c352773d4f5ca0f488fd865de6e32,13,10,1682,1204,478,12,13,1537,1509,28
fc0a9477ee6acca4eff41838f3772e01,34,26,27495,7978,19517,30,18,23159,8332,14827
6946edbd1b3410dc73bee6e56685b55d,132,89,248680,52244,196436,123,73,234593,52066,182527
1cac9e2d280f9ca4ba1a1a50be1b8aae,59,43,142216,36814,105402,66,50,117876,36797,81079
b54aea743539dd4cad29505e1962f0ef,26,18,18315,4308,14007,29,22,19660,7357,12303
fd67f2192dede641e20d997e816d3447,15,9,3705,1135,2570,8,10,4302,1207,3095
0ed9576c0278ef0c27e37b3b571d252c,92,69,104461,27543,76918,80,47,106015,18519,87496
4a8abbd7510f124918b238279c4643dc,145,127,485074,72503,412571,139,119,479917,70394,409523
b3a959dd25d51933da991c86b8eb1a54,36,21,19724,6321,13403,30,27,20512,9093,11419
596a9acd60725a1f690361f093403c35,113,86,241160,67995,173165,117,110,254168,68163,186005
547546b22328b948fe7e107e78375f6e,111,79,377424,70995,306429,198,168,748828,145022,603806
209148a04f15b8dbd44d0ee3615eb14d,225,152,1331690,270464,1061226,225,171,1748472,258087,1490385
772482275cebbd3ee587fe8ffb5840f4,95,57,113148,19870,93278,72,51,81178,31053,50125
deb7d2bf3636dfe2ac40fbc81d917b92,153,123,488126,117516,370610,152,121,455233,97784,357449
3082ff88c65adccb24f8cf72d1eb42ce,36,32,26791,4425,22366,27,31,11139,8351,2788
fd5395e3aaba334e0b6fe89440d3b012,139,108,357708,65667,292041,134,110,287201,61681,225520
edf39cee484fc94d7389ed3c9012a951,36,25,34770,8939,25831,31,23,23728,12546,11182
23d2ace96f954bca16d0e2acc4d79831,166,119,474536,120737,353799,142,114,395830,129793,266037
397f63de9f5e4da8cc5dee6df18974e4,36,28,26735,11113,15622,33,27,23032,11758,11274
2f8a98a31929fadc1c0c96ac9b240400,42,38,52584,27932,24652,68,43,92218,23742,68476
81f9f8d0033dfdc480a08813c0080d15,171,136,708538,150563,557975,165,122,556782,103427,453355
239b2c5a19737b8a8e9104bbe5771164,42,31,48323,20318,28005,46,37,51776,21176,30600
9ca9cc984b4ced4b0d5fe3163def88bf,127,79,309719,63812,245907,120,84,246687,64370,182317
586d61062fc3d6a7ebafbcd0b743804a,115,104,328342,112907,215435,153,115,465794,105931,359863
0188bb10699bf1f009853e6dcf49ece1,110,89,364167,73299,290868,167,135,556998,85737,471261
c3977bd865ca6500b787e439b574e40c,20,17,4359,1345,3014,16,13,5414,1246,4168
9d7f032e4da031d828d49b5145d97beb,37,26,23723,12754,10969,52,44,82158,16044,66114
20a7f44179b0a4b7ba8e26cec93804aa,153,113,464934,86929,378005,142,123,417257,97006,320251
b622dd21b8e9680625588bbaad3171e5,53,36,50858,9670,41188,37,26,20970,9833,11137
3c00851023540173c588bea6f3d14c59,61,53,94338,33198,61140,62,55,70109,34727,35382
31ea0d4c07b11371334bb0016edf15f2,116,93,306501,102220,204281,125,86,306968,63873,243095
ab17b8403f368afdbaed2fc74f94949a,133,111,348628,59438,289190,140,116,301323,73002,228321
2fa1155c3cd46ff6e45df3b923876da7,56,39,78954,12626,66328,59,47,68304,17142,51162
ea5e58255db03e4fe48ed248d9965b2f,67,47,86386,18768,67618,51,39,56787,15006,41781
ac55588acb6267aa0e18a2ebf7bdbd36,113,88,230116,45526,184590,127,100,265722,54259,211463
ec72cb1db8114fae512a686f0a668d83,11,10,2078,1672,406,17,13,2625,1082,1543
56df989e26ebd7d1020cd31713271543,52,39,56456,19347,37109,55,42,52653,18573,34080
ae74e8988c7d2cf829702b3a6e85d5bf,30,28,24843,13309,11534,27,21,20802,9892,10910
24ce6b4c930d5ed7d407f0802e63adc6,54,51,65899,30175,35724,61,42,98262,27786,70476
121291cd251bd1de61275bb80a7c5f75,96,78,212242,65333,146909,105,89,196252,66826,129426
2299ab698e3b3399d307265ca21b1fc1,155,100,418188,96356,321832,170,119,470046,98255,371791
fc8abe7da745386fe4d93a68b10cc694,51,40,29505,9220,20285,39,32,25834,7920,17914
47bcecc931aa02fcc3cdc914997300fc,134,105,415764,104734,311030,113,89,286815,83475,203340
20969a5760167d4f0e715997df0cea3b,167,98,503784,99317,404467,159,105,496281,120430,375851
28da8bdec907217261d19fe96c2f78d4,142,106,302657,47417,255240,130,101,213552,69237,144315
21caff529bac3ebe30a959b5869bd320,97,72,177766,74589,103177,107,81,275301,60866,214435
124d7eca51d160becb362c3db78ab939,48,35,56755,11444,45311,51,31,52139,15985,36154
dba6b8bcf17dbde6ed42f8da6c6cf72f,122,100,303593,36172,267421,110,101,267229,56193,211036
e22498cd3b01fa4198fd9a888f1e3eb4,45,36,52848,10767,42081,36,29,42893,11407,31486
0eaeab8589179a9b32ab5505a9309ec6,161,128,585354,130641,454713,191,143,709117,156016,553101
75ac27bf7a885e9f55a344804089e24a,108,93,218105,73325,144780,104,83,222207,72040,150167
f77f044e962218ceabfed28c77176193,31,25,15132,8031,7101,34,28,16537,6176,10361
e862f5f93d3d1c117ea8cfbfdd7f7b9f,111,90,207516,43073,164443,120,84,190122,35235,154887
c5cebb01de174a667be18b8154b1ca75,68,55,117911,46393,71518,87,68,198894,46085,152809
73f06a0e273831950da74317abbcf7f3,106,94,272664,65484,207180,106,88,243757,67237,176520
88042c7ef93bda389c3093be520c086b,104,72,147227,46991,100236,87,64,176882,42194,134688
8c93a31310950a45e191135050e6a22c,76,54,109312,25005,84307,65,50,79534,26043,53491
21f18c417b1f31a5646fa1a0869c8f89,92,64,162272,54125,108147,131,108,318536,63406,255130
ff9f0db5a93bf6a4fcfb71a5130ba96e,96,69,136688,47466,89222,102,72,182926,42394,140532
630e6324b896036d36e02ccea4dc3463,121,90,269070,51189,217881,120,107,247255,60823,186432
51254999395d8ea6d5dc123b4afde5ca,51,35,48824,25870,22954,88,57,107073,28167,78906
3d2c82bd3e0fbf34203083c07ee3af60,57,45,82055,19996,62059,39,32,50258,18050,32208
4d3be69dc166162155606bd8669ec51e,0,1,0,90,-90,1,0,90,0,90
29fb2ab0bf7c09fa47218b4fc41a5be5,123,87,237244,46740,190504,143,96,224441,39985,184456
d27c7d35d1f3b6d4cd4be842f2dda1b4,25,23,19010,7139,11871,31,25,19496,6641,12855
57ce336cc33687d29f628fe902e7d689,59,48,70420,39089,31331,67,52,107171,21898,85273
e06dfc01851dfae184cb53b87143a1aa,53,40,92376,28841,63535,76,68,130252,36380,93872
a9e5dfcca851ff05f3227dcda3368c24,23,20,11367,5790,5577,23,19,12830,5129,7701
a5e4ad6f992903093baab9d423aa701e,42,32,44120,20655,23465,53,33,70888,12907,57981
53751ccbd36760e83d60c5557231885c,192,151,822008,175121,646887,209,160,684797,218886,465911
6fbb6768d412be6923fc9aa73e8827a1,2,4,265,936,-671,4,2,936,265,671
8aea7044fafe8c9e8d5a2c348357bc39,141,110,457562,111860,345702,168,152,598749,172893,425856
286d87220f686551b527b1bb9c760600,192,159,716602,132793,583809,177,140,572446,130625,441821
d848cb37c8953ec4f4909e8691b9a067,32,31,28995,10339,18656,42,32,31224,10166,21058
bd27e1a4f5bd24f04219c2f0a681c51f,147,117,404359,113167,291192,149,109,487869,105642,382227
978fbb14918cb07045b9d0023708d312,44,40,37916,13221,24695,50,39,48042,13208,34834
69a219ed3d344d2872ed824366fbcd9f,97,82,165387,31853,133534,71,59,123190,31723,91467
e1d3dfb707a2f249501e6f48ce13a25a,19,14,3012,1018,1994,21,16,2957,1162,1795
8929b0caeed156930f80cbeed48981ed,22,19,11751,5788,5963,21,17,8220,6419,1801
a841e79bd9f818da801bb55def01e1be,65,60,76893,23769,53124,62,49,77112,20485,56627
97b3f5e045e846f40bc54d128e2eb476,113,106,290382,61223,229159,129,86,224944,33981,190963
99457bc5adaa8048631f5635968c3ef8,109,93,191724,40030,151694,75,74,95849,46020,49829
7ac4936401d8241c69388bf7ee6d2892,111,82,283450,76964,206486,110,76,229732,64110,165622
dfcdd907ec30879aedf32d1dfb9df803,48,37,55294,14657,40637,50,45,46965,16862,30103
0844c2983f05fbc6be319d11d1886be2,92,79,209035,48475,160560,95,76,159645,54112,105533
5d6a1b4546a1a8990de3e8962484f78a,159,125,505265,93140,412125,173,136,577696,98466,479230
87b746f3fefdb38091f45e4d314ca17c,50,38,46589,22535,24054,85,63,100278,25321,74957
0bad361c80006f1fd815a4f3105affd2,97,81,182184,44321,137863,108,98,213039,75488,137551
e38a8503982251a1d92c4c425e699a81,78,66,109271,43264,66007,96,77,115876,27065,88811
9f6a8f0880c05cff3dd26857b8b05c9c,88,77,177759,78848,98911,105,81,229238,64615,164623
e2d362341d290ad2ec4c33d6af6c031e,119,93,259613,64306,195307,124,99,361330,62845,298485
6c18df8b7ba4ff3b845584140a28f363,2,2,450,518,-68,2,2,518,450,68
57ca66137221846b37759079e1cd708f,124,97,290136,33305,256831,97,86,175962,63705,112257
e39b76a2a503c94ec000c1392cd1d65c,81,51,90559,28466,62093,73,60,92625,30819,61806
f67e84ded6a4acf2de78abc3758a9476,146,118,333224,96389,236835,101,82,234901,68144,166757
30a8e00fe4b8c87b4715a5935802ff49,75,45,109107,22228,86879,63,45,82673,20252,62421
f9a08d6775e6a0345328689fd8355516,93,56,115083,24785,90298,85,69,153760,26450,127310
fdd4b6734cc948558ee621bc6c3135a5,129,92,248585,58498,190087,117,91,267563,66083,201480
231f52fcf4ec62fb0d12989652d422d0,42,34,29302,11695,17607,44,36,30762,11471,19291
b20ed3be6ff5c63a93a146314d0bbb13,158,133,609401,96577,512824,138,117,446250,123397,322853
ccde0f2b066c9c3d503c533b6a9d5a6c,37,34,34084,9015,25069,37,29,33766,11160,22606
f9661aba66742e9298e5e0d58007d1ee,119,91,245440,63057,182383,116,100,270759,64763,205996
e5c0563ec3fe3a62eefefa5d1817aaae,46,35,46586,22632,23954,46,37,50760,18229,32531
8b7881c7206fbee19925727f9182a2b1,79,62,108336,31122,77214,102,71,153727,25168,128559
cd2d7cf379cbeebf5febf506559a23dd,205,157,779454,116271,663183,156,130,534743,134183,400560
6ed8a4f8d9879522972616e2b7c7b266,114,87,336692,96745,239947,136,115,332198,151184,181014
25083f8e31f430d05508db40268574c1,68,48,68607,20879,47728,61,55,65017,17841,47176
14eae3ae0247ea37b485f817b9a1faa2,101,95,202721,103484,99237,189,144,545648,75055,470593
5023c4e7010e5fbda55cfac2c720aba4,26,24,20961,11006,9955,29,21,16085,9103,6982
72d725f2c9bc12b0980b7fabba3a3586,162,117,382565,103023,279542,132,110,367717,108114,259603
000512626993f35d460fa7e9fbf31379,22,16,6941,2501,4440,16,18,6368,3248,3120
9e0ff77b3360ec6db0509046880b28d1,37,28,42489,14349,28140,47,31,41347,13178,28169
8e318e8bdb08e63881579c051c7e4485,47,37,33077,15080,17997,57,33,47261,13460,33801
66e3b9ed742219c451735f9a8ff2b635,123,90,312528,99265,213263,171,113,431606,121707,309899
3247405f8a0e41900f1d04c178a1a709,137,99,522116,118148,403968,172,140,530838,168147,362691
cfdd69ac853ec4ae5f7af0d259585396,124,84,207064,32048,175016,104,87,203146,36659,166487
bc55a0986f67836ee6011c65b4ac438f,98,74,242120,37381,204739,92,82,142370,49461,92909
d7a5149afb25d5af30ce24aabc4e2527,30,25,13255,6416,6839,31,15,10994,5826,5168
b0db47d225b26db6769b91e999bd2d58,62,51,82243,29674,52569,72,36,102326,24512,77814
0c865fc907e5d71ca0dd708d57facd31,102,84,208451,51313,157138,79,65,124965,51419,73546
9d9d94795b1eb52acafe29d0ff337d50,19,11,4350,2652,1698,16,22,4285,3172,1113
4ce7a72a42ca695f980b741494234eaa,178,126,370130,72069,298061,119,98,246799,81143,165656
2d81c9310b0a3e17d45bd499bd600969,118,94,240545,46463,194082,94,79,171612,63173,108439
ef645abe7bd8ac977ee14f37791f6ae4,61,52,92101,22917,69184,63,56,63752,34682,29070
13521250407fa46ab448a333b59edcaa,35,34,24899,9692,15207,24,17,18635,5591,13044
64fa625396153738fab1f2d49198d86c,77,64,122430,31848,90582,80,56,126406,27898,98508
b61e9cdd1c04bd768f88bd4de969d855,173,133,920194,178066,742128,159,125,705858,138495,567363
61a1a741d222abde5ea7af2f70ef2fe5,185,118,506540,85647,420893,111,67,279803,107297,172506
05961488d50f9fcbc2d3a288ecc9e407,32,20,22638,7585,15053,29,26,20568,11437,9131
683b59d4f3a4f157af7d3611e3601f89,160,116,564294,105093,459201,196,141,629332,118049,511283
22b4d54186d58c6100ef7932c2f5fdc6,188,130,561982,107843,454139,166,114,400314,78030,322284
83546f8c82ea3fcabedb79b7f631baa1,67,50,33428,12351,21077,50,42,38530,10354,28176
755fe2d0a8f30b90711acaf7d35cb0a6,164,109,352103,74372,277731,172,138,396623,87410,309213
96756ada8d2bc5a07583c7e3ef9634e7,101,80,182611,47171,135440,141,115,222489,45938,176551
9f5ebbf6872ac63d34f2ac0904a3cc46,42,35,50255,18831,31424,50,45,75923,25533,50390
cc3b97c2c7d15535938751b2c1d84f2f,177,140,770274,132200,638074,177,131,700558,147534,553024
8ac2b89324b491c61373b4963d806535,17,15,5493,2856,2637,15,19,4190,3120,1070
c26d86b0af9d5828a687643feffb8646,131,100,304913,82844,222069,149,96,362870,56859,306011
45a3d466dde1da7b963da435ec6d3ce0,180,133,568636,120387,448249,180,137,702562,129834,572728
0fdaa266c66186024e64a7a6bdda037a,151,108,519516,89921,429595,147,113,525795,114643,411152
6425c55c84a157906c276f46db18a9d7,169,120,318673,68206,250467,160,92,262193,50813,211380
76c966eb6e5b1bc073b7b4e847f0a07b,176,158,711127,159047,552080,142,117,547046,125501,421545
ba02fdc1ddb8cd752e0030aa2859787c,183,119,668293,165227,503066,162,124,687938,148683,539255
962e0a9952015fbc8c7fd9b69693068a,149,112,329593,69418,260175,117,93,216660,66750,149910
5c159341b63850ea2e3024809313f5c8,43,26,40288,13380,26908,50,44,72531,16557,55974
f24173d65c67d73283b8734d2e52b2d7,81,50,96300,23656,72644,82,67,118299,34851,83448
b4b838ce619a32f65b6d3905ab612bb9,81,70,129992,39237,90755,80,59,107100,26622,80478
27e336e3009925d2172efcd955cd5593,158,125,376346,87436,288910,154,100,357866,67382,290484
55109f075ff102b6283d4dcad8e1c9ed,113,70,171399,68255,103144,109,75,192826,46994,145832
1bf430e8e899159c4201a8bd875e9fdd,95,65,129985,46254,83731,93,69,154329,33347,120982
801056a97f1f5722854f3b5b63e93187,73,57,171598,54244,117354,154,111,314050,68827,245223
801cc44954f2a65430f064317f1f315d,92,67,147195,32401,114794,100,74,182748,34502,148246
1c84c05d73aa036cf5c532e845055ccb,91,71,160350,40229,120121,87,74,149170,43085,106085
69ef831b20f537495216e595f5059be5,31,21,26846,6965,19881,26,25,20158,11866,8292
55caef4ac795d9476bef9df524456985,47,39,52102,20315,31787,58,43,50191,20832,29359
f6c1ebd6f750d921f928682db7df1569,101,69,177529,37191,140338,100,69,160463,34161,126302
b84f21b5f99083e23bff50ed7fb620c6,123,103,279553,81424,198129,140,110,282175,69235,212940
133a0805c161030c818b0a1178d828c2,98,73,148090,43257,104833,98,76,167525,55468,112057
7c42b77197600c9823cd09b60e2064ab,104,85,186630,49976,136654,131,119,266108,50216,215892
569d5ccff0c95759ea26ba8782071aa7,34,30,19082,6452,12630,31,23,19059,6285,12774
2ff76752ba45a4b860378909b6b14ce8,160,130,642942,101625,541317,167,117,612402,140238,472164
2789941401015649d7bbd6c5831761a9,19,20,6404,3662,2742,17,19,5063,2742,2321
ab016102b040a880879371321624c114,45,38,52532,22824,29708,64,50,65265,23070,42195
a494cd3929095de4a12920c6d9c0ffbb,100,84,238447,64811,173636,144,113,401845,60061,341784
7c130c7c2a92825cdbee7a8693f46b27,90,72,179658,60784,118874,101,86,212388,50721,161667
a37ed06edecdcd85a483c5d2897989c5,75,51,79526,19328,60198,67,51,77008,21341,55667
1686dff70a7c9d5aeb09ab489ac0cbf4,73,62,130282,32716,97566,96,65,172828,43176,129652
c60ee657331d713244ccbc9cb7a2bef0,83,62,96384,28542,67842,73,54,77859,19730,58129
ec4056a5a4d03c833500980d27688273,47,43,48803,15775,33028,51,44,50745,15887,34858
d1f726d3d0cd18e67d756173c18981a7,193,157,1155767,242311,913456,221,155,1678050,214611,1463439
3bc43f7faa97a7befad7002223f0198b,156,128,498518,109588,388930,144,109,448252,89222,359030
398c2e2ddda60d8b19aa6a2a3c537a6d,158,109,402476,104987,297489,128,100,432637,112923,319714
55ce4c751b0b8f2cc3885b93b9a561d1,88,77,209483,45891,163592,106,87,216029,51289,164740
50494244231ea2eb4d207fea081843ac,145,114,619640,131950,487690,184,133,938592,124004,814588
29ab8f7878b434a87e2500ff170b9640,31,28,20423,9863,10560,51,36,47300,12855,34445
905d71b8e1f12647e47483d330355c5a,37,37,57243,21904,35339,44,32,46396,21862,24534
800d2af6d5001fbac02c8695b8ee6315,103,80,203099,37492,165607,93,74,120763,45604,75159
1cdf9f2db8e2f31a728598c3394af84a,89,66,140017,28345,111672,112,92,213459,29354,184105
9d59572e706203a7203f1d62e4f462df,17,12,5329,2830,2499,18,14,6411,2542,3869
caf09511655d5a662e60123f11de308d,127,98,440349,121687,318662,205,132,677961,94271,583690
890fd30839a8675a81b6db771a76c62c,30,22,7892,3509,4383,25,25,6873,2337,4536
b960f2b6b1d3fcc5c704cd7ea8c76a0d,43,31,35113,9065,26048,57,41,48380,10978,37402
b92ca6ffe741b6f7b2e5d354dec03b6e,124,103,274087,84976,189111,145,133,404332,114492,289840
dfb0a8a6cbbbc0757754df1aba1f8f89,96,64,363636,129385,234251,194,152,610652,118675,491977
8a95912ec78157ccde18865419293604,44,31,51002,13407,37595,44,35,43613,15024,28589
d8012ba233d617baa93354fb76981a1b,46,39,64431,19815,44616,67,51,88579,22766,65813
fe5e4986137dedbda31e76e38b0879ef,69,57,97986,13394,84592,72,53,82790,16215,66575
288d07620ae17df96b890483ec9b80a1,75,64,96411,29875,66536,72,64,119892,28494,91398
87867fdcc74b4d4fc24eaaad31ae4b82,59,36,65667,22299,43368,65,40,130911,17558,113353
5076a2184a3b59cb1656cf066616cd6d,108,81,354667,73961,280706,152,110,409025,71462,337563
e681c539330ed266a901cae9f175ed4a,8,6,1038,483,555,8,4,1565,284,1281
50b3082d30f191bbc4b394d43103d560,45,33,43228,17464,25764,51,44,65190,18130,47060
f026cd3912f471b99f05beb64cafc598,16,16,8444,4178,4266,24,16,10810,3298,7512
82ce2a858d17339fd3e0e8e5f0295110,65,43,98886,42197,56689,98,63,134125,37936,96189
4d6873862d1c9328072c273da3ad5717,211,153,757068,153352,603716,186,142,814683,129243,685440
2c98591f45603a3ee6ecbaf0b7eff08b,71,57,85496,35373,50123,67,46,69717,24857,44860
8ddee355c5bc06c88aade754c2b60ff8,48,43,72385,17940,54445,54,45,60016,14911,45105
730198a6f147886d9cc3aa221258d2e6,113,88,215321,37816,177505,98,78,150498,28183,122315
0b5b34f5edc228ac4dc81581107ce45e,206,145,855735,144352,711383,232,138,1229311,166899,1062412
231f6d4abae9149a43e8d6d4ff6c9106,37,31,42719,12002,30717,54,46,52585,18385,34200
923937cdf17c15b2cd8b711b8576f6d1,168,119,534858,75523,459335,165,118,411224,104523,306701
ef01a2ac45afe81056f45191fb647e27,53,48,55783,22340,33443,65,53,69205,16185,53020
4889f1d5077f2b17c125fc7c78e3cb26,19,16,6908,3179,3729,21,16,8088,2368,5720
89cad5bcd152de422823a051db2997dd,93,67,129599,47673,81926,122,91,211942,39466,172476
786104f9c77a443a4a6158c7318dd85c,67,45,73807,23037,50770,42,40,74258,15610,58648
9d399752d04e8b9416cf60348f39f564,193,146,674966,135585,539381,194,135,776800,156698,620102
98d5ed9f4fd08f1c12dd9116f90f3820,62,35,80019,13069,66950,64,52,63159,22274,40885
37dce2284a9874c1c813ac9afeaa35eb,111,86,219336,61838,157498,166,115,358508,65787,292721
913aaa1113febedd9ec32ccc406c66e4,73,52,83114,20529,62585,48,32,66890,20812,46078
06ceb2b6c7df85218466e104df347e0b,86,64,151568,42109,109459,122,77,184254,57217,127037
5ea541d45cadfdbe61adca1cc46b7954,29,25,22215,11461,10754,34,24,25126,10381,14745
9dea1116a0f4442e6a0b57a124983693,193,135,500577,105317,395260,171,129,782510,153698,628812
0feaf902df232d4093fdb54dfa242cf6,97,85,207245,49210,158035,119,63,195387,51870,143517
e4829a06474d56bbc9ebaa29232db886,189,136,485841,119003,366838,150,116,434349,122789,311560
0202be9762f8cb06a4009ec3b8e0b742,101,84,198662,39272,159390,82,70,128149,46250,81899
6f2eee52830e544918f51f39f444e9ab,41,28,47753,11849,35904,49,36,48590,13011,35579
11947e53813df15af7a27523e1553379,105,84,234551,37460,197091,88,75,191761,39026,152735
3324f6f446430c6ad997c78a9a21bea6,14,9,2946,3534,-588,15,10,4513,1733,2780
8192af750cee6b8f1f1d0148418c9f31,77,66,116887,24029,92858,80,61,80249,17862,62387
b92f633c305064d5f3f17b530ec625d5,134,85,348058,91372,256686,138,105,374306,113768,260538
ceda12860ad037775994311d890ad162,92,70,198394,44843,153551,140,113,285183,56320,228863
6c849aab618fae8016cb8e84ca50a780,6,4,437,277,160,5,2,434,227,207
539e3cc02dbbd9a486c9026cf3809e21,97,69,189175,52483,136692,90,82,172109,67024,105085
d92b01e927b524038a710e5bd15519dc,69,50,65171,20415,44756,83,64,99335,21122,78213
8c777b3bda0b9a065318b4870e136b40,100,63,159157,44754,114403,117,68,219268,47275,171993
8c0bbb0ad8123e5b717ccd574ebed690,17,12,6047,4421,1626,25,19,8715,4051,4664
dbf961c2578e4bf8342b46e9f83dadf9,81,78,155859,40001,115858,101,77,186807,38666,148141
751d7325ca7aff102a938c39a5442650,63,43,72790,18945,53845,111,86,154398,31169,123229
51ebaa426468df360f1f9e6da780bcdd,13,8,1783,2083,-300,14,14,3284,1317,1967
b6ab6d6017ed15668cd425ebe69f9370,241,171,973179,141922,831257,165,142,901991,117345,784646
ac5f0442dccdbc606cc905e403f9276d,99,82,373530,82827,290703,120,110,423906,119307,304599
3d11e4d3f95d81382d4631a6884c7f7b,40,28,39733,6629,33104,37,27,18224,9357,8867
e89154ce61da52419ab6695db824932a,129,107,225178,41922,183256,108,90,181630,53020,128610
12493dd22d1d84202ed977228e801614,15,16,2107,1780,327,22,10,4413,1406,3007
bc61af4af9d3289d6f73ddd9d35c4bde,94,75,175305,65414,109891,148,121,355517,72018,283499
1e85dce57926de8d5ed6fac1d395d563,48,42,49176,18397,30779,41,31,45066,16570,28496
94aa5079bf70bfb783579b45fbd06c95,27,15,10094,4029,6065,26,19,16731,4133,12598
4aecf15c97f539462157d1041c35bae7,59,40,101245,30044,71201,56,39,95663,36624,59039
e0e6d49adc5023f2f60413553cad9d94,72,54,107110,22544,84566,62,48,66442,21286,45156
d0aa9cdd4df6501e41daae24b796ac9a,136,67,283189,61880,221309,147,100,328662,102183,226479
c44fcac27ce06ea9ee77fc891a83bc5e,102,81,219309,62992,156317,131,94,310134,52012,258122
16de3584753ebb7deb54d77717090379,109,92,256097,99631,156466,143,87,398941,81411,317530
c1df85a78b92fbd9b09b661b4f5875bc,39,31,15983,6503,9480,27,27,23380,5007,18373
d47964f0ee3b9e884324228fbe5a451b,138,106,322878,55139,267739,124,110,245234,70916,174318
7e482d51d52b32f23b678366eb069f62,26,21,9308,4995,4313,25,24,10779,4926,5853
d3759bf3069bee0270bba7a857bb6c69,70,54,137005,48855,88150,83,70,144086,46554,97532
bc6162ebca996c69c197724434cc7f8b,37,21,27766,5573,22193,28,25,16189,8064,8125
00742a59733689e2b21ea7085aeface7,38,27,18117,10024,8093,38,29,20442,8970,11472
445d5456e1fe7cb88b9b48b05100cb92,139,112,327466,79368,248098,144,112,330958,80456,250502
a905744d230ba9fb95ef650eee561e79,77,59,104461,31096,73365,86,70,99212,28754,70458
7cafe97a2bc7f1234b7d5b03ee6ccd50,46,34,47815,20730,27085,60,32,73232,16282,56950
5f7d96fca6cd88e7be34bad8e291d14f,122,107,228203,56727,171476,98,75,164524,59279,105245
de82a73512215600a27d78eb311d4536,87,63,181335,60339,120996,84,66,164608,61318,103290
d4c26579796187ca86ac073cc6e0c464,10,7,1102,244,858,8,7,571,570,1
23f03f0eadecbbd13a35e68cf82ca042,35,37,38360,10626,27734,30,24,19627,11370,8257
d8a3d1e95da3b1e6b232f1731a98069b,89,55,126191,35956,90235,123,96,206468,35902,170566
5e625329c889ebb04ca09b656c8a4722,87,59,270685,71930,198755,149,109,280270,72360,207910
9734e9a6cd704bae0e32eaa75b295ed7,128,85,257591,40179,217412,116,83,157233,57928,99305
63cece7591ce5e1c1bcfa354c31f2955,72,60,66737,26243,40494,85,59,126462,15727,110735
85e16c1ca74adea24bd74a0d9d93b8d1,174,120,506802,84255,422547,142,112,467131,118494,348637
a2a45f14c40a33b3e5136764040de0b0,179,115,591304,73550,517754,120,95,430652,88826,341826
222c2e02e4c8a86d1cb0627fc85b7d09,36,32,47062,23106,23956,64,49,81329,25999,55330
efa9b71e897d61b06135a3f16dc86c4e,147,107,350797,100196,250601,182,139,569923,68009,501914
f36f316f586ddc56c62c6baeaef0d908,117,91,286709,74378,212331,117,96,304186,75840,228346
ae9a517bce7050fb0b06a353df1c286d,23,21,13102,3688,9414,27,25,13083,6799,6284
ecc309c09ad25f8e99c51cfec7bbc5f7,46,31,49468,17097,32371,63,48,93619,20720,72899
cb30923335752f6301d4cf9845bc27b7,118,88,191485,53944,137541,137,106,294076,50313,243763
b6f57d54ed4205db5099473360533878,23,18,6207,4470,1737,19,20,8856,3915,4941
d84b8e101a7521e09a321552d2aa6bd3,89,69,175301,30583,144718,72,61,128156,25293,102863
aa2d0863f002996db5bdd9ac22002c8b,180,148,872117,270717,601400,193,161,1014255,248076,766179
257c0f6750536e140822562c7b1cdef3,133,106,303652,66974,236678,122,86,271738,90622,181116
56bfff8ddd8880d2ca67d67973f05855,81,70,129330,33723,95607,105,74,222775,31738,191037
9ea2ece44369b5b14a84642e617b68e9,179,115,748245,83639,664606,138,106,613774,114272,499502
18dc34f3184ac78279e324fe8c153b00,22,17,7298,2640,4658,19,18,3845,3297,548
94c8d8c95672b254e32574ff0764a67d,18,12,7011,3736,3275,18,11,8569,2943,5626
095981d082c67a68335588a1f17fd086,97,70,165849,35354,130495,115,98,194550,44422,150128
2a8c37daada1dd3fdf974a8cd03cbed2,18,13,2735,692,2043,15,13,1605,904,701
782dbedafc8873b57704fa9bea25ce7f,55,51,64202,34753,29449,57,45,87989,22264,65725
68d7b55fcc0c5f6c9c4823ac7bf19bb4,169,118,388204,126594,261610,163,122,424612,94417,330195
84a65276e19494fb2c2cc48133cbfa41,40,31,58459,16365,42094,76,60,95377,20936,74441
e8e509dc8935aa47528dae73de85a62e,56,47,92520,31403,61117,54,43,57476,27868,29608
eb5ddd2fd12301bfcbbbbf5a472cfdab,124,104,363495,85596,277899,109,74,277596,75082,202514
f841ff8eb9eb7965e317fe6dc9e3021a,181,147,529703,127561,402142,161,115,586130,109932,476198
c291dcc54279d732e22041743f4175dc,231,168,1292493,208491,1084002,229,157,1478362,201021,1277341
b4dc32ab04d0fd062b903e24687f1a4e,177,133,787031,197920,589111,171,133,651308,141673,509635
69bd00c86efa13e3384316bc96935834,193,134,661742,100759,560983,170,132,546304,94699,451605
de2d8bbb5d56c1b61a498d37656d439d,40,27,43394,12480,30914,50,35,62424,18345,44079
5cbbbfaf9af7761d44cfb87609d8209d,25,23,10581,7705,2876,27,24,16239,5609,10630
aac3c054f0f7d3bf70b095120851a6ea,80,67,109027,31821,77206,55,43,85151,26114,59037
9644fa0b93995d9246ff3611f796f86d,55,47,51874,17282,34592,42,33,45735,12720,33015
5ed797c4ecf4053c42b3d194b7864366,173,105,341601,44130,297471,114,97,207980,46572,161408
cef620bf351a23d1e8490f073b13effc,11,10,1427,1168,259,8,8,1215,952,263
eab75c4f0e1cf5518c5b03401c286b51,100,80,252721,47540,205181,93,62,201450,40493,160957
9ea4bfe821b7da7c385f9c631bc28208,53,37,91491,30346,61145,58,46,104028,31576,72452
3b581a33f496e84797814dd020d83340,114,91,228432,46223,182209,99,85,165973,41427,124546
1b1882a8cc59b0f5412c4990506696f8,75,64,98800,24222,74578,94,63,117087,23985,93102
7e43dd74733a70e3ffe999bf04142d25,59,47,76518,17977,58541,69,53,120685,24166,96519
5c38de9713d7894e9688ba49122a058a,51,39,81629,21385,60244,43,33,66385,22816,43569
c4ca17e18a0cf8d204f95b454f20b010,112,95,304099,59802,244297,115,106,295381,65927,229454
c9c487508252319e5f2c6dce6b4f17f3,130,110,274922,74824,200098,143,116,404296,57749,346547
70f0fa1e573b17716be37fff5a14686e,15,12,3585,2308,1277,15,13,2641,2840,-199
9adb20db2ddf2858a975916247ffe62e,2,3,166,233,-67,4,2,263,188,75
1a6b156ba5e273446136ca60d440b27c,44,32,42572,14667,27905,47,37,45317,15214,30103
9b15d267ceff4671fc0ed2e7ad908bf3,15,12,2518,1902,616,18,15,2680,1436,1244
0626211de33a83b7bf648dd955d5b858,48,35,51222,22203,29019,65,53,91896,22951,68945
c91a0578fdc585d7893103f68f7af109,178,129,974398,155362,819036,171,139,685202,119070,566132
528189acb87109a097fd5f97b6b622e6,73,51,110878,54000,56878,106,62,164877,38188,126689
82d7a61b7723656408114e0e2831fe38,185,139,765923,141729,624194,212,149,743946,159052,584894
3d281207e61509c6376039c7d9a5dd47,39,29,42470,13151,29319,39,27,28086,7413,20673
dcdac60850c97883bd18bd4dd6006b03,45,34,38908,14633,24275,40,29,54769,9356,45413
9dd3c1d2b45fedd76dedf5233fc14689,94,79,158216,30446,127770,69,51,107517,29243,78274
993d6d7144bbf86b8443db79175773f6,48,33,56150,19565,36585,67,41,86312,17244,69068
395aac346ee3248a50197825799fc47a,75,48,95284,22424,72860,55,48,57873,17972,39901
78be09364a5c36797b9509d4fea92641,165,123,333511,60356,273155,99,82,166981,71850,95131
16f8083cb583835203cafbf88281205b,118,82,240196,37824,202372,89,72,114685,47796,66889
8a43fce88e340c3c87f678728b04a49a,57,42,70578,13601,56977,34,27,32810,12894,19916
5eb76c629aabe07ba4172db34354e480,102,87,186161,58192,127969,89,76,171015,35920,135095
ff4741f28b67d8d5780da941a06951d6,114,100,224803,47644,177159,120,94,233225,36297,196928
835f04ed665b96d3a2d401627b8a16af,93,73,232081,58928,173153,83,65,216263,47470,168793
048e82498a5aa50cd87718905b7208a9,150,134,464182,74328,389854,112,88,272785,80695,192090
55de46d715b56267d1a02e57cbdb8bb4,32,31,27461,17173,10288,37,28,28238,13995,14243
126bd02661507fb6ee8ed55080331177,165,119,349922,53349,296573,111,106,221653,57941,163712
8d78c82471c3e2b253c53af619380992,70,54,107400,36510,70890,54,44,81222,33643,47579
ff2bba06937a161569a347a3be5e8952,95,54,139804,31055,108749,68,60,111330,39792,71538
0886faff7cb516c472b27ef02c524bcf,160,124,644802,127879,516923,168,102,493627,164598,329029
25bdde4d41eac4158c06e96ba05809d6,85,50,119074,24491,94583,64,46,83365,35226,48139
c936b4d24d3dff29e2b8c02bb02b3977,135,98,490892,167946,322946,226,148,778506,124669,653837
84be306e724fa0f155321f3ac5f8d9e0,101,66,300437,58455,241982,160,126,479222,74830,404392
d7d72e3310ad45d585b064359ee4f5de,104,84,215884,102944,112940,135,110,327422,126338,201084
090f30bc545a87a3b08fb8a7a7ecd550,72,48,76272,16240,60032,56,43,45369,19848,25521
b185b106725bffe653df8c820ee2cbe2,79,63,131839,26388,105451,64,58,67984,32484,35500
d0315dda245119604762c28bded70328,172,150,578052,66816,511236,155,125,456422,82905,373517
6afb42e10604d9ea8c88a733b6813e0a,163,111,577410,115161,462249,166,120,509652,100639,409013
d4748b5417508944e35a87421de55d54,70,59,119097,31414,87683,57,49,91863,35049,56814
4f9bdeeb3e78d372723dd93699ce6afc,36,29,28271,8053,20218,28,27,12008,11156,852
20a914bf0d049f9a089150fcc51305ae,228,168,974452,203795,770657,202,167,1134761,275652,859109
52ab11edde9d822a74a3c76d28680db6,36,24,32691,10998,21693,34,30,23817,14014,9803
379dbcc05697926dbba2c9bd7c0e0ccb,146,114,656861,115282,541579,140,117,464048,117218,346830
d93bacdb5d7697afdc961f1ef8b2132b,76,68,121672,46609,75063,77,68,174713,76600,98113
5ef288c920dfe05fbc87ec39a11654a5,174,139,822888,110377,712511,202,128,596224,145456,450768
3cd41ca0cf51b26d39e97e1a2ab679f2,45,40,55356,14856,40500,58,54,71111,25572,45539
41d6ade8cb8cf8e19015c5584fefc965,18,8,3685,1173,2512,16,13,2866,2039,827
c64f076be73cd21ab07602fad63410d4,67,61,128824,30482,98342,69,52,78977,33656,45321
1b9a053f9065fcd3d0b72b3f631771e7,123,85,307707,133037,174670,119,114,386612,119500,267112
98845a5f5207d86b5b603ee027ddb36a,110,94,267216,97168,170048,130,90,368953,61518,307435
f1821d96d9a05eb5581b5a93a687d9ad,26,22,10086,4209,5877,23,24,7737,3702,4035
22edb916dbd086195bb46287df8f938b,74,51,75232,26058,49174,67,48,93657,25099,68558
47fad99355dd3ab727a9c53829b48145,136,94,394330,101311,293019,174,145,587439,101500,485939
1e51f6103f5f7e5b86f903e39fc49290,117,72,186505,72071,114434,90,60,215991,53698,162293
9ea70fa6aa19c840998fb2b9d0eb65f5,93,72,156322,35229,121093,75,65,117937,34279,83658
8459d10b387842d5ca777f1e90f8f3a8,45,40,39617,13844,25773,39,30,31997,12599,19398
31b02e988a96339c56107929fe3f259c,47,35,65722,12599,53123,39,30,37317,17503,19814
a2d27f49228f733e69f83abea8e1493c,37,35,25084,13707,11377,50,25,39963,9210,30753
4175da5135ae4844c066c06369650aae,135,103,374669,110424,264245,130,107,363511,105600,257911
e4c61fda5716767a432396572e4c6441,109,90,222569,46213,176356,121,89,222521,39622,182899
8b39f003cb494f475a58775f6baa05bd,90,65,133778,26078,107700,101,88,149304,38523,110781
ca8f64644fad3db4936a83ab577b2e14,76,60,143229,35805,107424,93,72,128074,49416,78658
8796054f50af10ebb5bad0835b6ba732,34,27,40847,10326,30521,38,27,36067,15095,20972
df48e72ab9b1d5d774952c1b5816c1b8,50,39,79213,24410,54803,41,37,60192,25000,35192
3d0ea3c1383e88c5a1ff278e4f780c44,145,111,798612,173927,624685,198,154,624049,158739,465310
3c347312b37db17eac6715f57feba869,34,31,24900,9742,15158,42,37,34360,10246,24114
942f09b4ef48e647d934b1d35c843709,23,15,11261,4687,6574,27,22,16916,5199,11717
3d9968fc8a15f29b08b6397d75be84be,116,99,192224,54485,137739,122,93,215560,48881,166679
7f5d878911b76187d4a70063c2ba14f2,66,58,90456,24318,66138,71,53,97673,24848,72825
d90923ef9aefedfbe8fc1f5d65208070,41,25,43188,11001,32187,43,26,32983,13201,19782
c7eb77df652154636c1f54f2f4902721,165,102,293381,67307,226074,169,104,383324,84983,298341
0b76e5ab28688fe1ca67caf139056930,176,118,534018,146366,387652,184,145,694971,118744,576227
d2af2080aaf6706586e8ef87e80f2821,8,6,1392,885,507,8,6,1050,1292,-242
79b70f1e189a52b571ca946781d5e923,96,64,127135,30710,96425,76,64,96131,37741,58390
6c7833575b30634b4187887fa2aacdd7,105,85,213724,43079,170645,102,76,144874,39354,105520
4f43fc50efb712bcc154336e26990075,109,73,197143,33955,163188,115,92,222810,39781,183029
8425a9012b216884c06aa08aa33ff7a5,142,103,379811,54004,325807,131,92,268034,63535,204499
96e2e16522b8a10e38689bf62367f648,81,52,99289,15103,84186,75,61,79622,20227,59395
7d155e036e1544b45befa3b289052516,2,2,268,322,-54,3,3,382,328,54
72919b7317a3790fbcfffd6385f4a4b9,23,24,13218,5959,7259,25,25,13739,4370,9369
6d3124d9be98f21eae29f56bc81d3c04,127,95,285306,83408,201898,143,108,359661,63040,296621
40a8d4209b6f5adaba018cfc67a3370e,134,103,351334,125061,226273,122,95,324296,85540,238756
83013008e87a62e7ba32506914267a4d,115,84,200034,44289,155745,123,97,197418,39521,157897
9c9094c2fe31d2c3dd537cb0ec8ebd22,49,43,42296,17991,24305,52,35,52696,12199,40497
94d873aca7965c0540843fb764a32e84,33,27,47169,21175,25994,35,31,65266,21241,44025
424b99d4c297345eef22c4e3f5f29b8f,58,45,75035,19925,55110,48,38,58233,16874,41359
c15fd3875e4ac5f8a06540e9da013c5a,50,36,98571,20938,77633,56,43,77538,23215,54323
94f6fec58c4a63cf1206974daa2038a8,29,21,15981,6555,9426,35,25,15838,5878,9960
799df5fc866bd6c6f705b7346c0c1ee9,19,17,4058,2997,1061,19,17,6597,1975,4622
d440d2cf3af07ef9a234fb74d9d6d566,22,19,6395,4460,1935,27,22,13716,4627,9089
86de8e7727871a3e901156dad305380b,76,59,102740,22503,80237,62,44,78201,26650,51551
e408c30a2b105771ce21ade228d0f721,95,72,170267,28641,141626,78,67,121772,49209,72563
044f2ec421988880cfc92867bd7b7c38,58,46,56580,14336,42244,34,31,27316,13715,13601
e787581f7984240f718c99d442cddbb6,33,23,20279,8807,11472,39,22,29109,5583,23526
4122bb6b76a0241b1833060e164f5a39,27,24,10431,5739,4692,27,24,12500,3802,8698
6f432fe406c7b163b299c2a634b2b23f,13,13,2083,1921,162,11,10,1971,1871,100
8133b617544944118b6df36ff09fde6d,136,87,416163,96409,319754,99,61,232862,84427,148435
dfe40986a2c8445a926c8bb82caec1ba,32,28,10642,5588,5054,30,20,18207,4382,13825
6ff8e7b50548b7043e592d95ea5e7982,119,97,208152,52816,155336,119,96,295256,50814,244442
c78a962048f8087c149d2b0216760385,145,115,414245,94892,319353,80,64,256295,77277,179018
b353a7766eacd492b1b03400d608f965,175,147,692552,140027,552525,178,144,699411,108300,591111
4746f47cb92d9102b5ae4bd012db8322,39,24,29207,9586,19621,27,23,22515,8535,13980
736f13ae5d49fe392113ef46f6c2b593,19,13,4664,2643,2021,19,16,6264,2681,3583
58aba17583c71573fc6cc323c7249bea,101,81,150650,38409,112241,119,90,178025,31202,146823
120927b028001801947946531a9b8918,26,18,8321,3782,4539,30,23,13075,6288,6787
a2e5b88e8b38a0d1c33610fbcb6bc2a9,7,10,2020,1404,616,7,6,2531,1468,1063
04c4c4a709a284bd443cef72719f4a08,152,120,461983,116311,345672,143,110,535762,136112,399650
f20c909807798670b7676aad7ec15761,81,73,168612,43130,125482,116,91,199728,42529,157199
ce805a7e7b217193a3868b907074825d,46,29,47985,22075,25910,43,33,77108,17147,59961
3f82f893ca32494a496ce9e6d163ddcf,115,96,220340,63433,156907,98,71,191072,48564,142508
e0515add67516e46f1f1a10a8a361f55,189,144,834883,151033,683850,144,105,502803,137604,365199
7af7c935e9d76a4fbe87230215566f62,152,116,448810,97782,351028,147,111,500281,98596,401685
b9b2bde99da5dcfdedd093ab18c753eb,68,55,104825,28352,76473,65,49,93913,27726,66187
a9977c8c22e0793439eae57abb736978,47,35,38861,10193,28668,32,27,17266,9825,7441
9f140908a2c7b8f1f7e75df83e5d0d40,93,63,155838,46666,109172,148,95,228958,58637,170321
172755121908958ae4ac46da533d90d3,215,158,829562,152102,677460,219,169,782593,163903,618690
cacf2c44039ac348598bd0c1fbcb6e37,174,141,678688,114533,564155,198,155,662526,106205,556321
152f6765b880fb09d5eb8befee54f498,87,62,143566,38029,105537,90,75,124993,40309,84684
81cb70299fdfe7b57fbdc34a9f4155a9,196,118,598928,103664,495264,200,154,623767,151226,472541
f4840ea164522fc2c7890e7e11c58571,76,55,79204,17565,61639,50,25,67428,13666,53762
694d591b199ef6a69dc2631ba656d224,146,104,400635,80562,320073,153,98,345612,88186,257426
9c045783f55dbd9757a2e3304aa7662f,103,89,240319,60559,179760,97,78,171597,37269,134328
a97b18c340a3bc86f739150937ed32df,169,143,516370,93065,423305,177,131,515227,75552,439675
bda454b5008b6713d405d84098711ec3,29,23,22111,7470,14641,33,27,13919,7521,6398
33830a812a7df608f40bc12b02fb3544,97,76,126664,32677,93987,67,64,78210,29903,48307
1c61bc07b5a9730c4ed9046e1d57e60b,146,104,392776,77621,315155,141,97,366854,92081,274773
42468ede3e366079de64cd5d2b2c1c12,180,153,1348603,189696,1158907,211,164,1073627,240225,833402
897764dade8f3687e2e2e85334dc07c7,32,21,20889,9025,11864,35,28,23074,10829,12245
62d3a723420adc0cd60a3ea21bfb820f,126,106,411836,56193,355643,121,100,256422,52778,203644
554eef1dda9ca880cb33610adfce72d5,65,60,87600,31743,55857,82,75,80604,28326,52278
4f2fa1cc303da42b8f9c2772e1ed019a,41,30,36305,9993,26312,36,32,31278,12266,19012
242a0e4891dfc992778d114e04632ac8,44,35,69452,19401,50051,57,54,65085,27514,37571
c628fce0eeea62f7b4a7b30785d373a4,76,50,148844,34633,114211,92,73,125833,41088,84745
b94d91bb4635a70686efa0284972e433,36,27,36125,15464,20661,29,27,29823,14874,14949
fcfb1e1b19996d415546eb55aed102b5,82,65,153475,33111,120364,66,52,98037,25852,72185
f3191c919b96a55448d84aea6f1fa5b9,3,1,425,212,213,1,3,212,425,-213
2227cd7920a7b1134809ebd2e1696088,65,39,95544,23013,72531,72,67,108286,29894,78392
8ea6367cee3d3a63b5e6e5690bd26639,72,67,103973,38644,65329,69,46,116427,21793,94634
e30b3ac8d2def8879cb9a424837dd429,102,76,164823,73315,91508,83,69,204263,43759,160504
ac7609d49c376add962e32a3e8ce506d,171,139,724173,100266,623907,214,160,758780,91023,667757
76fce9a3de7eaec5c56db5dc0861d315,111,84,202853,45469,157384,89,69,158714,35501,123213
7355c571aeaf3ce9ed0435991fc7560c,124,87,250519,112238,138281,156,126,477860,86980,390880
758b5770d8a7a5e3622aa4739b0250b9,69,45,105845,17924,87921,42,31,48000,13999,34001
1086479b78a61ed3fddca10c418392a4,104,92,238706,40944,197762,87,72,159150,61791,97359
8969b6075bced40e2c1e6bbf50042389,27,21,15443,10046,5397,34,21,23470,7303,16167
e8ae06f640c5f607a1e0de70ac64aced,132,77,231773,68628,163145,100,80,205736,63655,142081
f0b400fc56a4a1e8ff3a22d88755ef16,25,15,8537,2266,6271,17,19,6454,3287,3167
9736bb2ef195e7534b7f64463ada454d,90,77,218923,51882,167041,96,75,199381,60630,138751
33f314ddc6fdf09d0482fa7c2f637cd4,123,80,306323,58454,247869,184,133,415868,69267,346601
ef42e658763e567535c0bd635872894f,168,115,425471,86802,338669,163,132,343296,79672,263624
c42d68149a3f5b15a1239f4e1760734b,62,44,105599,35187,70412,88,58,149137,36803,112334
b1c5440b5d5710f5522a584ded41ca88,85,71,115617,50196,65421,99,74,148475,33687,114788
e1c427ca67cbf41aebbd69207918cd8a,90,66,167196,54185,113011,134,82,211703,45740,165963
3e7242ce790955bbd8a357e83c816e68,75,45,113126,18844,94282,47,44,52035,26869,25166
9065df4d414ae9bcf02b5b48b8b78969,109,80,219977,55230,164747,141,111,312714,48494,264220
554278e18eafff864e9eb4cef9121176,95,79,175811,45453,130358,87,73,198463,46401,152062
805a2d3ce82b174af8ba11915ec82e40,130,105,425683,73280,352403,137,110,353833,71297,282536
3c73daac34839df8fde45126a73668ee,192,143,791491,133222,658269,180,146,728680,184265,544415
309b0d95bc9e091aa5bd56ecbe3a92f3,50,45,58624,28732,29892,62,54,85346,24065,61281
4bf522b48f2bbed73ef9342ba316229b,0,0,0,0,0,0,0,0,0,0
42a9cc80568507d4f845e68e242a9d8a,172,134,569688,130070,439618,161,132,479619,101106,378513
308249b46337d84d89a76505f78cbdf6,123,91,399015,143480,255535,174,153,625975,129490,496485
22788472f8859efdb99f1f26d46e1eac,213,169,732328,120114,612214,162,114,540005,88579,451426
c7365f994febc741634eecaf7c20cc64,27,21,15507,4085,11422,22,20,11657,2903,8754
2f280472ae8c256d6e1f7946abdd88fd,41,32,28066,12538,15528,47,38,48401,12820,35581
0523b8031c4eb20987937dd03aca45af,79,62,112101,24503,87598,55,39,66378,25049,41329
77f62c91120b937e55eae06c9ddf17e4,48,32,37112,17599,19513,51,45,64665,17973,46692
089d4dafbb18347624d49f0c1b02c3a4,111,81,197029,39352,157677,120,101,238140,57064,181076
9cc901068cc53d2a43db64e6b94d31e9,67,46,84968,29274,55694,79,65,110930,22518,88412
08afbfbaa58cd8908266730755496016,62,50,105447,30897,74550,40,36,43279,24182,19097
c97f459c98d5a4d3bbbe2ca2bac3ad71,102,74,226056,51051,175005,108,85,189155,54878,134277
19359914c6e7dfcd4e4b814d01d5ba78,97,71,240771,95513,145258,151,90,454255,79223,375032
e08c4db450f2517bb54fb6c0f0d69791,59,50,77304,30364,46940,67,44,86391,30205,56186
d979cfb0f6224ffd64b352d834c93d63,104,103,322697,113621,209076,93,78,300556,97334,203222
7603742e0183e68aa95435cb76010f55,65,58,93902,20981,72921,66,46,94491,23569,70922
17669cb96e977a022cc49c99b7082698,111,80,371321,122587,248734,206,154,518264,117357,400907
0165d2dcd65599dfde1443f76fb00869,185,142,710840,58440,652400,148,101,377307,71064,306243
14e05065520879ec023d5238c0c15e2a,82,63,163274,58081,105193,151,124,391517,63179,328338
359004d840c17ce677a05786e3df3ec9,49,33,46084,12320,33764,37,28,29839,15603,14236
8955aa8ea7cb74a392aa8b4e207e3f34,81,68,153303,44841,108462,89,78,196687,41721,154966
24bc45078993f30407f4860b8070b7f0,53,41,46165,17317,28848,62,52,63905,18091,45814
f67d960d9782396dbacf0bcc16fb89fe,107,100,231995,62526,169469,108,87,237170,44989,192181
8fd7ec9b5d91f568544f180be949884f,105,71,173476,38294,135182,99,77,152704,47979,104725
b48a401749c94f060a0f46aa6d3be713,115,76,257877,45819,212058,117,75,208302,59619,148683
6af21d782376085b8298a608287e686e,174,103,393962,80142,313820,130,101,395840,82870,312970
6187ab8bdf41beeb3b83a8b5b9fc5a67,99,62,150379,22769,127610,98,78,134194,41719,92475
d1bb8f19e621fc11e367a5b6509d20ae,47,39,52886,26530,26356,60,48,81882,21368,60514
e3e2abbb67986356aced0e1ad9ce8948,95,76,349144,90025,259119,199,137,653325,138837,514488
c23c590d892eb67ec7a03ff9998b0464,33,26,28639,11751,16888,41,34,32382,10303,22079
b1fa8e5af27501bab22a82c58454c80a,108,89,231174,56937,174237,112,90,255748,54090,201658
07c5c92c9e7d17ad06bbcf81528cf044,127,107,413318,120344,292974,134,100,463904,93302,370602
d8300f01e205c38e56449e1776e131d3,88,74,181455,28775,152680,102,77,205556,37837,167719
219d2871e39911c4b1d50d553ec4ea6b,13,13,2277,1457,820,15,12,1838,860,978
fe65409193e59f9a9b9656c6cee834d2,97,79,167982,41946,126036,120,80,226826,38585,188241
274fea4e53014cb58f8ff4b77cae3076,148,108,359214,136116,223098,150,103,398302,103577,294725
7f5160408c4498fb93e85866d8bb009b,86,64,128513,34865,93648,108,99,139535,37280,102255
0883069d2e0f51639d9841063e605af3,161,135,816358,140835,675523,160,119,596809,140023,456786
0c25f768151d48249571ffad02cb9483,52,41,57059,22466,34593,60,48,59698,22756,36942
f70f2222c50a41401353eb8215dd87ba,96,66,194298,43895,150403,123,112,245742,68381,177361
d7f7346ff32221e3102995fb92b38220,166,137,808941,123729,685212,139,112,537145,136773,400372
b7f75b5b48e5073063f76b2a14822f16,25,26,11808,5743,6065,27,21,8755,3968,4787
9a3cea22f8d1649c821b20ef09bcd66f,115,108,301447,124103,177344,148,104,438066,79319,358747
cfa40c899155c7a94fdc3de5d28c91b3,61,49,100901,31040,69861,57,41,93496,26300,67196
6cb33ee0cae9ec80ad99ed1b3ea2c9ce,167,117,437311,68276,369035,156,125,466000,101588,364412
abe7b116415087c2d23b4b5f70d95c63,132,121,296134,79257,216877,108,90,186660,60938,125722
af8e8f934af916d309c0ed16989ababa,65,57,165189,105296,59893,153,101,366628,79957,286671
e8992d03ce3a082a29e24db764d47bfe,34,26,10399,6439,3960,32,27,15473,5848,9625
70f6338e09d73b0451898e798196872a,85,63,189020,54746,134274,146,103,277963,49220,228743
8364ca808a38c6b336a711ea3b10c744,65,54,69840,14259,55581,67,56,65673,17304,48369
3642f6f366a13b29a9f5a61b7feeb100,42,34,59949,17586,42363,55,43,49503,14286,35217
9ebe1712e29ebdfbe259dcaa99246639,152,96,543080,166688,376392,209,146,960785,194455,766330
f6ebae1a8cd35a922c40bbe5ffbfe1f7,25,25,20575,5968,14607,33,23,18733,6165,12568
ef9484ff1e83440700d1acc2397c78c3,48,40,52035,20424,31611,52,52,49427,20685,28742
aa91383c92440e39288db858e27356cf,95,64,175478,41765,133713,93,75,170345,51509,118836
cef7ae3cf40a5869720f7441a602a019,28,23,18941,9416,9525,25,19,23509,8870,14639
8d521cf61a77afc7c8f87a0d90b62a3d,29,30,28331,10935,17396,40,34,28750,10803,17947
7267c67b44d99a85b42d2ce112bdc2ed,71,51,133370,22414,110956,84,78,143885,32653,111232
ccef6367df58ce274e7751e8f3579f82,159,90,276841,55567,221274,80,56,161263,49054,112209
84de61f0ed98d59ace9889e1607e5a6a,161,111,334918,58566,276352,97,80,178420,52548,125872
74674579ed9e12d90658539a8fd2146c,155,95,587402,61623,525779,139,115,393186,118121,275065
bf19db92ae97f5235b2948bba3b01b18,75,64,73924,30038,43886,77,62,106166,22486,83680
cd4228adcd403a9fc74a2a84f21249a5,225,176,807121,132135,674986,201,126,490778,92851,397927
071b1ca09a817b071960e03e01f1e507,159,132,401199,100450,300749,144,122,432105,99452,332653
6bee0d23a67c0ac7b2528f89b07350e6,114,91,255311,78346,176965,116,94,247304,54969,192335
f5eb3cb421ed5879bc89407e7db6d8ed,163,119,566157,110195,455962,153,108,542698,78800,463898
6436d077535080c20e0d40a79cd5bc90,17,10,2690,1022,1668,14,15,1858,1649,209
cea7e4f830d799569d7b393cfe695b4c,28,25,13683,6097,7586,21,22,15865,7115,8750
5aef326388b38fb276b6069661d181b5,56,48,89052,30765,58287,56,38,82206,26505,55701
da794ec3fc2c56fc0237d179d58ef00f,6,4,363,317,46,4,4,345,289,56
2a2679e04ee272908b29e2ebe791b62d,101,61,137047,29803,107244,86,73,99206,38589,60617
9e29e98811c1d6efce2b934f0df301df,109,80,247145,64726,182419,140,94,358400,71600,286800
f508b9981013a791e030abd3d3b5d58b,24,22,10249,4397,5852,23,21,5342,5086,256
5ce1690fbb0c00a34a4076d13100c4d7,95,76,173930,52576,121354,102,79,232902,52701,180201
46091bcdb407f2038682d25edc808133,38,33,45033,10834,34199,51,47,53830,15993,37837
6d99e338e1f8418596c83b6d091ddd4d,148,97,292514,62702,229812,136,84,250417,45704,204713
aabd96b83f7de4555463352869a80cce,147,113,494954,146222,348732,163,124,521139,99256,421883
0ef977390f575f7db005ad2bce4ebd9d,97,88,201914,62495,139419,117,85,188168,42032,146136
7deb7be6b4da25938ea6f100b56ebb31,134,95,247308,51336,195972,122,97,290583,49969,240614
04d16e174b515b61f0879f2ca0572cf8,112,82,172640,44764,127876,99,78,154247,44956,109291
9cf5b5c8ff201213b99cb49b7a94b3db,140,119,537388,152929,384459,212,133,654092,106595,547497
50ad259d0ee2bfd7b09c8ecbcc7f01d1,57,52,63606,22874,40732,69,47,87606,20645,66961
15772437b71b4d89822da32c96a27eb5,32,20,15527,4901,10626,15,17,8082,4073,4009
5a76cddf0bda1dd913ecd8d9adbdf743,30,26,19494,8778,10716,34,35,25971,9579,16392
1fdebb67a23de8947d4db4d2f39abf24,110,86,174986,51919,123067,111,79,203496,47943,155553
47aab801fa266226fc083e14e54f111b,170,155,711512,145213,566299,118,97,420022,150080,269942
0a53e685c79f9874d9be96df9cac4649,27,20,11741,6281,5460,27,22,14645,5300,9345
974e26a86b454a91174e6eacf620e489,163,130,551970,123843,428127,181,136,645686,116628,529058
41140754f4724bd7b055ad5f769d7a0c,65,54,97945,29953,67992,61,48,86407,22608,63799
0caef43f36a2e268ce7cf9acd766537e,152,105,345067,80805,264262,94,74,282049,122554,159495
ffbf6586015df80dba89e76004e5b9ca,114,92,263962,91708,172254,144,105,444451,90974,353477
3adec48c7c13114b49a477981b4e4f30,110,96,215477,33839,181638,105,81,185931,34734,151197
7c6e1a2d01a48959fd5a6f42742c55bc,197,155,1121827,312673,809154,180,143,891465,180848,710617
9d47bdcd0fca7b590dc2aa976b7d3f7c,167,130,550569,93792,456777,196,130,601210,100855,500355
b167448c642b5f43013c4eb42d4414a7,65,53,105063,37714,67349,80,62,105322,49662,55660
ff928f68f02dfeb697fa3bd2c41b0efb,78,44,105454,22844,82610,62,55,136498,26012,110486
3a23382753dfb8f29bddc8ef66abace6,49,38,44581,12347,32234,53,41,34338,15814,18524
29b941fd62573f7a4595258a5a63b0bf,88,77,159058,25980,133078,86,72,167316,51104,116212
aca9312f3a462301a9367a35b872609b,83,63,147200,39162,108038,63,53,97863,34090,63773
b82a54afa0afaa5604ebd88a2633466f,103,80,199079,59847,139232,130,99,287152,64105,223047
562c38d7814bd2870a40ffe7dca7b7a4,114,104,191046,58254,132792,112,79,196736,29641,167095
10b68a549e1ff8b7a5c80cf6b97e3240,143,108,224931,63088,161843,129,98,322903,50663,272240
12e025acf2ff28874a999d5bdc2a4d26,107,76,140810,48452,92358,80,61,115592,41942,73650
44ae9a64e096eef0169154c7d923d0a6,166,123,404071,80273,323798,144,109,298768,78159,220609
78c32ffe0ac0554a1dbfea5bcecec554,181,135,781347,135168,646179,196,138,714384,141559,572825
554993488618ebdf8301cce28fe29d15,101,74,165888,57965,107923,146,106,298206,84205,214001
e73a93a20d66bde12430f5909e6fa45a,15,15,3587,1539,2048,21,13,4352,693,3659
b47b18fe7017fe8b3b9b85c1888e12fe,14,15,3076,2044,1032,22,13,4488,1807,2681
69e1299cb3adffb9e27484646cc704cc,44,32,49315,21126,28189,37,30,66942,19117,47825
0e5af39d549287e985491a2e9bb06a1e,106,87,288965,77542,211423,119,85,249849,71182,178667
0492cfc513f16f6ff0c071fa454fe6bd,46,32,39757,14572,25185,54,44,62102,19391,42711
638da7efd03e85e68e437e4a1741880f,142,119,532792,136977,395815,178,134,687011,133796,553215
38092d3192d13ebbd8a532174546ba20,21,18,6263,3341,2922,19,12,7868,2177,5691
9689e36e8139b283b468a2d0973b4757,130,109,258326,68720,189606,103,73,207322,41119,166203
4e2205396b8f3d0584dbdab15e1ce160,181,117,397517,52544,344973,134,101,264277,67989,196288
6d659d26958235a2c1eb0ef9d1efc1e7,32,22,19349,7214,12135,39,30,26857,7145,19712
afffc03619db0a479d5e323e0acf272a,97,86,148950,35729,113221,89,88,148584,39859,108725
a53a844fde87f5388aca61a04b2bbd23,56,39,46664,12255,34409,44,39,30754,17368,13386
25d294a40316a087d0089c65b4b7353a,128,97,228861,47766,181095,110,97,199145,52101,147044
4eb12f6885244d7b3e63af66ed552069,42,27,56667,14389,42278,35,32,39333,18835,20498
8fb531c4af6a5bfad85754a9124cdb97,80,68,79205,31056,48149,52,50,79720,26609,53111
fd7c4faac58a72be3bd236831e8fe5c4,156,117,730589,158238,572351,174,134,795827,120064,675763
1425a91ee6679116656fd6d83c52d8ff,12,11,1318,1418,-100,10,10,1966,952,1014
71438c6a0d8dcf741a4e4c548aea81fd,67,51,92150,27529,64621,84,62,124116,25579,98537
f797dbbcb7abc3e62a28585876a96e2b,36,29,52647,21711,30936,38,28,58693,18603,40090
5682532e257869bf59480f9f2d746d26,130,107,248096,56351,191745,127,101,281105,53061,228044
f73a53996ac4f8141849cbe3ec333a93,54,44,62190,19264,42926,50,33,55165,23519,31646
9333e3bb20ba06d6cbfcf0fca38a6889,122,90,417647,123202,294445,182,122,583829,118408,465421
197a1d5a8d5b9254d00c2ecde97d2a9e,84,60,141237,21457,119780,78,74,91325,35537,55788
040aedeceb4fee73f7f56f368e296420,107,82,236964,54917,182047,126,102,350897,83333,267564
a3c4ede22d8419fe2a36a89099c01f2b,189,154,1146405,244816,901589,190,146,1199135,171555,1027580
b8d06563b6f76b13f7848ad8d3ff3f39,67,71,152211,49569,102642,101,76,180112,41123,138989
7590637f44006fd2c3d1b9dded121b11,48,48,78739,25753,52986,79,48,75509,19560,55949
2ca81bb8120c6ed174ac225b64be7039,108,85,277385,36286,241099,107,90,191348,45558,145790
486b80480a36ce7906b9257c2f1230f0,84,71,142102,42021,100081,98,92,183859,37824,146035
2bd46937f47c3d5af1aee26cff0c4d48,89,83,134708,57519,77189,143,110,264550,47661,216889
9b9a250d43f1a13c5e12628e4d465fd9,67,50,83563,35017,48546,48,36,79258,23057,56201
e3da37346584995d700a1a5e8e0a6740,86,69,298442,99746,198696,212,173,867520,113184,754336
205906e845f8f0c4a422f8f2184f2eed,60,48,80018,34531,45487,66,47,95424,30819,64605
cfe32a83262567d38d8724a244aac0bb,112,86,281833,54654,227179,140,108,317422,62556,254866
d1e218f7a40bdee510049feacba14102,69,48,81628,21679,59949,67,58,87102,21908,65194
797e0f8c128dc798e879fd8307589afd,147,97,387507,76346,311161,117,98,342305,97066,245239
395e30d60bb0dc9a5bab625e1a69545b,29,23,23135,11065,12070,32,23,26632,8345,18287
a683186022e1437dca9030dea5b4b8d5,97,76,151662,39001,112661,90,75,206502,43254,163248
14c3ea64a1f4da2c2cb11dc7d45fc98d,81,63,165639,42405,123234,108,72,179466,57581,121885
10bf780ae081859d64e0c14b21086fdf,173,116,534911,92637,442274,148,127,442137,86290,355847
0237f6fde1f7dfb11bb2bce8bf2ff470,36,23,28984,8472,20512,32,25,22288,10844,11444
e9c1d953da106ba395aae23bc4fe274f,89,75,147327,54817,92510,100,81,191258,43621,147637
26c389cc453c779dbb6ff86ed7d0cb3f,32,25,22433,8657,13776,33,30,24042,10697,13345
f3865c8e38ba501b8a11d74655d5dd7b,60,54,113747,50602,63145,93,68,153310,39600,113710
05ef0e3d5754077bc4ef94070454736f,112,87,179472,47985,131487,118,90,200645,37348,163297
d21593c58bae5eb80d86b1b4b3a3cc76,26,20,17588,5018,12570,24,19,12468,6865,5603
78512bdc0af1be71b25c2e3314c31dad,167,106,564796,131499,433297,215,160,820364,159460,660904
c7fef9fda7bb0dbd30cfcab1ce4e0dea,86,77,150705,44876,105829,95,72,165971,47974,117997
d14f16a3513232360bca5294094635bb,64,57,67289,24555,42734,49,42,61414,13464,47950
cb8f8fbe7f3763751d21d1ff14ac4ce7,41,30,39572,12470,27102,47,35,38941,14029,24912
6cbee0b19d178679814af763cced35f7,31,20,24431,12305,12126,42,31,48502,12468,36034
ccfdfd22374e06f8aad9354e299f67de,49,31,52222,19087,33135,50,41,41319,18036,23283
838ab99fb1ede21cbccec6114e66f8b8,23,18,15404,5081,10323,23,19,16463,5941,10522
3573c092979d49ac8113e24bc899baff,74,52,117546,28292,89254,75,52,98556,33498,65058
7988e2c0e5bcf16fbb2385621bad8d12,38,30,26405,11473,14932,33,29,25830,10033,15797
fc77f22bdf92fb342f4c9ca7ec4c7e0b,108,62,163918,29276,134642,86,79,131824,30047,101777
96c5250d793e938fd6fdeb64f2ef0eb0,113,103,244990,70626,174364,99,86,248681,66467,182214
8665da4d6f7de48d73c6c1bb452ad825,170,126,503186,76471,426715,106,89,265011,88521,176490
0206c40504e3bb7f1308db9222f86082,106,84,252500,57100,195400,158,120,364775,79280,285495
eddbc21b04b60ca60dbb3ea4fd427b0f,130,82,330100,40391,289709,149,129,336507,68117,268390
633ba25e67cab52d7e04c712c2f82841,157,101,573269,125703,447566,220,163,783031,126708,656323
4efcfaf8916c8e2262cbae798b9aa468,196,133,506630,104820,401810,119,81,330457,109954,220503
ca89a0babc6396676a9abce2f0e8f1c3,147,102,460079,99045,361034,193,155,535592,119779,415813
190bd2c216052005038963be645bc014,162,128,414320,101963,312357,145,115,401977,134010,267967
a7f42628662038db87d08ff43dbb91e6,26,23,11922,7859,4063,31,21,15119,4124,10995
6c2d49a889bb2ec92c0f9b4945b8be6b,105,91,251725,89251,162474,117,103,329459,68912,260547
13bbc8a82f5455812bc0014711efefcc,17,13,4726,2081,2645,18,18,2845,1969,876
30d85cf2105aefb40ae54497b9931222,21,12,2945,1638,1307,14,18,3089,2118,971
64d8898996c9b452f6dca318f93caea2,75,56,110350,29964,80386,83,65,139275,28812,110463
325ae5aa995dc70f08337b8fca940fcd,149,99,365673,56543,309130,132,95,274934,76884,198050
8c6d17c2305bffd479fdd9d577366e28,197,100,405398,62946,342452,124,101,266655,124396,142259
339f9a27a9c0330b851ee496330a827d,95,70,141349,23253,118096,90,74,153880,27277,126603
01068f1cb9e823a37acd95efe6bca09d,30,26,19398,9244,10154,28,19,17553,10354,7199
842e14e8c72c652b0ee4682e5d814270,134,108,490504,129675,360829,132,93,453460,88789,364671
eb3826359280694709b3be0542ee4df6,150,111,455649,79524,376125,164,126,516871,98383,418488
eb1f4d698796a595359835b91f856b0b,50,43,33277,11088,22189,44,36,36029,11934,24095
997e92dbf1f821e3faa7e0195006b178,114,87,192625,58945,133680,141,106,280179,59106,221073
94a2110414efc1bdc38b6a94cd37ac76,160,139,478858,97830,381028,170,116,457982,69328,388654
b7d80937b09e2ad5c76ea4f9e0615f22,173,145,582640,146517,436123,155,117,486704,88634,398070
f01936743538299745eb9a3034bd0e4a,85,61,132505,38876,93629,92,77,145345,51984,93361
dc5741f1c738b3e1a44a9b50ea7b44b0,79,60,138002,49356,88646,79,57,144067,43315,100752
695d82d355168d09f336edd5acbd1ac9,153,102,439829,102858,336971,122,90,351497,96560,254937
11f73a871091bb049485633114bc0d39,53,41,78440,24924,53516,83,65,121552,27362,94190
c7bdc6b6469883596aed02c66882b8ce,140,88,274315,138873,135442,116,84,296199,100740,195459
596c7b5d54173b8978458b0ce56e1c38,137,87,330115,71721,258394,145,112,317274,112295,204979
d0898f6d70f0c387cc515b6d515f653d,157,126,538444,99707,438737,172,150,678516,91895,586621
51c9fbe671562d8cea9806a2a4d07187,28,22,10410,5180,5230,20,18,9035,4059,4976
caab43db16a431a9a5f3b9290c0cf134,75,51,109124,35443,73681,68,56,109156,37028,72128
3d2c35068561db2ae0b99b9c5647f49c,22,15,7750,2820,4930,22,12,7576,2815,4761
6badfa62b8163199bfb1c79540857d71,131,111,272503,62525,209978,135,117,302305,77629,224676
823982cc4d5f48910fcf6266c7d58d40,175,124,575263,102166,473097,168,100,469111,138638,330473
bbc0b843d62cfbfd90780e81d3dbab34,143,75,316187,63213,252974,138,116,406478,78113,328365
b4e2fcfee026c170f26baf3afc21ec6a,27,26,22983,9970,13013,31,24,22522,10703,11819
1256d1c07ddf31967edea8f71579e9fc,139,96,425561,92656,332905,189,115,460179,90144,370035
acc6c0880d1768fa939006be7f504c5d,151,129,286336,45257,241079,151,124,299982,44768,255214
f6b12661833ac4c6f7e2100d00d1ef36,83,60,157017,59429,97588,110,98,243440,68168,175272
34401a19d15743d9fc321737322645dd,69,58,117319,27330,89989,57,42,63689,22222,41467
d05b4d69268e82e01913e45fb2e9a738,34,34,28142,7225,20917,36,26,25954,8210,17744
7cabf886e3801ea4a7b8d32dd5ae988f,31,26,28967,8454,20513,29,25,16022,9195,6827
59029d7d7c821019e68aeca3ae1bb78d,89,72,170225,47864,122361,81,61,133852,42715,91137
222ed1d6de649b00e38f694d60fe98bc,136,100,445631,96578,349053,123,101,398505,121987,276518
5e5640d3f73560314a79148684e93579,0,0,0,0,0,0,0,0,0,0
8438c841011a645bcca0b55bb9a5d61b,61,47,53637,19117,34520,51,38,60579,14957,45622
a76a5f42adcdb8909d8904587ed2efef,88,67,112444,25944,86500,86,77,103315,47572,55743
c087d52186386d84fd6fd3ea6164892a,80,66,152140,44500,107640,86,68,154690,51920,102770
ca392b6fe9f6ed19a7e77f2841cd9583,108,87,233866,42430,191436,113,92,192980,41201,151779
e04e77e8825cd32ac0c870cbc2271a25,14,16,5374,3013,2361,26,21,7296,2856,4440
0de458f1caf7bc1700f36aeb8d594fe7,37,21,17525,7253,10272,38,22,25154,7188,17966
85da386b7c3796440feddfce7b493324,87,70,190374,44785,145589,80,56,122115,43625,78490
5cb7808155b48f36aa1081aca5dd3333,153,117,445322,91808,353514,217,139,509672,75896,433776
3c43c0cfd47486f99c336dfc930c7b2b,163,131,571128,144348,426780,174,143,565772,152037,413735
5ac35b16f553c08ecbb78b4b6d1a43a1,157,114,484456,80605,403851,126,90,381342,96968,284374
258aab122e16bfa7585a2a5c589c94c2,59,48,97462,26431,71031,73,62,100177,36045,64132
62849556d2011ae0aa403fb65e61075d,151,119,425019,86485,338534,171,126,462843,90630,372213
b234c5fe5f539d2a4e0beef007cfd5bc,178,108,382061,97114,284947,122,86,489101,77043,412058
7b15ef8842d39799e26849fec6791262,97,74,185374,42828,142546,118,96,269693,49758,219935
e5d9a9a7d49dfe0f2702cfeb8d3b2cb4,9,7,1304,982,322,9,6,1365,594,771
1b7ff4338c3ec9bbd93a088d0675a7c0,36,27,18744,7355,11389,30,26,18760,9483,9277
204b6eedb99995bffe0820ad66df2a09,172,129,506215,106193,400022,186,154,551858,131445,420413
da89bd7ac0e74af2d993e1750433993a,33,25,20682,5294,15388,22,16,11380,4378,7002
4b5fce53ac6a7d45a50572bcfc6a48be,112,93,255102,52237,202865,133,108,200760,56796,143964
f8077734a9320f6dad9c479de954aab8,6,10,1102,558,544,14,8,1891,887,1004
ef3f07cd62c78a3be014b4dd16653f75,35,23,30840,10860,19980,43,33,41883,14490,27393
994611e2422d74f96eb5bf7d9d51db7c,33,23,14966,6579,8387,32,27,23170,4180,18990
108075064f9a38138199b0c5bc3f69d7,86,65,160243,33226,127017,100,80,159173,44604,114569
12c0c056726953376029c8adc6ff5bde,142,114,367377,58526,308851,146,109,279057,43730,235327
be70a232b72a540e62af2984b778339e,157,114,757918,168191,589727,171,135,500639,121941,378698
55de7013040395c5724c71c1ab586c6d,19,13,5109,1850,3259,18,12,3539,3389,150
23e4144e8d082559c0fbeca37625da53,33,26,35569,15079,20490,38,25,34018,15322,18696
52d80ecdd1d2038246f9720fddbe573a,194,121,667626,139613,528013,189,135,621368,147840,473528
1e0d9e47faa80616f2e7ee71c4bcf9f2,27,22,23610,8553,15057,23,20,21128,7493,13635
19fabd820a58c73a9a8b7aea570ce832,140,95,359004,87613,271391,134,108,372382,80553,291829
5c12d14e1d832e5a032ee174c772331f,107,73,407947,75108,332839,179,146,550248,82622,467626
290767077646d5a3654190eb4d4ccfd1,63,48,81409,30109,51300,55,49,61396,33818,27578
397b9c5795aba6c642912316a640802e,40,32,38571,19819,18752,63,55,81933,23182,58751
19a564c6c667bb70e9ba0f05d55b64a6,34,22,23391,7049,16342,41,30,29249,7443,21806
eb6be1106bdf75d83630949a3e900ce2,45,29,45469,14368,31101,30,24,35258,14739,20519
56b5f4afdb71d798f4ffd8a940c2e065,146,93,323874,80307,243567,111,88,272831,93963,178868
089a48ca4718b5a4044b7e06fd676f42,32,26,22114,10118,11996,32,24,20895,11594,9301
a90f39da3c5fafde45f9bbbce3d1d251,137,110,289150,85838,203312,109,79,265762,58814,206948
aff124c0417ad24e7cd04b3c3661bbfa,188,152,663913,109604,554309,183,138,579210,140266,438944
e962dd370748afe75b2cef0d186f6783,51,53,51017,21308,29709,61,44,55640,18807,36833
e6989f5eae9c37c048eb56cc163d1a73,38,23,18667,7713,10954,32,27,19409,6219,13190
4536d87713f3a1701cd41b85c58449e1,191,104,804947,152647,652300,209,150,702409,230514,471895
ff74be65411284e3e3ded451c0a7aca1,15,16,3688,4507,-819,25,16,10164,2059,8105
63e34d795001f79d66129cc25b0ced06,67,59,90667,31273,59394,48,36,73493,18160,55333
2f324f187f75ab325be536ca8bf77fc9,47,42,41512,21572,19940,54,40,56029,19349,36680
b3aa9661b37a062a9bccc82aae192958,25,22,16238,8546,7692,36,32,27722,9146,18576
049aecd452894c181f3a536ccc2235ee,123,98,239289,67702,171587,129,117,354687,60022,294665
45c8b19df1fdb603a21f5297cb45e1cd,58,48,85939,21260,64679,60,43,76057,24691,51366
47bb6b8a3e709fa68d24c6eeec6e6eb4,133,94,342742,92979,249763,177,138,442191,104878,337313
89d062fd294919965e28ff4888f386b7,28,25,12404,6608,5796,24,20,10769,4734,6035
a706e331a1c642c24c97198e1e74f376,92,69,239788,65677,174111,143,86,348197,45212,302985
ae08940371cd37396753a8e92e54cd2b,28,25,16964,8005,8959,28,20,24238,8239,15999
aa9af7893350b8e9f188b00a594bca4b,16,17,4689,4220,469,21,14,8284,2626,5658
e89eb5e9abf7cb2ee3aab7e7e5506bde,60,50,60676,21729,38947,66,45,65861,13540,52321
d0bffb5862e07fafedbed9d6172b2f06,131,122,386248,91408,294840,83,63,216438,89570,126868
041f80e7e2702e4b064d22fb8fe05604,143,105,282269,60052,222217,129,100,240969,44928,196041
5c6a9f3d3df2d165c1ac08033afb6417,35,26,44415,16760,27655,50,41,52446,19419,33027
f1d83adb288f6086fc6d3156ebd78085,191,136,632544,129848,502696,223,130,795171,109813,685358
00320b09aff2a1c672a61627a8360e02,53,38,80003,12234,67769,45,33,29896,19709,10187
95a97c6aa33cd1e01a883974300d2b4c,132,106,251331,52353,198978,106,87,216313,49533,166780
923f2a968e5431a2cf056bd4802dd8b3,109,89,248704,64048,184656,119,93,258525,71550,186975
f91045511011f2affa8e681496679b68,76,63,167497,34934,132563,66,53,103035,40054,62981
e0c9f9bb3a7c50bf6065e3f81fd3bf59,9,9,673,603,70,9,6,764,251,513
f89fe43ae78ddd121db32ef0aa5d61c2,33,22,14481,7502,6979,33,20,19382,5306,14076
00a2591894378bec4f9e32a69a263606,116,105,298656,76597,222059,144,101,402861,67040,335821
151d8a7ce13fe4b3a06210cb68b97bfa,135,99,338653,70525,268128,105,77,292515,71490,221025
654a16f88207c7286b68f7c3179298ab,69,62,112375,37589,74786,77,66,116422,41920,74502
344e97085a8b0301c8421929aafd07cf,23,21,18441,7667,10774,32,23,23941,6816,17125
9d55988c009f854230696023fcea8081,101,86,187148,50277,136871,84,67,149978,47657,102321
6608d1e090a8021479b46b9c7e88484b,29,28,24555,10258,14297,31,23,20523,9290,11233
26e1d1b95a854e7b374f0908a37ea7f6,94,92,132739,54234,78505,59,41,122734,34148,88586
564e442583e06e07c31eba676978ddf2,183,141,625896,79888,546008,136,110,356983,85146,271837
9dd3af836b5d2a91c2c3a9e662321ef4,107,89,294465,72855,221610,139,111,346871,77040,269831
0e4caa7ba2c3c2cb79b8f7d4cec120e2,232,122,652337,125787,526550,183,136,708479,105172,603307
e29799f593bd45008ad2742ab61a61b1,132,112,717013,164718,552295,168,111,619300,152831,466469
545c8a7505751e22bb7945f215218e27,34,36,17521,8825,8696,44,30,22461,6757,15704
37bbf416ca7226867cfaf891258186a9,217,158,888518,180715,707803,227,173,903509,253544,649965
f88eb8ec48f627bc2b9507d63c361f76,25,22,12500,7721,4779,36,31,25961,7140,18821
7eefbb5ea4b973306f25c543ace936fd,181,103,386484,117345,269139,183,117,470735,94540,376195
8cd877e910c14d84902a295b09a56946,152,115,378165,68434,309731,195,156,565453,71927,493526
34cc5f40f48e0233c916c22f6bda11ee,69,49,89220,22830,66390,65,44,75468,17524,57944
9839dc17839f9fa782a813e60cfa1bec,64,53,89236,29035,60201,87,72,150206,26945,123261
70a9858aeb6e3e3631137692fd3f566c,57,37,52411,17047,35364,44,42,60886,17033,43853
ca0436cc5bf4f297ef6cdd1ff6e6939a,29,21,14676,7214,7462,33,24,19050,8911,10139
a1412d1e3835092324bda0e73fb9641e,78,59,97563,31309,66254,95,61,99870,30939,68931
1ea99425bc22de762f15a7ae9bf1572c,164,143,546175,78227,467948,120,93,419608,54155,365453
fc676960eec6dcb698c87711c3471159,38,34,36989,14137,22852,44,29,39287,12919,26368
0ec93d40d172bc10db4259ce2756ae6b,152,101,412567,77444,335123,192,131,655697,77453,578244
5aca397df8234197f15435bd5846b3ce,149,100,688221,96681,591540,232,173,811952,129702,682250
ed7931e7dc04b2316b71bc9d0a62425d,87,57,162305,37654,124651,95,90,203125,56442,146683
357361e5df1e0e1b04141740151460e6,46,44,48437,19913,28524,58,47,63722,23219,40503
02456cf41fba94dc3b23bf5186339061,204,147,747603,171178,576425,240,132,739532,133626,605906
1a42ee56cd41949584acf9d8d44d96a8,156,123,494192,117099,377093,140,103,435138,91631,343507
0f342a4b3e5b539c9d57c0d3b30365bd,31,24,32083,10465,21618,40,31,39503,12594,26909
f807b136b9eeb251a3712b06959f55d1,138,99,634624,109847,524777,157,123,575579,100642,474937
e0e1b13fe8de61b3832c7bb2fe4ef26f,135,108,249930,86160,163770,170,129,375879,57400,318479
194893a1d6cb4838dc550766d0cbeb7f,79,69,101295,34963,66332,72,53,108351,24912,83439
6d390a0340450893b7a5561f4c410957,78,60,142563,29365,113198,83,68,133862,35891,97971
0bcd00ca748990ae9a8cf351e99ba978,33,19,26242,8388,17854,37,26,34367,6958,27409
655fa93914f4e9b09bcb204dd4bc2ea1,52,39,70424,32149,38275,61,48,77781,27968,49813
e6e059674fd5fa96b5944cbe97506e28,49,41,37693,8456,29237,39,40,25914,10049,15865
3f248bca9c75389942caf9f2f4e205a2,5,4,454,439,15,10,3,960,98,862
24bcdc97a9814944b762c3e5ac2b661e,171,130,536436,89543,446893,141,135,401186,80440,320746
7a7959fcbda316df5264278c13d78d8b,87,78,150380,50726,99654,85,73,146446,37771,108675
fcf7cdde2da6f04ec54108f523698c99,140,127,327778,79580,248198,126,95,281684,58796,222888
bb951278b88a5735af59569cf820ff0f,27,21,15320,6886,8434,32,23,21332,6198,15134
dc609df1c9eacd938e4f83340c765964,207,132,839944,163662,676282,153,118,749296,146851,602445
bd72c19fb02877be750f4042cec78f5a,76,62,142595,32677,109918,60,50,108560,25309,83251
24fcccd7c601de9bb07582b05c5f9f38,171,111,365631,82834,282797,128,114,357604,83270,274334
021d59b11ff86b53dbe931e9ae7e37bd,124,89,344642,64681,279961,171,123,368812,45882,322930
54c1240cd2c0906a74e44c8775e261fb,192,151,652761,161281,491480,194,148,734016,161812,572204
935b70771c79576979347e1b5692f58d,149,117,461241,71114,390127,141,107,393680,59512,334168
3e26a1f48dae4cf181be54895aab3ba8,37,25,41884,20689,21195,37,30,66106,17720,48386
602c3ca42013acd42fb5bed3498d43ae,166,120,694110,136092,558018,211,141,754280,118344,635936
5bcc7ea3cde5e7b51b9bfe5ea18e82ff,24,20,13160,5696,7464,26,18,11412,4696,6716
535315d6cea1a3e043b29c57f248a78e,69,54,68740,19178,49562,69,54,79911,18753,61158
94493eebacaf2fc69c094cfb6fde30cd,44,39,52746,14461,38285,41,30,30354,10093,20261
c359404fe264cb09a188c2ceb5181e9a,21,18,12070,5001,7069,37,34,29795,5309,24486
dc49a768982e96a0618f3deabdb42c79,127,97,295673,93875,201798,94,72,216675,61595,155080
303b2cccd665ddc8c5664a30988ea8c8,160,113,419620,77053,342567,112,82,280428,72914,207514
c3ed1a473b6f075daa153f5c480e0b2f,170,133,577826,102090,475736,189,172,697806,133358,564448
d1d290f2aa66825438a3a36ac627841b,49,32,71900,18518,53382,41,44,44558,22474,22084
5970a7099d20838b84054697c268ec2e,87,63,184093,45020,139073,113,83,209987,51893,158094
3ba64309e98f571a2f06567b347a7bf8,22,18,7192,2283,4909,25,17,4660,3120,1540
0eb39d05d9052e0ae458caef987d5f07,164,115,437748,117834,319914,181,137,558256,114533,443723
f5c7b07d19043d4a6d0a6e7d8970892a,102,76,133489,41195,92294,89,70,116612,34268,82344
e1762d6d1a69d48d74478106d4cca298,70,58,112476,32450,80026,77,61,125304,32501,92803
c4156d771d7bff1d671056666f9a9219,142,118,362192,76262,285930,131,92,282481,60665,221816
7a467bb8c34bdc0c759f8b38e0379fa3,85,76,149330,40514,108816,101,63,170614,36541,134073
a92842227020cbc5f186fa4e56547714,80,55,162887,48008,114879,93,69,193960,45754,148206
db716dc1ad49b60ca7847d34163b306a,93,78,173940,49824,124116,107,90,166783,51800,114983
5e4dab58f79cf6a7e0568326b0f2c4dc,54,43,49317,20588,28729,49,37,46984,15461,31523
b0e38fc55b6c017d5e69d69136af2379,110,82,202922,74636,128286,116,75,217822,51341,166481
c22bc6092c80f75f60fefb8a7d5002e9,94,84,153390,53157,100233,83,59,144350,31215,113135
909a7de815cde2b450f880783daa00d5,36,26,47321,12116,35205,52,38,61455,19040,42415
8c28dbae20a252921fbb19d6fe25240e,65,55,139760,33604,106156,102,79,158837,42261,116576
e9193c9efa6f1d5058b56690b52fb1d1,120,87,257494,35583,221911,81,62,145211,24064,121147
a5e903f7e8f3c1d29f6511bc96d27c01,163,115,583014,127128,455886,197,142,639626,112280,527346
db526e27103b59657ff3bf3f450105d1,48,35,40029,13722,26307,38,30,31158,8681,22477
d3b357cf70d2818a0832789b52adf73c,27,18,17897,5477,12420,24,20,9448,7986,1462
7b6fce3edfe5e643c32376475c683a8a,41,39,53888,19942,33946,44,32,46692,15284,31408
8cc3daf63b71c5946fb18109093aea16,159,128,432075,63453,368622,119,92,239551,53867,185684
1b152a688d6f01d4094d482e4b1401ba,103,93,218583,93247,125336,148,113,413335,123908,289427
221733315a90a222868bcac8e01a8725,182,126,369414,67178,302236,114,66,280853,56522,224331
71a3579055d4dede98db7dcc9f9156ed,44,33,47055,12974,34081,53,41,61650,17389,44261
520a9375b9bb6a8050f01503008cf618,111,93,203031,72847,130184,148,106,319448,60140,259308
a9f16ba2be60497a697dbaf4b8822b12,188,109,463620,54393,409227,138,115,328324,84596,243728
eaa90d9815a2296405f801639292b4aa,86,65,151275,44211,107064,126,99,273175,42243,230932
b60a667dbdd8d766570d903f2c78983c,105,81,168424,60281,108143,143,100,264360,51161,213199
8cca569b1d6909eadcfcaa85d2aa8188,72,66,100165,35120,65045,47,43,87871,29208,58663
c185b3841686aea0577cc0b6af33e050,180,154,577525,105120,472405,153,110,517753,104832,412921
8a95354c0606debb562c610462508b12,32,26,14856,8912,5944,26,22,17840,9244,8596
639d0f237b14924b9d1e87bfba0d9230,159,127,414275,74471,339804,140,115,344877,99789,245088
b295fbe1ea95a4a689e0984e71883d54,168,111,449644,88695,360949,147,114,362103,72605,289498
762c4835f168aa70e42fbf7af3910a9d,57,36,107666,28034,79632,50,48,70957,20832,50125
560056f64f2a3125ad3576380eda18a4,162,127,516347,94181,422166,149,126,491590,73028,418562
ae7d3d50cf5f8fe3d9d2109e50ba9771,26,20,8825,5726,3099,25,20,10731,5303,5428
307d14207648a1c67cad89cab6ccb78e,25,19,14988,2488,12500,15,9,5077,2399,2678
74b52bdb94efdcab1c73f6a8451e18a3,55,42,64581,22874,41707,51,57,81317,21325,59992
a8114ef46f3c840fdb8b8577809d4acf,27,27,29833,9677,20156,32,29,30133,11194,18939
840217ede1f6b11eef124ef716554edf,78,66,103324,35043,68281,84,74,156090,47927,108163
ea2ab083ecf6b924ce55622833381f39,133,99,378944,125329,253615,182,130,452376,97241,355135
090865015009543879fb9c4c281c4438,26,23,13656,4742,8914,25,22,9607,5601,4006
6a8416f0c75dd6f46ae874db2630d5f4,27,22,11944,4201,7743,22,19,7753,4310,3443
a5d34e9dd6bc19c9b1d7e6ef44249e5c,25,23,8802,4698,4104,24,19,7322,4477,2845
0d4364a2d4e8397a12008abe71074353,104,82,162884,47560,115324,99,83,196310,44878,151432
6126441316b2bac90b9cde60e8ea14bb,88,72,151511,44651,106860,96,56,217939,40281,177658
7fc3b223816bf955b80e7ca31bcfa604,113,92,228332,89441,138891,85,69,176080,68189,107891
0810486b54dead8a88e25c1ec85c4759,128,96,498751,117957,380794,182,146,757486,118891,638595
3ae5a24aa7bcca9c3ef0b9d91b496cb5,74,62,147926,48284,99642,46,41,109928,31014,78914
74927c176b992a42bd3f19103c6f44c5,93,72,226129,52783,173346,99,78,159019,41569,117450
fad30ea81614b304c65970fff369dbf9,53,34,63212,16081,47131,48,33,45371,16656,28715
c782501cbeff1d0290f90d197de4acc2,31,27,22778,8555,14223,34,31,30858,8131,22727
bd75f3a010ce84fe1ad14a2381324f78,71,54,122861,32741,90120,50,42,54343,23538,30805
b24591c4f67644d4863c6def497791b4,147,125,469082,85496,383586,129,112,363496,90359,273137
95f42e997c339a97bbd69b2e64e8e9bc,60,44,48207,22121,26086,47,45,51470,15429,36041
7b640da7509a9129ffd26147671b8f8f,61,45,110002,22949,87053,66,57,137348,40357,96991
212c80d3cfe5d5bf7b25b1ddefd240b8,140,113,393145,45948,347197,117,93,269893,67423,202470
ac7974e989a74969e899ab9a31faa9ae,20,17,6227,3263,2964,22,16,5108,3214,1894
1b6e96bb728b3cc650838c4b17be1913,121,90,315988,69365,246623,145,109,297471,66203,231268
78cbdcbd85f34f5ed1896f32b8877b5b,21,18,9145,5133,4012,21,15,7320,2692,4628
004713add42a11e9b6d2373fdc54ce20,119,101,301409,80853,220556,145,113,403097,107754,295343
d97bba5ea2045a817fff5eb97f95416c,12,16,3429,2859,570,18,12,5056,2146,2910
0b004957b0e964589473982e80db7448,48,36,62638,21482,41156,63,48,82805,24591,58214
aaf0193bc922c2d236701e756545b65b,118,86,309669,72864,236805,120,92,267563,71841,195722
206573e15f4a9f653d9b637231ffd262,51,52,96747,27210,69537,57,43,94382,31217,63165
54dc051bd1336c3c91c5ca0b1110f8fc,33,30,26699,11065,15634,39,28,27895,10287,17608
46c318be0c3b952fa44093430b77d8be,112,81,289657,65591,224066,178,130,468163,80648,387515
f2756f33321ba25b227ffca274809cd5,113,75,136149,45848,90301,84,63,96375,40772,55603
e83c41ced049a1f26f4532800d52f345,113,91,272666,56874,215792,113,101,269023,59868,209155
55b76177840e6f03630d79500dc10e1b,172,114,554783,103228,451555,184,147,581303,122946,458357
a492d749bad5c91b64238c729ca7ba4e,100,73,172008,30793,141215,114,88,202915,44478,158437
1b179ab7990ef9e811bda551fa9beabd,118,93,230685,49555,181130,100,74,179575,49951,129624
7041552d644eb96e79910e4becb0a607,66,52,90165,15648,74517,41,34,44578,18993,25585
b0ac64996bb12f6e727ebd6cbd45e1a7,49,41,45762,17553,28209,51,40,54168,18392,35776
e24660d531951512b0776ae02d6cb4fd,82,61,159697,35729,123968,46,40,58020,34344,23676
09c0f6e70fe5e3a11442856da20734aa,32,29,30306,13546,16760,41,29,27266,12296,14970
9c52abaeba57967edc309ce2130dffb2,178,136,677655,143087,534568,168,118,545707,166626,379081
29a60549ae68c0b698a1c615aa08acba,132,93,250140,52720,197420,88,60,172219,60418,111801
4800c3442c7152ec89cd1ced6090a8ac,175,98,414692,48786,365906,149,102,303177,68063,235114
571d3a5d4e1d01bac6c8aeee1d92bf23,92,70,140207,31794,108413,61,48,76725,37420,39305
62fe5a13844cc14ee8aebf85309bff50,161,111,542861,106082,436779,159,103,413725,134553,279172
f682056b68f0c1a747443fd72f611247,1,3,86,314,-228,3,0,314,0,314
2408f28281d56d67a268f485fa784d77,50,42,59576,11617,47959,48,48,30504,18200,12304
7e1c6cc416e979cd85e253e75c3b05b2,114,85,251195,96760,154435,94,70,232620,81660,150960
6cbf39bfdcd379aa5fa140cc81cacdd2,8,4,1121,744,377,5,7,879,1022,-143
4df74cee918e89764362ec15f552b01e,61,50,103625,24358,79267,55,45,75710,33344,42366
1988ec695c47e79c2a33f3bfbc53cd80,129,93,214465,42878,171587,120,91,189789,54656,135133
ff9ab702a4c11f760e9704e26079e35d,23,22,24096,6163,17933,24,18,11641,5871,5770
aaf524eff382c75eecb4ecd1432484aa,77,50,91216,23708,67508,82,65,135321,34551,100770
a77334b3c4b8579c0acd9c86bdf2ab13,76,53,123487,45193,78294,101,91,204972,49089,155883
79d5a4c05199acc8236ca1cdaa5475de,119,94,268906,93065,175841,192,129,530968,71458,459510
b4160e77fa8cb98651e5b0547c9c0737,78,64,123612,41180,82432,60,51,87542,31144,56398
fb5e3138ab7680535c62e0580454372a,112,90,248916,45751,203165,91,60,185785,46180,139605
9f0d896dd2979b83dfc32fc87586c74f,53,50,68924,24778,44146,65,53,127934,32122,95812
2cfe067a0fb2b2b0f170b00b7229d030,183,118,568689,109807,458882,135,113,430916,131930,298986
3ad39a7a80521c3b5e5e3db54923e617,162,132,492580,123955,368625,170,124,538539,93056,445483
407897e9da061ead61ffad8310978397,116,70,228160,40940,187220,125,92,277545,40135,237410
0f9740424138a0627e6107d333afc88c,157,111,380320,115059,265261,190,129,443698,83297,360401
efcc78f43ff908997bea52bb251946bc,117,88,262503,64377,198126,146,109,405383,60464,344919
e3519ed3479146441c9456980d8fd0eb,43,34,51574,19824,31750,62,53,67891,21714,46177
434b55906c77da0d2a1470d9ed0da541,159,118,472580,101689,370891,121,100,339169,91786,247383
465778445dc0a4fe5777d97325701064,110,84,181762,39669,142093,114,95,186547,42817,143730
39f4d2bf0e11613838664b8367685770,108,86,197988,46781,151207,83,60,120787,55663,65124
4c9939d1552b02fbd4900499dad135a1,20,21,7282,3531,3751,27,18,6728,3818,2910
300935dcd42d23b79dcdb71043125a5d,20,15,8824,2958,5866,26,18,5768,3298,2470
f8e3b01089af6f8e7c681efecaef92e7,56,40,69422,11259,58163,38,30,30759,16532,14227
1e418638d8ba1736db71a0cfe3ef556d,41,38,93115,26476,66639,48,42,95080,27927,67153
1191e09a38f497fc8aa34c446f4cd152,57,48,57491,26379,31112,47,46,58145,22098,36047
e4daf69a4441f8d902d258894ec309ce,87,61,160045,31926,128119,72,56,103031,44788,58243
8421b9fb6ad80552b30ed267ed968708,93,76,208114,63456,144658,111,79,237984,47916,190068
2e1f9fcdb3493434759ad9d5b08b30ad,116,71,173847,65770,108077,149,101,260293,57756,202537
efd8a4cc05bd9eda6b512264c16252a6,145,92,380038,81990,298048,142,96,385374,68067,317307
8712e7fc764999a73927c39f65595055,100,85,234664,87519,147145,166,115,498731,68128,430603
f8b00adb6c496eb79321bd06b82d8484,35,29,27015,12271,14744,35,28,29627,8046,21581
fb2719a286a962d9da5652c421eb15e8,120,74,222536,38403,184133,123,93,188359,49545,138814
777cb5822385e36c031f79b6a3c979e9,176,154,732642,149260,583382,148,106,422668,194880,227788
68391b7e54c5d32646ab55604b4db78f,155,112,333491,42293,291198,121,98,227504,63729,163775
514a2861bf1301be8917140a2a019abd,146,120,468966,108197,360769,133,105,451691,117774,333917
c42df3746c3bc79e3aacd9bc62fd817a,40,31,40259,8832,31427,51,34,47041,18046,28995
9bd2ad1780211f312b4fdc63d3b475e6,142,118,314142,55394,258748,100,84,200806,51982,148824
a4f8afffe8cbe8a7799f721eff431453,36,32,26999,13439,13560,47,31,26244,11659,14585
4e88704ca06c4c798d13c52deb48e515,137,111,353711,62601,291110,158,115,457456,71902,385554
a972f0492e2cf5d6d2dc341a76e21c11,6,6,390,459,-69,8,7,998,469,529
544ecab9b25b2cf5f6bba3b165b85edd,24,18,7272,3856,3416,14,18,4392,4444,-52
fed4112c384c6c9871940bc24be9bdd1,112,84,232685,43080,189605,109,93,232428,42891,189537
67d5f3d599e94797515912419df475ca,41,38,36755,13052,23703,41,27,27694,11068,16626
6acb2d13203e1dffbf3ed1533602c370,62,54,75584,30861,44723,58,45,80606,22977,57629
ee11ffbdc61f4d7d1af8c610f91c3d30,61,46,93068,24385,68683,50,47,58328,27252,31076
130f4f30f523a4206c6481efb0440ac7,120,114,289092,89610,199482,136,109,275185,74136,201049
32dfe38d6ee294300a632eff48a70af7,137,100,420122,73237,346885,162,92,407050,89006,318044
0a34ae19bbad4bf19d861517735e9e9d,56,36,69128,18758,50370,74,49,85481,27100,58381
2e4530d9ea159b484143ef269514d618,33,27,19810,11541,8269,33,32,21271,8959,12312
e6e2bd6f2a8d86c45157b45570e73bdf,29,23,19993,8429,11564,27,21,24823,6461,18362
cfe68e9e58342047de00a6e0c1847ed8,30,27,26787,13615,13172,30,21,23642,10218,13424
4433e38fb36805d6f5daace4bcf198fc,135,102,243618,79872,163746,131,76,305436,64486,240950
2157323cc6695bed2a728e17dc52d5c8,163,111,440740,74492,366248,126,87,299352,64137,235215
7a155df51fbb8c1096eb1d36f32976a1,61,49,64374,20855,43519,85,54,109874,21242,88632
5384103034d5af1081c5a6518e532617,60,34,59150,12715,46435,56,51,40264,23736,16528
4d4f33fa8b8185ef89b99a17740534dc,148,105,486865,134983,351882,198,156,636929,147173,489756
93044b595fb4a924f8c80134d194db7f,162,142,464469,91761,372708,144,96,424607,80012,344595
09e2a36b8b9261267d7a80a7bd05de71,113,73,177333,38673,138660,102,90,139649,56376,83273
a4da04b59f551098a0af673b93cb11e9,180,155,973830,284418,689412,194,149,794688,191963,602725
e0c725207917b5cbfc12b8d3bee51949,77,62,86563,29909,56654,112,86,138261,35340,102921
f21cdfe5ca34791d2317075513927572,58,41,77199,45282,31917,83,58,168396,35579,132817
8f4d173a611d2101b639638c269d7f13,163,112,373296,57893,315403,165,138,445052,91175,353877
5c5e850549b7c7a1b5f48b9020f17685,124,92,391758,101696,290062,176,123,572969,127341,445628
664873fd1c6e842e9aa0e659a25aff79,216,152,851552,133533,718019,176,142,716778,160552,556226
491c5b419125ce5a6632d8b09b62de3d,32,24,25665,9256,16409,28,23,22820,9240,13580
2156731e9b59d367bb3115612fcdf7ec,5,4,814,529,285,8,7,1160,868,292
5a6f344ff407a236690286e2710e7c5d,76,68,151777,37070,114707,69,48,89580,29811,59769
b09227fd5ec970d6838b4ae888f12cb8,102,75,143208,53950,89258,117,97,222057,43962,178095
ac2739bb046fa79e9476af8df855b59c,28,21,25665,9372,16293,29,22,25079,11655,13424
6a75000f4836b928ddc67aa7e8ea1eed,110,94,231108,34061,197047,94,68,144619,32406,112213
16f8ce03d66aae8e8d13a828ebb68496,119,106,334391,80781,253610,131,86,272640,68904,203736
eedeb4fee7bee5cc344c984c82b97225,184,140,452860,92843,360017,100,76,216935,57740,159195
7fff4a9836727ecb4b9de1368495fc1f,89,72,149792,46116,103676,99,81,164248,50391,113857
eed764b22e903a6bd375dfc0fa84f0e2,143,110,517477,61705,455772,106,86,253439,106376,147063
629f2a79ce0e184fcaeb95e5d0a0f79e,90,64,181406,36068,145338,78,52,122537,52497,70040
79600f1136a8fa01b109e95f0d8a10d4,85,59,116748,41303,75445,81,63,108906,40941,67965
bbda55b04eb1250f1d9976c38a27689c,120,93,203918,36600,167318,114,90,226406,32505,193901
48b511df2d4164e1aada5b03b1705830,121,102,337280,64447,272833,111,90,236012,53320,182692
436e78b69b78ee3e07cb9ff1f48dcfa0,79,66,166727,45222,121505,66,55,137764,48396,89368
2817678c406ececfc4cbfc2340546d89,34,21,25590,9408,16182,43,30,36863,12779,24084
c056c69a7594afe2b2d69aa273b59a02,19,16,3442,1914,1528,15,12,4436,1381,3055
965ac7eb277ae7ff2ecb0d23acd5bff4,181,135,702525,189714,512811,193,125,618936,120781,498155
763829a8c76e45ad43e57bbf9a23c0b4,83,56,279679,65539,214140,195,151,560887,107813,453074
48f7a7d652933a11fba0e1a387956a82,59,42,50831,28173,22658,50,41,63408,26057,37351
ee5cee780b18c2830953628e2ccfefa8,53,33,60669,18814,41855,42,34,43836,26198,17638
91ab056274de90c0fcd261ef2d1c6097,115,100,274419,68650,205769,129,105,281814,93867,187947
a32fa8dc763a1a7fd82bb1a14b9c71b1,55,46,44929,13226,31703,37,28,26852,10963,15889
06a40866275ebece1f922cf2387c6a20,131,110,330591,68904,261687,92,78,222669,79819,142850
a7fc6cb8526b70a1ee5213a225d2546f,154,102,340306,72424,267882,129,96,288429,55123,233306
619a21ef0c809629a9f7ab7beb66a98d,45,36,76603,17374,59229,53,40,72969,23121,49848
add811a9295fc1c1f812aa619af95ade,23,27,20884,6725,14159,41,33,33326,9042,24284
e0c628598278d267d275234372c5878b,24,16,4805,1748,3057,16,18,3148,1710,1438
7b16bccba53b64bdf15f99be2361af36,128,76,219310,54810,164500,103,71,232272,64441,167831
620f398d6deb8027e010abd86f32662a,26,18,8397,3843,4554,23,17,13416,2411,11005
4e25eda020efea96bebc8b53697a4c23,64,52,79267,18762,60505,61,42,68480,15492,52988
b150fd060082119159805faf31dc8668,141,89,316143,77348,238795,162,135,518624,126703,391921
7989cc146081a794317450e02d49bb94,92,69,123080,34645,88435,74,65,149904,31121,118783
085985a627f01e96752ba88d2357afb8,56,45,68769,24841,43928,71,52,77904,18455,59449
bb602a25a6c964e656c1a25aea32a97a,117,93,505899,140701,365198,170,146,731990,162459,569531
c25d01e63943f2b3e988161b41bda6b0,20,22,5850,2904,2946,26,19,9098,3113,5985
0cc4577a5466bee4bbf7a326823ccb2c,82,65,87318,28805,58513,85,75,98523,33542,64981
407cd21c658c4dfbc236816e305af8ed,42,32,44682,16510,28172,44,30,30718,15164,15554
80c7a3a4c88b6f9fc41b937f6bd87b8b,145,103,370609,99158,271451,173,124,621519,85132,536387
ffef66a0a21bb3ec4b151a92db38b8a0,226,172,877940,244511,633429,241,166,1391548,183172,1208376
5ebb539c948fe728f0f8518f92e76db4,52,44,56073,11355,44718,45,38,44201,13072,31129
f81bec4fa2020a4384bf75d7f8ef4514,52,40,83615,26911,56704,62,49,96381,34406,61975
09951651ba43e8b939410e983a0b1f84,88,72,200162,41384,158778,87,70,170019,29269,140750
e23174ac6971239e7917e5d5da1b1015,82,63,128946,29822,99124,103,93,145691,45434,100257
84ffa8526f7375cb1d6ef1c2f1ba31a5,62,50,94095,26011,68084,44,35,65204,18298,46906
5a3c6208638f359050cd41835e3da854,143,101,270508,44281,226227,104,79,157541,65422,92119
86d10edf38fb20c84c9e681d902baaf7,89,64,145350,29338,116012,76,66,99581,33444,66137
59186c8d3aa589e53216bb7f5d8977ec,167,108,658602,111938,546664,189,138,780247,142159,638088
f84882b5805ea2039bb07ec754d20e60,30,21,16651,9896,6755,31,21,19612,7822,11790
185a3538d201ca061f28471d894f8cf9,132,80,240976,38779,202197,133,100,235640,29840,205800
c4f072fad8f90af795f2722286216f6a,43,32,49139,14566,34573,63,43,75180,12730,62450
63d281a21f2db5dce67122beb24a56ad,43,37,43344,14814,28530,40,29,32668,12460,20208
1db0b524b6de1089f4dea0eeffab0581,56,43,69021,13771,55250,42,40,50807,16033,34774
7807fb8172ddd7e53e194845cd261db2,98,79,315787,99612,216175,151,123,422092,108050,314042
1d1d2666fac8f8a09ecab5d668639ab0,177,138,948354,159159,789195,226,176,928798,175518,753280
5dfd5b90124018a8597904259a3454be,73,68,105248,47242,58006,134,111,265162,33736,231426
7628ec4dc146c0cb5df1ea6add4c0ef9,102,79,224440,65902,158538,104,72,237676,51292,186384
4cbc63c1e0d9448e4f816027db8facee,191,108,621848,118723,503125,185,123,502328,168201,334127
319e01df4ce3109d402558c7d64ffecc,37,25,34356,15187,19169,36,21,35181,11117,24064
3b4c5feeffbf5fb404b5623d1ed9c71a,176,146,587299,124834,462465,179,138,570314,127062,443252
06e307789d93b2dc7bdd38287213abab,65,55,99751,37348,62403,72,50,139251,39453,99798
a6c7d78bf71181dc9f04feb739f1f955,73,61,104920,42212,62708,94,66,157822,28366,129456
0a106035bad04ef667573d561d4f9a08,12,9,1860,733,1127,12,8,1648,800,848
14348839fc0eed18d33463c6b1e20d5d,58,40,66829,23124,43705,59,55,72385,22179,50206
167322be80b8acffa7a48ac9ecfaba95,82,68,147499,45621,101878,119,90,220132,53713,166419
0200d097a5c27b597c2b8030553c3d68,50,39,39629,16138,23491,36,29,25120,12452,12668
bf31ffd514bf16a767abafad573afa5a,29,27,27475,11149,16326,31,21,26392,10276,16116
1cfac529ad03267e792a692c8e2b61b1,93,59,137573,34175,103398,91,78,109047,50480,58567
3d8a209f048c1c3e5d92e71c4d72c0c8,29,25,11795,6158,5637,27,23,14389,6465,7924
3c239078cd1b702659d018f727bd9e50,59,44,62567,20805,41762,46,38,54286,14585,39701
42d604d2d0889650ba59625538d9ed2e,184,147,584551,118272,466279,192,162,834723,87084,747639
b49af39ebb1fb1e70d8acf54f3233f72,107,87,258818,56207,202611,138,103,273238,64691,208547
d85b1467eb5b0cd84da9633c51ee2d62,43,35,50160,18898,31262,39,31,42434,9262,33172
2580d8a5faaa5611a7ac733959b035fa,41,30,26843,10235,16608,52,45,53607,14345,39262
9923c47d7f4fda692508ca628ba94973,95,80,177441,33603,143838,69,51,112733,40012,72721
c6a859398825541ab5722fe5c267e063,52,43,66966,33432,33534,154,118,296570,51007,245563
cad46066950d497ab1eb53c206b13a2b,107,85,196525,52782,143743,127,105,238427,59990,178437
95905e0a58f3f6d266ae97faade23da9,103,67,175156,41917,133239,96,88,215106,53653,161453
ee2f6be2af179bcea7bbf55ef319c358,153,116,413982,83515,330467,133,94,334878,78756,256122
d71183a64d198a744a3df8d3a0370610,73,64,115812,28650,87162,60,47,58305,34350,23955
ef0ac730f67b8ac93c1097359134c7fd,99,87,270810,75801,195009,133,98,271789,54130,217659
0b5cbdbaea1dff1ccbc5085cbdc98acb,210,163,868386,198773,669613,149,88,762069,188895,573174
3a5d6efd9912e859972e412b66d8363b,92,70,222875,81311,141564,75,58,181992,58280,123712
cce3759a061a2796542da527316dd76b,24,18,10557,4205,6352,23,21,12085,5268,6817
ad49caceb4389f957d474bef1a172b26,50,42,69975,20331,49644,70,57,81140,27706,53434
7a673ae4ff470c40c90d04dae42f20dc,29,24,16659,8879,7780,36,32,30649,8760,21889
6cc54bd68889f49a28329bb7665a0ba7,80,64,96469,24616,71853,67,52,71623,17104,54519
c86c7da9806014df3dc2639d9ac9aff7,149,124,627855,150622,477233,174,142,563993,139478,424515
f1ca90a60fbf39695a9a0212929ba4dc,75,71,121934,35320,86614,70,59,105506,28268,77238
837304d0579f614074a2848365e7dc88,143,116,426883,83831,343052,118,87,336288,77958,258330
1351b185bafb5916bb3efc02bf2f0caf,129,91,380800,75273,305527,125,106,386952,83794,303158
92f8d680f9117d31e8b4d2420237423b,34,27,21805,9702,12103,31,25,23250,10708,12542
9a29e878d1b176f726228ea57afb4658,157,134,408090,99686,308404,185,122,778136,60636,717500
00e1f202ed75319b6a234fc794ec71c3,58,36,69233,23020,46213,54,42,76740,27648,49092
a1af1c946bdfbd68b5b95bcdc69722b1,36,30,40201,12459,27742,41,27,43208,10683,32525
21f963ec23d78ea70a942058e325eb03,163,130,467252,121741,345511,123,99,425184,161524,263660
9612eeb38390f62f44a733a7f1e101eb,193,140,748016,135132,612884,157,104,667493,99375,568118
171a6ed23727a7751af7d3f13ad1a7cf,59,34,46163,19407,26756,85,55,96175,13635,82540
b63fec766f38090fb7116964fb8c8ab3,101,80,222614,46744,175870,87,76,214945,49369,165576
bc05e088e5a8b3ba68449fa822ae0ecd,76,46,86797,22302,64495,79,71,105162,32217,72945
35d79882f47b5a09b2e527a4102439f5,43,28,36061,9166,26895,30,21,18506,9383,9123
d2ea3ff50e9aa97e16721eeae284da6b,42,42,41124,11880,29244,46,38,39994,13326,26668
52c98590064d16c270a67518e5ed482d,39,30,33579,12179,21400,38,25,25796,10932,14864
a5e7d1f34e8c8d21cab441c87964a337,75,67,92154,24237,67917,70,59,77687,22299,55388
a20bae3d89db1ffc4b40f8c85a798021,4,2,210,169,41,4,2,288,117,171
f27132f036e3635a8236c5d9651b2d0f,28,21,19978,8395,11583,25,23,19441,10324,9117
d14497e4a650faa3d0821dce9d01de75,56,31,69003,21056,47947,49,35,69833,15850,53983
99538bcad2131a5bac3a8617f49736db,45,31,28403,6500,21903,41,24,24780,6663,18117
e649d62c111fc7091db1803ba4ffdb17,49,42,55552,22704,32848,55,41,56878,26099,30779
1330104469e18400ad3428878013cb49,138,109,298074,38486,259588,105,98,175249,44230,131019
6e10369cf0cee9fa691e39ede62966cb,106,73,200922,35696,165226,119,98,236700,38148,198552
da2492211ac33295385b685fdb5990eb,52,34,77865,16282,61583,38,28,41515,17396,24119
01170c865d6068f4f4f4f6b667f09770,148,113,486515,108875,377640,169,104,419608,107246,312362
e3cd494398b0c07742073cbe60980b6f,136,93,386368,56905,329463,148,128,444722,56220,388502
f2534dbf04167eb672d3625e6456a822,138,97,389829,98984,290845,124,87,324577,143217,181360
dc027d779c660ae858eaac866cc692e5,30,23,18462,3952,14510,28,20,8652,5922,2730
e35f54844d4fa9cf1712c6b6a1835763,146,83,310785,111212,199573,162,112,450577,106638,343939
5255dd583c45079b9e6571d32a28dfac,137,91,327553,80309,247244,159,122,405695,90127,315568
65cd3d91716c96b08da9ab3eaf85750f,229,173,1690777,217051,1473726,230,172,974745,196676,778069
ac76731258c0b3d230f2ce6b9e622080,75,62,147120,53017,94103,148,101,412202,41465,370737
9652a50f8fc3935b071d067251ff531e,66,48,90361,29639,60722,74,67,107279,38054,69225
62b0f66692aa6c409f9bd293235c4400,24,28,21891,8277,13614,26,18,16880,6549,10331
31922bf2c778a8b755eb29db1f15c198,97,73,146814,32590,114224,64,45,64855,31775,33080
097b53a8be2045166c540fe38585259a,92,77,186126,41146,144980,87,71,172781,58599,114182
2e441384f1d42bbf1c4ee3e066ee611f,30,29,24837,6473,18364,25,25,14798,9740,5058
d6c577f2d1c982c1def5236c2c7aa9b7,32,27,25501,10988,14513,42,31,29103,12274,16829
4a7853ae3be307121ccf7546b8d96fd8,133,90,359463,103257,256206,137,106,360064,104037,256027
3cd18032c02ccf5c7dec741bd3a83064,124,78,268871,62699,206172,139,114,262596,95146,167450
f6ec0fa904aa547657f047671e5b18be,169,152,588218,112374,475844,136,99,464105,123464,340641
5635b5e04fbcc8f4ffebd1fa6b6e8450,155,107,424314,55242,369072,121,62,231683,63475,168208
2a6d3eb4373cc1f73ca1b975995db55f,100,81,220325,35386,184939,83,56,154109,50576,103533
ffbc3f2e5e3c7b1a4352bb157ad8e889,95,75,207095,55546,151549,125,88,248639,44737,203902
f362a9ecd114a6d3eaf66a3b560037e2,76,62,135045,38425,96620,84,63,155042,27770,127272
743c6e7102cd94d144942a2349f73941,82,72,105783,34410,71373,98,71,153923,40052,113871
946f7db555f619d2d6ca3caee562c014,90,71,114854,31683,83171,68,60,104548,31419,73129
cb04a7ed53deef3d93fd94bcbc7cef66,53,49,51550,18827,32723,75,51,100118,16948,83170
7d09b88acecfbfe4269da383d9b4c245,113,93,326028,114074,211954,136,100,400790,81354,319436
1c098e83717f39187c79c5a6c225d986,3,1,147,14,133,1,2,110,52,58
7c3c0c6da56dd1c79145dc05fe3dc04d,136,102,535132,111733,423399,136,124,445963,123948,322015
f3b2ada1902fe71242fea7fa61120fa4,229,176,1036582,247338,789244,198,159,1182530,187918,994612
b19962a77dfa65a6512cd8b4a0a961e8,112,90,180453,33012,147441,86,67,122410,36943,85467
3a976295475feb1b4b4ecc1166c6da59,1,1,346,421,-75,1,1,421,346,75
b6eb14719a7d8758be288b50bf4c0fd3,34,29,26376,9634,16742,31,28,21785,7109,14676
54c426be5d9e540d31ee19144a1ba094,44,33,43815,22433,21382,57,43,60044,18183,41861
4f1801bb57391d0557f6e7c285b89a56,22,16,5781,2684,3097,21,18,5142,3913,1229
598d164a63dc1b489a98efd563ccc76a,119,94,244038,56283,187755,127,93,272854,50970,221884
29d62825bb89816675d654a0758d83f1,53,44,75205,16521,58684,42,33,45223,14636,30587
13ad2ec0ab0360387321c7ea3e7415bd,28,19,11216,4272,6944,20,13,7686,5094,2592
410f1bec3752916045a4d479857dbff4,98,75,192064,52968,139096,78,72,120300,54326,65974
fc407c2dcb5c49cb9a5358469f3b751d,113,82,263191,50942,212249,122,103,254126,40297,213829
e03182389f9a2ea808b2c57e380c86ce,27,24,21407,9390,12017,28,20,22334,7716,14618
fe0558fe1e86b06642de5e70456f5d54,75,64,108089,57270,50819,89,58,180717,25649,155068
053ff25d63ec3251a200e9a579f7e85b,116,77,257954,76803,181151,89,68,231564,56838,174726
5ca2c388a987c22a7661a2ecfe69e5cc,49,40,52548,16804,35744,40,33,37658,19763,17895
1f065fa8b0bb0e92ba21fdcf749d5737,60,51,77873,25997,51876,70,55,88620,25123,63497
8b3f4b831336d1b2cc0e963daa1268b0,102,83,195264,45395,149869,81,68,120332,49867,70465
a07b8625277614c2f0dca2587a51d1d7,23,21,9747,5272,4475,28,23,16099,3658,12441
d897a33d02ec95a6530db1eec8c50bf1,37,30,24899,9516,15383,35,29,21118,9509,11609
7117fa1f8877c78706480e921a586ea3,30,24,18856,5592,13264,27,20,13391,5518,7873
892c7c038c86c7a46190f92f553356ac,92,72,136171,32195,103976,60,44,94681,28746,65935
62e0d6c8f65dc16fc8735751ec388fc6,22,15,9936,4022,5914,25,18,15607,4081,11526
2b5106f5bb3a32b6339d83dd2f6dbead,7,2,1346,455,891,2,7,455,1346,-891
9d4f30540c3f98a45e347a3946ed71df,141,121,256795,77242,179553,89,71,199194,67048,132146
e9573953dc72c91eb5b8577fa9c77277,215,166,756497,137432,619065,206,135,600120,151604,448516
014ea4cde7cde50d69c7d671e59666ac,158,118,404583,77319,327264,163,127,350777,60421,290356
b1b5e987612744eda70cab0c258b9302,133,113,354330,83027,271303,118,86,219918,69128,150790
3773aeb56bb55ae960d658d74662e744,128,106,314586,81743,232843,124,103,296953,78321,218632
7fbc820056ab2fd4e43f2aaf7f426f35,109,91,203791,67486,136305,148,115,368963,72771,296192
b321a925d5d9409a277aff5f864ea323,42,35,55935,19139,36796,57,37,65309,16455,48854
7d450fa69cee92a0e14b71afbf251a66,145,112,296939,52123,244816,124,109,213143,57270,155873
8669f0e5ff48f57e64df6b294374d529,85,72,153771,43114,110657,78,64,108955,34894,74061
8ec51a28dad92d97453284c7332bf076,74,48,93904,25007,68897,68,57,102118,30146,71972
4d1ac950d06c3ef1619473e7676779b8,37,32,36598,10472,26126,47,44,58840,14820,44020
6819056aa74fedcb3e3490f888c0a684,119,95,421998,88111,333887,166,130,485246,111034,374212
db34f078335ea8f9bcbe3986d84031fa,61,44,73965,15287,58678,65,57,89246,24587,64659
1a09a22a4da7ed96796b5375bd5dd0f1,154,116,619465,113887,505578,175,142,536584,134526,402058
6289651e02dcc00334fdc34a6b2408d1,178,123,527217,84513,442704,153,122,501244,97960,403284
37bd24e7e4aae4f0ceb6328767fb8582,53,40,63126,23697,39429,53,41,60408,21898,38510
c5c128aa28fe44e8ea71d79ca722b459,6,3,1124,442,682,3,6,442,1124,-682
cb2c118abd7103ea230bf7e4cf6dc67a,31,22,15060,4333,10727,25,19,13743,3589,10154
3b1d41ef896d548915a28a9ca36ff505,43,42,58501,26682,31819,59,44,55186,23852,31334
08fb80423a79f6d88e3c60140a8b5c56,31,28,29870,11927,17943,47,32,40355,8976,31379
78c660a2545ed83307c280c155ca5544,115,84,368889,77947,290942,133,105,302659,89660,212999
3e9a9849d2841df89224d606276491ee,42,30,33438,17804,15634,41,31,64814,12556,52258
30936e796166c2196038bf9afbbf7d2d,202,151,958293,121745,836548,135,79,548303,134538,413765
380e36771d25c3f721b3eddc8db47389,55,47,81746,33605,48141,79,69,131576,28527,103049
7324227b4ae44887901d84a855a1479d,3,1,166,84,82,1,2,84,129,-45
50067a6366e8ea21b92cb90d61875c43,162,121,775680,162932,612748,153,103,731095,135892,595203
44e570ab3baa8ce87b0b23d8c9014605,21,20,11955,5091,6864,31,23,20911,5753,15158
f20755646f1383d8bbe3375df3e458d9,31,18,12446,4217,8229,26,20,17106,5285,11821
a7b2d9c7f2e55c62576df1f21afa6d13,101,91,192819,95052,97767,106,95,248242,58074,190168
d75b1fee14a39fcef3684db0bc1c13ee,22,18,7383,3332,4051,25,20,11271,3967,7304
3bfdcb14b974ec954bbc646a54048b8a,114,98,209683,29814,179869,71,61,67489,23577,43912
7a8a346b4c113d09ae8886820779b773,89,64,114153,31553,82600,73,60,116447,28395,88052
f9e6a6307e3f9a363fdfc27e4b43b09b,164,120,608176,124563,483613,219,169,1045870,158465,887405
17536de2e0256e837758c1fc6e859720,46,35,53699,21865,31834,47,33,50112,16545,33567
f46364635b56ad692a5d9ee1c3a60553,134,115,435198,100240,334958,154,116,377526,80879,296647
a46f4d9e72769de99bafe7a4b08aafa6,59,41,44394,12120,32274,65,36,38448,10001,28447
f9e6c11691971883bc670b6cfb02823b,136,94,200577,28850,171727,144,108,253617,28845,224772
bb5416f7d152e8e25c37a883a4f68090,147,93,379618,97193,282425,138,100,457187,96365,360822
8b5f71856e47eead79634189883a21cd,32,23,34274,7215,27059,32,26,18313,10965,7348
e3bb2d2fe2eae43a31e07c36f83b8bff,38,25,25610,9658,15952,35,26,24361,11073,13288
4ec01d2507ca571a896ff8f2e2261203,174,112,725251,214433,510818,193,159,839864,234115,605749
250971e4c769eb3f025f90bd53a0ccd0,26,22,13944,6134,7810,26,24,12195,7790,4405
60ceb4ccfe9d7145279557e23b8ccf39,145,89,279629,57504,222125,108,92,198034,58543,139491
d51e02c942e9de012f43b9a82e75abda,84,79,168553,38586,129967,96,76,171680,41896,129784
a31abd215d031bdc2f1e9b1dcc6fdb8a,139,93,351310,54258,297052,112,82,265670,75029,190641
b27c33427126976135c534039d934ef9,67,59,122116,36259,85857,103,83,167572,47825,119747
893c81df6e9497ecb528b3adaf4d9bda,158,110,365591,64297,301294,121,101,242120,100275,141845
e13af2f2f4ac31df2641d8ae9cd34128,37,36,40425,18949,21476,60,35,72128,14611,57517
2d43e8c9f58d0628340fb32a7cbc51dc,196,94,514157,106312,407845,152,110,473315,100837,372478
4ecdf53f0947037a493a4c5ed88b1c89,6,3,434,539,-105,4,4,773,324,449
0144d914ccb356cc8ffb7c3e547421d7,85,71,132157,35911,96246,63,56,106083,35245,70838
9cd0d0100cb2d96e3cabc27a9465bc1f,80,53,124991,31871,93120,72,52,99504,45040,54464
9af89afcfe9480e07a424966b847ac92,103,67,185114,31980,153134,91,73,157344,38958,118386
acfffe9e330306ca33de6e9115aef198,27,24,17125,5325,11800,30,25,15536,5475,10061
79c5fb02ee6f5983cab511723a187722,52,45,74167,24157,50010,44,38,58560,21227,37333
462213a0a293bb1ef843a554b1d1ba68,58,35,66215,17832,48383,48,38,56800,17907,38893
a315da71ae7aad6d0ec62d4c11f5aa66,94,80,180154,49239,130915,81,71,210496,44804,165692
39783fddac7c128c6c7e6d1cfb2728d1,43,30,36384,16579,19805,48,39,42964,16980,25984
44be860397a0d60d63bbe2e99dc1168c,148,127,457177,99793,357384,166,126,372445,115051,257394
d6e3dba6cd39826118b6938892103caa,159,132,623406,117796,505610,167,130,578463,120553,457910
cafd37459a856f288007f3a7900ee5e2,118,97,267042,55427,211615,89,67,227422,45908,181514
a5be868fe3d329b6fc0519122a4a0992,111,82,249848,66916,182932,94,78,186174,68480,117694
0bd7402482b10aad30789ee089e5fbee,82,66,141172,37371,103801,113,89,141720,60832,80888
52556cdc105003ccb634fef3809faacb,23,19,11136,4293,6843,34,21,18709,4364,14345
bf094d356b0f4fbcb5c31c8e2d2ad041,47,31,44369,13628,30741,36,29,24791,18871,5920
b989d17c23f6e0f7032ba544c3c6ef7b,81,70,121596,36080,85516,89,64,131805,26832,104973
c0d808f70cd0dd5940870eb64e571a7c,197,134,700427,94311,606116,174,108,598495,82140,516355
1f1011261201caed36ca6d9e402feea1,81,61,130793,50170,80623,77,61,132530,29794,102736
c13b022c81ef28ac61ce595b8a092bf5,128,102,286452,66036,220416,82,79,188100,90990,97110
b5b64256e4dcc6c1ec6469cadcdd1309,113,94,197224,46214,151010,80,71,110676,42270,68406
c28b1dbd3689aeee01d1c302b2e7388d,63,55,123797,28518,95279,61,53,72588,28194,44394
8b153c564bb392bd805fc89752ea0892,42,35,49693,11793,37900,39,23,43854,9001,34853
9368155fc1969f04d321c4ed9284e081,72,52,142100,31956,110144,99,75,177755,45035,132720
618789b134c730f7ca6c8f8a45c4ef4c,74,55,141192,32116,109076,48,49,55757,39536,16221
72f99cf28512f7dafdbc5a0f1436e646,70,61,64048,29286,34762,54,46,73040,23759,49281
6d0bc27acdaeaaf7d48f56fb68d937d2,137,95,350650,109112,241538,158,102,555137,112665,442472
879f2ad1c790d2c9991a33b2e2c5489b,24,18,15378,4831,10547,30,24,17762,7851,9911
a54d98fe2b6d32a57129eb9028711977,176,124,388100,85777,302323,114,84,251878,78737,173141
a91d765f675cd54d0a6fd81efa0f3da2,42,31,44444,11038,33406,44,36,25320,13076,12244
26b2b3c2252fe457e80eb660462a1e35,118,95,316377,77111,239266,180,131,482314,61883,420431
c877f5701d6b5964381f0564743d8716,18,16,2722,1567,1155,19,15,5502,1731,3771
49be2d4d774f35b566956a34160e44a2,43,36,55912,19490,36422,53,40,74939,16089,58850
d77742251a7f2bb43e8e7337f08212b7,136,98,570528,100903,469625,140,107,341889,120480,221409
3e6c7672a0c436b4345b8fc78860d9e1,79,70,142557,50261,92296,65,50,140122,31163,108959
f81c5e0e2d996b8bc00e86d7b9bc7503,3,1,230,45,185,1,3,45,230,-185
ca7243f1123caece7a029586f70d71b1,51,40,86616,23619,62997,48,30,46949,22809,24140
5c04dc60bef601fe56d6f4e122b65d81,160,120,469546,91012,378534,167,118,470027,92272,377755
02ecf1d1c0ea159701f6c9c3076e9af4,83,71,114893,31498,83395,93,86,127268,29570,97698
dc711283fc13d62ccb88aa08556e08ae,112,85,333802,62787,271015,138,98,346823,63039,283784
1e23425ca6b43f4feed582cab4583802,136,98,333984,75577,258407,127,107,384111,72239,311872
abbe67fd3a90a5dd87af4350b3708636,66,50,77474,30611,46863,74,52,105664,20134,85530
dcbb6ddd0c17608a3d4c583d42a58097,19,15,4727,1985,2742,16,17,2348,2622,-274
d1144d5430a3bb7c49ac9ad9726f19da,23,15,6134,2995,3139,27,21,9426,2621,6805
6a362d8f661d03a6074b286ce1b2144b,132,98,365514,88151,277363,174,138,511882,114194,397688
6d77f88af60159f50139b5dd6a88c54c,32,33,23941,10227,13714,47,36,38295,8133,30162
051f9d6dfb6bcd38d69b179020cf0835,28,19,12980,5506,7474,24,18,9553,6034,3519
66a87b2183c981df8bbb3ef233a391ee,22,15,8849,3747,5102,20,16,6969,2613,4356
2fd7b6f4d475347e3d353d133499fe20,170,131,634544,118582,515962,139,120,578097,110254,467843
15579a0a71a4fc45babc39bce8793925,145,122,468319,60046,408273,125,96,298459,78906,219553
27e511e3a4699e737732a452b6cbf43b,130,112,352717,73838,278879,136,107,371503,86748,284755
76e7b23f7d6d221ec340c12023af55f7,41,34,24051,13379,10672,38,28,37816,12513,25303
a03aea94c1425630ab3092b518cdf29d,153,110,451346,92867,358479,137,124,412045,129910,282135
9ae4195859e84747a2fe97804c0b74b4,133,113,254118,54959,199159,86,65,161989,57443,104546
d0c73d233bb0d2ff23a903ecd9d4ddd4,98,69,110433,31052,79381,100,75,122597,33095,89502
70372f61e0e93b605e87140023391181,112,90,226003,43737,182266,101,89,194660,58766,135894
1f707047676ac6b5012c9c676c9b67c8,57,55,72937,38443,34494,82,51,109170,28203,80967
04c8cb6f779e0a0185cc8ee42a1cb0af,180,132,441529,98965,342564,139,107,333377,89727,243650
833bb8125ae1e9bef4aa251b66fae165,50,49,48461,24314,24147,68,52,84902,25134,59768
080b2348303f3c667420292d49734619,52,41,85134,25947,59187,66,60,121098,37002,84096
081dd52da74ace9bfc7f3aafdcfbbbd1,163,122,418672,65580,353092,161,117,367894,60968,306926
e27484bdca7787db51331e56eab2e1c9,156,116,393608,78210,315398,111,95,353676,73701,279975
dc0f51321d10bc3f2f8beb9a433a2f4b,117,108,172311,57148,115163,96,78,154321,42323,111998
277fb928ead7244a2b84be393e4e73c8,109,80,228709,68036,160673,133,119,305181,67478,237703
32cd3b99a4082431d2d1571a8d2324a0,146,102,448087,150365,297722,184,132,599539,127425,472114
f65047c6c4429bcf6931d3208733248a,64,46,93177,22410,70767,74,75,108774,31212,77562
662b58768e930f7e2b423a373504bb30,34,25,24385,8290,16095,38,28,35365,9401,25964
dfbfb5ef2b87766433033933ea521d0d,27,20,8512,1773,6739,23,18,5738,2436,3302
bb2369bdf3f33b66634546ecfa9a9dbb,57,49,98348,37874,60474,75,57,99437,34212,65225
99f9a0601af77ef213af4163196629b7,85,66,76235,25398,50837,65,59,61383,18961,42422
0ea1c7a3dba97697c394be56d25c4071,60,43,83615,39158,44457,75,64,139000,32978,106022
78430b487d89f706a88fe715c87ba9db,26,18,12920,5851,7069,32,22,15984,6239,9745
85a87efdfe956e54fcda67b1fedaf98b,196,155,756436,138710,617726,172,138,637633,128006,509627
9546960f45fd05db3762f5970ed7e6b5,82,68,175033,36600,138433,60,54,92249,44766,47483
38074562cb4a6f6ce7432c1cdbcdc58a,28,22,15427,5340,10087,33,25,14434,7495,6939
a7cc72cb3cf370211ede2092dd60c399,22,18,5869,4268,1601,23,18,7071,3741,3330
aed4e24c2614a8d0b9a115b9fbd772f4,26,29,12995,7267,5728,31,29,18911,8303,10608
1b6963b79fd3f1d16a8f28c8de3a65f3,61,63,88738,35897,52841,78,66,109185,38936,70249
6c966c7da0c7c699acc3a7ccf40c811a,55,38,72715,26318,46397,54,42,82558,22651,59907
ae9090d27ca632fe5af8405c329e45a2,148,107,323855,80107,243748,146,112,371573,81064,290509
0def8e3b9da919e05d5d68b340210d1f,44,36,33369,10482,22887,35,32,21366,12178,9188
cf671ba7c559642e51ec9f624dcdbe6d,94,81,203912,47107,156805,94,83,183297,47934,135363
0ba1a7d0f641237e53cf797ad0e4b193,68,50,89080,33139,55941,54,45,63548,29660,33888
73f56c5796088d14e4d9b8f705662d0c,16,17,4207,2749,1458,25,16,5103,2093,3010
6c2f44c54971cca94c9e8716cf6d5dc1,84,41,151077,29647,121430,105,70,176699,41262,135437
325daa14b70a030151e8fe766473bd27,24,21,15263,5531,9732,28,16,13064,5061,8003
017ff740c091a25a7cd12c761271d92c,178,110,743907,148640,595267,197,146,1153724,147978,1005746
961c553f192ede4c2ffe9f7b72254bb2,71,53,85210,30171,55039,63,53,78221,29334,48887
4951e9f82d2dad2c087e062bbe0200dd,63,41,64327,17218,47109,75,57,85357,23826,61531
78dff2322b1836f7263d4c6ad6a20e3f,62,54,71509,17916,53593,43,37,50173,15955,34218
06889ecd72ba984a20f636d3e2f18d5a,54,48,101617,31943,69674,57,41,78793,28171,50622
59ba056345fa87b8496dae8a2db0d97b,105,78,195771,53772,141999,74,65,146040,62646,83394
8b0be209d0f5a1de48ead67d1429fc1a,127,102,388296,93502,294794,129,95,398749,102984,295765
3abfadd8a3a7988353a606979154290d,44,37,40841,12183,28658,48,38,45237,16568,28669
10194a36c43a4218b7c1f6c1b15421e8,117,85,236433,51511,184922,87,73,175585,42538,133047
4031eb37d84a79901fb0506d2898ac7c,29,27,23364,12280,11084,31,27,23562,11751,11811
29e37cefd562bb05500d2dc1b022b93f,45,33,32528,12000,20528,32,31,33350,11311,22039
acb1dd6c8d1d3b2a64dba84fdb2c57ab,29,20,20006,4681,15325,25,20,14113,3142,10971
0136ff26f5f6063694211852353e6dbc,39,26,32244,12361,19883,40,24,27264,10914,16350
0213f484f537d5e895a63b1b2cf78471,62,53,64583,20738,43845,87,64,79805,22542,57263
5f227a400e04d47b53cfce8e49eeff34,18,13,3461,1885,1576,15,13,4686,1448,3238
2a8d8241dfd10c1013c0adfec6e8bd17,193,125,1132105,124818,1007287,225,145,774884,134535,640349
7dd61020747b703ece9889d053d38755,90,84,139975,29690,110285,74,68,86906,25487,61419
4a55f44cb86e78fd7fc5ced2de2c10e5,34,24,35557,12635,22922,28,19,25896,7594,18302
4cc918026d6c64171c5c97f6cf8582de,77,56,111406,19472,91934,89,70,113999,28425,85574
75b2f1e278173c52dbdb0697c9788fbc,9,9,1153,1279,-126,12,7,1558,624,934
554c8288998913d538bc9a5ed620e569,191,149,800654,145873,654781,214,169,968803,183801,785002
f8adbee4d5966c48044e769814055fc4,170,147,554107,101605,452502,147,111,323459,75542,247917
06fa8b8f03de4035fd997fec3aa5122e,108,78,457137,97992,359145,118,98,374831,96982,277849
2cd2e7047eda887a38153bcfa5b1e6b2,39,30,37190,12694,24496,42,32,41443,14179,27264
1293eaf61d3706b6eb0b57a038020f58,120,92,219419,40738,178681,102,76,184821,48762,136059
ff1c85c0240dae69098acc65aa41109e,204,165,750658,109614,641044,145,110,447426,136669,310757
bc7f08f36e8a66253d5249a0560d8945,180,128,681405,114431,566974,214,158,853186,123781,729405
4f696e0b8da30fe3706602f52283d371,192,129,697279,121125,576154,164,124,925749,154400,771349
e8233a177b80246a62cd62af7a840b77,135,103,304812,86487,218325,90,67,281313,105301,176012
fb8c218f56f730c0ab05b4ff1f407614,20,15,3918,1347,2571,16,16,2261,2841,-580
008348dc6558923096f8b93de38489c9,3,4,586,385,201,4,4,385,598,-213
8aa3383e155315e279bc5c5fcc274a6e,45,35,45635,16739,28896,47,30,50387,10831,39556
260bd4a29cf1b82806ec0e1573dd0628,98,68,158127,33078,125049,112,88,190791,55668,135123
e25c1b47a4cc17c2319e01bf1100bbea,162,108,397012,74714,322298,180,115,471853,63983,407870
ddf5703c1d30609bd442e3bfb1996076,81,57,156829,34839,121990,58,47,96523,37268,59255
ea694123f433ad059b59b7db77f896c8,35,28,22772,9320,13452,28,25,14844,9463,5381
a944ec9d012eb8b248129512f9da127c,21,14,6292,2954,3338,19,20,10926,3327,7599
7cda63a10936bb6d7d5e08e8d30f4682,57,51,59739,24065,35674,75,52,69137,16932,52205
df09d818c893a04783d1000e08f1d483,84,60,130090,28262,101828,101,77,199744,40275,159469
e1cccfc77a11c6ec0bb459a49d533d8c,63,47,63194,27291,35903,60,56,71121,21446,49675
864ac7311c661d34d43b92e1d37ce0e8,23,23,10776,7082,3694,24,19,10389,5960,4429
27e53c5268864bff290dd7e90fbe0615,172,124,422313,69522,352791,132,112,321159,86295,234864
a6666ceaccd1f660732561981ef2724e,32,22,23578,12526,11052,29,21,25717,8188,17529
9419802d3d23d733ce48cd9618647514,124,114,417894,79458,338436,159,122,413769,80363,333406
46c69275a2faf9ee4b52d3b353cafa87,118,98,271957,71019,200938,120,84,231562,58644,172918
d06c9343645cfa32b8bbf5caa78f8b6b,120,90,289751,54567,235184,128,104,254287,88940,165347
6df86f3b34daafdea24648eecd256d63,25,21,21142,5720,15422,18,18,14306,7321,6985
742c092fe02172e5869a2ed1a20e2129,87,56,123367,33134,90233,80,68,125006,31107,93899
6878e6291df9056bb957be69286f50f4,120,108,250723,73222,177501,110,82,211912,65198,146714
05720d64dc1cd1ee8371996757dcedb8,77,58,109133,21502,87631,70,60,84038,32755,51283
481a285db97f50460175385dbcb42943,149,109,414611,60878,353733,132,109,493292,114919,378373
4ba1b58280b0594f033c5bb24a247fbe,96,71,317584,61400,256184,99,75,210909,79028,131881
a84c058593d667976aa9939e41791cb3,60,50,81807,15625,66182,58,42,55351,17454,37897
412a74a13346eb0b9962f6858edcfa2b,89,71,144889,29681,115208,99,88,180756,34293,146463
057470259a8c94bb9943e480df610aa6,71,56,97276,27596,69680,47,40,70523,31483,39040
db22ade92b2e8779ed6b00b098368bc3,109,74,232611,47991,184620,71,55,188936,50167,138769
ab2bac4850bb221ea425362077a1f5f5,167,116,318891,89343,229548,145,111,326168,76944,249224
5af869cfdab174dc49710305b8276b05,185,142,1095799,215685,880114,186,145,822209,221645,600564
ab1b37e52633045e883597dddf796fb4,79,70,146791,47521,99270,125,89,228093,50869,177224
54fa581c1c9466735b37332c595ad30e,14,11,2835,1378,1457,10,7,1757,896,861
718cf73c58bd77be087c8eb03d58ff35,153,111,581344,89539,491805,175,142,586101,86008,500093
cd7c33870ea50e8452438c1fbdcc2e2a,77,56,155278,53580,101698,120,89,220265,81056,139209
442acd3606833fc85ff69707cc5f9aad,148,91,338775,67097,271678,86,74,247989,47650,200339
2804fb682bb26427adc9ac63e5e4aee5,153,130,524640,134238,390402,197,126,594017,153076,440941
8cc489429dd844b896aed8a3ae482240,82,49,136127,37347,98780,88,66,176961,41567,135394
5463eba837bc4d6e6909667677b5a641,156,100,425886,64275,361611,129,105,253150,80459,172691
3257318d4faf825145f3d6ebfb113193,105,73,201540,38360,163180,88,81,133916,58199,75717
a5bd6e72b2b8c5608c94fc12e5896ae6,43,38,45755,17843,27912,58,43,59636,20384,39252
8639171438ed2284517559ccd23a06cf,111,92,235468,47468,188000,119,105,231085,78923,152162
3c6aaf761d1a23ab858a54320cf2faea,21,19,13836,4488,9348,30,20,14409,5697,8712
d60870ee765c8048e8ac35939a92dc5e,158,100,311735,52913,258822,133,97,266317,90871,175446
0a31a7c3392661f761a7f31f9b928dbe,113,87,321754,90309,231445,176,141,498341,56290,442051
a43ad999113388e11e7037b3a83ddf20,39,24,51346,10507,40839,33,31,29049,13181,15868
cac95f1ab4369d50f4a82223b088326b,59,46,70054,19846,50208,42,33,78671,14914,63757
59339a2b49efb00719b758c1f8d145c8,136,110,347815,66064,281751,134,109,376221,66702,309519
2b09c8714e96131febf75abb2e4fc68d,43,34,40378,19550,20828,55,46,77942,22400,55542
6a27ba3c909bb114415cd4ddfd4216f0,48,33,53730,22376,31354,41,23,76271,15468,60803
6cabad979d3f4ea4cbb438f80bd06203,74,52,88126,24866,63260,68,58,94085,31008,63077
2c2546d500e28144218da9d317263888,91,85,116679,35284,81395,82,70,97772,40230,57542
47682e644dbac02145e4d094f36e7812,109,95,263393,62102,201291,131,101,310670,66340,244330
62782443f34b31cb9f682b5dcc8e0775,58,47,60994,16294,44700,42,35,34982,14893,20089
60d3d09e663c0afed111bb542b03f0ea,37,30,29238,12040,17198,35,33,29280,13246,16034
f7e1722147329d75f1a9fb8650833f43,106,85,174575,33454,141121,79,60,116244,34090,82154
e7796d96aeabdc9697c3cfaf83db82b6,96,80,182495,48721,133774,87,66,168371,49204,119167
57c56d44b5f8c37bd6b5cfdd1df1351d,38,28,45507,15408,30099,33,25,38623,13774,24849
a1add31fb7e7e843a4c62fa675670fb5,1,3,30,355,-325,3,1,355,30,325
d8d1973722cc5c38a9b80baba3ba0dda,50,33,49929,11093,38836,36,31,36714,11872,24842
28c3e81f6cd35e256879ba11c599089d,92,81,189678,49747,139931,97,68,195872,39408,156464
5be2856b05c59f5b9bb5d51ff931c623,111,79,226329,43849,182480,131,113,286950,68312,218638
2dcf4de88e82013e6be281cf8a40cd88,219,151,949489,144101,805388,200,154,760760,154035,606725
7359bcc00e2ed1b1d0acaaab77058113,127,104,304743,63654,241089,115,93,243200,72100,171100
8c5a83e52003eed75f404be3ccdd7115,121,71,211018,38239,172779,112,79,234865,40140,194725
180d1c06cd0e454996136b40a655eff1,1,2,124,224,-100,2,3,224,204,20
e6ef3707b378b4af795e5c982b32fed1,154,124,281201,60875,220326,119,87,265002,53164,211838
d63a263531c7b19050095ba8b1486bf2,132,113,301580,93017,208563,122,102,339980,87493,252487
8d01627551d95d732f510badcdfb77ac,103,76,272671,74200,198471,105,79,214192,80140,134052
e1514b3820d1a2c1d7e3b781ea057ab2,97,76,164381,35926,128455,122,81,245954,29774,216180
7c0cffc7299cde336088650e422e378c,46,39,56858,19592,37266,44,32,52977,12474,40503
a32ea5adf3325111a350362fcca70360,137,123,430713,90811,339902,190,152,562854,77646,485208
73ec9deaf0c79eca6cf68ddb4e4b9d16,100,66,185611,35421,150190,98,50,143560,25253,118307
5d69f3e70d3c154a6b80661b6daa1a93,38,26,32729,6989,25740,47,33,51562,9196,42366
bceab85b26ef7fd4e7843903a44dbfcb,84,62,118102,25902,92200,99,84,161181,31821,129360
28e5c6d022e33aa5e5c59ee2ee3f0159,92,74,181368,59358,122010,103,77,184062,37868,146194
9433e85c00e3ccf10e910fb1fd8d8380,148,106,636276,119457,516819,148,115,692367,122706,569661
5deeaf5303435971d1daed9a4977867b,97,76,180065,78167,101898,123,91,281684,79584,202100
6aa0c3012efd8aed5a4b9b8538e1a5f0,139,94,313626,48172,265454,126,108,277742,80360,197382
6e8318526786a31965df282e3f78a6a5,26,23,19292,7630,11662,33,25,25797,8153,17644
3180bb1fcb20f81f81bc6396a769e4f4,141,106,345451,91105,254346,116,86,260003,89680,170323
aa5be112e26585378b78a3e4a894d792,109,68,224244,66723,157521,99,85,205314,73972,131342
1ad16393edb6ebd8f3668ff3831a0cb2,44,31,52214,11508,40706,56,39,50115,15456,34659
3b0a04c91bba3c8b841387e574d94320,150,89,369183,90613,278570,162,121,443107,94578,348529
3990afa90583a8a3a60ba97c2a6e0913,21,16,6975,3618,3357,20,18,7502,2571,4931
1a42f6101832a6e1cf7a5c6d0748452f,124,90,334243,69568,264675,141,105,426421,80712,345709
d8396154841daa2f8613fc059463a875,176,113,358592,85875,272717,153,113,383409,80548,302861
f5a89baa49939cc73e37a42158d0d19d,27,14,19197,3880,15317,26,21,13252,4794,8458
5071de6112fe2726338f54475a861679,53,40,62564,22527,40037,53,41,71394,17069,54325
cca7d2eabcd611e3c42efb5987c81903,99,69,154109,34882,119227,90,65,145739,26395,119344
9b9d31d704854be8369bbe5382b10610,39,27,26440,9316,17124,33,27,39552,10484,29068
beb8c30242851101642709056c15b899,53,31,45556,23904,21652,56,34,69553,22796,46757
76743db1979e062b0729c00241ae10c2,54,43,43654,23914,19740,58,51,59102,16482,42620
84fbb1a2d37bbf25791c57125e8c0f18,80,65,170316,59303,111013,101,75,199787,62296,137491
a996367a0ba915ae643c6a95ec9c4d7e,64,48,64280,29957,34323,72,57,92136,24541,67595
0f7a62bc538f737085ad50acc37534e7,134,113,321853,99617,222236,75,59,234192,63251,170941
35ed381eed82eb9d1d6f457748ff1266,66,56,82538,58396,24142,110,84,254686,48785,205901
607c757ca71d71aa1076d00b7d5dd48f,100,87,184619,57053,127566,85,74,172389,41531,130858
5cd9480fdd7a81ef9f110c71c5ebf88f,47,35,45106,13030,32076,39,30,43374,16671,26703
ea8b8191cc603df56dfccf0cee75a89a,92,60,218061,37712,180349,82,67,181011,51966,129045
df5363c653cf02fc1eb46e22e89724a3,50,38,52751,12817,39934,62,39,48608,14647,33961
6f6386913589e73df706e0fa9f45d4b2,143,102,391617,103120,288497,157,113,556468,121276,435192
07e614b8f2a789b1ca63aaea5fc78b07,114,92,257130,39312,217818,103,84,192591,36770,155821
6bbd33e481a83ef7226deabbd82b7a80,134,129,385458,77944,307514,144,117,424298,78417,345881
35cda216939c6b407568929f3ee31f64,4,3,921,633,288,4,5,681,969,-288
a660db88f7f58ca3bd4159f827b66a03,140,120,327224,65347,261877,121,105,285079,53831,231248
ee16a74445d6cc8334c27c123e7a54bd,129,96,320384,51007,269377,129,127,357410,76799,280611
5031bdd140ff57d597d17c1b1f00d469,29,25,15499,7075,8424,26,19,13503,6373,7130
8dd687110a4356e5dd5f28ebec392def,79,67,139807,49543,90264,109,98,183565,53389,130176
ebd87b5e8640d753d0bdaceeab87d7bd,161,94,542161,113730,428431,188,152,687097,171646,515451
d899adc62b1ebb3b53e0892f9638c65e,73,67,117686,38666,79020,69,56,119233,33528,85705
40144b6ebe57e185b440b8b0435a55ea,81,59,144688,57207,87481,99,80,222041,45793,176248
17d2da572f574b1226021cf12ebcb44e,92,78,169118,46177,122941,90,71,183550,38911,144639
920d11afa753370ad0e407096e64b045,42,27,33738,13354,20384,43,32,38640,11423,27217
eab478ac867ffbbf236b79eaffb4180d,51,45,59669,24693,34976,55,43,73134,24026,49108
a1cee42687784949546a5dc5772e52b3,150,103,426361,121234,305127,101,75,393501,88858,304643
1301e872bffac38f7b5f89130960ffe9,62,45,53508,18601,34907,50,43,58034,18887,39147
ce136514a5ded5c0f0278cf7f3162a3d,116,92,265998,74543,191455,143,113,361802,67287,294515
bb8346d552b0d9734b46b0065d95bcca,124,90,208688,57301,151387,93,66,159048,50541,108507
dc5db5fbe8d69af585238427b6e9b5f7,106,85,214919,36641,178278,104,89,191905,43825,148080
901555d3844b76b1733afe967554bb2f,82,66,230667,52118,178549,140,115,438923,67914,371009
c5e2fac94489f50156c5650a05f017eb,51,40,63992,38023,25969,87,73,121252,29627,91625
28e0763a6c417a3d02a3cb5292594992,60,52,75082,23205,51877,55,43,60388,29791,30597
e95eff1ca3ab3fbc62c003338802a894,45,33,37430,18745,18685,43,31,42699,15090,27609
f1e17067f8cec02481d2b25e2c2d7138,38,23,28798,9552,19246,33,25,28731,9456,19275
16179c47ae09ef493cf46f71e917f567,32,23,31661,7883,23778,30,24,15853,10936,4917
8fa134ff3d25fd10b03ae2e56c39d177,106,90,252135,54208,197927,109,96,290750,69014,221736
584c569ea0a25060b0f2329d85afd802,98,82,136872,24027,112845,51,33,78581,17003,61578
bea8d88fb37d84446b00df5cef9ecd7c,17,16,4366,2441,1925,24,15,3921,3250,671
623ba1f1924b9f7bed94712de4f81301,24,23,22850,5283,17567,22,19,15957,8218,7739
86bbdfc30a155189aca7ea7d6fdd1f21,123,86,317493,119837,197656,185,129,466574,106238,360336
a998259afecbc8115679b112faa3f147,24,13,5467,2795,2672,21,14,5491,1787,3704
3ff4b02c2d06c663c57219ed9b0f9b50,86,64,142138,38403,103735,78,69,124623,36880,87743
e62f2ea2accc84a611429a3d57415ab9,139,101,285949,68268,217681,99,82,210059,62575,147484
7de66880628acc510f1b839246f9af3e,34,26,34498,13833,20665,35,29,24252,16565,7687
e08f56844400cb0794bde51cba87a30b,190,146,789395,118870,670525,226,162,954601,113909,840692
930a6d077f1802a6c7ee547e67e860b8,39,35,24854,10073,14781,36,24,27203,9369,17834
d43666b9a356d07a49e16002eda26cc3,66,57,101551,48334,53217,97,76,160831,47294,113537
9c5da25e6e2e55b3f5a8638068be6e8a,32,26,26653,6462,20191,47,37,35187,11384,23803
358aeddc7ca4895449f54bf27560756a,27,20,13621,3906,9715,29,24,9369,5736,3633
5439030d2f7e3ba8f480fd6243f78fd5,147,122,441843,104567,337276,119,86,325300,97014,228286
ddeeec150c526572ddfa8d8ac2af27db,19,15,3022,1741,1281,17,11,4708,1094,3614
aaec6eb0be4a37c836d3ad5effa2463d,94,72,210046,47510,162536,78,61,143054,40605,102449
eace4ed35bba304da43e65f7f9a91251,136,96,352981,84463,268518,111,98,393976,81048,312928
eb3e3f38890f3e95eadc3873995377e4,20,7,3006,451,2555,11,7,1831,875,956
3048e6e255683ff82e32e90e3cfb9f28,25,22,18790,3087,15703,35,30,18899,7887,11012
5ed56443865840b12a6357223eed2042,88,62,109371,28481,80890,89,60,147724,29197,118527
ae2555ffbb95f2b21b97679ea8dc4cea,179,123,610959,111724,499235,140,127,432436,147491,284945
34c16651ab083d961f77629bfa4f2811,26,19,15773,5432,10341,26,21,14049,7164,6885
4dfc4e006aedac9fe3bb3909f9e2cf70,35,26,35925,11290,24635,32,25,22607,11135,11472
89161abf41be3d645508ec00aaa30e56,72,59,79398,22672,56726,54,42,87458,21831,65627
b5d482229cbe3e8fb0f3c86f62f74d70,80,65,170948,62861,108087,111,87,293410,88493,204917
0644081b34ac56f6b6833b5fdfc69e1a,190,146,621245,97377,523868,173,123,562097,91401,470696
947c48d1a8b73b49c4f73035fc3cded9,112,84,320350,48569,271781,172,95,292958,49088,243870
bae566877daf93ac90db4605b7f41ab0,34,29,45607,20047,25560,50,39,71498,21370,50128
2128e86da643677a47977c7b90124ab5,50,40,70387,23771,46616,68,59,88166,28603,59563
a0ff252df5648cd30abf55ec3a4e9067,181,119,568777,145218,423559,187,165,755781,146516,609265
4471bfee94179aae72c1453d66c33caa,182,158,706287,142830,563457,187,163,759953,143508,616445
ae85122413856267d3f40c7c28342522,155,93,370863,79388,291475,135,109,307410,76716,230694
855d741e26367caf8dc7c87cddcbbfa1,111,95,283968,71477,212491,134,110,319759,91192,228567
5cb90782d7592e244477396f069dcc92,42,39,45266,15896,29370,46,37,37339,13823,23516
ebf663d29a82b7d9a545549752e06f03,24,24,14160,4501,9659,25,13,10680,2424,8256
05458b082b94ed38715cbfc45b543c6a,113,76,178145,44156,133989,107,90,197771,44698,153073
4687c2c3be1797d9c3d90def1e88cc96,94,64,243831,54550,189281,140,108,298715,80421,218294
e2f31de3a9a73ab56dddfdd76bfe1e2b,116,86,237796,49880,187916,125,79,255918,38363,217555
d330ad5a23e7fbd3306d6970b31c2b33,23,20,8133,4486,3647,26,20,12090,3287,8803
a57f905b27d99e33124d480dedb9a1f9,137,100,278719,66112,212607,176,96,345167,66525,278642
a28f86ee8639508a315b732a3a4e5161,80,68,121883,36190,85693,84,68,120205,37340,82865
d8181451fcfd2918a3159fd0e768c61c,34,28,25624,10849,14775,32,27,27285,13344,13941
f5174e7508092b17053832c521e4c78e,142,106,401351,93487,307864,149,115,476543,84041,392502
8e3db4ba6cecbf888df63422aee8302a,50,40,38263,16163,22100,50,33,47274,11671,35603
528e074a0c0b6ed9fdb3ca0bd3aa9655,25,21,8895,2051,6844,21,16,5546,3254,2292
0c3769a8b63af797d34ff543bf5c0f72,32,25,29864,11101,18763,33,23,22414,10202,12212
9a34b95d74989ebf1f777095865fb7c9,134,96,279862,54311,225551,133,98,235026,55509,179517
f2aaadc00620176107172d11e94901ac,40,30,52432,15572,36860,34,25,41314,19646,21668
11662ba323851799cc30385291a1a60b,86,67,156267,38925,117342,68,58,150615,45219,105396
5a88f045be6815f3021b37f9d96ddaf4,44,38,31861,11459,20402,44,34,47622,9708,37914
1cc2459cf51dd0a081b7f971f7758d0e,126,106,243933,54437,189496,126,102,260762,46003,214759
47a4d96e2f753cfb9c29f5dc81ef3412,146,88,500216,145448,354768,161,130,677101,121924,555177
ca48d42fdb7c0c281838a5e03a22380f,141,121,407201,107277,299924,159,114,380903,117634,263269
32181246b222ee2eaeed84c2189fda6c,57,47,90943,27438,63505,63,52,56756,25724,31032
6d1bf38e9227eac3c7892e8012a7020f,125,91,237701,51422,186279,148,103,298559,54035,244524
4e5c4b341242955be15258fa672a8cb7,185,129,370335,94455,275880,120,91,246074,94254,151820
ed3bd772616ead04aa9e540040491169,66,58,89978,27425,62553,55,42,66907,21580,45327
a0f51188aab1d39dac61b4170ce32a53,144,122,247130,54799,192331,105,86,155363,43047,112316
3ec6aff40e5ff60294518359e07ab7dd,31,31,18631,7899,10732,32,24,25452,4807,20645
2fd4484647cc29194ecc85287d05ab13,26,22,22243,8836,13407,29,30,17981,9548,8433
0f25f5ade9b9cc56ac5b2ff3aed2bac0,97,79,159490,46762,112728,89,75,152178,40502,111676
fd713e3d59554e306ea31b22d2ba5111,116,97,321128,89068,232060,136,95,339690,77438,262252
45631eae5733b9a8fb2b5ae4692ded2b,61,46,96066,28419,67647,47,32,62091,12193,49898
3f46e82a02ec9b1e467e49a14e6c8675,191,108,507021,115963,391058,175,112,545743,136878,408865
19707ad5d316028b7e9e1b0278d39f49,39,32,30465,13604,16861,36,24,23624,12227,11397
1aa4197f60866868be75d48023a355ad,160,122,358208,117903,240305,130,81,346934,86760,260174
670897e0acb1ee0b0a842842fdabda0a,134,112,376144,97758,278386,168,135,593466,74399,519067
fbaed1045d43fbb469d2d2dbeac38321,144,92,441808,99353,342455,182,131,711093,96828,614265
e8c1beed8f77534a2a034fc41e1da31b,55,43,47419,15403,32016,43,42,41753,16641,25112
7a4c57028c0b4856be2c37a645feb9d2,63,49,98698,20572,78126,56,46,56194,24315,31879
5492fca767a3b4eec6a76eb5432a8627,3,5,628,433,195,5,3,433,628,-195
9a969f92e8579f6e0687de513532c5e1,61,55,116692,31537,85155,63,51,130923,35869,95054
c9336efa9fa1481325040c15214cb4c7,109,79,270831,71110,199721,118,101,338565,54620,283945
dc4c38e6450c3f41502c3d6a053b17b7,88,58,192458,87243,105215,103,81,298957,87944,211013
7bfdb497cc365070d52334946f07f276,180,158,576941,175144,401797,185,137,668975,154350,514625
ccd201d0bdb6e47962f65fca5695da97,40,27,49840,13478,36362,34,30,37426,16901,20525
c32ee065874ac646fabf1606b4382d71,88,82,185929,53025,132904,77,52,161590,39538,122052
279d88db00af5e96c1ad5e5c817f9634,46,37,54259,20626,33633,50,43,51937,18700,33237
db01062b05982cc0a8e9bf59bdbaba4f,11,9,4714,1571,3143,18,9,4801,1627,3174
c7532721a3485631fbc0ea9f1c5db2ae,83,53,84358,31851,52507,92,65,149318,35129,114189
2ec3d758b35b3d0cac97596d44ec6f74,30,24,22956,9192,13764,44,35,32157,10185,21972
e2f0270ca50ef4b28f95e88467dfcb3f,37,24,39955,14198,25757,35,33,45930,16750,29180
95cbecc008a15c8d4dec5541f9e34178,185,119,760911,94157,666754,165,150,599624,209953,389671
c1c419646baa3cfc157520b27d03f62a,19,16,4271,1831,2440,28,19,6718,2327,4391
9330f4a15149464a900490c4973fd059,172,121,492142,90190,401952,115,90,324814,87612,237202
6d498bf27c839d87573bd7a02a6c053a,60,46,91694,21276,70418,87,66,100604,30345,70259
d632e7ed6518a05ee0c88059ee566b7f,42,39,47943,13487,34456,51,44,52046,13288,38758
372bf412aa5ff193ee073c0f9f719a1c,35,25,32111,8807,23304,33,22,23970,11426,12544
1183a152cca36eadf2a324495e7f10fe,152,101,415326,59222,356104,157,125,358689,80491,278198
a79cbc12a3ae5e3f0ef109624beece34,173,145,903551,131384,772167,228,169,760454,127343,633111
43230b81cff60c2ad53c32ee104aea72,135,111,343395,55598,287797,142,117,330579,73299,257280
abd2e338c51eab327d13a53d99923347,134,93,205930,43751,162179,99,72,182307,45413,136894
7d9124d59437ac64e62f9cfb6cc7a692,67,50,88059,23258,64801,70,56,103476,21218,82258
a98bdf52aef9f17f2b0eb6deda3e4536,123,87,332892,102764,230128,150,114,439852,122885,316967
0cf40d909f071adab07ae7130725d293,46,36,52332,28959,23373,92,67,159460,35252,124208
f185c663e238965b54006c5062f40db3,21,15,8369,2829,5540,23,19,14045,5457,8588
718148c74c660ec90339c4adbf3be199,94,71,148627,34426,114201,84,63,126116,31735,94381
a57919e8eb719e3bbd7156da04002d0f,65,53,110268,41531,68737,82,61,142994,31008,111986
4adb6cd7db37c108aeca589177fca8ef,17,15,4687,3425,1262,19,15,7243,3003,4240
ece7fbee4a4aefbde3c12a8154f35bcb,108,68,190662,51416,139246,120,105,305088,63579,241509
35355bc046e1513a97321dd4320280e6,147,109,320229,83475,236754,136,92,264116,76930,187186
c209f6c55fa1d5461dcaa23508dfaf9f,44,30,50361,14639,35722,46,26,38601,13281,25320
60c1baf4145393d60222895f74ed3f96,94,77,190205,63003,127202,140,106,273424,59206,214218
ad26a1e7ccceca2eb772056a4cd8e482,169,125,614783,92952,521831,158,134,670019,158410,511609
6fe26124d641fa6ad20a67c4de0da505,70,56,118688,30247,88441,66,41,74759,35212,39547
1e955e45c7c0c19c582394e92913cf88,104,88,218634,46853,171781,71,63,165918,64968,100950
80a0af81bc712f2851bb38a67bd49499,142,106,418137,55598,362539,162,123,352411,45961,306450
f7771f812bb1cba935caa7a53a075570,28,22,11520,5331,6189,21,15,9245,3995,5250
3e3d9346b81a160f3df0cf05d47b4bd2,125,111,348861,62362,286499,122,106,351327,70962,280365
aa0488b857f0cbb4c20c22c45e66f27c,27,24,14849,6799,8050,30,24,15097,9622,5475
b2bdcb9ab0c26deae14e824d2f5eb8d6,139,95,387972,91456,296516,136,96,416072,102492,313580
413916b4ba88d874585e7be72e587308,25,15,7596,3239,4357,26,16,11032,3848,7184
caac3e472396f2f01c09385064bf0519,49,35,86273,20591,65682,56,44,81528,27974,53554
9ca818f5d8550054f877042d35d3f3af,150,104,355511,90996,264515,188,139,528263,92190,436073
69d095606a0048d772c59d84b4c9f2e0,84,65,176882,34473,142409,91,79,248053,45581,202472
cdc47dcdf200d4ebf63afcb7b13346ac,134,117,440338,109164,331174,139,114,434736,81800,352936
8d6c5875e33175cbba5a87955bc4428a,197,140,983139,136832,846307,161,133,810716,145384,665332
be0efbd572622a802d30fc4f0cc87cbe,104,91,263479,79788,183691,102,72,235410,74233,161177
1d2305481675dc170b10a30964a985bd,156,115,408529,95519,313010,138,98,331722,94205,237517
443eb405d17c1f5e133b72036f8ac987,86,65,172476,48204,124272,84,68,157104,46239,110865
f1c5fe6b2143d4d0371b0dae7844febe,115,101,304295,69788,234507,61,54,150832,90189,60643
2da327c3f8604013539f07ba3aab8dae,30,25,37473,15973,21500,30,23,33492,16101,17391
f82937805db7a259d6194b800bf88ce3,55,44,68417,19415,49002,50,35,82734,12647,70087
b509ad630255d3b931bb267c198274d4,100,81,140928,52530,88398,107,79,211691,60433,151258
55711bcc988ba766ca1f85428f3c1f8f,67,62,67745,19277,48468,46,37,50234,15248,34986
49e375acdf58f852a17657bf17ea285b,2,1,132,47,85,1,2,47,132,-85
1ce71286e1c313aadf8c32a4c442fa7e,69,53,58751,18104,40647,69,52,88098,16203,71895
ee1a0eb00adf82232251f2208ac1a634,70,58,139317,42242,97075,81,56,120058,56495,63563
dc7da7b0befbb0c24d9a0d1501c768c8,10,14,885,1470,-585,12,10,1425,761,664
a77405de2ee5e659301ed21dfcbc9a8e,151,96,504357,87077,417280,139,110,434189,93223,340966
a7ffb315e181e38dff70968198cc9d78,149,117,430563,156108,274455,146,111,533455,120252,413203
b5a646b7809dcb881e01763ee70a58c2,33,25,15616,5356,10260,34,26,19935,6880,13055
4fbd36676900ae37c0c413dab12f27d6,175,136,574254,99765,474489,147,113,433856,97493,336363
157927327f3979f089fa569b9edab248,21,17,6177,2912,3265,21,16,6698,1950,4748
970d0542eec679369d71c0e0b9946174,98,72,187175,68451,118724,95,72,176358,51510,124848
df392b6ab16fb7f859af0a968832db30,147,116,377002,81153,295849,156,123,465097,81568,383529
1ea13da6a0b5be6c412485b5f900e8b6,207,145,899770,167350,732420,167,132,698291,195592,502699
fe107e610262f6d31c83162522560192,122,97,274279,48191,226088,100,78,203089,54815,148274
670de33a1519d25069e290f15d27f827,23,17,33040,6846,26194,35,27,31171,13153,18018
0b09e2332a70e788d2a05cc2174bdd9e,216,132,872650,106379,766271,250,167,947859,125266,822593
f8cf9676a686e8d0678c04ed25742c82,78,60,106987,27653,79334,67,46,70837,22974,47863
dd318eb9c941d9b1890446ed482ea3fc,21,19,5447,3635,1812,17,15,5833,2554,3279
28b6b93be36d3d6ea372758ac1349af3,54,44,71973,38972,33001,65,52,128915,26105,102810
21081dc1d594bbdb3c386d4ced928c6e,55,36,48835,17555,31280,56,42,74349,20367,53982
9b0b6d96f3418e3f6c426c16ff59524a,149,124,405511,78047,327464,126,99,365211,65438,299773
6839d33eb0d6e31a1e13f2bbf8197763,122,111,336963,85713,251250,130,90,313566,77544,236022
c2a4b5b39c56343679f04c6134e4ce60,140,104,234482,59039,175443,97,85,162081,54422,107659
9a89b7ee74b8638a6011ef320792b2bf,84,68,110415,43667,66748,99,82,165789,30062,135727
111f198c82a3020c7f51a03e7622400e,90,74,189140,37898,151242,108,73,203854,54337,149517
ffc6c71e9c709a1b4f7ac1ecd74de5c3,142,114,441224,123929,317295,164,135,493286,79155,414131
ebbcf63c2ac91f2bfe6bfe26bd99625a,74,60,111450,25668,85782,83,59,116910,29220,87690
0440b77bee7b497a41f4246d22ea2b5f,13,16,2127,912,1215,16,9,2407,690,1717
61cc4c5419463acd126c8fb98d4a4ccb,24,16,8082,1854,6228,19,12,7981,2800,5181
0aa71254642ecf9839c0edc6655426e8,56,50,61991,21386,40605,51,42,60271,19421,40850
6ba81859324d13ada4b8df4d7fb7d20e,24,19,10806,4481,6325,26,19,7942,3315,4627
319c30aed1335d28656034f924b3d848,24,17,9173,3600,5573,30,23,14192,4069,10123
5377dba7af50410a8131e8edb013de1b,30,20,15644,6539,9105,22,19,10782,6111,4671
a019bfa8969b83a186cff249f80286a0,134,117,312623,129129,183494,146,90,373415,75266,298149
d84638c4beb38beeebc55ac1f9cc7063,54,42,47718,19288,28430,51,36,68983,14923,54060
a3b646c7805a16987255dfc707a7c856,50,41,70404,20939,49465,58,52,87426,24131,63295
92c25417281806a3d25ca18d507edd3c,103,89,184084,50960,133124,82,66,103812,38343,65469
fc33a6f3ca688d62592bbef736d0b0de,54,40,78329,23361,54968,53,47,63238,28645,34593
b1e3f132590c6802cdcd477534734fea,77,64,177793,56730,121063,73,62,124124,59038,65086
f09ff1452cbc5af20b75d28ec2e3d3dd,122,101,248372,68887,179485,127,110,396190,73133,323057
3aee075996086e834205c2f411359b0c,133,105,270128,50086,220042,126,84,263351,49351,214000
dde866905575c3f518b2a25c37840dd2,24,19,11808,2987,8821,23,20,8959,4429,4530
0aeb66ec4aaf0b6c64a716d57c4d4a0e,128,103,353588,129107,224481,171,122,614182,73973,540209
3f6f64b345099b683049a1bb450bc941,28,22,12750,6647,6103,24,20,15415,6656,8759
817a27ec904deae83cac59a723b6467b,170,133,482276,94311,387965,181,142,571998,99864,472134
92bb0b215b86851df245089c612fe6ee,87,64,110952,29791,81161,95,74,114732,30801,83931
4a67c5dba9a2b38d4310ac97d6bd36e2,67,52,82501,24897,57604,78,67,96368,37718,58650
6952473baba6a7d61a8fdd3fd6ad0b27,74,65,83567,35505,48062,72,61,100888,26942,73946
c9a888bf5665537b709ac06b9199722f,43,36,45458,22370,23088,55,41,50676,21079,29597
28294610321b62c1f9088cdd41ece317,29,30,26157,11327,14830,34,24,24572,13175,11397
693e21cac16e961848570bffd994a93b,68,64,116299,39270,77029,57,43,89527,27345,62182
3e5379a0227da99e1b323b417df08cc4,163,113,474985,94807,380178,182,136,673992,119766,554226
89225fd55c424f4578be95fb63593682,251,170,1600197,366037,1234160,180,105,1384409,219864,1164545
55fead152cf4d90790e4655beac5dbd0,100,75,162012,56469,105543,108,90,227568,41246,186322
7271d945a54da828d0a2121f06ea8d28,79,49,98650,30420,68230,63,59,86139,41464,44675
aa472e8c8f878a4d57e7d1b923fb1802,175,125,681086,108864,572222,212,166,690391,154198,536193
254e6614b7896c3b825e257e99ee8d99,92,62,155598,36483,119115,77,54,102037,35789,66248
fd5c2acaf669175a286c3c84630db684,73,59,92799,28013,64786,73,63,96259,26696,69563
891ce9076211c540728317482a835b28,89,61,126786,44128,82658,105,91,182100,48463,133637
7bb74dca50381a7b5749e44b07a94352,17,13,3925,2673,1252,17,16,5859,2777,3082
48dc1189275172d89e59d262b85de681,108,96,277742,72035,205707,142,121,377390,65272,312118
01f2b80a91c856e526728efd683542b2,60,50,68433,27390,41043,69,47,92032,24794,67238
ece9bb89a977814779f147f87531a282,26,23,24972,9090,15882,29,21,17470,11776,5694
b6383c9c57cf670cd9fc037b0ece964b,57,43,55471,13206,42265,35,28,28293,7234,21059
3de2ca66fa7816da008f00dea4b62971,163,133,415707,95610,320097,179,134,446009,61972,384037
00abecb94e10abc80db1277fe5b650ce,153,101,418968,88006,330962,146,105,449193,99365,349828
ab589cf14de7d1a2ab35c84392aace04,100,74,227081,41266,185815,102,85,213065,61310,151755
7cf717dc6fd061bded750268ac28571b,48,37,68476,18040,50436,40,33,44687,21226,23461
31f786ac675ad7fab9dd2f1bf34d78d4,63,48,124316,25332,98984,80,61,123321,27974,95347
15449f2ff8a87f62d8ae07a194298db0,112,100,286696,63874,222822,104,86,235059,66983,168076
51df84296879c884f643323a9ac45949,102,91,232538,79920,152618,102,80,226947,74933,152014
5dd0b00cefead1c09eb6283358a5f841,187,146,621556,214856,406700,170,120,795009,134646,660363
694c2b601f56f04832b85009d8802752,101,73,302858,45594,257264,122,90,276186,69086,207100
0b1f1400a73d5e9c2a6669df374bad59,91,66,141356,47442,93914,176,133,287624,56809,230815
f12d5ae11bfab3c52c78d52ec2b33f0f,16,17,4845,1231,3614,18,13,3343,1185,2158
27a066831344afd305c5080c9f330676,187,156,676310,116534,559776,152,112,578884,116239,462645
a23461766344a213167a24f70d655065,60,44,88186,20045,68141,81,69,129659,24573,105086
7f06b254c3deefedecd98fa9aa45627b,78,54,152570,51679,100891,108,84,198908,51729,147179
84513c5107d2e94c58e279a9086142f7,4,3,445,497,-52,3,4,497,445,52
206ca334df1bc6c9105bc113a0fe04b8,135,107,309691,72647,237044,150,115,287919,51708,236211
74c9d25bef8054e90aa7bc7d1ed9eee5,41,30,28538,14203,14335,45,32,35366,10349,25017
9bdc94270772a66bafdeda327bda559f,126,97,364411,67117,297294,100,90,300909,83028,217881
ac0a505bb5687487c0b27c04c94178e8,149,91,422740,75881,346859,133,79,429406,65392,364014
a620e85c776e9e0855533ffcc0c8a71e,32,28,44790,14706,30084,33,32,42538,20454,22084
c686a3a75fc6b6631ac57510cb6a50a3,143,100,241102,39987,201115,105,79,147729,47502,100227
667f315f58bd4c4a721208185c1f0776,135,95,410431,75375,335056,141,121,402181,102836,299345
5aaccea104e8b82ba704074a92d5a747,167,122,428165,86299,341866,128,93,342224,88063,254161
e9345d98d8fe2412344ea94c752085cb,108,84,274165,58023,216142,138,111,343321,51235,292086
1bf6a9b3d0178da973e1dbca476a65e9,37,29,21848,7443,14405,34,31,17634,10484,7150
8b3ccad9a9512208fb496e6cc3eac0f6,53,45,49173,14895,34278,45,28,40534,9605,30929
fc632936dd96ede5b0ccf57877a3988c,52,38,62079,17810,44269,59,46,59815,16391,43424
ca454df27e26857ef8d8ef62d1e68439,54,36,37401,8979,28422,31,28,16467,10059,6408
cd56b272214136808165494d88ca0aa4,176,135,770210,173930,596280,184,140,657024,157769,499255
5ea488e4624e02529d3743d47c77b7ab,23,16,12999,3292,9707,30,17,11472,4384,7088
6533e274312453b3bd3e14d054a41c32,41,30,34944,9052,25892,60,50,49184,15477,33707
5164a073a81d729dcc0af44bc4c04775,43,27,29363,11346,18017,42,29,34662,15784,18878
bdaf89228c2d6e8664ee8b3b3a87fe08,124,88,291224,62478,228746,143,131,390575,75664,314911
e259104e308ec6779f1f2b3854c5d7b8,19,19,4794,2497,2297,26,12,5523,1997,3526
c82dd93ee61ca54726aa5c3fd2fa9cbb,182,144,998306,147266,851040,225,177,1086573,169850,916723
1b57d3187c85f21cdd06a504eb8ade6b,106,100,167349,54907,112442,78,54,120432,30262,90170
2d00df84cebfdd17ba009e4678a62d7f,143,118,486772,98344,388428,230,176,639157,118257,520900
d8da0bb812f2002dee2a2ee10c2cfdfd,65,54,116210,32053,84157,91,78,132826,39285,93541
4a3914403ecfeb9cbc71320e88062522,91,80,138889,36813,102076,117,101,194689,40864,153825
fd3b46fb3c1bda71858855546b9deb05,53,39,47181,15173,32008,45,44,34146,16668,17478
d5e5c60dc3d86146bbd3456f0d6c1ad2,9,9,827,2063,-1236,10,10,2078,869,1209
78ba2333e1cf6bb903cff0464e59614c,61,52,74489,23609,50880,54,34,48269,15255,33014
86ac2c37027911e1f210c3fcabdea957,159,132,508284,114911,393373,182,129,597831,117637,480194
23a7d4d008c5ec56aaf588454e33ccef,39,41,25819,13035,12784,44,41,21616,10246,11370
d7e14a64259808be93871937866e6ddd,34,26,60334,20793,39541,67,55,157011,30440,126571
71114978188fa382240b24d9321e4395,151,122,372029,78576,293453,155,127,472583,97941,374642
148fcafd441842155a07b7a17ad2425b,45,25,30734,13182,17552,41,30,41478,10795,30683
ab66d5728f18786cc72cf3dc633b4f01,155,126,327479,48490,278989,135,109,257459,39836,217623
2cb2adfcd8255fe51172cd4d461d9f14,140,91,361115,95869,265246,161,132,478932,111139,367793
8406e470daaa63eab456c70473796835,180,115,483625,79591,404034,133,109,287324,95426,191898
da778e99632ad5b2d71bc8fcb909d602,29,25,16004,6766,9238,24,21,8506,4493,4013
7f20cc98803db2de96373a508849ae9c,61,52,143325,30922,112403,59,51,100593,40285,60308
5d961508045b1d44a65871098a5a887b,115,83,221025,51384,169641,102,65,187470,44878,142592
7ea16d75bfa2d3e9d797f65f51007db7,47,32,60241,13174,47067,37,32,33460,14372,19088
b5bf636dbdcd36d145a70a3f7784d954,146,117,565739,104489,461250,168,123,554977,104345,450632
71d2dacabbeed94faf8c7d68017d664d,154,114,468075,99425,368650,150,115,414976,68507,346469
7467d6347277beee4532db9ec3eae86f,39,25,35291,11380,23911,38,35,38238,18553,19685
7caa961aafcc1bdb1b7a00dade164ef9,50,32,68352,11716,56636,40,37,32246,16443,15803
f6c823b428dc4077efa96e07146a2e74,41,24,30960,11643,19317,46,34,32834,11059,21775
7ee81434fffb99fe83d093ddb6de07be,99,78,192363,47906,144457,90,55,160078,37297,122781
91d1bee184e9b61e1f5f542eccaa37d1,91,76,150071,36400,113671,89,70,121716,46517,75199
620ecd1130a2c04f000b60aa37a918cd,25,21,15107,2513,12594,27,21,12461,3371,9090
06a21556d9b2e9d60f3e74d2c6119ae0,38,31,40738,21387,19351,46,29,49572,13198,36374
4b412b89b80d7a71d5c16bbe2830e4f6,54,47,81734,17703,64031,69,53,114438,22723,91715
1ddf32aebb1f4a570b9ea9ba632b59e7,31,23,15813,7308,8505,24,24,17932,10931,7001
7b31cf97ac56189f25782c1761c4f5e0,71,59,145926,38453,107473,123,100,222553,43186,179367
0ce509d41d5ef0f91147af769b88dc97,149,118,481861,73224,408637,149,123,370673,90357,280316
77b93bb6003a7dbbb98e37bcf209c3ae,75,63,185327,34968,150359,122,91,242395,57139,185256
0c8a4701b88466fb7528e74d9a921156,88,67,163026,41468,121558,100,80,158624,43153,115471
c18f2d1e8f443441ec1007a37a049942,138,117,369519,85758,283761,139,117,426272,80495,345777
4d8b43714d0e29fa555f3d3f7e70c8f1,98,72,199994,33685,166309,67,60,139485,48744,90741
ed07db737b2883039091e4ad4c60857c,174,130,640883,135160,505723,193,151,707331,122374,584957
b82fbaa4431ee0b0d51cab5572c8fcca,121,106,285551,72732,212819,150,110,314158,62573,251585
c96b722a661caa81705557fad668d415,122,84,401788,78300,323488,201,177,744034,89118,654916
99062290732a18db10ba4308f8c8917a,24,20,12838,6887,5951,31,23,17765,7289,10476
3eb51e9ef9b634c63e7d8841cca1d433,18,13,14796,4230,10566,19,14,6147,3942,2205
7b58b078ba544d3118a27342158deb97,207,144,600361,87998,512363,139,96,380175,108978,271197
99c5c8a37e2949541d7e4e9c8e524b19,50,46,36191,19477,16714,42,27,41544,11747,29797
4b4fbe4745889b9f037321330e90a737,85,66,154163,122191,31972,116,79,251590,49583,202007
c1e36a53f55bf2535945e5cc0dcb6d0c,157,118,444235,165215,279020,189,133,517814,117044,400770
7eb4ea76dec1a66539426c5bdb8f991c,91,79,174878,30247,144631,90,68,130856,36259,94597
fbf68a402c0e5dec9b98541f89ea0120,44,36,62766,17142,45624,36,30,49107,12537,36570
415c803ab5a48b28a7f713e945a3753c,133,111,428324,97678,330646,124,98,304626,72067,232559
b160982410b54c1cade46e44f6ab933c,96,65,193128,49858,143270,111,72,183309,48048,135261
09d01bef93f8715a5d3fbe5e51f33a81,163,124,735675,136059,599616,248,185,1196145,163722,1032423
b2a3087dd498cc609b3b743d02b398b6,44,41,55746,21084,34662,44,35,63012,20777,42235
5894cf6595cc1325bfdf4b443d2a5742,65,42,100478,23516,76962,97,72,132340,36276,96064
86fbd3638116a093fc6d6bc1884a4d10,64,51,91601,26713,64888,68,51,88789,25394,63395
36869cc730ab1d98cfc031923b891a50,27,20,20323,6906,13417,31,25,24428,7499,16929
6481bdf15b88a3d7c8700f4647b60800,135,113,295657,77641,218016,174,133,402052,57061,344991
6578290b672e80ca86780b3ac98acfa2,184,140,536021,81394,454627,160,119,337659,82457,255202
4777a80bcf6521f0611c1fd4c5ef4b00,177,137,524796,91806,432990,157,121,505702,83487,422215
5c7a87180fc04f1e3ad9a05cae7e0726,64,45,88088,20813,67275,65,50,76194,26963,49231
3181cad6fb558b7ea772b2e0b5b1065f,24,17,12442,3985,8457,33,23,19444,7238,12206
d8057f639df9f3461d4e8ec079242cf5,92,65,140693,19711,120982,83,66,120468,23158,97310
313431043a933866d529de4e1f2f8c07,130,99,283561,64777,218784,137,99,369069,56792,312277
78f337b5c5cad9add4c306fc0e4c7a10,131,115,222593,47851,174742,134,95,210473,40832,169641
148624234bb3a3f7837272b88b4a4225,0,0,0,0,0,1,0,47,0,47
d059f2af30a9d32c50647ab36f3353d1,153,97,484708,83139,401569,95,74,276096,78133,197963
7386e7fbd64ceaf9f7971c7fcf6a6c94,56,46,79818,26381,53437,60,39,90609,14546,76063
ad6f49b793322ffcda1dfdbc1dc6b8d9,181,145,593666,138412,455254,128,97,461810,159455,302355
46a466360a78789010ed6ae0733c8912,53,47,55071,14669,40402,50,31,55126,11938,43188
d59c144447f32b5d1c749b63ea211e8b,6,6,591,470,121,10,7,805,473,332
0ea2807d7c4a0046378c1f76b3b0c5d3,102,86,337641,48192,289449,150,105,311169,61034,250135
a05134aa5efe81e7dc674ff6cdffbd82,1,3,35,330,-295,3,1,330,35,295
21c2fc33b52bc394520cbc159f96ce21,141,104,403988,57411,346577,112,91,260266,111139,149127
24eb8d8ae9be76672bd784595f4a944d,199,144,655796,108195,547601,200,149,782489,103971,678518
0f9bd4be66b58cb8b67eac5fce13fadb,182,125,522239,70475,451764,191,154,634813,96882,537931
ee3e3f71eb620636780ce1e94766b5d8,127,92,257904,64491,193413,140,115,303885,74353,229532
49a19be181f87dc4a61046996c768e85,21,19,9831,6221,3610,28,20,13586,5779,7807
ce30573fd3ff073205336f8aaade1eb9,30,31,22087,8544,13543,37,25,23945,4430,19515
fb2c38a06ed25e4afc269714c59eb79e,38,30,29639,18717,10922,38,31,50826,15002,35824
1e72ff45c63c6c545da9f481f0722e6a,80,68,162506,42112,120394,88,71,193334,44380,148954
46ed49611032af36a26dfd2c1b3f1af6,61,48,55589,34028,21561,77,66,121855,26905,94950
2a0a6f4e97fc5a3914f788fb732e219c,169,121,596856,154502,442354,147,95,508745,132448,376297
1c426e0e6f53b969ee017edf75b75911,63,46,148852,30939,117913,69,59,123734,44824,78910
5e76cd014680edfa620ae27da2e9aad0,69,56,109952,37267,72685,79,69,84979,34553,50426
33ac784653a83b19b39d58c3ba6f5b23,22,19,10783,3741,7042,27,21,10346,3503,6843
2b31ec2f6416a50dd6f5394e364dd8cb,28,23,21885,5219,16666,31,26,15484,6954,8530
f956fee81e930f70447a9fd6222ae575,50,30,46438,10970,35468,34,25,23906,7227,16679
32b07950f23d77703eaaf2891f2c058e,39,33,35656,12400,23256,34,29,24683,12002,12681
99fb4479d306946a36f908d316a30bec,80,59,123519,33331,90188,93,75,171544,47184,124360
65a5f45f01ca9f464971af646396f776,120,90,399300,130625,268675,115,85,478680,102070,376610
c2db635fcf3fec3f568682ee52212464,39,30,67508,24409,43099,53,44,64840,28133,36707
e2bc551f5eb42d18e0f4f266e7194e00,40,29,26661,9078,17583,36,27,29842,9348,20494
7959b1b0997359ac06cc3d74620b4001,67,45,79640,16306,63334,80,55,102768,22651,80117
9d10b48f9b0690de4664db3c7aa9a0ec,128,107,553633,162806,390827,175,137,758948,128575,630373
888df2267af3456f7a8fe91d68c7a817,5,7,391,756,-365,9,4,971,212,759
c44360d561d80f1512a56c8703475fef,165,139,495114,112072,383042,133,115,399646,80804,318842
123b1e2f301aaa61d0ad85f8ecff9ea7,122,90,278113,54557,223556,154,128,375997,74644,301353
1a7b55c77a724cdc590b79efbc437e19,168,126,460388,77418,382970,139,116,329297,88440,240857
fc5e35751650bb6ab30b3aff80d69a47,134,107,381168,109524,271644,148,116,348357,81327,267030
4388630f812a4d7a9e28b569a5d021b9,124,85,173311,34755,138556,108,91,150302,38171,112131
904e3966a20a77e3893c9cd101994f70,49,37,68804,20799,48005,64,59,97416,27670,69746
067fd5804dff8e4313f27c3ac81698c4,145,105,507874,130768,377106,194,149,638487,127376,511111
dd9d16d19a535dfa0267f3f87776c392,150,119,382073,89745,292328,128,93,369427,84897,284530
cccbbf6c31c7e9b584b300b2e10f198e,152,97,413721,71020,342701,156,126,431385,110289,321096
1c579fc99efd2df67f53990e5f1d3448,168,127,591102,118421,472681,217,167,789858,123424,666434
554cd6c543edefbded6ca619dbbe1782,115,84,196570,43600,152970,86,75,158138,60999,97139
f1e7720495a2a732c3e83256382f1da2,60,54,66868,16247,50621,38,36,32214,14736,17478
766f27534b9d9267a9480ee24f723830,102,66,275308,75672,199636,144,100,372827,59196,313631
178aea1e10161851bfcd740f999d858f,64,55,72791,31167,41624,82,59,104417,30354,74063
2806183cce0467c62a9abf9960988845,119,92,336538,96165,240373,197,132,493466,81451,412015
a87674aad9399bfb370abbf9203c41c2,84,67,163140,49608,113532,107,78,209139,36132,173007
93b33dce78efd056046b9956149457b3,99,82,228221,51364,176857,109,87,205798,54155,151643
90dd9eed8edc2b5254cdd808ac7c9ce8,77,69,145536,48238,97298,93,65,141286,40549,100737
a79ee6bb27fbca7afe81cb661275ce53,164,96,331186,70427,260759,117,92,342137,84099,258038
844ef6acc7b2cd834905c67d9d7c9d44,169,127,492725,148085,344640,168,118,495340,101205,394135
e0f0b0623df0f49f8a120137fb04f1f3,145,112,323079,57822,265257,136,107,298353,83411,214942
2e5bbcfc8b22c97dfbe000c7a7664ed5,136,103,319521,49606,269915,160,117,360812,42401,318411
f173b5c1001988cdf72b45e43441dc0f,120,82,282218,90753,191465,132,92,306523,90417,216106
85eb0892c48ae7c7b16cfc738f71af40,187,158,705951,124176,581775,184,147,621682,156328,465354
59c0bea24fe26074656c853c049b78c7,52,51,109183,26249,82934,94,82,140295,35076,105219
2b21437470f5837d41ea9178ba24501b,58,46,55915,21571,34344,48,45,59180,18682,40498
41dac08e0969e4ea309f24f65824b29d,21,14,7163,3034,4129,28,21,9033,2541,6492
df86c485ef5f16409320e198ee3fbc0c,79,62,191885,39648,152237,91,79,175656,51526,124130
a3471a063e9f1056c2cad2c08c5e54fc,150,115,363161,96962,266199,123,98,333526,89140,244386
b5ba1a031ba37e6ce0321d8cc288172f,64,52,88340,26472,61868,66,48,91330,31316,60014
dee7faa973908a1c8d6e4bbfb7e8742f,58,52,79472,34717,44755,71,46,119084,25110,93974
de94b28ba7432de2d7c044639b3585da,114,85,167177,41162,126015,119,108,199515,34855,164660
503775d673beaa0b3fed905e3e91c40f,185,136,659426,151259,508167,183,146,836444,149616,686828
aa1b071d3f50eba6cfc0eb32f217bbe1,76,57,119209,25950,93259,88,66,120289,38937,81352
433ffb8b7fd08da7e8b96890e48a2ac4,126,93,371617,72075,299542,143,125,454511,88957,365554
37233de6a8aca45ce18038a7e7c21ae1,129,103,264754,84021,180733,119,93,251247,78684,172563
05cdc3db14cbc1ae20e6926faf915ff5,69,58,80090,24851,55239,90,73,127324,28067,99257
80c2da4d0dcf899937be2b8d8e7bd9a3,140,120,478583,107234,371349,158,136,584756,92932,491824
385743a44a36101ab4fde7aa9c57c6ac,123,86,366961,61440,305521,177,140,549026,74019,475007
3e7fbeae4e325faa16f7f38f70565bb2,147,112,319380,68293,251087,154,128,332911,58787,274124
075081958e6212d6644acfbd63ba4ce0,96,81,188218,48099,140119,103,90,169977,48933,121044
cdca75373ce91afeed06844cc9bc0c37,69,48,108985,14659,94326,85,81,133264,38311,94953
ed5e2431620c698281b9b1ac79c4e770,46,34,40540,13208,27332,49,43,47242,13854,33388
084310bbe9e7a6b0b2341d69931b404f,76,57,135431,29125,106306,68,60,85222,29506,55716
4b5214d0f1c38264e204c77a04fb208f,217,142,1353095,215614,1137481,221,164,1220618,293765,926853
7602294131a18acaa08dff277d6725ce,83,74,111509,35759,75750,80,60,131715,27123,104592
f7f04d49d630a953a2f3bf62197547c2,85,68,152221,55473,96748,114,89,206830,47620,159210
9c47d48d8d782e4b0007438019e289b0,35,23,26986,12897,14089,42,28,37824,10095,27729
a7743311db486db9ed11b9911364b4c3,153,109,513522,88827,424695,206,150,573092,88793,484299
d4587f3a06fa8241ba3d1acd0bbb3b4b,66,66,177229,102571,74658,109,84,305800,64687,241113
aa56f2143d17f610c7838a6fea5d8c71,90,52,102427,25281,77146,82,63,94002,34074,59928
254e9785fb1d898a1737a6cc17af4e36,44,30,42389,15097,27292,34,28,30949,13060,17889
0f1da98ff5e124a22b9f9e2e79ca329f,116,103,201291,48311,152980,104,88,208385,48007,160378
9aeedf3aaba949628fa346f490c0fe13,40,35,42859,15864,26995,32,26,30658,14840,15818
d096b5d91bcc336100c924c8bebf99ac,124,81,235114,35102,200012,83,56,100682,43961,56721
e12643595315471b8e63356dc5b6a275,35,24,31377,9455,21922,32,31,21856,10750,11106
92523dcecbe566dd5f002ee56af98e96,126,111,240576,64280,176296,112,88,200683,40160,160523
91ae4185c8efb1ae4cc7ef7efae4ade4,164,130,440708,96065,344643,145,97,388082,80121,307961
88cdd87968122df65e08aa39dd4f9537,34,28,23347,10969,12378,42,33,49630,14515,35115
799a9c0e7f9ebc21306a08678da5c409,117,87,209414,57094,152320,84,67,130601,50026,80575
ed8f771a09bed995b96074c813b74bab,68,54,77356,29261,48095,66,59,105546,28719,76827
156f4ef0cce52f83939f62d74269bb7a,107,78,185688,56186,129502,74,69,120006,48236,71770
913ef54fc66c114bd65d30a4f9bbeb2f,86,64,177221,39319,137902,88,75,150973,46903,104070
5c5d48b3b765c2199f897bb44ac1046a,44,35,73008,28437,44571,60,51,121704,33578,88126
dbe8a8124791c6592de75abc62b58892,31,28,32424,9342,23082,36,25,21593,11747,9846
2c32203a93a60035bcb638beb5115aab,24,22,8575,4265,4310,22,15,8104,1956,6148
7663f32ca2d8d4b75ce35e33d149233f,214,171,1152696,182358,970338,186,131,733539,167807,565732
c81e5a724cfb53f2350f447c7619d5c8,155,94,366725,76983,289742,162,110,313201,90384,222817
81ff5be4a3443a9d2cd114411e7eb208,82,58,146391,32783,113608,123,93,214861,41309,173552
74804be6728b64dce00bc9b4c68f9fbf,118,101,249716,66610,183106,133,112,302188,64678,237510
f6cf39571024fed4efa4016526fb243e,149,118,473102,104279,368823,143,107,446754,76206,370548
62ac852b68c6d8bacd668f44560bede5,37,32,43177,14808,28369,39,28,33804,12329,21475
7f61bfecf765f51b9988d46dd4455b74,69,62,78146,38801,39345,64,44,91058,22736,68322
903246f0892ead39e01bf0db1c1d3ec5,55,42,72160,23767,48393,53,42,68952,22015,46937
f41d920ef33cd4595b283f325b5b0fe4,170,142,613912,214158,399754,192,139,716137,161712,554425
33239ddb05a5281d55a4d3ec399cd605,62,55,90580,25148,65432,57,37,57261,21247,36014
c5aedb292715878f7d240c5a94f2a8bc,119,91,283075,113997,169078,162,118,507564,97978,409586
de1d8d04d38f6ba4590c5d6606bfecf6,72,56,89146,37464,51682,68,53,95973,28151,67822
bb6a68020a39cc12b9230f6ab4064291,159,119,596332,173636,422696,233,170,750465,129951,620514
bd43cc4c2881fb6a78939fdf1cd182ad,122,101,283729,86792,196937,171,112,464259,82333,381926
8a3626cd7724ab08f37a18d160660b6d,54,46,55360,25188,30172,68,63,102246,27626,74620
af46f22ee247c898189a80c89d77fd17,23,17,7620,2386,5234,23,14,5444,1594,3850
1b7496699eed2db24500ffb069cc53d2,81,65,105328,19585,85743,61,43,45113,21629,23484
0e957d8da23e142a1d648a2bc74eeb9a,63,50,100147,19995,80152,52,46,56659,18900,37759
61ee95e6f1c0c12b669207339ce43e94,80,65,173227,52045,121182,112,76,217739,50084,167655
9840b26689c9959d17e4cb999c07e9af,134,105,401746,92174,309572,134,106,438069,96582,341487
942a302c68f0499ce71ce75d324c35f7,86,63,118193,29187,89006,68,60,72885,38513,34372
6c9cbc6310ac307b4a84f98ed6fde4be,151,117,398019,113266,284753,141,113,339942,107732,232210
be53c23a69142c9bd395ddc49c29c899,4,7,1099,1039,60,6,4,751,698,53
2b7702d5bd307c265c2a576692bd0550,176,91,447539,54757,392782,130,91,276387,87693,188694
08ddce78fc509388713fb33de624c088,37,28,27311,12874,14437,34,28,31870,11330,20540
62fefcd2dd16ab248e719116d87b55d5,92,58,122555,40205,82350,88,73,195371,46419,148952
fe6dc9a2142b9c4809bcf049edb95322,44,34,62423,25851,36572,62,52,81512,20167,61345
2a5e033972a41e6c1af17d34430c7fac,121,94,234263,52996,181267,97,89,191602,54615,136987
c4c35fb3c2af3d7fa7aeefaeb7461146,52,38,75633,29674,45959,60,40,89182,29427,59755
aa66cc67676bb425e7b97eeec8e0cf60,59,52,71763,20791,50972,61,58,83349,27084,56265
6eda10ef855245881db07a6e1c4632f3,56,40,51730,18214,33516,54,42,51326,17655,33671
333a31161cef0a17807a204a120d6572,119,96,293019,50222,242797,100,99,218555,55558,162997
a5b708e1fd1239f4eeba9db8cc60bc7c,6,3,313,130,183,9,6,469,143,326
db2e6d00696589bfce98a050597098f4,180,114,387748,75820,311928,194,131,527146,102904,424242
89828d2debabfa590c696f7dc6f03a0c,152,114,606049,113204,492845,165,119,450398,74969,375429
f3e309d0601eb8419f592906e219ecef,61,47,71411,27566,43845,90,75,100826,26795,74031
4b1b3d70144b13c6fd3d2834ca93e5bc,210,144,845216,276137,569079,197,128,1026833,245314,781519
13ff82dc25e636e6429957ce968c6c2f,38,29,54465,9018,45447,49,39,53736,18003,35733
5077173de74ac76698e81892d10b57b3,15,9,3281,967,2314,20,10,4849,1121,3728
3bd84eb660822c33396d169b8c0264da,33,22,27243,8804,18439,30,26,26050,10993,15057
4c4b2f1e3be78b0d2039a8882ad17b19,71,47,81840,25599,56241,82,60,91530,33315,58215
f5e0e5683a236ceb87ff608638a6e7d1,120,97,252517,55921,196596,113,90,245506,58703,186803
b3078cd01b99eadf9a468ca362be23df,127,104,444173,143898,300275,211,154,608011,135498,472513
d40358830f5c32281f64a44f56d89e2f,154,102,282927,56316,226611,107,89,249163,60196,188967
28a1b87dd3a127e78dce638eee5f6c1c,32,21,20444,10292,10152,32,28,24873,9507,15366
d4057d52506aaf3eb1c1c2939521200a,177,134,664560,123591,540969,203,139,734979,143265,591714
07e2ddc2b2636ac0e2ffe7d6f82effe7,62,38,89626,21635,67991,75,47,104070,21150,82920
b6f00c12516056e918d0c2c6837b98fb,80,59,116611,23269,93342,74,52,81792,24570,57222
83718d9277cd452b396ee539896c547f,53,38,41849,9285,32564,40,27,23981,8943,15038
27ebe8644c0c8254c3790310db2c6370,174,109,515578,147665,367913,169,101,611476,118025,493451
375543c3c3ff770c334f35fa35332e43,11,11,1224,840,384,13,7,1817,924,893
460c77415f49a3c6993be1a175c069f0,11,10,1744,678,1066,12,10,1455,761,694
7b00e290dfe22231c9ba1c04b8dc43df,120,95,272073,65045,207028,95,88,215089,85836,129253
d652f165ab60ae8f51f7afa62f0045b0,100,82,288309,87015,201294,115,96,258576,77657,180919
5bf1643b58e5204fb45ab988ec9a045a,110,75,307773,88993,218780,116,93,330261,64028,266233
10e0e3fdd3d71152b3b75b6851fc39f2,172,140,423462,107806,315656,152,118,387556,83405,304151
92e902496d02889beba14c2f2bc88f54,153,94,229843,36813,193030,129,99,199964,46688,153276
00baac875deb26247d858fdbe60c56e6,173,129,642764,134578,508186,177,137,532297,148894,383403
530f090d50d566f8ccd2eb71a58b85b4,69,53,117371,42284,75087,82,59,100107,52589,47518
77dffd26d8ea02b8b846af847d8b16e1,71,57,107415,29914,77501,55,47,68053,28874,39179
7fd0c5eb651eae4e86b6e7c4cad9b4fd,132,89,243930,56395,187535,126,105,227867,71167,156700
08100e8e32edac207164f7b76eab20ce,83,46,156147,42016,114131,110,93,236967,39174,197793
9444cd750480ddc0be5fa9bada07e61b,187,145,1186848,254315,932533,247,193,1302559,222871,1079688
5149ce877a774c14120a369e047a80f1,197,159,729668,165074,564594,178,110,561021,126795,434226
1d811a6c6cbe03757cfbf52640f38d27,90,67,181120,50301,130819,84,63,204999,34720,170279
ee5a8b28039a19c35a313e5352e9a488,98,70,124088,25547,98541,94,76,144218,33475,110743
68352610a3283ae5a8e3704a956282f0,147,103,583855,118640,465215,153,113,684450,129406,555044
308bf5235daa5b242969e4abbf978eef,158,115,587559,137703,449856,188,143,520070,127843,392227
40510e774f964996b7be5e730264e62c,151,141,540526,156166,384360,156,118,547030,136586,410444
c9a90dc34c8c01c232fdc35ee485876b,131,100,420089,62148,357941,110,85,206360,62676,143684
74ef58e61932d2f85e66208ec9b974e2,74,57,100157,37886,62271,73,60,146664,31959,114705
435efc041ba5fddcc9bd9ee167c9145a,56,38,90777,23824,66953,68,55,66745,28342,38403
d150675b83edcb6a0e75d40a71a1b44a,133,98,311700,80353,231347,172,113,360130,89418,270712
daecad3a96ee33f8d6e7ab52d0773b91,114,103,282082,42097,239985,103,91,189962,61267,128695
7f4638f84d7b354278056f7d2759fd8d,116,89,236046,68903,167143,117,88,200597,53662,146935
3ed0b223d4d9463f1aba0004d6602ca0,54,48,77343,32507,44836,47,50,64219,38470,25749
2dd97b97fd659add7b4c1a27920cd96f,86,68,147211,44150,103061,78,61,140751,36489,104262
e2df3c5eeb6653c7e205d25676a80af8,110,80,256227,56930,199297,111,98,221347,57355,163992
483c2a384559caf75633f403e249fd2d,28,23,12873,8345,4528,28,23,16870,7258,9612
5be39f7837d40f52db2b23a9e7cba9b4,99,79,129000,34562,94438,104,85,115716,31406,84310
5e81240a8b58e4d9b868cd4b6a55fa21,89,76,206824,66501,140323,95,75,222084,76049,146035
de306c9ea36981909742d0a394dbeb99,117,74,181709,30531,151178,111,86,182760,49349,133411
45d5ab8608e16fd8cd525472af066597,109,83,301080,75826,225254,164,132,396099,107160,288939
e0f85673ab00c277ebc48975b52b9242,54,40,54847,14138,40709,44,35,52117,20760,31357
774406c2aa036595fa07aafbe7d5a836,52,36,64882,23360,41522,54,46,70093,31977,38116
053aac2e566db5afa87e5ce526a0d62b,178,141,566759,139739,427020,178,141,579039,125723,453316
f9418caf60ca2d597bae2b3e32319d35,108,80,227931,49559,178372,102,82,204534,45009,159525
b474edb43cc345b3e7c293ba57c15d50,153,134,651036,137914,513122,179,151,569039,130189,438850
29061d519b0d48beb9110cac791f385b,73,52,107706,23291,84415,64,47,99839,16681,83158
951b010d911af1250f1628cbb531be77,94,65,151100,56330,94770,116,76,200017,53861,146156
41f1bc4cb0456e87cee8951cda12cd6b,129,99,292292,61053,231239,127,82,225467,61997,163470
9a3715dc9eb979a02d4a8d329827cf02,93,76,156094,37335,118759,101,80,151281,32456,118825
0c7b3ef79673e616d6cdc74e47489dc5,26,20,6668,2886,3782,21,21,4529,3300,1229
87873a8ab6a0165d2f9391def33d6d07,156,123,723023,144158,578865,194,127,574488,165491,408997
a23f3686d3b40d8f70ca192763759a6b,119,99,251254,70320,180934,106,72,294249,40732,253517
d619a43bda5d00648a8699e4e25b2168,69,59,136962,34991,101971,68,61,104683,34455,70228
c78ecd58a19af5fdb33b8dfcf1720043,88,62,117537,31661,85876,74,52,110022,28536,81486
f4818fbb9d7e2e8008025f2c87ad31e6,96,78,170756,49417,121339,137,99,252036,45014,207022
c8589257663c94960d26764ffd6c5c76,213,160,1390688,284050,1106638,235,201,1860610,484761,1375849
431fe2a520da79cc6912d1eeb5feb0b0,150,112,400596,76190,324406,153,131,401393,80429,320964
29bb5eba33305ba80f9724d44a518674,78,53,127359,31001,96358,63,53,102298,36888,65410
d347650831d469f6a5a55a1b242bfa35,58,34,81021,15858,65163,65,57,107262,27591,79671
6cdb224acfd3d0e07f82867cb15ff784,166,129,488899,73422,415477,187,139,523066,92774,430292
023a7225ea58a711f80f5243b23a664f,30,24,22721,7772,14949,29,27,13444,8192,5252
de5bb5ca1c5d165a49ead947dec297fe,163,116,544748,114826,429922,143,121,448836,119190,329646
59393c8c718b0e0fe6b954cf969746b3,107,72,202782,31994,170788,65,52,126209,39556,86653
88cac68598d0bcb9e248bb9c05891993,73,55,79854,34885,44969,76,59,92154,25317,66837
ef9ec479fe515689134493c448b50100,79,63,188752,47710,141042,99,83,200803,45346,155457
638734acce47f9b41c75f0555fae919f,133,94,260345,78133,182212,168,145,430877,89141,341736
60cd82075a1f04c97a1c416a8c7545e1,228,155,773916,184222,589694,170,120,828014,138058,689956
f64147b2cb01d3b161f767d98ae2b7e5,120,101,234133,56312,177821,85,76,158889,57455,101434
6ab6b42e3c5155303be8dbcf7c8345c2,71,62,121315,30725,90590,99,75,158624,32122,126502
50cc15cef8564aa6bb2aeb2c1fe26df3,169,129,441229,92108,349121,151,109,314944,78299,236645
354b0513225dd030d75796c22756f09c,102,78,204856,51536,153320,116,74,264403,38374,226029
e166c18950c0b56f77eef97b8ece341b,98,69,197823,45736,152087,106,78,166402,42868,123534
225ea2e94b69b7dd740b14e207eb61c8,129,121,447357,93346,354011,149,115,464966,98692,366274
3475db677e4ce427fd21351ddcc2b521,144,98,373587,109707,263880,120,115,321224,109619,211605
5d956690f32fa57ad8833a7c1221fc62,56,44,105089,24152,80937,51,52,77202,32146,45056
38be9ac8c402b9a485f55c248a7b0443,61,46,93254,37051,56203,74,52,85322,31275,54047
a53d0a8882efe5a4065c43db31b1ff72,9,12,1226,1299,-73,12,6,1459,948,511
3be8d15500400fc945d2981b364df21c,56,47,74433,19779,54654,45,32,38300,15449,22851
0df36b84d4ca559982ef1c769834d3a4,20,17,5914,3150,2764,19,13,7922,2124,5798
e6e27cf87724752b4bd38306f8aa265b,117,86,286078,62115,223963,118,91,304207,76339,227868
d1dcc7ae9130a2421d8ceee8ede224ab,155,128,546320,155759,390561,164,124,477104,104949,372155
fce321b777d876d36e70dc2852698f0d,129,98,316251,65303,250948,119,94,251079,61173,189906
aac5defb159a576b9094df9cc60e126b,47,42,73587,12461,61126,60,50,76369,28091,48278
1b9e8ba1a80d9b245ae7286bd631aca7,172,145,767180,119877,647303,164,121,581529,113880,467649
14c58134a4906bce948982f363101b02,104,89,299407,112291,187116,145,124,380820,106193,274627
e00cff601650aa3c1393de30a5bd2502,40,23,34024,15607,18417,36,27,27622,16519,11103
c43d7d8bf18e969b99d6db29ae560d9e,89,65,111079,42504,68575,98,79,138171,32151,106020
9d8e6af7b5fc181fa00bac27d62d930a,43,35,65544,15970,49574,85,68,99792,22924,76868
f138e7c497631722b83aecc8657a699e,65,59,88754,26903,61851,76,66,110347,27495,82852
1d02231531d9bae9cf4206b12b6129f2,46,31,58287,18781,39506,39,30,59640,20474,39166
5d9d57ca2364f1b1a7468279acfa0e48,148,124,464096,92123,371973,136,109,469721,84425,385296
df6b0118507f7948affe51ed945f7e40,23,12,6391,2135,4256,16,12,3583,2088,1495
43708c6cc391cdef90ef6723b5cd00f2,50,33,59077,15768,43309,44,29,53719,17398,36321
1287e704bda26626366dda4c645b1481,161,99,554376,124052,430324,158,120,552750,132053,420697
93f81d6d814602ba66a48b741008f8f9,25,24,14201,8747,5454,26,22,14305,5369,8936
9d6413cef6ffd88ff9e082e943a66733,30,24,16708,8359,8349,37,28,21712,6872,14840
ee1f8ca00d89d1ca45edd9dc344140a8,65,53,143912,42518,101394,68,63,108278,47490,60788
9f08606329f94e31392023cd159b9d9d,196,154,1350867,184003,1166864,181,125,790586,179526,611060
97ffd8de9b170a7d4090b07f8496404b,45,34,50803,15279,35524,44,37,49634,18039,31595
54f103576372fb9d116c7954e8eccf1d,23,24,25204,11681,13523,25,19,17831,10557,7274
2424535b275b4e5dfab5162d7d989782,38,25,25792,8374,17418,35,33,28764,11585,17179
9a9c7716764194ce086a8e9a8bea9f6b,83,55,78948,29597,49351,72,60,88254,24458,63796
d9ba5df5a363672ca18ba5051f84d81f,119,66,159070,42649,116421,106,73,163382,30203,133179
d87b58cb0d4366c7b77aeddda17579c9,106,75,244857,73036,171821,129,100,304272,88437,215835
197b74c0f6f57a6dd16e825b1aa211b0,141,102,470280,69217,401063,155,124,496257,94707,401550
b00d287a695ed9afe34debd72377c6c8,24,19,7775,2700,5075,21,18,6058,3446,2612
2495a81f3860c46a44251df62811c482,135,84,345458,69064,276394,138,101,349061,88202,260859
329bf0d162c6d3ac0ec1b45eb6e38cd1,168,141,606811,153698,453113,187,128,552110,113298,438812
83775b61dae69c690c8e57a330bdb09b,53,48,46177,21003,25174,56,38,60107,23245,36862
0827bd0ed605ba6a4f5d498b5694f308,160,124,585292,152764,432528,178,146,630146,118900,511246
46f450b2aa2f7c71654339be8dac4089,200,147,538550,101395,437155,142,97,333008,75709,257299
e3bde89b1a53bbc8eb08417a6afeac26,24,19,6612,3490,3122,19,18,7733,3606,4127
3c674c99c542382859ec2729466935cb,119,104,310638,53438,257200,142,105,298284,71319,226965
ee42c2e63911c6b30e7f7ee058068d7e,126,112,276133,69422,206711,105,87,259370,66604,192766
bd7a5fab52708a7ecf12bcf969e59606,135,124,400148,112802,287346,168,126,486574,125924,360650
0c4ce4a2cf750d9378bf6fd82845613f,126,108,334977,63301,271676,98,78,197294,62601,134693
8fe418b5f7638de9cf2982b088e18494,117,82,234882,38691,196191,76,63,117233,50622,66611
5008755f41e18641056e8f79d6428643,32,26,15690,5133,10557,25,22,15230,3792,11438
0a8d679e95b764ab5b0b11e1905fcbff,112,66,189928,35989,153939,122,84,195688,60768,134920
e8d07c7ced45fc3781a720a9b804acb7,184,131,829428,150421,679007,190,147,988485,193627,794858
8088c9f0b1af62d728d5987a7b06996a,29,23,11864,4085,7779,54,36,35226,7342,27884
22757b7a795805fe730a4107e9ab6f64,207,139,648361,111838,536523,172,124,706249,135893,570356
5e9a634a16895200160a20aa9dfc0c16,148,96,502452,120715,381737,215,163,669476,135500,533976
86d6e3602521978c0e72e0af02ad2f84,219,139,718417,140808,577609,162,126,664507,182094,482413
cad7eadcd916e09ec2e924425dadbb7c,47,39,65897,18566,47331,48,37,49718,12222,37496
9ed6817d9d6c2897140e37780e43a2f6,3,3,254,286,-32,3,3,286,254,32
52b4d151f2006781aaff0f7015b90762,99,81,170331,42329,128002,92,74,154214,47156,107058
ec767d030c2e57d7dd98d7cd67510571,46,36,81558,34832,46726,47,40,69683,34044,35639
d0d9ef1014f2aec750ba3eb2057ae2e8,167,121,970872,254774,716098,190,164,862954,254127,608827
a8f4315d4b9f6b3e58cd457f699e5e95,108,79,181609,58799,122810,103,91,207306,72484,134822
9e7716cc77c06cfa093bac071b4e643e,123,91,346908,65415,281493,107,99,253276,96437,156839
6437e4d8c0c7f3e11a9f8e9b1b654932,91,84,141732,40732,101000,112,76,204250,37942,166308
97e102de870a6100e128111cab5ea7ce,61,46,87944,26716,61228,59,52,80537,29746,50791
4637fb0cef308e7f618df83018d098b8,134,85,554530,123734,430796,198,139,692872,165434,527438
e758e7670a40865b168c7fc5bcf9f2ff,148,119,591072,136490,454582,178,150,693010,135940,557070
1c00d9c22dc34cb451a53304c3edde72,69,55,114599,40334,74265,75,66,108216,28292,79924
0f4ced14c7e890e0151a7a18d2e06b93,76,58,117567,37689,79878,77,61,130728,29044,101684
37a3272d033d820664ccd74dd4ca68a1,60,48,61331,26300,35031,66,51,91644,24481,67163
597316844de2288b0ed13a57c4731e30,2,4,208,697,-489,4,2,697,208,489
5824283d8c0f0b47758e6bf2afbba9a1,47,52,32000,19834,12166,77,54,95552,21371,74181
cbe273c601e251329a38001caee66e3c,89,69,167270,41326,125944,126,114,279960,59398,220562
0e31acbb075d5901808b5c93e1b262fe,38,32,43967,17091,26876,62,54,76367,21143,55224
8e74efc8a123d2e0443708d5af305966,99,79,136093,48282,87811,94,80,125303,41039,84264
b080a5fc779921fa204c27a91e7944f6,64,55,116894,31101,85793,83,65,123967,32506,91461
1f471123f9fee0e144534ad11c9250b0,22,17,13122,4063,9059,28,22,12700,5251,7449
173e34723d4e640a7ed46a597afb9a92,39,33,48485,20502,27983,43,27,58207,15848,42359
b3562de49b6fd7ae90910936273326d0,201,152,1022151,144056,878095,233,142,884820,162960,721860
52b2b42757d9b30991cfe76f13f66952,139,102,322958,73430,249528,139,99,273628,85055,188573
173dd6a76829680953366ad87fbe1c34,191,146,574770,105698,469072,137,122,522611,95200,427411
4666a1cc7679afa7a915b4e31d1073e6,60,52,57941,21561,36380,75,52,100112,17708,82404
267a390bb2516789f63cd8c7e01d3a80,30,25,20851,11355,9496,25,22,16881,8777,8104
d82fa918844cd0b19ed72a12371f83a1,178,124,557034,78399,478635,124,101,334817,107325,227492
863aae8576ed9ec94acd2bcc5cc3fe26,186,135,680716,142252,538464,171,105,557280,95289,461991
dbd3dcf681e230a6b58063aab83a2325,68,50,159921,51216,108705,54,40,131284,54106,77178
64c4eda1c9e83c2723cfc26869789d14,120,90,242528,63274,179254,140,117,263996,57902,206094
151653b6b9e081a2ef50a3c4799a90ff,64,45,82419,25313,57106,101,74,121071,28623,92448
cfaffcdaf68dcb3166030d8eac225fe1,69,51,95731,20984,74747,66,54,66245,36863,29382
6c29c5860679d60e59f8b6e393248b31,150,120,496640,83633,413007,136,111,354199,112366,241833
08c09b69ddaa76d8d604bb81dce3415a,181,122,564165,89570,474595,151,154,466935,102459,364476
ddfcd5ccd3f11fd33eb7dcda0a97b302,113,72,191148,39716,151432,100,67,141492,28845,112647
40274fbe5199c0bcb814e32b89a72176,106,78,199584,80740,118844,153,115,334487,65245,269242
6aa78b21e6c2ae832492d35ef9f28e15,115,81,220219,47391,172828,122,97,241894,54150,187744
257eaf0aeab0be8071b2959bfc1c70c2,18,13,3672,1497,2175,13,12,4209,2087,2122
1f31fba7095289f88b86071c9d8cf76a,161,140,483271,114995,368276,181,154,548126,89082,459044
b3beffe6528e0db5d5adf5cc0d9f0cda,132,108,316198,82849,233349,106,91,276016,74671,201345
6f019cfcee527dbf34656210ed94dbf0,59,39,44954,12453,32501,52,39,41027,16081,24946
221f59d461d573dfdd1a5680d9aaacaa,34,21,25760,7473,18287,30,24,24692,8611,16081
b494e7390b2a121e8dad40c3b41e6c69,56,53,120619,24494,96125,86,73,113378,33912,79466
fb444a147f354dbbe90c0f9e652fcf7d,31,24,21322,16040,5282,35,22,39086,10692,28394
4dcf6ada3506c7fee9368c0331309d7f,155,117,477196,87958,389238,163,91,417938,70258,347680
8bcdc53afdd2b617606b31c09a35e3e2,133,91,424652,55901,368751,136,121,394498,89272,305226
b28394c72f6aafd2618df9427497751b,131,110,263143,59061,204082,141,85,273582,53123,220459
645c6ae6f1066ed579d01cb0381425bc,28,23,11967,9706,2261,37,27,20990,7972,13018
6b051f1d6fe6c005d9312d453d312b61,23,18,6166,2814,3352,20,21,5887,3312,2575
b822b9840edbcb2d675b9e55a6fd243b,129,94,268594,52360,216234,166,99,266686,52001,214685
1f6b22d7cd8c42acb0fdc4e615ef632d,179,125,791280,192067,599213,218,171,1006605,171752,834853
128fd3bb724b5281d412d08e2473498a,75,54,117615,30402,87213,80,56,141091,30860,110231
8bbbf11153e9cdaac9f50e9cfd4ccdee,63,51,89218,21447,67771,53,44,71230,13146,58084
e358aed2a2bfe06365bfd841a5ab52e2,41,34,32337,10072,22265,38,35,16600,11479,5121
d1d654e41d05591c763fe5999e2fb2de,111,102,340067,51684,288383,112,98,277287,58872,218415
8933b2391fdfaa5df7a53ba4d4d72bf8,34,37,43763,14258,29505,39,33,29377,11190,18187
6855e1080ffbae42c31ecbbda1b23821,101,77,222691,76432,146259,130,95,280719,55602,225117
3c9a73199fd2a85c9b7e3cc6a0fd392e,118,79,198000,63412,134588,116,79,194903,62543,132360
1866db10635a5331a2e286feb3c225b3,154,96,412964,75572,337392,168,139,634527,121310,513217
aec86c1eb4104700ae93d45fbc4ce70a,16,12,2694,1179,1515,16,12,3193,738,2455
097becb1a1b42d5eab340855e9b12fc7,18,18,7786,3708,4078,19,15,8255,4575,3680
c0364e603a36662185deb5655238ceb3,154,97,350383,41973,308410,159,125,350181,64044,286137
da986009006c5353da983433a474741d,48,39,106072,24310,81762,40,42,58013,30344,27669
516db8b270b177ad8addf76854c0fc9a,118,93,380260,61059,319201,170,154,445767,117893,327874
6bd29e6533d1a10b419be9200a304f15,109,75,207178,41119,166059,76,58,123607,57520,66087
cf28b09e9c0dde810babb2c0b22b2837,140,95,359030,55481,303549,131,95,309383,64618,244765
e1caa2a4f08be2a792171e3da0272850,43,29,40503,11880,28623,35,35,29255,14160,15095
87f7d3dbc11c35c13b0ad30abb514aaa,83,83,171091,49682,121409,105,91,175211,38541,136670
0f444ee4d1f160c41e9ccf86ee19e540,154,111,505386,97147,408239,213,157,709053,135845,573208
275ceb55603bc9effdb20c6a9b709ae1,41,38,36446,32389,4057,76,48,128031,23267,104764
c8f782f04ba0995cc1707e4f8d7cf790,70,53,129901,49722,80179,96,69,187502,36505,150997
9aedd907229f8ff4ee45ecf1b1d582b4,101,75,148665,34059,114606,103,83,150785,33813,116972
fec482f3c59f6b528b11b96c8a715c84,49,37,69310,18411,50899,53,48,74311,20606,53705
4ef638467f6899abe2632b98cc0c7532,16,15,6262,3083,3179,24,17,10615,2829,7786
680138894e9830944013a7c80919552d,125,70,320579,136003,184576,149,93,380834,123116,257718
7dcf15b8d11c91027ae52dc7d4c5c3b2,141,88,336387,77019,259368,141,113,413716,119526,294190
6bde341c56528ff73b3ff634f4a7c1ba,130,101,332519,72085,260434,125,102,371763,60364,311399
84a1f9c0416b7c533453903599698877,109,80,294309,89080,205229,144,105,379242,83043,296199
eeb612148e39b645d9aac3a8f2200e7f,4,3,807,308,499,3,5,510,775,-265
17f8920f30f01918682d0e9cf332415a,45,35,43743,19190,24553,56,40,61798,15725,46073
4f3df71fb4352b1c412e6b0e35dd5c94,11,6,1588,655,933,9,7,1723,632,1091
304b91aa0a8a1032f815e32de9b95905,153,126,450561,118069,332492,133,111,501564,90953,410611
bf0d931d3a0c9128ab3d9205715bbb08,50,40,69521,31997,37524,52,36,66259,29522,36737
0076bc23568fe30cbef87918b4c603b5,63,44,57918,20321,37597,47,40,61341,17838,43503
3bc01aade74ca1dc344ade48936c58ba,131,104,261383,61070,200313,132,106,288348,69179,219169
a043f0be26242439f23812d38daeaad3,101,77,270906,96640,174266,150,112,513374,87708,425666
b03077646d7994900123b710326b7f75,103,82,152030,47675,104355,129,95,198092,35001,163091
d7bb0e8b84ab7a9cbfd10b32c135b721,95,70,102939,29669,73270,104,71,106088,23034,83054
af84e0e7d0ad0e44918d58b4d26a0484,38,30,32480,14575,17905,40,34,35384,13498,21886
1075342c0068fdd370e5700e813faefd,41,28,39951,14731,25220,46,30,50300,15026,35274
bbebd822223e80802025c4d5c6e26f97,101,85,234643,66674,167969,118,83,340567,52185,288382
049db41b145c09c530e2ea5466c03271,45,35,46801,15140,31661,56,44,49839,20558,29281
901cc95d55a58e2e22dc870378ee6b76,133,101,282619,56935,225684,116,105,276444,74798,201646
8f0ec00876739ad416c2d6c34ca371ff,81,56,113292,34597,78695,65,57,94857,28011,66846
96057e1a76d8fb1267e04f3e5d4193f2,125,90,402382,159974,242408,180,141,472044,135985,336059
746228a3fa693c7618fb4de887770967,12,15,1901,716,1185,17,8,2755,707,2048
1fc36bfe199eba50792086e0dc6e7d73,97,84,177857,62276,115581,108,80,184707,47427,137280
c9674a4f075a77f7603d2932d37d9b4a,72,58,100180,17820,82360,52,46,82786,18485,64301
b3afe06528a8077f1f426cc3b7da297b,20,17,8712,5874,2838,28,24,13778,5342,8436
f06ed713aa42d351b3e9f0909226fe7e,135,110,391347,85965,305382,152,106,498403,83380,415023
7343ec45c69bbf1ec09174f5c07dc31d,31,23,24233,7262,16971,31,21,20313,8845,11468
8beb5eecda86c2d2e4130b314880d47f,98,84,197260,57792,139468,111,95,205758,44347,161411
603867452b8cc538f25306f117119c72,64,42,79284,18297,60987,60,53,53716,16884,36832
44a5d7b6933429a2f807a43dea31d81b,77,61,144134,40385,103749,56,48,127576,33961,93615
15cc688b852844e06364fb56b5745665,25,21,7963,3203,4760,21,16,6173,2875,3298
0f76cefa541d2d66a446d3ec72872a74,58,43,50382,18833,31549,46,37,53599,18943,34656
491571471140014b153daeb5e6a3b17e,48,45,98757,31896,66861,62,53,108086,30601,77485
bf8777d82483bf48e0b3668e9017e965,40,33,46538,16119,30419,48,36,60318,15636,44682
a930ab741e41f0d71c46d2d54c4c2f77,50,48,68895,29605,39290,78,69,153050,31806,121244
1da7d3371a3d5202c704e66ae697a370,14,12,2159,1155,1004,17,9,1981,1087,894
95794c6fb797f1b3b1a3674a034ab2dc,123,89,200250,80499,119751,125,100,303330,66985,236345
cd5daef9039194772cf8a0cea37f657f,169,118,560259,66812,493447,163,130,559400,97222,462178
1504372ae993202fd57578fb8fde87ce,106,89,201476,75633,125843,141,118,307470,56455,251015
b4aea79cb5da74bd607e2c0f54271b0e,120,90,304030,57179,246851,121,98,291992,58325,233667
413c81bc92364fbfc2f40f5404250a06,57,42,75903,25958,49945,57,43,63699,24992,38707
a6e062e4cecc2b8caf7c7dab63c0ce4a,86,62,187437,39834,147603,80,69,174347,49656,124691
bb10349aede4e6862641a17b5f5324fe,79,65,101343,27002,74341,92,72,124118,34243,89875
c090aa98c20cf52a43dd694d667a6166,18,18,9123,3450,5673,18,17,6461,5153,1308
eb976f53e69331b5383127913bf013a3,111,86,250678,57272,193406,142,114,287606,42664,244942
f9e6b2febe9efebf1e85b66b68ebd6a0,57,53,63931,18332,45599,45,38,42982,18374,24608
5275ecbc0e4d280ed0d62d407a16608d,103,83,240615,71412,169203,96,76,211177,79128,132049
3cd0b3a750988c0a3fe4b44456dc3bf0,77,62,118348,31984,86364,69,59,113303,30671,82632
6ca04331fb7fb6e8b321d38a512f2856,71,55,173096,35477,137619,77,66,103142,47304,55838
c419197c999880e319c3421dc5945050,119,89,263818,55885,207933,135,99,287978,68377,219601
a5030e6df898857574776b0806dab610,183,149,1014122,176246,837876,237,139,859245,178973,680272
a72867338641e53702577185ec6bb03a,105,76,174302,46141,128161,99,71,167900,48295,119605
d747aae6f6f8ae4d23fd2e50164dabf7,63,45,95725,35060,60665,77,65,120083,32024,88059
cdf0d9d3b356fd90f8ea3f3d9b74cb87,96,71,137598,32685,104913,104,69,137619,19613,118006
3c9005eac265cc1e2bdcee91842ada4b,20,18,3210,1773,1437,18,17,3610,1865,1745
880fee0b9968036fab1c9e4caf9855c8,76,44,71221,23385,47836,49,44,50491,23155,27336
1ba1582b56608bbaf6c94a63a077ee28,14,9,2157,1199,958,8,10,1274,1504,-230
06f7d1bac8f7b06fd4311e0bf03dbd20,90,75,140150,31301,108849,91,74,155899,44594,111305
dd978a60550b4bb731570bf8feb83fab,216,123,469747,89432,380315,173,141,524059,112232,411827
faf6692dfc29f5f48b4c049e48c58426,89,58,130951,30360,100591,118,86,130017,36977,93040
ad724fb0ff6ead096b3000fbb1161a36,45,33,48437,14400,34037,41,33,43134,13535,29599
7278050e23b94b339b9f3d8b4998cf3c,120,82,292957,67794,225163,104,80,246864,52702,194162
a9565a9d40e8da66c36d4ce4ed22a9b8,55,45,73146,27599,45547,65,49,102726,28586,74140
3435a4f6a060c07de56ed5fe99ddb6d0,120,97,264406,58055,206351,117,84,263934,68238,195696
cb26d46397e9ca915731c14887f6c5aa,117,94,255440,60717,194723,100,87,197201,68674,128527
1e3c77ee05839f5daa2d1a6fdf579364,78,47,76007,20766,55241,78,65,76634,26903,49731
8460820653d919e975860f767569ae03,51,38,38868,17431,21437,55,41,44652,18423,26229
edc80e2641d54c2f3defae31af165235,113,86,432221,97193,335028,158,124,427097,103356,323741
57a5aa502c0d4ab7e0e7426293847eff,196,144,810545,163631,646914,229,169,837617,161210,676407
9ffd14bc063c975469f76856aa85bce9,120,105,301016,67869,233147,120,101,314539,72579,241960
7252290fec86410551971f92efae933f,58,51,68519,21988,46531,42,39,55215,12769,42446
2fc14826f3c82f655fa3ab78e90469d3,49,47,82412,30720,51692,59,45,91133,27047,64086
1f210a3ba32848e671126de28c4745a8,145,106,483567,82124,401443,149,104,514342,82804,431538
57ae1265c0aa197792c2a646ce1bd4ff,120,87,280813,69943,210870,143,122,355190,101941,253249
be909633433587b2aadb74f97fcf7d43,51,36,61297,13726,47571,42,31,51531,14644,36887
95a0cb05fc33132180871d31dcc4e70f,78,63,135749,27226,108523,37,32,60379,17317,43062
c79b27e4c322fad2b4e21f1274e9915e,112,87,247912,59516,188396,119,92,215909,55385,160524
b268da1f4889b73066010a408f103b0d,120,85,259697,77751,181946,110,85,226084,75714,150370
23d0fa5892997d23d69bb032412598a3,98,68,171586,36830,134756,82,66,128272,51304,76968
7692b302d7772c7ad08ccfabc0e7da9f,143,107,350767,59435,291332,177,144,485394,63017,422377
ce4862ba92c5e7916e75ecc17bd4a061,164,126,511365,128738,382627,180,131,602535,95254,507281
002bcdf6551429848c09fbc8b814b9c3,77,43,90090,21395,68695,78,63,155818,27085,128733
761e8054ea7d0339f146ec1073359560,127,93,260338,39197,221141,103,94,195235,48590,146645
3387d669691fd5dc9b13ecfa978d0d76,145,114,381291,65154,316137,138,123,395121,55670,339451
8508002fc07bdb4306ce3513a6f9dbf5,128,80,289353,91560,197793,108,90,249294,99681,149613
cb6d0afe1cc6367eb82069fc26e73f0b,101,66,212601,77193,135408,138,87,288672,78513,210159
8738e5c9db816dfeaf66b341c5c5b934,4,3,552,348,204,2,2,268,433,-165
7912d052d04866f4a1debc18733696c3,141,98,401745,102636,299109,204,123,685750,80117,605633
dd0343847c784150266624ae0e6c152d,80,58,161866,33613,128253,87,79,154347,54899,99448
83499a722532cdad3383e7bb1487a6c1,59,45,84132,18851,65281,54,52,61210,26025,35185
9a5bac5d815ffa3dedd580c2d0b40a98,39,37,61000,31685,29315,73,52,107718,28285,79433
920a51c3f976fa5d0d885b9790b15ddd,115,99,382284,78939,303345,132,102,348339,80526,267813
0f4accc5f1721037f534904fa1277b40,58,41,84909,20319,64590,52,41,68868,26144,42724
62248f6e949a7fcf3bb2f1bae8cc9554,155,119,452528,72855,379673,119,101,286927,73799,213128
b602f403db238efe2dfa228aa82fa66c,50,37,51714,17123,34591,38,24,29330,12938,16392
6e89fc880f25f0faa0b1cd946740a7c4,161,110,477719,87193,390526,173,140,550310,122631,427679
e093574307773b6a2cd262991aa4785c,112,87,228170,67706,160464,140,128,371059,91908,279151
d5fb9f62c8ea3ac4815118290f5b0f11,91,75,119621,58439,61182,109,82,202746,34704,168042
bc02192d6f0d10ea9576b463c2123658,174,125,461175,75655,385520,143,110,396452,93576,302876
c0fbc34c03d6a36776d9b4f8f66c334b,90,70,139860,31200,108660,64,57,103663,29278,74385
4ee6b2023621e6d592230e4aafe5fdb4,5,0,450,0,450,3,0,393,0,393
804cc6bb44a9ec3c3a6a7be3733d688b,71,56,114350,41111,73239,118,79,155779,53091,102688
aa6e2522417b1229e0cc502a9bf9cf38,125,103,248783,56919,191864,107,78,252598,44892,207706
e2d144a8eb5104b5b68dc8c68981bfe1,65,48,56464,29907,26557,69,53,97147,16143,81004
a50e51ffd134d61e74759c1943dfee39,20,19,8097,4400,3697,26,20,7686,5192,2494
631c38a928174eb7da2367dcef8f471a,30,24,13878,7708,6170,28,25,17004,8761,8243
b7993d5baf3258f6b37cbf53f4d1869e,131,112,349271,99213,250058,141,109,389678,69405,320273
531715ea3b8a897a9da3dd547f40400d,60,35,67695,16386,51309,51,39,62803,22061,40742
27188006d9d0f9044dc9371ff35193e6,134,103,318622,82351,236271,122,79,242586,62511,180075
d2afb387ea921d6b31a6bc71135a7da3,10,8,2032,1166,866,8,9,1308,1302,6
1d0bbb7edb0a826a5d2055b837fe597b,94,74,209439,41691,167748,132,113,276972,64228,212744
4718dcfe325fca1daf6104ef4f07ea06,68,53,112249,24430,87819,69,32,81999,18069,63930
1deacaf529a5441733bcc5640144243f,190,123,504215,128524,375691,164,109,580378,142450,437928
60addcb030c3fec0cf2a79aa48ab6fc0,32,23,25633,8914,16719,32,27,30765,9356,21409
a230226159d3e8b356027324bcf36c31,130,104,285493,65449,220044,133,119,397315,53800,343515
4060e115583ed198a1d256910a076ec3,92,77,188735,59230,129505,94,78,187972,60908,127064
b5de8d945af7f1eccd7410047d6a4849,157,128,392232,84046,308186,130,107,372199,62545,309654
cd3f9b0b8d0fb87bf87716b9f70136ec,133,104,270806,78365,192441,191,148,467801,92411,375390
f3f95cec4fd5df24edb641488d509428,47,37,80840,27773,53067,66,49,95627,26679,68948
d0d753b1d1af4915358ce3f08fc87afc,76,74,125600,37200,88400,60,37,90435,23303,67132
17354aeab43a807a10505d82c35c542f,100,85,247492,57460,190032,117,100,262759,46968,215791
940448a9d1384f21cb99ee4ae0f227d4,90,57,147268,22164,125104,102,76,224109,37437,186672
c265be3eed5e3e50f95416c1cf85ba8c,191,114,539900,129137,410763,177,141,495303,132508,362795
b572423796031f208469ea661aaf41aa,45,35,53804,16232,37572,44,36,52099,16301,35798
1408fcb67b9d3a6c5cc4afd5f42da8c0,117,90,250609,56745,193864,95,82,221644,55814,165830
c6b1828c66a2eb891f5e91398e1cc6c6,91,70,197848,74684,123164,129,91,360291,53844,306447
d6b89215f6f5a89afcaa4136044b0342,22,19,6602,4700,1902,22,19,9862,4408,5454
b41b08090a63cd740ae7877a195bee96,99,79,166002,33438,132564,90,77,148255,50778,97477
28eed603a593d56b8ac0e9bcd59d1249,56,42,52116,13427,38689,65,57,58730,20477,38253
30173e787c819d9db8fc5e3d21e3f6ea,36,21,27051,12241,14810,40,34,33694,11975,21719
13b131cf57734bd667e93ffb930f7fa8,53,41,44649,16264,28385,46,39,52752,13983,38769
afd16f53bdccf31455c1b4b86363dc7d,83,72,121355,43268,78087,101,72,160598,31937,128661
5d11a9b3cc285c857cff18c9c8a72c92,151,116,482064,99035,383029,189,161,655376,153365,502011
542e4a97fab871bd465980e850783b5a,65,61,84168,30088,54080,78,64,117479,32073,85406
9dabc4d2d2d41daa829ed3ebce3d0a47,32,26,21941,6406,15535,28,25,16766,7168,9598
07aff8f5e6f245b45672aa42df0d2e64,162,105,444110,87823,356287,169,123,398112,122179,275933
3fffac2d1d8140db87647e99096b9879,45,37,58607,19539,39068,35,27,48028,13573,34455
7812d388148dc72f3f0ed54683cbb5c0,54,47,76033,18609,57424,57,46,74703,18629,56074
9d352f06e50f255c48b04bbc4bd51374,28,30,33142,13957,19185,31,27,33951,14125,19826
509cb7a8e65503ae455c3fd8276ce91f,79,56,105327,39881,65446,69,54,122644,28911,93733
16db56130b4e163291c45d3f887ba252,131,107,388487,84868,303619,149,125,511183,89007,422176
3acd659455a4b0faac1286720f08ce0e,185,126,621022,107561,513461,208,171,718803,159818,558985
b26a7c389437ca11fd413527287f8d0d,64,55,65853,24018,41835,49,45,47703,23077,24626
beee7212a4ad6c2bb271f606cbc82a96,79,65,109795,26745,83050,94,75,140082,28133,111949
49258cfa39260ae494baa04e90aaefe0,46,38,44770,17460,27310,52,44,61398,19871,41527
d140b24649c1933113c5609a079f72cf,90,63,132349,36884,95465,103,73,178935,39003,139932
80449b04c45850e76cb85e3ea7855591,96,68,131967,27077,104890,67,53,105719,24242,81477
6e4d7cdef2271c207af27fef9accc9c5,7,3,719,282,437,5,7,560,765,-205
91a96e6d836970ad773629de0b93417a,173,103,684110,100023,584087,162,140,645115,124605,520510
0f6f02a47d3ca20f13352d7f88766613,30,25,14505,8011,6494,27,27,19592,10025,9567
15003d5aa989d51a53458dea2df09df9,58,44,70286,18266,52020,58,55,56707,25396,31311
27b18b951dc32488dc545e7b6dd55d02,93,80,131382,45960,85422,113,82,158996,43475,115521
e37645660c164fdbe3980a61fb8fac00,118,90,243229,51636,191593,118,94,217093,45770,171323
87ebc7f4d6381fde48f7f7318bdfee54,167,109,490067,107292,382775,170,127,492736,117058,375678
c80a8d078095fb53745856434db7f25c,132,123,372784,78513,294271,106,94,233857,90952,142905
6c9ee8914cacf451e442d43faa808c7d,138,109,318874,43461,275413,130,102,272875,52904,219971
8deab13f2352475459ff21ebe293c0ee,139,86,270197,44588,225609,126,105,246238,63237,183001
93bb1805be0ebac9960db6a9267d790a,107,74,204049,65538,138511,150,99,359313,60402,298911
54bc3885874cb67a566efcb7a8df3055,191,138,769652,113664,655988,194,135,849066,109512,739554
93da6884c81b5f54284b564096bd7c64,78,46,146561,31434,115127,95,76,138882,52407,86475
3619e2ffb3a99d3e0766a86694728b64,145,107,453259,81534,371725,149,108,391445,99266,292179
c1c3608b3a0c6201eade4814a6131355,181,148,631774,128360,503414,133,105,459350,131457,327893
600d04069ea4677d0eb0e4a259680b21,138,99,361406,50614,310792,153,131,396250,49170,347080
7f6b7cbf8db8ecfc8412b30eda0ab0f5,104,84,145888,43388,102500,80,59,124877,24352,100525
af88812c3d620fce2a4d56e10713390f,202,171,925908,238766,687142,186,156,953246,132137,821109
e98ceda0407e4993316b6038cff0d294,21,16,8115,2973,5142,22,22,6526,3487,3039
92301ce9364e7a2415aa51700af06f6f,125,95,370943,80059,290884,169,132,482452,67106,415346
e0e46d3a0f0386202c110d12cfd72e4e,69,57,114774,26521,88253,61,46,63236,27617,35619
e7662a3700d6ac172093881c05a95463,107,82,280331,69265,211066,126,107,307639,85760,221879
76c17f7ac79ec07db02500e763cbd7c5,60,45,77113,22979,54134,44,36,54068,22077,31991
da899b9f02bfdaa2e3f35b4bc6f8d8cf,47,32,63019,14981,48038,62,45,63452,21897,41555
1938ecb55b26bc789344fd24293bf690,44,38,79860,24991,54869,40,32,48835,25865,22970
678003bbcfbc7ccf76c5355afd6d205d,124,107,278807,59964,218843,135,104,346849,72972,273877
2967600c54d0321a62f9eca71ff323b6,97,65,249915,66048,183867,112,88,222922,65861,157061
6fe3b39a8249608b5110cd23b3fb7eff,43,36,86274,22236,64038,46,36,53580,16264,37316
8cf7ef4a51734114b1756076c5d7efa7,48,35,73448,19500,53948,38,30,63262,18249,45013
0ac6fcef4fc016c9d6c74f4dd1dc175f,166,137,493641,131939,361702,194,153,781189,103785,677404
3b77aee12476290171eed25c7fe273e4,158,120,740126,125577,614549,194,167,615366,152901,462465
99d51cf77a1e4149bfb4fc5f28e65d4a,28,24,27569,9925,17644,28,25,16061,9446,6615
25efc1f06011535eff368e80d2dc0203,66,49,70175,23885,46290,61,44,67179,21282,45897
9d4d04a9f8f96c49ee2a84974337cc0d,158,115,557445,124686,432759,172,127,565831,123869,441962
783cfef20cf031a560af34dd995842a1,61,44,79298,16647,62651,45,31,50984,16640,34344
0d057ccbf859c1f27ee536ae212c366d,33,19,25905,9676,16229,34,27,22512,10999,11513
67ffb185af23aa054eabfc4d646d9e05,30,24,23136,11117,12019,35,26,20821,11068,9753
d2bce8c98e6772632715f372d6e3153d,108,75,209407,68622,140785,128,102,318778,53821,264957
66f9416be51718cefdf8d8f1a6e7947b,121,95,327180,86498,240682,142,112,354771,92897,261874
82ffe22bd276f2327fead79be1843ffa,148,117,371774,57794,313980,178,158,487726,102179,385547
3c55d557d5d2de7804f87b7557d654a0,69,54,102424,21699,80725,45,38,73069,24873,48196
1c2596684be05e0f0fc0fd335ee693ae,118,98,314780,57004,257776,116,89,251074,68988,182086
0dda08e04ea6c5e9c915f93fbb9909a0,17,12,5914,819,5095,17,16,2545,2228,317
d94b13fefa33288e7bec43018857e989,93,79,175315,43974,131341,83,70,148659,47252,101407
af60f72f344378372d7e656ea25afd3b,69,65,106368,37689,68679,65,50,109880,31218,78662
b9655c15f13e1b614525857d6b9d9178,78,54,159588,32210,127378,57,48,75777,39128,36649
edba6cbdfda01884dde88bfe6884f80f,106,96,271430,82615,188815,127,93,356460,61844,294616
076d8152161bf7cc5c6525daf879996a,80,59,199585,90160,109425,122,106,260214,91048,169166
b2fecc3d12b0a09bfdb1e39f3ead92c8,85,62,168395,56346,112049,73,60,172726,48454,124272
bc0ca06979b3c99e547f6f42cd828f0d,100,60,130919,34083,96836,128,103,213742,47622,166120
c9e3db3b09e8edb0f8759dfd41dfd8eb,118,84,411968,98658,313310,174,119,557530,82015,475515
ae84042cadeca1c9a0767f1606d4005e,33,28,65400,18080,47320,42,29,50329,20848,29481
bb1e11214034c180c4bdbda27825acd7,95,86,415972,99266,316706,113,92,350107,127611,222496
bd9557a997ada42037152d1016a9a2a5,103,81,141935,30361,111574,96,64,119822,28403,91419
1c14ce14c844970a0eb3d9f4b9ca6efb,37,29,23122,10013,13109,40,24,25881,11824,14057
f63dbe87b4d33bb5c28ef9f48a1d0c95,126,109,297633,49277,248356,85,66,149332,49534,99798
5b91f671225256f4cbb54b18952a997f,176,149,492424,114764,377660,140,110,387435,134687,252748
4dd1cef38d82f941583f0ac013976189,21,17,8601,3378,5223,23,16,10489,3458,7031
144f0276d1b94bbea7af4e1906f9dd36,48,36,45848,20791,25057,48,35,64238,26684,37554
653e49b01725e1d2e7130b0ab11940a6,51,40,70282,36894,33388,57,45,102292,36231,66061
380ff0467782d79e404716d705cd3d35,100,72,172008,55672,116336,66,62,135634,60705,74929
866b05fd340b44d069ccb4ef1cf2ce24,36,25,32084,14733,17351,44,35,53170,14956,38214
7569b5c4e7f25013a9374b5c1d2e0fc6,191,153,631963,103577,528386,143,108,414476,85611,328865
91c183f74e60e1705a4bd0cb1e07261d,155,114,314470,63815,250655,128,105,375610,53877,321733
020049e292cf892bb28dc2b65364b4af,166,137,388502,68510,319992,147,115,365738,86856,278882
f5678532052c5b9edc9472d1b422076b,117,87,300281,80167,220114,147,122,387820,96066,291754
293ec5c03af93b91598dfce56573eec0,157,114,385299,73615,311684,185,131,456183,70894,385289
dd90be502f58a1de4ddc9e3fcd661bb6,34,23,37777,12858,24919,38,30,35541,14915,20626
f1d5cf2a7dcfb195e98806c805b05e35,40,32,21454,14944,6510,39,33,46814,13233,33581
917292c284ac630188688c884ea52c60,41,34,28424,17912,10512,53,38,52305,14082,38223
0715d567cddc00c2b4a7d8b91e2fa436,33,28,31398,7692,23706,40,35,41252,14311,26941
35693d6929d48adb1e4b9ce7e6a0f8cd,35,23,33373,8293,25080,34,28,21756,12768,8988
b51d952ea19d21a7a4b198fcc698594b,45,38,51102,24327,26775,56,45,53961,19629,34332
14a9c6bfa9842ed591151aaa83be92a0,103,86,206420,52619,153801,66,55,137041,47046,89995
77f9e489071dda9ec0cff58a3af85934,185,137,453155,79963,373192,159,104,380923,77922,303001
1b424797f316d9e1a3845512d48b8286,89,70,143567,35389,108178,101,76,167740,39397,128343
746bb6cb82807a2f4e95806f8545e8e1,102,82,209580,64645,144935,138,94,262191,47195,214996
a4816823ddc00eafbf741b4594cb0899,0,0,0,0,0,0,0,0,0,0
382f1ad8d0c2234be9f171487ec1136a,158,115,366513,81176,285337,123,88,376192,79616,296576
1d73d2c5310b96f10afdd1d7f6fdc008,92,66,142531,27235,115296,116,87,166759,45918,120841
a29d16b7afcf218bcb149578afa19dcc,16,15,6109,2742,3367,21,14,6230,2491,3739
35bb420858fc53d2ee3803ef6a74a549,75,65,124511,37823,86688,71,64,110210,43589,66621
1785d98409dea1b332c6830a22b34368,177,133,621655,144918,476737,223,128,619909,134777,485132
05f31f5c2223cab22c94b76118c65ced,35,27,28120,10637,17483,36,32,24446,12257,12189
0f7b3be4ab72a46c23403b74aceea66e,151,118,476909,98736,378173,182,140,415241,93543,321698
21823afa2f6f8032c108ae923fdce90b,54,45,76242,23247,52995,62,47,85026,19862,65164
047aabb645f3c04d813c8aabec191dbf,39,30,37977,16304,21673,51,36,60017,14417,45600
a3ab022c3173a83fc6ae5c8913a23cbe,63,47,83935,26409,57526,82,75,136101,31641,104460
c89f80be05690b4303ff2cae1f2f951d,106,93,274994,85400,189594,132,99,349909,100372,249537
569f7b5593275de35f0eca276151c312,177,131,411722,94411,317311,140,77,336643,74780,261863
f5ad4b03e9ffb9dd4e390bf69d61b410,136,86,337403,76836,260567,108,86,283594,106261,177333
e98c4de9a958de7662f46986437d52be,84,69,194501,57510,136991,113,97,203896,94067,109829
8a0bfe8061f6bd6da3aa96b99c46d458,60,45,63999,21716,42283,53,44,50284,22375,27909
f3fb6fa976eed0482648ae9883064d7f,209,164,909200,166522,742678,225,152,1072360,127347,945013
8db75f07c307783d4197eebb83567335,139,116,276475,75926,200549,97,82,249657,70702,178955
847ba0c188241945a61bc2813b53750a,124,106,337435,119194,218241,142,121,448938,94588,354350
cefe9743e34368e148985971eb0f88c6,188,121,558431,88915,469516,133,89,333235,115053,218182
460295a9129673e1293ddc7c2bfb7bcf,145,112,313792,47878,265914,146,112,313141,33541,279600
010e689359ca27f0ab39d7bd09de0dcb,210,142,800006,171261,628745,208,181,1063612,141144,922468
65a4897cccc8ae460d8b3153f9869364,112,85,228593,50175,178418,122,78,236736,45448,191288
031a6c0db83f5a97fbbf0c3e1e324c5e,107,92,180575,44788,135787,83,62,149156,49082,100074
cda54e71bed8a051c0e4bd64d1124659,125,101,275921,140779,135142,108,82,279741,95858,183883
886ab62ca78c9b5fbe9f2632fe541d6a,161,114,461369,66624,394745,68,43,190713,64657,126056
d0c47a3b36d8db8da29b0d632a431b7a,65,57,93063,23778,69285,46,44,69816,21594,48222
43d9975f82cb51cdf275328528e599ab,68,46,72989,23207,49782,52,35,97659,20299,77360
ff5a465572a9dbbb16319eec58e0fe3a,44,40,68015,19641,48374,39,30,55788,23884,31904
69070868a772fb2a153f7c9ebddcc759,41,40,65539,35299,30240,57,37,92174,30742,61432
5ffbcaf8df5617b0531d790a83f18129,187,133,620491,97033,523458,145,108,455589,94673,360916
802ec254527f84ac1985cf366b795236,47,32,57624,18707,38917,41,40,36503,18243,18260
ce2efea943d09dd70d2a619e142f3602,27,20,14870,5171,9699,28,20,12586,8130,4456
9cda3d84c2dc37d67f0c87e88c8ae7a0,105,80,279059,47553,231506,129,115,291207,52400,238807
1acf3c2c7bb9d63f6ff9e813aa33c128,55,43,97050,20954,76096,52,38,74062,23428,50634
7e1505b0506fccca6afd2e13663d8426,67,41,72650,21536,51114,62,42,87923,23393,64530
62b3a3e757cf08b539539ca94533571e,69,60,109568,25221,84347,78,58,137228,19013,118215
f05464f445090388cc0e2ceaea6e1b0d,171,120,407089,68817,338272,156,115,362863,74571,288292
7b5b358a8ea1204f907c9475d049f3f0,71,68,152800,47132,105668,89,77,177404,38730,138674
de7f88d667637b339d023459579cdaef,27,24,14255,8087,6168,32,22,17132,8574,8558
bba4274440af1702840fcd6d81ee4697,41,30,63407,26107,37300,47,28,84741,19226,65515
3d753028c452caf05b53dc4969f9bfb9,15,16,6029,2964,3065,20,14,2830,3485,-655
8d9ba99142cc9615bc299c243f1d7e67,196,129,821000,76116,744884,175,143,717607,132396,585211
9c42a1789e19c77bbf63d824e37c50f0,31,21,20744,10197,10547,23,24,21392,10297,11095
da6642f5734831d5b3aacff4290221cf,22,19,16904,5468,11436,22,16,14012,4827,9185
281d4a538b62548e59947cb36a72f0a8,12,13,2258,2608,-350,21,15,4670,1642,3028
1dc9ea2ccf504bcd433955b2bc67bdf7,60,39,65864,18353,47511,56,45,69175,13983,55192
8be38c7da42b7da91bac8d25a70b03ad,118,80,209816,31888,177928,104,70,134914,39994,94920
541efe3aa106214af0c589db89ab2641,88,63,137520,35601,101919,78,69,131209,38179,93030
992b0a5a420d3d53882579bfa564d70b,87,68,138181,40401,97780,77,48,61336,37511,23825
0cb02030c20909b2c0435b83a9b235ae,167,98,625435,115148,510287,173,116,777854,157084,620770
385c71833bc3556c8ea646dfa7cbd274,20,19,10591,4585,6006,20,19,10686,3975,6711
be2e50e55bb3f9b65a550c8866d3a6e6,119,88,287921,81239,206682,123,76,323344,98776,224568
72551b0f26eb831d4484c108a35798f9,73,61,103571,22419,81152,81,65,86648,21172,65476
2b0ed8bea560c8db30a04938946155ea,46,42,48286,23916,24370,60,57,59396,22173,37223
2584be63edfc249c597702a59a15f898,97,72,143435,34378,109057,84,67,169211,24702,144509
cd3538a96dd3bba0f33395c3529db156,119,102,254606,76095,178511,100,82,209140,65376,143764
82ec48072d01c6fe1cdfdfed4c70ab01,64,52,99823,36782,63041,59,46,96636,20926,75710
12e7bef67758400a4c3215dceb265b6d,22,25,9082,3859,5223,28,19,9926,5045,4881
25721166ff9389f0ec39347d01105923,172,137,530158,83696,446462,173,128,658432,94226,564206
dc38c1e8a1aac98f2da27332c852f04d,108,86,282401,72163,210238,189,148,587742,73798,513944
8ab452e013a0f5a0ced4b360d18548d5,0,1,0,75,-75,1,0,75,0,75
f1478f47df83fa38212fd48e17a6ffce,123,97,327917,96916,231001,106,86,299096,106279,192817
7cc25765aa124e5e797394513d7ea648,86,66,139562,29703,109859,84,75,96883,42685,54198
a2cafc5526f892b3615c8123a0aaa1e8,101,68,139730,46887,92843,99,75,172287,49884,122403
6e746f5c29c614a54235c97b1523678c,105,88,209398,78220,131178,106,89,266476,69663,196813
3720d66a64bf618d177512d747b944ef,169,125,470783,142994,327789,177,133,926620,163880,762740
41cec0e96622885b194284c297390525,85,68,181654,52165,129489,91,89,217319,60151,157168
d65fabc7b46b702959f17447e393307b,50,44,62786,33775,29011,87,72,113106,30945,82161
f3b8f1bbda25537e4c4822bd3eed0dfc,46,29,56853,16253,40600,77,49,70884,16749,54135
0d98e815f2da3de8e1046decef48470e,5,4,1093,1030,63,4,5,1030,1093,-63
080933a96e0054b402e7ad06a32b0f53,28,24,12201,5858,6343,23,20,10834,6524,4310
526b5fcf030e3875eab1f37e8d5de7cb,75,61,119628,38222,81406,98,87,125568,43688,81880
71939a36a48521b2c4c69b3f1aa272f1,96,78,222203,42813,179390,74,61,120040,44190,75850
8028ff5d1e15203bd295ef4b7eabf104,97,83,221696,86704,134992,154,125,423340,62805,360535
8dc4163a6a339706114f41a54763c78e,192,133,711785,154425,557360,195,141,801368,139718,661650
276847d07c6714d4c438f4657e66cc39,92,57,117841,25446,92395,72,50,83916,31634,52282
74b4eb227d0dcb9b348e869f67c000d2,61,49,96853,40190,56663,84,63,180232,36148,144084
447b4fd6b1542d5466ef80d85df63988,103,79,210278,81099,129179,137,123,360221,58851,301370
4400481dd38531f0c059b8d3ab450272,45,37,54060,16671,37389,53,38,65078,21758,43320
9e46e86c388bedee05a294e22e01ee14,35,22,16031,7599,8432,34,25,21270,3641,17629
d24d7b4217595d3eb00d7c63fcfcf14a,184,154,703491,94347,609144,151,119,533626,130416,403210
4a5e4567acc4d3f15191791b11b5e4f6,80,60,101472,29265,72207,70,55,84291,32307,51984
7759b7c867a3d437d34bbcd48bf949e6,27,20,12518,4391,8127,25,22,12296,4487,7809
5b3fb5416829ad3a5c0a8316a7c9bb20,108,76,165172,56289,108883,88,83,148226,46160,102066
badc00cdeb6e55cae72f874f2502bb58,61,60,74022,31761,42261,87,67,100873,22225,78648
51ad8abd2fe1bb907880d05b69c7bc6d,23,17,6734,2974,3760,26,19,5994,3439,2555
8e82952527a0dc5695aab1af7c1e7d51,122,79,217029,35466,181563,96,85,126604,47099,79505
00080e07b97d88a49811775b735eb8e5,77,62,212662,53126,159536,110,94,264859,54147,210712
4a21a80f8f358cb2c253497cbce9e2aa,37,21,19918,6250,13668,31,24,20631,6391,14240
c6067390a1f52585b1ba9dfe14e61299,68,56,67851,23107,44744,66,57,97584,24653,72931
6112e384d3c0bcba2fdb69be098aaf9a,73,65,156161,38410,117751,78,67,123036,38821,84215
4a0c1e89d89bc90b45ebaf0151195bee,164,126,584175,148729,435446,174,136,629886,152499,477387
91aff123524e2a43c17387804bc992ec,36,30,25197,10004,15193,38,28,35574,9167,26407
6a52a169183cd03800561ed54eebb1b6,151,121,373565,87006,286559,140,119,425253,92249,333004
4700c5f3bf9ecd15cf8e9f0f905daa02,173,129,911580,132464,779116,200,153,1024717,169188,855529
7cda26935e06a72d6efd09fef51c920b,147,116,614181,147191,466990,179,122,681871,155313,526558
c423f33de9ace053a2c16e03b9b66be2,52,35,79697,15538,64159,49,37,47827,26327,21500
d1b22675622656d36950fd6d5aa258ba,37,27,31034,15917,15117,33,26,23879,9980,13899
b37c793c7ab011216b76c05d2d345aa8,63,49,76407,38509,37898,112,101,192269,36448,155821
3c22229e49da75d93edeb966beb766aa,20,16,5740,3358,2382,17,14,5792,2295,3497
67d94fbafd7462ca38048d1979228035,103,87,348089,125571,222518,134,108,495013,100578,394435
861e0b24308490d9daa7f1dbad00ec8b,55,36,47388,12842,34546,42,28,36551,14967,21584
5cb549ca638c2529d13ac65ea0659300,27,20,16479,6416,10063,24,20,11451,7315,4136
c438ee12792266d7d070175ff16cfe13,109,95,308364,67012,241352,109,90,272179,66979,205200
e5da6da382aaa29b5d920e8417f878f0,24,19,8780,4283,4497,21,17,9863,4904,4959
2f141c45bf07cb026d70e0a3bb911b90,46,39,58345,26010,32335,57,38,64063,19483,44580
9ebbab7e5ac019403037a7d99304ce6d,22,14,4355,1462,2893,17,15,3710,1541,2169
60e620aa3b0b4f33ea8fe0feadfcc245,128,107,301914,61255,240659,130,102,252349,46453,205896
533be20b26e7435db14b978ac381a40c,124,60,176035,27034,149001,95,72,109285,32131,77154
231c1f761ea394b2091370ef520d2f23,14,10,3815,2351,1464,19,12,7589,2703,4886
a221a125b6196cea8d9f8edc0e265c6a,45,39,46466,17892,28574,57,39,63529,13956,49573
98917f96200464d35f22d8623e3629ba,76,58,85657,18286,67371,54,35,56832,14096,42736
596fb2806f9f574fa88e814a8659e6ed,189,116,435324,95682,339642,180,129,503898,102185,401713
00aa7a837216ccda625dfdfaa883b469,179,132,555642,131519,424123,188,107,537250,105455,431795
107c85133bc8bc49b833e4507947ca70,164,122,481932,118823,363109,127,87,368384,93661,274723
4d4604457ea662c9bccd006444b9b7e2,88,79,247525,111974,135551,90,62,199356,69443,129913
2a3a9c197d4c65aa48ce3bcefc9b599b,110,100,298814,75980,222834,193,155,582701,62660,520041
46c718181c9dc5adee17057ad0bad93b,210,153,711494,130440,581054,156,124,612112,117002,495110
47f8b77f2aa750b2a895bbee2d69ee14,140,109,352978,76168,276810,172,128,371396,65412,305984
f78f6df47d726454338201e5761836d5,41,37,87609,20764,66845,76,70,88836,32878,55958
ffd51f8ac8414f6442276ba9d07ad94a,181,117,763856,163845,600011,207,158,662519,137254,525265
9baa7c7328c3325a5778643ab690304a,97,76,200685,47454,153231,115,90,236565,47214,189351
cbe35997d6e52c8defadf578e1d6b08d,93,64,175667,39899,135768,78,60,123766,51135,72631
2ce266e1288e84b48059f2e9e67efc48,43,31,43333,11956,31377,49,38,39552,12753,26799
cab9f2070cb694acb3f3a0546098d6b7,29,22,25353,9725,15628,31,24,28329,8065,20264
422d0b350b492bf3fd41cc3122ad0211,44,33,30320,13701,16619,39,25,43489,8126,35363
2a79ff2965b4ea477e2be4842f1e595e,102,89,214082,48549,165533,142,91,225871,37178,188693
5085978895dc9822d10fed1d0f7fc875,60,46,79247,29015,50232,42,39,69161,29223,39938
ff97bf0cd23cbea2f9ca88fc187ee7be,131,87,463920,89618,374302,177,138,437183,85764,351419
f4b3fcafe926edc502e466996c7bcf24,165,90,487878,74728,413150,141,106,401419,85783,315636
8c4b6b9a71cb5a618ec696e5efc45c0f,29,23,15773,6289,9484,30,19,21089,4769,16320
e46e04877c0a57a458dcd47e1cb19c1d,74,66,102459,29424,73035,102,83,189570,20901,168669
289e0957b1bfa919fe2ab15a8e28ec38,94,68,137449,49146,88303,94,61,143771,37345,106426
cd300d4a33e76754b777ec2cda3002f0,110,99,189276,36167,153109,104,86,191942,44021,147921
e9cd7945b8185d0870be514e5018f244,67,48,90534,34636,55898,68,63,101372,31007,70365
ce31cd14a41d16b34ae8a28332338fb1,152,120,489870,61275,428595,124,108,415790,106817,308973
1b24b0569739d35f83c5d314d5d79de8,129,102,276110,71214,204896,110,89,222019,73750,148269
b7c5d71ffb23baf10bd0f299f1c334fb,88,72,167793,70229,97564,115,86,229868,55966,173902
02a352016f699127ca7f926ddb0e67a8,36,28,36826,9909,26917,31,22,18166,9816,8350
f609f71b0f34363991e98239b2a6a974,165,140,831334,175516,655818,191,159,833379,229622,603757
c0708e123c6ce508a22269e5767a043f,38,32,33370,22641,10729,43,36,61889,14909,46980
7d426180b3dbe37a133ca0cab22510bc,32,25,36105,18657,17448,39,28,57608,17382,40226
53e6a7182b7963a5c1f55b75bc4490b8,94,87,203191,65944,137247,94,84,188235,59211,129024
a2fd8e72d93c88c2414be98aa6a6579f,17,6,2085,664,1421,16,9,2077,1083,994
691f34b7408b326878391725db38ba73,124,94,375845,114526,261319,176,106,394566,99442,295124
6132bac13413e897ab91743bc41574bb,41,34,27639,14474,13165,42,31,41814,10401,31413
e62adbe0fe3e7afe1eeff1f4e0554af6,94,76,157086,37145,119941,61,52,89441,40853,48588
70ce06d2d5146c19f96540f0b1d88b07,93,78,141498,36950,104548,69,48,132582,26905,105677
bb6f7bbda17e1461e247b43297596b8a,34,23,27011,15755,11256,39,30,48059,10769,37290
7ac337732e3f6ea42cfa6270ea7e08ab,100,79,182052,43230,138822,86,67,141563,52860,88703
f8c513522c3a216741db58cfdd768481,55,35,54407,10583,43824,37,29,27266,9967,17299
aaa743e4212c0b9fa9eb8f9060104dfb,43,26,41064,11395,29669,45,33,54082,13868,40214
f3237b367237c97e43806069667e1ad8,174,98,517408,83928,433480,176,131,556325,95188,461137
51cecbcf119cd8ffe9b5eb4e179d00c5,46,35,34562,11906,22656,37,34,28159,13568,14591
9825ff2a1d7ef602fad0126323fa899f,50,33,38008,6645,31363,35,28,19246,8538,10708
67afa29306124e2d970b3fe1926f67a6,69,39,82303,22772,59531,54,39,67644,23314,44330
288042f7321bd161f4428e1b352d214f,32,25,21068,8131,12937,32,24,22830,8585,14245
5fc863c5807ac89d1b0f45346341eab4,118,102,264351,81806,182545,132,97,264400,64873,199527
452ce5db99b08daf5efe893bad55a8c0,65,51,89034,30783,58251,76,60,116188,25870,90318
8d1f82120198024788a0928a06372927,139,98,280563,37581,242982,104,91,183461,69084,114377
dd0d81ba9608a2dc16b52f4c5bdd2bdb,70,59,145921,61749,84172,156,115,296800,62994,233806
143cbfba347141c65d6a8e4446cf8f3d,135,97,314736,58505,256231,145,81,241356,51611,189745
4d2f49dd6be408ae50816e6561705a77,26,20,6963,3652,3311,23,21,6912,3383,3529
71bfa8ac62d226ea6e78081999d7ddbc,94,75,96700,40302,56398,84,64,114657,34477,80180
c27eb6007b444a6b607a8032f49de17d,138,103,277507,65728,211779,118,94,255387,59261,196126
af384de9d03e5bdd3213bd9400d29e51,140,104,295259,66256,229003,103,82,312196,75450,236746
20b94e79abc17b54480e6dfd437b1f87,179,119,626519,100310,526209,163,122,582380,154850,427530
3ca2e7fb0e0706fde76633a17e53b110,88,68,141729,34323,107406,90,71,132982,32880,100102
124f391eb962527d3affb31e216fc9c2,144,102,284245,54293,229952,80,58,131153,58554,72599
d523e3aad2dc46691a76e7ab335255ba,53,41,51736,14279,37457,42,32,35155,17122,18033
ade885188e360a8edd9668eefade5233,43,31,49907,13506,36401,48,40,56650,26144,30506
0dc8347315fda132844c7226e1cdcbc0,98,69,141853,31863,109990,70,45,114935,28545,86390
013f08fb232f2ef1407e33d6c0379246,193,130,787881,160677,627204,169,137,614356,136527,477829
249aaa2d65550748125ebc62e7ad9349,18,13,4028,1430,2598,15,13,4182,1349,2833
9f928b412e0b24ec7f6e2b46ee0642c0,109,90,260504,43966,216538,77,55,136255,39564,96691
20ad7e61d0e2ce680ad67d1b72965013,43,35,55551,21098,34453,52,35,62194,20024,42170
f07e3d18bf9880ebe79ef6b4ee5ccf54,88,80,148579,38758,109821,71,59,119374,31167,88207
f9ce37f1fb89d51b823b5746e1dff791,27,26,23107,8070,15037,32,23,29704,6360,23344
ca9a17e6529d253366aa6473da5e786a,119,84,199154,41526,157628,87,73,150307,57898,92409
f48b065a5b967bf78290e468ff07f1c5,182,150,819891,148324,671567,196,157,853369,146138,707231
2e948bcc0b26578ae2287780bacfeed6,65,43,65696,22550,43146,72,48,95169,19697,75472
9312b217de83ed5303ee87159f90167b,173,131,494529,111209,383320,136,102,353273,81304,271969
3d61f18463ea178a54a5b530ea0c9104,115,93,321367,131979,189388,122,109,621670,149587,472083
803d0a50f1cb90db1b2b9820f53bd48c,157,120,407279,75597,331682,181,128,441339,87242,354097
e600f82fa9a949a4e3f2e6c2ab7fd019,27,20,8638,5428,3210,26,21,12984,4834,8150
b5b7dbe21fe1d16a2071529d90b97ea6,127,76,345157,75397,269760,110,76,286163,81527,204636
590b902919176660b8ae24fcdac9256c,31,17,6446,2434,4012,20,18,5567,2031,3536
9340cc334dbf13348318ee85a020fbd1,12,13,2112,1580,532,24,10,5347,1205,4142
0d479a76faa0a7625aed70ff7bfcc563,106,74,250290,55597,194693,120,100,283581,72121,211460
96c8cbac09e5278c270c4bdb6613b646,25,21,9505,4182,5323,20,13,4987,2137,2850
ba629a94a7ca5148b5420aa6b9c18eae,102,81,260748,52992,207756,140,126,330812,60603,270209
1b87788d30b4c0f0d446ab56ee77c9b5,171,129,457884,78782,379102,192,149,607711,80166,527545
b6166103287c69ce26b2a65fb697a9e5,40,34,35001,12766,22235,42,33,41780,14844,26936
c8d1526afe7fd3f555824bbe28a061b2,76,54,109553,30383,79170,94,54,137677,28741,108936
e6b25e470547e9f4234b0c5d6d05716c,194,150,547238,93134,454104,186,139,594668,90973,503695
8fbc87e799ae3cc818f77b73b5180a8f,167,120,689578,168156,521422,170,118,625595,154074,471521
58ad1aea87033b2f6c55f256ed86e001,118,80,273478,60016,213462,116,95,287973,81189,206784
d4f58a6211a78b20bc044c905caca5e4,11,2,895,59,836,4,7,267,394,-127
158fb35768f235f59d1a4a70a9319529,159,139,364397,80518,283879,137,106,334070,74806,259264
0ec70f9883403a5d523bdde0f1040cdf,157,101,345810,69399,276411,113,84,269010,71125,197885
0d682ad485ee618dabb65d9eb82a74c2,157,116,272666,67388,205278,133,98,259603,54894,204709
14329ba0d771e060b056e27fca25ec52,103,72,318321,92357,225964,181,158,857285,92469,764816
b90db508dc5a1d93b330578c165c62d9,33,25,23766,7244,16522,29,21,18942,4926,14016
13c653e09ccedb541fcaceff209beb9e,171,121,568251,92351,475900,173,113,370936,89942,280994
76630ebf930e9e424fcbd03ef1f3d1cd,153,116,600921,141704,459217,160,133,525888,122784,403104
9ace42a61a78a6837ada9857a76ba0f1,121,91,252803,88841,163962,164,107,373192,64755,308437
9332d7d61b4139a4552f0504ef52e175,66,53,98757,35083,63674,82,72,101385,31630,69755
5faca50dc9bab91f410ab2cdba56e721,130,115,352596,78235,274361,113,94,325036,91876,233160
72aaa9d3436cfa665c8a1d6c528d37be,18,18,8407,5558,2849,23,22,10866,5239,5627
630173987c9f1731a8f2187d0668f787,121,87,289315,50625,238690,147,110,390784,69721,321063
c67a9df201308750095c3b2f7b636574,44,35,46763,21990,24773,53,40,62052,23982,38070
f2b07ba722562054e958727698c21307,172,140,636745,110933,525812,181,128,587428,135032,452396
3cef090d6cbc5487c6d49cbb8debb31a,191,137,510198,135951,374247,155,107,501792,118898,382894
0b4e3ddb56c13b5071ac8e6dae32a95e,56,38,46149,14711,31438,39,30,46554,15871,30683
d3420fee2fef7e232c7363ba225aee90,95,80,193035,51031,142004,133,102,296406,42253,254153
763ff598bcaa63526ce95d04ad5ed595,132,103,287499,74222,213277,106,94,244425,89524,154901
ebedf738af8dce8fc851fd3f31c7f13a,43,40,43049,18185,24864,38,35,33138,17795,15343
90425360254786c99e0737715828418e,117,85,262117,77237,184880,152,129,380690,71094,309596
4673f81d63ed17f6e4daba3db0717051,186,131,701226,146499,554727,196,148,812685,176640,636045
e02387c4011b49106d967ec6a1dd30f0,22,21,9219,9466,-247,26,22,17622,7166,10456
b75965aabfcfb174b29db9f3b42d2057,22,18,11123,4323,6800,25,20,10777,3644,7133
6eae4573c8a46d093a270400548a2007,189,137,531627,76081,455546,166,145,499674,77028,422646
03e3ed561b059b6fb48cb5040ddd9e8f,86,54,111138,24836,86302,71,46,82797,24877,57920
216329de782d3d75f347975d51eacea6,98,69,163418,36949,126469,101,70,170871,36790,134081
1e60e67ad875185ddee551fd3d5b4b07,30,19,12944,4510,8434,39,22,22064,4621,17443
b35333eac734f98284ff8dffab335d66,139,87,240323,55243,185080,90,72,166159,48128,118031
94dcd8a844774fc31625230f4406e077,106,91,147405,29603,117802,99,63,137404,28935,108469
e05ab2336c7216261c1fe6af52bff308,86,73,151096,44784,106312,114,85,162710,46127,116583
31d95c529051e2299d27a230593068f8,47,34,33220,12747,20473,36,27,22854,13669,9185
c07c0379bf356775bfbccae7335edcf6,54,47,77151,35319,41832,109,91,130973,33615,97358
df1cda7adb9eaaeba47d24659ac427ae,94,70,141473,45075,96398,79,62,125079,46309,78770
65565523290e027ac5c4b286e776a856,35,31,27641,7252,20389,41,30,17920,6411,11509
f5f77f4955902bbd10c06a722a8fa137,29,25,18000,6893,11107,24,18,10826,3628,7198
efdf0c37d34ce1549e35f806406b43f4,170,124,645247,144239,501008,182,151,812957,126328,686629
69aa50323f960ab514e12959248746bd,178,124,479590,110348,369242,155,136,509693,122365,387328
1d94a8a8b514a681acb38449283d69cc,29,25,22250,10951,11299,42,31,36216,8964,27252
ea3ebefb44de73ae82f52e60a8def62f,25,20,25604,7107,18497,26,20,16282,9549,6733
47257dc66a0ebb6e06b425d722cabc66,119,97,301702,99734,201968,185,143,563019,69721,493298
c62cba6f6d425ef45fe5017c92571029,181,127,566038,137284,428754,160,94,549870,151602,398268
336abe9c0922a2bc75c92f4f6219316c,124,94,262544,56930,205614,126,115,271300,88492,182808
97410cdc904f63bd53a728b00efa5c3c,121,81,446100,83003,363097,193,146,515901,132279,383622
d05cfd43fdd4e76b03feb14234bf088a,123,100,341652,62823,278829,112,96,293516,89294,204222
cf3cbc9a147449cd217790b2ba88a42c,22,20,9580,4139,5441,18,14,13120,2346,10774
ec7f3ad9f3a0347247133a75610e0afa,108,71,195528,53024,142504,122,103,247134,64133,183001
31eef58498ecc5edaecab389aaf62635,107,87,221167,27514,193653,69,57,96402,40843,55559
d62cf84c01a47710b9f03450ab14f37b,122,110,296768,80281,216487,116,94,323658,66233,257425
8357fc5628864b8292d4b7237226d89e,13,5,3072,266,2806,8,9,1491,1095,396
8d74b2c54b50ed64a9ad7dea49ffbd5e,128,99,263237,61700,201537,104,87,243328,47242,196086
80e4ebbc6faef26d0cea34057cda9195,110,98,279604,58899,220705,105,81,296838,73062,223776
b53e8640c454ab023bbe195d1d020e8f,177,129,407426,54683,352743,158,118,311091,55034,256057
2ad4667664c9c31ff39b18e83719b38a,22,13,5827,1857,3970,15,15,3421,2840,581
51e8924d9fb9d009e0673ea91740112e,74,59,116885,30729,86156,59,50,68999,29864,39135
317f3bf398f357964a4c83baed4181fb,66,42,97267,32047,65220,86,56,121273,21938,99335
d7b5bc3587b5da650071b4e98401cabb,107,87,206530,69949,136581,106,90,221758,60763,160995
134c8bc45b2b453bc2573cd900ba3ddc,161,117,361542,45497,316045,124,97,217780,58721,159059
351eff069b7fa34a4d0d3cb9b08ed499,25,24,13418,6050,7368,27,19,13822,5646,8176
fe1abc8419715cbaeb891355dcbad0fc,24,20,9414,5099,4315,28,18,13526,4031,9495
21a2382279651638690cfe87e599b58d,18,14,3731,1568,2163,14,11,1855,1957,-102
998e36d342be1592e5a04231de7b9055,104,79,183976,43192,140784,97,72,229100,28642,200458
b1c07a2bea448f20059ee4c785bfb630,156,122,497636,57284,440352,141,130,440201,75665,364536
1127b97ac56341399836fa4e21207497,107,81,309341,59743,249598,116,64,317311,47614,269697
6d286b4efea4cd15cc68f24f2cd240bb,86,70,197670,65802,131868,152,97,348792,53124,295668
f66f6a9942f30907e09aac7a19688ccb,67,34,69276,15906,53370,67,59,77886,23991,53895
0d1d3b46913ce41a44cefc9cfef50e70,41,26,55884,14595,41289,40,32,45525,18227,27298
b0440c2e0fc0ac9cbc57ad786c60d86b,94,55,89729,28837,60892,84,59,120262,22961,97301
a6c7cecc5d1f6ae9d9f00dd7c0f4a788,7,7,513,672,-159,5,5,576,417,159
e1f2e0571eca59e5f1fd2417387bc63d,120,104,254378,47846,206532,117,88,179485,54665,124820
96509ebdd54c2bd309605821d1bb7fb6,42,34,26840,14152,12688,37,36,27795,10115,17680
155c5c378620873ac85821c8b2a137ac,91,69,174275,38511,135764,132,98,276678,44040,232638
f1137c1bb7adb96fabadbec5ba701258,172,126,532008,81832,450176,162,116,562695,78888,483807
f28bcb9f20a616255f4f8f35de35ee08,180,114,443122,90405,352717,176,122,475111,80841,394270
e4985e8fbeac6a73706a94268d416af1,110,83,197944,43064,154880,91,72,143358,40340,103018
1d3864bc89ee86410f95173ed70f9b99,90,70,178694,30030,148664,92,81,148255,31492,116763
9b8105ad8e4474fc07c099f30f00f02e,126,88,247238,94698,152540,153,119,381588,58071,323517
66f8b21f9b31bca83c6da304f9b390fa,134,119,356013,89568,266445,160,115,416993,82405,334588
2b4e092e487c8b117dc6cbf4801399b8,25,19,11643,5611,6032,27,21,12649,5185,7464
c0e069916c6d0ab2b5ffc670fa79f77d,45,35,41065,17101,23964,44,34,40861,15490,25371
15518533bb18e012e6cdd6640d18c288,123,94,205769,50107,155662,101,75,180811,28181,152630
7232c94b1188cea24f5fb65354629178,59,32,92730,16817,75913,78,54,79344,21564,57780
6737dc33d1b5945f5174b13840ed6bf3,89,73,171007,30740,140267,92,65,128903,33881,95022
91098921a3801d11c21ca8768b034251,99,90,171691,52890,118801,99,76,180906,47212,133694
db2fc729abd29e71ce3fc93d097790d3,173,97,291264,48651,242613,101,64,189184,59327,129857
512a127da3b68d93019f9047a34c8279,20,19,10220,4472,5748,22,18,7932,2866,5066
5970d410036bd2ddcbf558c0e35421e5,142,94,292749,69046,223703,123,112,288937,75274,213663
c5d3f05d02b06e772bbfdc9448551171,79,63,104450,30360,74090,70,54,96867,26859,70008
7cfe2211c61d502021e610ece1465540,68,55,92595,19803,72792,59,56,78632,25198,53434
8df8946fc909a0d5d1c180c636085304,61,53,70389,19153,51236,51,35,53703,19800,33903
e69ed61a11dc690a714d6146d1109426,29,22,9503,4064,5439,19,20,6025,5313,712
8a468c8c87d29e9c83b6a26e1e3af712,19,10,5216,1283,3933,22,14,5098,1479,3619
98c618f18295d56810cbcbd814eb775a,159,127,390755,59630,331125,136,108,308115,59549,248566
79a7442706a6ba76723ed7338ae9d565,119,103,231281,46785,184496,114,88,213657,43731,169926
92dc6f802e40a74f4fb7116852232fff,101,89,254751,49356,205395,97,78,174452,54262,120190
4811046311c5a2fb947cdcbc694861d6,13,10,1391,1436,-45,8,11,1525,1010,515
29333582ac9ece37edb05ed0e161e647,127,92,411772,69420,342352,155,113,434390,69379,365011
59720aeed3845ef8a6310789a56b0d08,65,39,78703,18090,60613,44,39,51431,23462,27969
ab191359ffadba53b4ed7dff64ef583d,119,101,295314,50035,245279,57,48,131128,50865,80263
a6d19e1350a102fd5c232efde4a4cc7d,24,19,9345,4085,5260,27,22,12696,3934,8762
c9dfcc9c254c7c54837b01719556480c,132,110,484201,106024,378177,124,98,328528,66084,262444
bd2ad386e8f4e5c95c5906018161b433,53,40,93152,26756,66396,58,45,88929,33440,55489
607a8e2e3a52b54c662c3e9719bae580,151,116,339253,81427,257826,159,111,522822,67772,455050
bb391fe7592958ebc283164daab28fd0,16,12,2028,1932,96,11,13,3026,1493,1533
990cff47e2a8016247267b74b4ce4994,64,53,124371,35039,89332,80,67,148281,35061,113220
6b88a5545dab453453944093a0816a5c,61,48,110011,25228,84783,81,69,99141,33956,65185
bc61421d3acfc3d9b60091663f1faea7,55,36,47312,16590,30722,60,52,81854,17644,64210
4a76b252da5c17420502d529a382eef5,32,33,31865,11069,20796,41,28,31572,11100,20472
12b0ad98ef6a039c2a17c1972f3e7af4,144,115,418835,133482,285353,122,84,468453,93352,375101
ed1174e6301ad9349e98fa3d72971c6f,74,62,81831,21621,60210,76,59,106757,27309,79448
f90de2c63826c1850002fd61458f6a83,78,65,125444,32348,93096,89,72,135899,43424,92475
e026682ea8f03d8535609d3138330efa,92,64,175959,43407,132552,105,84,185401,50454,134947
d6f8d2801a20726af3b7c691e597cefb,100,92,213933,46523,167410,74,63,138082,43748,94334
1805ff957831f2174cdf696b0588da10,92,68,172821,44788,128033,134,124,281313,51604,229709
8b09efda0b17eff2eb3689fb49ed3494,34,29,36750,10085,26665,26,22,21890,9211,12679
3f5f46b7d7d5c804ea02d0096773c6ef,166,142,429084,147282,281802,137,114,361942,122955,238987
93d1e5afe78018f1b82f5e384270f21b,159,116,545689,88316,457373,148,130,432915,93558,339357
4014da423b4b3f8d04bb6960a45d313f,40,29,36969,12104,24865,38,32,34896,13780,21116
2c07ee4b846503ab74d0a6a6a08101c2,102,82,210920,83070,127850,125,91,251014,62957,188057
873dadf0b595ff1bbd95aa80a88d80cf,156,98,369018,66280,302738,141,111,310437,63427,247010
e77cb330dfe92a08fb31c2f2ef16f306,13,6,1330,572,758,8,10,933,868,65
4cba2ca2141315e124eef45dee595f1f,48,43,51797,22852,28945,55,38,56535,20618,35917
ae4599a0a62526cfda32ae1ee06a78a3,64,53,100464,32925,67539,58,37,93861,30560,63301
b79fbbd100f1a6ef86c14011ee9a9c6c,145,101,283500,54580,228920,143,104,304208,68797,235411
fac9674b44ca6896c40669a5f2b384e5,141,96,329452,72184,257268,145,97,337428,75328,262100
1cb0a481fde277885ad7c0bfcda00f08,41,34,28089,16148,11941,54,40,37543,13022,24521
df5a2745d162bd3c116cf663da0fbabc,58,41,71082,31453,39629,63,49,101265,21804,79461
f48de732fae8bfaa50e7e96ee1743143,33,28,25464,9333,16131,34,26,24994,11601,13393
b14102f082a544a3233d0ea750bb71a0,31,24,16737,9380,7357,37,38,27122,8623,18499
5cfe6d416598e197aca9a47137c158d1,133,111,395434,108673,286761,130,109,423969,152576,271393
97ca36d5d578d174905f22347ac43afd,101,73,208412,55808,152604,149,118,240255,58748,181507
132fdd6bff36a49ecaaf031e01061c71,216,165,957735,187168,770567,177,147,853264,245236,608028
0c4db6fce374ec15089c073c55f03e13,44,30,62848,12182,50666,59,36,68216,16152,52064
728686f5935a12a90ab08d30cc84d46c,108,69,228409,51372,177037,84,68,162478,61870,100608
596343520d011e8f586716c907b1613c,17,11,2780,1056,1724,11,14,1204,1584,-380
5231257bafa206f13fbb5900c7607372,58,47,69569,29475,40094,62,48,86696,35746,50950
42337fbbcd0abe7744622ade982e383a,41,25,28795,9003,19792,36,27,22494,11926,10568
ed391c72fa24a07817b5e4270e25b9ef,29,21,24494,6848,17646,35,31,22162,10479,11683
8160165345db3503c1abae68918caacb,102,84,180383,46782,133601,100,77,144332,38154,106178
097822dc8d64cba49bb11dd6cd96cc1c,148,105,311537,72682,238855,94,70,226271,76917,149354
740b93ceab1dff0325d89dfff499013a,55,38,54151,14175,39976,48,40,50738,19670,31068
3e78d224ce0d9a5b23919b416adca287,86,58,120731,26277,94454,92,74,161482,42659,118823
752df53a2330f31cf63f1be3ba3fc2e4,34,23,22509,11827,10682,38,34,34329,9603,24726
cd61fbfc0014086c5605f54f9f7986b7,90,80,126839,38231,88608,99,85,148244,32500,115744
c16ca9a32ce9a97ba05eacf30ab547d5,131,97,264068,73632,190436,128,91,345025,51803,293222
422035388e947100d749e8273ad73d03,18,17,3483,1982,1501,20,18,6428,2077,4351
b31c6a036729a1b3f97668a0b6c66de4,35,26,21403,7158,14245,35,33,29953,7811,22142
2f22a383c19a4dce03e6c24e5ce66444,32,22,13537,6266,7271,28,28,24037,6269,17768
c8ad294d89f62007c3eeb9b09617c89f,137,110,380427,69504,310923,174,151,490375,84248,406127
e49d6bdc22aa850ecd4328121c36abdb,177,129,834924,172409,662515,209,173,882589,135058,747531
5dda535b7e5cb9700e09eb40da475d45,19,16,5243,1897,3346,19,16,5095,1887,3208
ac91ffa6299df03dbaa2741358d24f5e,107,80,169148,38257,130891,102,86,175661,44572,131089
bcc9d580fabda6b195c94f862926f507,38,30,29470,9158,20312,51,49,45461,16026,29435
49d072160ca0a1edfd55325d8525195e,101,67,181281,37196,144085,124,78,198387,41292,157095
f64676c8b78919c217ba6d944e31b8ba,23,23,16109,7677,8432,28,22,15394,6455,8939
b010c3dbebbde06631c0b3e4d984ec56,27,14,8638,1926,6712,23,21,9466,2755,6711
586b6f18aa2362ba1bea9eb701e8973a,147,108,336793,64767,272026,112,96,273263,66464,206799
1ae615993543fdf44210cfd95ab0aba2,158,139,556249,103381,452868,193,153,629435,94636,534799
bbce91f5c0c77e888ec2c8717f37291a,69,50,99039,25879,73160,40,35,59173,25645,33528
f0646ace859f5ae5ecab73c92d014120,108,62,136246,35349,100897,85,54,93405,44512,48893
d2fb829225fa757fb3ef435a853c2616,182,115,424837,128087,296750,136,115,479150,141561,337589
e932c831462abad60514e96ad1b1a59f,174,134,622648,139881,482767,175,142,673382,181033,492349
41f6fd963b99158cf5db13e1ba1f3d28,40,27,38051,16648,21403,33,28,37973,11838,26135
a0ca547a67d89569e27a6ba027008375,122,96,325308,78970,246338,113,88,262919,71023,191896
c0dc1368322e586706e4383c426e1d3d,148,127,529580,113573,416007,158,117,528989,87929,441060
2cdf191b1e430225589d1259488f30e4,58,47,65823,21477,44346,65,51,96427,33341,63086
8313e08981e353f11b29c434bc236151,60,43,67776,22541,45235,38,33,35487,18427,17060
b1c543ab0e73f8383024064f59d11001,98,75,192134,64224,127910,143,102,409279,57711,351568
e9b310bfa516bbfa06340def8ccd57b6,140,101,468713,106198,362515,134,111,447597,86756,360841
bca7a6b42c067e998af31eaa233c88d2,108,99,188693,57010,131683,84,71,166888,36853,130035
47adde8fb8b466ead2f228477c2807ba,104,79,268951,104387,164564,142,116,426738,91461,335277
1fbd32a6114424fff0f17d2d5cdf8913,141,107,264320,69359,194961,127,95,251890,57576,194314
85e8f91ad8c22e985725a2850ab22541,121,102,329554,79578,249976,127,107,352994,70530,282464
0cbac4d11ad33d8b0b7862d539a11295,27,19,10100,5440,4660,20,24,9981,4814,5167
b2389c3608a5955251f2defa4af511ed,144,113,433581,85066,348515,163,130,464919,103010,361909
ddf3a3552531ddc3c9586f0e377ffe08,139,130,381043,62441,318602,127,101,302741,57541,245200
bafcbaa18ee66a094b9b3649a04189c5,102,69,216954,60797,156157,104,81,209164,52350,156814
d5a5ca6a5e4d00fbf7f6c5cb191f1194,38,35,38625,10677,27948,53,43,51662,11971,39691
aeb26e7160127958299d2dadba7d4b7d,193,136,836245,112232,724013,153,116,507449,130145,377304
533ff415e451fb6540a62c7c061c1fba,58,40,67997,18314,49683,46,33,48689,17012,31677
0284d58fa85fa61775eef02d47f3f134,75,62,102071,33316,68755,53,42,72777,28040,44737
71cafe1ba7d9fe16d8a905e669811327,80,74,159259,49943,109316,113,87,213152,43931,169221
6bace1d9f818ca453137388623e93a0e,89,70,142739,29354,113385,65,55,110970,26022,84948
1065828684e0c6e4aec758c3ee61fa0e,157,130,845953,241632,604321,186,125,758977,161842,597135
ff799fe292987568179f9e225504f6a4,167,106,370626,61124,309502,145,109,273455,84188,189267
c8c1efdbd7464789df83ce9c1a454d85,181,134,474898,117268,357630,169,103,434007,98384,335623
f1730ee8d69b02d83c28550cde767eaa,29,27,18053,6761,11292,29,21,16909,6074,10835
ada1299a560a9eb473673825edbb8ef3,80,52,203462,56595,146867,114,91,272504,78801,193703
4e627e15c15a62911be2586ce277fdae,92,75,169135,56813,112322,108,73,203646,48908,154738
9ba74419a78d7a34f57653c5704b6ff6,61,51,75215,23061,52154,49,33,54359,20124,34235
399bb3b6488ec05314f2b26b5d87a79e,111,92,202084,61990,140094,94,65,145500,66319,79181
58b6dd8723904424d69f8cdea13408f1,108,85,186175,62179,123996,144,108,297730,46481,251249
0ff400834d8e8f733632b30380da1789,149,111,542652,167687,374965,196,148,734933,116881,618052
5a5773af71d183f3ac21997db603efa2,161,115,423118,107275,315843,161,105,448434,95241,353193
279075bb6dd19e327374778ec492689a,97,71,199767,49282,150485,106,74,190959,59427,131532
5b5d74cafb701916633e4981ed0a9c49,162,140,982553,175233,807320,191,150,950169,237604,712565
f3ce9918423857d3ca412813d8044507,54,44,82204,25010,57194,52,39,65073,27312,37761
9f5eb259f05ddc88efd988284d71919c,36,25,40583,17383,23200,34,32,42911,20683,22228
1d7958696ea4c03111451c417cb2558b,1,2,136,249,-113,3,0,299,0,299
ea239ef853b29214cf175727af63cfac,140,106,336085,88398,247687,142,114,410518,73821,336697
4cf28c77916160c963e78cff58b5db38,75,59,122667,32341,90326,86,71,118907,44371,74536
fcdd76683deb962ade97bdfa7528f3cf,73,63,176797,55331,121466,115,91,223054,62087,160967
0047741e0dafe898bbdca10981de651f,43,31,28457,11497,16960,34,27,23643,11341,12302
6ff713fa7f08b4406bdd53197ac17595,159,134,925309,180022,745287,213,160,741125,121689,619436
7c60275b64f7981b927d6da429ec90cb,77,67,149388,45776,103612,99,80,193930,40701,153229
846bc71ebe609c2bcf867a2cc048aa31,97,66,123033,38397,84636,81,66,117481,33952,83529
4104050220c7297f1c692d064872bc47,19,17,5403,3064,2339,25,18,6816,3362,3454
51307732f775c8e0bc05a81b1af32765,24,20,11433,3745,7688,21,21,6186,4953,1233
89fe75f691af53a62f4cc73e5b9847f8,25,19,24787,8583,16204,28,25,20706,8657,12049
f1ebceaa38207af08e0fdb0e9b0f1dc9,58,53,89611,36666,52945,98,78,187434,34466,152968
b831fbba521003c89df4985d832b9913,125,87,379844,113443,266401,210,101,529833,82068,447765
ebd04cbf34878b04c770a02c64c541d1,27,26,12437,7056,5381,43,30,17744,7255,10489
8fbc343ebf037b9b8515d27779feb5b4,73,63,101524,30045,71479,113,71,134036,30128,103908
2cba4c068efd53eb2cd42c6e3840824e,30,15,12365,2466,9899,26,27,14399,5025,9374
10ac4b782602f3d4d78ed05e34a66217,57,44,73765,22656,51109,43,40,57214,25735,31479
4548ba7a9c3703087966cd70512eeaec,28,17,13790,5274,8516,25,24,13557,4979,8578
ce25c0a2dc673ed19fc25d109ef5ae0a,147,101,391185,87732,303453,181,154,487594,184501,303093
1bad5b4eb3b58dd504d4acb42aa7771f,150,124,395020,99437,295583,141,110,313133,75589,237544
fbcc0c649d03e705da655bcacb777305,72,61,146951,26490,120461,66,58,109002,36594,72408
68b73514644502bd77ee36c9f448dbfc,73,61,92788,18603,74185,81,63,115952,25178,90774
5b0330a4972f48995979076e84b085f8,77,68,147371,37670,109701,82,63,120622,35466,85156
b1b89a58141f624f6e5f049070efc375,70,57,117593,25036,92557,71,44,73697,23805,49892
d48adc3dd6995d668a68519446e3ab54,133,109,293124,45919,247205,106,82,199527,34618,164909
82a3e611a3d4226b4655422c298bfac7,1,1,52,101,-49,1,1,101,52,49
038a2404b6b2744076bc8827d2cfa8e0,88,64,133520,32305,101215,80,62,107890,28002,79888
fbcaf193f896c47f1aa5842bdc02b1f7,141,111,369881,68505,301376,136,108,274894,80096,194798
cf87c80a6e9b267909ac55544a05dd7a,159,123,396954,73837,323117,177,124,569165,61858,507307
4d69f19f38a8a1ede0b7f1866664d90c,127,97,298386,69015,229371,142,85,320678,85523,235155
521fcf2dc1f012809b775baaeaa9c5bb,50,43,78866,15398,63468,49,33,46971,17297,29674
8a14a5bdb2b4f73e810b3b4620c81b5c,92,82,235580,76721,158859,99,85,224090,89131,134959
2c8b0b81470ba872399c4f620403d4ea,25,17,7991,3841,4150,26,22,9570,4891,4679
c20629135e03201a1dc8f3068410c0c4,69,30,63877,16265,47612,83,65,70675,19628,51047
2f05108cf3f636a9acce91e5a65d0cea,170,109,565627,141578,424049,188,162,770379,176108,594271
41bf261159074906d551eba864fd2140,117,90,213298,22474,190824,98,84,156885,43421,113464
c1f144cc29a95aad37a3f493c2950d8d,39,33,27921,12343,15578,44,37,33141,11929,21212
468a0e2bba666092427817b4cec40bd3,29,24,20562,5973,14589,31,23,18836,6664,12172
ad8b7a1ee0c337d43ee24fb9c5ce9252,132,95,450272,107408,342864,143,111,377410,91430,285980
a33cb98303faa63cfbc9c4fc4a01426e,160,115,565404,133573,431831,170,139,528585,81764,446821
06a4feee33e1befba32ea788087664f5,118,91,348100,101130,246970,125,100,363418,88505,274913
bbd196c642072a2265bfe79fdcda657e,98,79,221068,57953,163115,115,94,191317,54364,136953
7c586b78157fc4acbebe733345da07d8,30,27,20757,5910,14847,26,22,13862,4616,9246
08d0a483461f15b6f64248d6e30bfc48,104,74,181866,49245,132621,107,88,223226,50221,173005
6d57d6d741166afde36af5212ee61a8c,86,76,173140,32841,140299,69,59,132323,29258,103065
8fa07e6c568c75376d9cf4f7d46e3742,81,68,143249,30848,112401,79,64,106642,37972,68670
97f70c4817a352ad09232c8c09d0c6d3,111,88,231890,65354,166536,118,83,192231,47582,144649
cea13ae86fb0a65bc1a3868293de3049,127,98,350898,69871,281027,142,107,360686,106036,254650
64150332ac05bee54cc6d651514ba5de,187,134,626862,142179,484683,208,153,586545,150171,436374
66edb7b550c6306025831994f9f725e5,46,47,50995,17157,33838,42,29,48106,10754,37352
8138bf063437b4b2642334568e80f93d,36,30,40434,14178,26256,50,37,44364,14934,29430
3c6cd334f1311e946ce909045f500888,89,78,204633,60957,143676,129,117,291054,75356,215698
7aa31c9dc36908ea42b22b9670780e30,140,113,574757,166985,407772,205,144,719983,126174,593809
7944621c2b312f5dfd9632b7199455a8,94,67,156724,57904,98820,93,56,157333,51062,106271
c793e68d80333447506fd3fcb12eac10,77,56,130600,34474,96126,74,70,125709,33225,92484
3f8f9fac8a410f0ff7ff4d31de783be4,27,20,13504,4255,9249,39,32,23572,4502,19070
0d992e66e318d511c6d51d32d1bb3725,23,13,3029,1210,1819,20,15,3750,1392,2358
97d412ae84b1ff44226356f66308af80,74,68,174032,49354,124678,95,69,146289,51087,95202
0efed6d14efb377928a2be9ae1c41bc0,168,114,521464,101423,420041,170,117,521042,85314,435728
59dbfbbac1ebb989d30a514f2a3b8eee,128,91,220376,54316,166060,108,97,224386,67560,156826
63ed6d926acdba2d5dcc461cc9321ae9,155,112,547071,150375,396696,207,132,753412,159049,594363
19ccbcb390dfc35dc1b60fca0413e098,169,111,393849,59736,334113,122,98,219038,71727,147311
61fc8c0a4bd138d6bf99667f94f68dbf,171,122,552437,95948,456489,151,114,466147,87547,378600
832d3b9c2afe557e52d2e57a87a61e9c,39,33,24609,10289,14320,35,30,23558,10181,13377
c116d297fa46299949824c04c0701fac,39,30,30677,12966,17711,54,32,40986,8720,32266
9b9885460f04028939fb439f57f3c0b2,174,141,789434,133591,655843,174,130,767731,155796,611935
24a8680e5308ebb56093c3e1446ef3f2,150,115,411940,73169,338771,161,113,459153,68992,390161
01980e73c3add1106b51a24f559c6b28,38,33,30755,12318,18437,38,36,37593,11366,26227
3396ff17ec5d79a25e5253320620cd98,111,95,374449,97390,277059,141,110,467131,107837,359294
8c53638af0df5cbf554480e33785b903,32,21,12064,8270,3794,33,29,18846,8467,10379
b6ed55496b9263d58d103ad54c749ad0,78,52,168821,65531,103290,86,73,200103,63451,136652
ff1b2161399b6a295991a8d98a31d681,67,54,99538,32569,66969,66,49,71597,27214,44383
fceee53d4c3807b62cb6947d2c6224c3,164,99,364862,70527,294335,135,82,378340,63155,315185
387d2fb357d72b752d895aae098cfeb2,166,102,309381,77770,231611,140,101,268272,76524,191748
028de52eca0c04b53b8d6df66e3c6922,83,63,134208,24554,109654,94,70,111929,30443,81486
41d13ecdebd7552abaa1417853c36648,207,132,958538,180569,777969,178,121,1121782,198044,923738
50c02521dcbe5a693323b41ec7225a1b,99,69,143420,32510,110910,82,59,115458,38243,77215
a187addd57c3f25768b581c4c9b2699f,67,52,117014,19989,97025,64,59,96572,31952,64620
bbf56c2ca06f5344fb5feca30f59aefa,60,46,93028,12858,80170,40,32,37996,20717,17279
6a077138279f7f1b9a49eddd46d53ad9,91,76,241615,90308,151307,111,88,276534,62866,213668
a9e71e221486bfd09b48614239240294,93,78,172463,49700,122763,96,73,179574,52966,126608
b8fb7504417e39ef353a8c967941f624,73,58,139817,38510,101307,92,57,135921,48441,87480
bd902720023b5348dcd9236c710a9a35,39,29,41530,18043,23487,60,49,97142,19810,77332
12be06a78bc9e3f704084d55157749c2,144,107,367875,86335,281540,136,104,368287,92009,276278
3bc5731c54ea82c8ec7151a078711679,152,118,415698,73098,342600,140,116,398955,87365,311590
ba7fd16ea35950bd6900faf1f3077d2f,103,75,209324,69090,140234,123,96,309291,76626,232665
75b9207e9eeee90b7acd6093b1f98abd,93,84,180297,42953,137344,85,74,128448,43981,84467
6cd9f1afd212280ff71e71ae845880f2,147,99,424210,84360,339850,178,139,480197,79050,401147
d6fc5614e25c691f1aa9bad5328d97ef,87,64,142372,62190,80182,127,79,198875,61545,137330
73bc342533a627dad2af9d34a34fed48,98,78,139789,41074,98715,70,52,113025,28434,84591
1856b11696cfd637c37bd45f17a7931d,27,17,9810,2861,6949,21,23,4729,3355,1374
5f238bdcc8ca3170e170929d619c042a,188,114,655631,98569,557062,150,101,394200,80998,313202
1ad330aee66d81eeb34258ce24d4eceb,91,72,148832,35575,113257,79,59,113793,32595,81198
f7355fb2de2717de3e66feceaf4c17e0,90,51,157182,30842,126340,62,33,93879,33722,60157
83940d4fde4b0ea6a159f4cef0b6204b,104,86,245797,57071,188726,120,89,261028,78982,182046
278038840c42e580532277070aeb472d,145,122,512603,86236,426367,157,117,442824,114445,328379
9e33dd1cf01b247a65975d6c1fe6c1de,139,97,422805,123937,298868,173,124,466233,119312,346921
128b10ca0e08a33cd2b5d86728576cdc,61,54,65669,25945,39724,56,52,73142,24461,48681
dfafc3e2cdcddc569ed2af0d32262143,76,57,131065,45240,85825,100,71,157796,45151,112645
601097ef2a02effd5eb2aa76ba1f47f6,41,34,33433,10205,23228,36,21,28312,9695,18617
a2cc8c7c5ec2dbb08149078769d11fac,98,75,206673,43342,163331,97,66,206895,46485,160410
24c99d0cfbd705a58f5af56da490d688,24,19,15963,4833,11130,23,20,12852,5355,7497
44f527ddbc058d4f60163ce8bf053863,18,19,9134,6103,3031,24,19,13304,5584,7720
ac85d6780b053ba330117809d479eef1,46,44,68990,35331,33659,63,52,141065,27424,113641
cc6404f238305f09a788051b897ec60d,44,34,65339,26796,38543,57,34,104579,25354,79225
d322c5454593c1905393db738432e68b,125,95,246263,52621,193642,118,88,261351,58266,203085
f46d03d6c325dc7a17925399ec32dc8b,119,85,252828,35751,217077,98,76,139922,48984,90938
0b190e1b7955a3597a671d5656f48134,135,111,720353,166885,553468,191,168,675399,204333,471066
1f2d7e1f4ee14635785ba3c2b1f90682,143,110,237728,50204,187524,107,79,159615,41693,117922
9134918465b7d9a2fa7c3ddd3a0ef218,37,36,24972,10443,14529,42,31,28747,9927,18820
caab847694d71032ef804b73cb3de428,7,8,1054,459,595,9,5,1663,250,1413
caa7ef7b59b566d2dbce5d64e249213d,142,91,307039,90787,216252,141,114,443312,64304,379008
0234e3be8846708594c413ebf9451f22,28,24,26118,7576,18542,26,18,16103,5492,10611
2c473e2b13d75389981d19663a0324d5,146,118,639009,105110,533899,147,107,670891,92825,578066
ac57820ad97b520d08c40f4cde5ffb33,24,13,4940,1844,3096,19,19,3750,2247,1503
fb55c4990beba286285224867aec7ead,81,59,146244,37690,108554,74,63,157459,34904,122555
5070d2197504970f6fbd68ef8dda527e,77,65,135743,24862,110881,74,58,84759,31682,53077
3049cd478aa0bdc02f39cdeb6ec2a93f,108,92,219955,48644,171311,105,91,264119,69642,194477
3c0c22393a57a9cac50ff55b7c62ac35,60,48,57926,19862,38064,55,44,65611,17190,48421
ed0c564c4239921655135db93554c069,181,124,524222,118264,405958,115,85,430584,117030,313554
be4498653b4d6072c3639a86a76cd4b7,150,101,304710,55421,249289,74,63,149623,50615,99008
e4061dcf367feca3fd37ab28b7ea367a,102,79,213460,47160,166300,72,62,104448,37153,67295
de73ce1433744275e8985ef1b39a9c3c,122,100,288945,67829,221116,126,103,292772,75178,217594
05269026e9dce92123ba8bffb1fd403d,77,41,117930,38922,79008,83,59,129865,40453,89412
cd023dfc44cb68c9dda30cca5477d0f4,65,39,67505,15591,51914,84,69,84165,23418,60747
490a96a1c30eea284c69c429ee87771c,49,45,60524,19225,41299,37,25,45404,7041,38363
19f24b152d2da963a92189f64177bebb,178,135,476429,61435,414994,134,114,288900,66068,222832
658bb027db608ec60c526b8b30d1f38b,118,82,229992,68439,161553,95,69,223477,62284,161193
aeb547c422a4d5bbf0130b64c4bf09a5,67,51,98045,24918,73127,64,56,87474,23990,63484
c9fef7ab803c64669d317107b68429bd,152,129,744383,197199,547184,166,134,651148,156808,494340
98ec6bba925e56221f0e7e924ad902ef,79,70,105425,29205,76220,74,52,93891,27321,66570
55349b3ec2fffbf548c6bc59768b0ab1,44,30,35777,13385,22392,45,33,26862,14582,12280
2e624c875f4be3689d1c344a7b29a887,66,40,90602,12985,77617,65,55,73746,19201,54545
68ed2070e8d17af5d3bcca52cd7b2d5c,20,23,8406,5110,3296,25,18,6264,3624,2640
9b759077307d44fde1adf362e6d93e04,89,70,190357,47687,142670,95,84,177792,48334,129458
0df32af71d10bc38a2183cfdf33f5e4e,156,127,513175,126306,386869,144,138,499130,143213,355917
e45179aba30a57506f9e5864f374a2a1,67,37,63972,20871,43101,48,41,49925,25698,24227
92a1ef0022be1a7dd680b0cbcb890cc3,124,104,277755,53772,223983,128,103,317949,61254,256695
05d63dc52131eae7174c010eefa64420,135,109,274648,89664,184984,127,104,242781,54287,188494
7342fc85ddc1fb7943a206b4a8068734,56,42,56423,33579,22844,59,42,73340,24799,48541
214cae830f3910d3976319ade79dd5e0,17,9,3607,1001,2606,13,10,2461,918,1543
4de93798f29ca1e76fd7d48317b7aeba,38,29,35184,14478,20706,41,30,31813,16336,15477
a3cf2c7dfdeb16ede6a7af3297e8215e,125,86,318680,98062,220618,163,125,426006,102765,323241
13c54c62bde48fb633f6f15caa7c19fc,75,65,141870,44432,97438,87,66,117451,25899,91552
85120625130b69df1e57cc5a4162868b,158,116,339579,79028,260551,143,103,257949,61072,196877
087348dd5ffc22ee0e5ef44e55b62c37,56,51,81493,22044,59449,73,43,108253,16924,91329
721b99f3c82a0bcedb2a917c7dda3913,140,109,433593,89849,343744,155,123,468409,100097,368312
5279b388d644fd74d39b1861af953bac,12,9,1044,530,514,10,10,1489,584,905
c5a68d801de45d470f8a7a45f5f6f468,80,61,95267,29890,65377,78,65,147210,26437,120773
7d28432fe61a1e84e44af812b5201d44,21,19,7226,4050,3176,20,12,8008,2571,5437
f2b8f3d8a834bc0a5e342b2ba9091215,30,30,15014,6517,8497,37,29,23861,6205,17656
9ecb4fdf0545bac19a90dc6856b2ae94,153,113,469840,108842,360998,188,159,604060,127897,476163
7f299519193d9f54f4da065debca795a,109,105,221294,76816,144478,136,105,263644,66006,197638
74c6aa87ad7d826ad669e892808c57be,118,94,221930,70113,151817,92,82,210932,69029,141903
942aaa72c480dd50b6e443d87b88dcb6,194,166,644993,135416,509577,196,136,583411,145410,438001
d528aa88c3241fac41e3cfa9a8e6ce77,108,96,230459,52376,178083,79,67,159670,51836,107834
a5d158e0cc18771edef8c2d9f4409385,79,58,107032,41344,65688,104,86,179559,30833,148726
7ea882cd17703fafdd1717081222e037,35,22,27619,10805,16814,40,37,40765,13869,26896
575329dfb8348863582a275f16e59fcd,173,134,605292,199570,405722,143,115,527811,178221,349590
8d10bef22982b88d40f51ee25a0f19d0,49,48,51426,17314,34112,43,34,40679,16114,24565
4cc33feab2f5d812395dbe298b54ee2a,68,66,67184,31282,35902,68,49,52002,27496,24506
edf0e4bd55d21dafc337b709f9ae0dce,132,89,216417,48597,167820,129,103,276877,52138,224739
a95c8c047ccae6a714675e7a06273cb9,137,102,374125,61998,312127,149,124,323930,73690,250240
6e94066d3f372a1cd2fe1768efef0756,16,12,5425,1792,3633,19,16,5292,2608,2684
264ff497217dc99a09dbf70a203ba911,31,28,22102,10386,11716,58,37,75400,10349,65051
314edb7ff09973b18b0c3e791fdd8e30,11,12,1348,958,390,13,10,2152,916,1236
ef6946a8712dd999af610922d1bb08f0,107,90,163414,40395,123019,101,81,129977,38635,91342
37401c3564ef8af32fdd4338e105eca8,25,22,11156,4175,6981,23,17,9610,2435,7175
0defdb83cad1acbc3666b9d6b7ae6297,78,55,112789,23660,89129,49,33,66693,21193,45500
b91461621078a04143cd654bf12baaf4,166,117,586336,99608,486728,199,148,789438,140050,649388
b64c5aa3457dd940c780f606488ffd69,42,31,24219,12273,11946,45,31,30132,9229,20903
0df1217b142291935682d0e16c206f59,55,35,64040,26935,37105,55,51,70989,29942,41047
ccb8966d2297a01554a4e09560bd61ab,105,77,180319,25423,154896,111,85,151624,38592,113032
3289b989948aba45f56d675d7663a2a2,45,26,39030,10234,28796,39,29,27047,17914,9133
cce4b7a020fdb03f0de20cec272b70ee,57,33,53888,22909,30979,72,52,112895,19666,93229
38c20e5fed97c4f1136995515116994c,101,91,208057,48427,159630,86,54,141686,37674,104012
c2ee3e8c4f461bebff3371183b21216d,150,86,770837,106748,664089,189,157,813370,156506,656864
70562e1be50c61c34923da1be595a358,22,20,8600,2839,5761,17,13,5736,3012,2724
51d1ce6aa37c9bffc1d358087d27821f,87,64,138802,49639,89163,88,77,161850,50444,111406
51ea74b55ab6a4b4102e0fe1b009c5a3,99,72,165233,50121,115112,105,77,204999,46700,158299
28b09c87e6d1ec250f33f7e213bffbc4,67,61,92834,38555,54279,54,42,80731,19944,60787
39cc35016a5dc342644d15ea6d4de5d9,191,157,893434,155162,738272,167,112,642182,162141,480041
7414c3d6b369f7d86ec9e79054e52d15,90,70,156511,44630,111881,63,49,109029,50345,58684
b89c678542ef437b6607434e3d7a7a81,178,136,623395,107183,516212,143,113,483172,149970,333202
fe7e1999fb3c63a625cb8b18bf6d44fa,20,18,5967,2960,3007,21,18,4262,2176,2086
bec457fb9a3b8c87d8e1f48e645605b0,91,63,100890,23976,76914,80,57,88283,33877,54406
106bcc6fd43ca53dd5656065a4f558db,108,72,199474,24246,175228,99,67,121358,27660,93698
8e6604f0317514291388b898af9f4d12,26,22,11627,6657,4970,33,21,16779,5374,11405
09f794cd835f16b761946bae0808007e,42,40,43984,16678,27306,39,30,39255,20058,19197
42d957d4b8bda8267b8df1aed606a806,42,30,75913,12732,63181,50,38,47818,17757,30061
b3a6c1dda796152eed08e1bf2c81f8db,37,29,31532,8112,23420,38,32,30932,11104,19828
74bc16d8a15fb5cdecf31d403f923384,30,30,21473,9913,11560,32,27,21596,7741,13855
8a494e125993aa56b9469c552e8ceca3,76,56,144654,41814,102840,82,64,179224,44402,134822
dc20d20c6f8b8b30ea9c7514c7e0f522,93,71,177080,53198,123882,102,82,172960,61564,111396
402f8ec1716e2c58c37d4f0e8ecd4990,153,113,325660,39734,285926,123,90,238228,47731,190497
eefb1a544b616af28cb9206788f5e3a2,19,17,7317,3441,3876,27,21,9600,3463,6137
7377dcc7ea156a49c8f5281f5445ed4f,80,49,142657,23313,119344,69,65,82735,30996,51739
7ea3259ad158c7410028f15bb19f039d,62,55,89312,27074,62238,55,45,67052,26755,40297
77e348289a4948151c7c3d56505a1cdf,150,79,558670,138613,420057,175,136,848865,125526,723339
567aa8b9bd8f167dc469402ea78a19d8,148,120,405118,71153,333965,147,102,355266,81335,273931
0bda5f1425cb7ced8704f6c54d618afe,103,73,178055,45178,132877,87,61,99656,57174,42482
28bf526109e5484a3eccccf11de8e761,115,101,271747,80167,191580,109,81,242909,51720,191189
f0bf5f31a2e90076ec289b29d15a20b7,7,5,762,286,476,8,6,1285,577,708
5e404ce2afcff4f72d0499144a521c25,25,19,7753,3003,4750,22,19,5702,3908,1794
5732100518e41a3f1bcef2e037b97aae,30,29,30657,12278,18379,29,27,31520,11781,19739
240daf0d34c52f2ea4bf27787b7026dc,135,109,383857,83158,300699,171,141,465011,98964,366047
4e6821fe7a08a6eedbc1a8492f0934b7,38,27,37605,8898,28707,38,30,38001,12795,25206
e0aae203e9c33438347508f6a2dbaed9,125,77,229473,44204,185269,127,106,274782,52571,222211
161856f3dbff2721da2afa59dea88185,103,75,164384,51895,112489,124,99,277329,48659,228670
e4a415ad0e258199a0c3fdb032f3d7ed,102,73,168480,93408,75072,118,70,218431,55673,162758
927df78dbfaccfc38304e67c6f4739b6,31,20,16367,9199,7168,46,31,52036,6689,45347
58721b262528a3a684a345824b74530e,148,120,405549,88143,317406,151,107,420739,104954,315785
11705f8028f409612c9ab287f9c15048,59,47,77485,26790,50695,61,47,74455,20537,53918
dcd5a161f90af65be5523ad93cac6ed3,72,47,76065,18702,57363,54,52,56964,20947,36017
af84e5d2eeeb6b686b1ae3e15b820c0e,35,31,26264,9178,17086,58,52,51468,13767,37701
fa4de75160f55776c28432a424915cc2,33,22,22105,8412,13693,41,40,47720,8014,39706
94b206af2578c3002697c403dbdef89d,197,142,756582,129242,627340,159,103,647637,140212,507425
12b9bc45adcd7abee297fda777423811,116,85,188709,22078,166631,86,73,145141,28228,116913
ac483b354386b7a655a706c2944b2c72,12,9,3150,698,2452,16,5,2122,471,1651
51665b498bc9435e129feacca372286e,130,64,447135,78111,369024,98,75,452221,123698,328523
f69f253d89a32bc5fa28037600ad71d2,45,35,30644,11251,19393,43,26,30758,8249,22509
17de12e5e46e9f4a1f523d2c62626521,18,11,5202,2246,2956,19,14,4387,2752,1635
d04a14bebb0bc196f28555cd0445d05a,54,40,79092,20430,58662,45,36,56757,18085,38672
87b8f7d206c3e6ff07e243ee05945c61,90,71,152795,33920,118875,55,51,74646,39854,34792
962c68605506660c1fca52d26ae3f048,125,98,403382,104120,299262,120,99,290503,94809,195694
36edf815ec1a02b698f386924ce5c749,97,76,215372,58774,156598,101,71,186570,48410,138160
2601e13bbbb4ab7d49fa6f595bd9552c,128,100,278688,52792,225896,123,104,300905,73531,227374
3a522275c456bc49af8129e4634f3c22,19,18,6191,2349,3842,17,13,3764,2973,791
537a9bea74302bea2ace5907bd6e5f6b,194,156,597752,91344,506408,133,101,396804,84694,312110
a39d40bbb9521373d1c01ed6297a114e,93,76,286372,50509,235863,82,67,182901,45112,137789
000203e013b023dc4525e14cb6d7c9df,22,21,8748,4226,4522,27,21,9725,4311,5414
445db110990915c497af08dd882c781b,83,65,139943,34610,105333,57,48,79219,29474,49745
3b0af150d218ae3268f18b02783bc035,96,75,140909,28886,112023,101,74,125509,28179,97330
5b57c1accc60a22812e4280ececfcee1,87,68,107623,27011,80612,65,57,110002,25576,84426
ea1b7b35aaa5696ebcda5c6042fe0a5f,64,51,94178,28970,65208,51,42,81254,27497,53757
d4d598ebbb5c6356d5de85b3e38e18f5,27,24,17702,7424,10278,26,22,18242,7476,10766
1cf9886fc94e9f13e65e332eadb8b25c,155,109,591467,115892,475575,182,141,829251,144199,685052
68484cfd749749faf6f209de8c32a189,31,24,28791,9781,19010,25,24,17278,8766,8512
4bec15ac38bc81767eb41f10b251da23,186,162,891565,103406,788159,176,143,770711,131780,638931
b949ce4f1d53109a916e01cd68f203c0,23,17,6625,2468,4157,22,14,9443,1863,7580
42b1775ea3a12a08b22dfdb1612e3466,65,66,137067,50837,86230,117,85,224738,45010,179728
8c8a4cd96cd626496e0a8bd64d537daf,14,13,3551,1631,1920,16,10,4412,1369,3043
8dc3c81a62683ae06e497a2ec298b942,27,20,13625,10314,3311,27,25,15457,7773,7684
0f04adee43bed13911c2d331f60a9fdc,118,107,240704,71200,169504,143,101,314099,74483,239616
29e7378e70ed68f232ac48bdab068016,38,31,24947,9970,14977,38,29,19752,12213,7539
b8af90f167ac42353067d23d45efdd36,22,16,5046,2929,2117,26,25,7163,3127,4036
6af431b07d797932071860cf5d515c3f,70,64,102241,30345,71896,67,58,100874,28338,72536
a3b3ba156e2dbc1693669fd35aee0392,34,23,25432,10287,15145,32,23,23244,7506,15738
48210153dd1cd2f6a911058064ff09fd,51,48,90173,22066,68107,55,42,55413,23840,31573
cdb1dc2f0e1b0000ea22197fc36430ac,1,2,89,559,-470,2,1,559,89,470
294180a2a89775491e04cd1f712124f4,113,99,200770,46765,154005,115,98,224804,42963,181841
62916e98260443903746d95a220f67d5,75,60,83166,13654,69512,58,52,58691,17937,40754
41cbd25ed22a830b72483976499feff5,65,42,92135,20979,71156,81,74,99785,37168,62617
6e6879ce8fa0f1b277b9649a61df0e7f,128,106,394111,138715,255396,147,111,386026,99226,286800
899a324f6f8b7b470cda8c1881be66f1,87,72,195064,71466,123598,90,77,209555,58694,150861
360dd584c3a1a4e1a2a5161facac22f9,139,95,357932,63465,294467,155,130,397105,94812,302293
afb5152afe3d4a3d56b0c47303149a47,45,36,44911,14972,29939,50,43,48907,19912,28995
2fbabb8e1ec5613634146c216f2ac1aa,162,135,721950,133345,588605,167,132,672629,221337,451292
f6226da70131ac7e8e554f5ed92ff697,168,141,722341,121058,601283,197,150,700802,150356,550446
f03ed4d18d4b8bd7d6d920a8a295ab00,37,24,41728,13823,27905,39,27,38718,14696,24022
94250f5bdc4c427fc8cf77976dbb805d,153,113,322672,100627,222045,139,111,367517,70072,297445
83e006d54138341fd0666ce93adc206c,98,72,102117,27870,74247,84,65,101291,31427,69864
ceec2c2a6f355311263779c3a775cb24,56,53,107225,28437,78788,85,71,144936,35762,109174
1f6f6cc2b79fba643858d52ea4b3c0fe,31,20,9802,3258,6544,29,25,11703,4375,7328
fff6e7c99807c419577a37802100f77f,187,117,353237,76859,276378,145,106,367211,95942,271269
719105b45d30b0047cbc43b4ab4336d5,152,121,664652,147213,517439,155,116,491340,122969,368371
3dde3f4131b5a07e5ca579e0b8127392,18,8,4936,790,4146,10,10,2342,1698,644
dcae2e59b70ef954202506d1c6a1e700,113,84,206519,78728,127791,92,73,175166,46513,128653
f1ce8a8de31b33d1669144244cbb6ddf,17,17,5589,2433,3156,16,15,5289,2751,2538
984ea562ab2e04f918a41e6b2dfb1fc9,11,10,1615,1228,387,12,10,2123,1071,1052
d230e47d1fc07fede877fe99b3e940c0,166,123,455183,88943,366240,152,123,523129,97990,425139
631fd7a5d91ff4902a61dbe870e3d057,123,82,196985,32478,164507,118,96,212360,30833,181527
3500aac22f2be1de3da6c394a2a0736c,130,94,309919,90947,218972,126,105,313029,88827,224202
6ffeb08429464528c85a28898e86d859,32,28,14156,8518,5638,22,21,13075,6826,6249
1204d84f2e425c473869e3822cb18157,157,134,671181,115625,555556,168,113,733157,117085,616072
37e8b055f86248e4ed4bb213c60bb6ad,20,18,8701,3960,4741,24,24,10270,6123,4147
fcbe4e53ce4e5b33a33e9a55332e80fa,39,30,35107,12928,22179,33,30,34969,13267,21702
24e20b1a7f31ee11e0f359d6244f9ed9,139,117,334384,72945,261439,141,119,328596,56635,271961
f577a0d7d16e02215a0c2dce032eff29,79,64,139163,47663,91500,123,93,209279,45266,164013
ecc0e788aee4aa0099158f9ceb3c75ee,146,106,369272,65534,303738,143,115,317822,66055,251767
49c60defe3c6033b164076a168b07dce,121,94,196473,57090,139383,120,103,239594,59546,180048
1056f46115b03815297f650a54e3ddcd,40,32,29022,11146,17876,38,31,26693,9969,16724
70bd996c4b656f018e471e50cb15c218,118,99,348553,77993,270560,150,134,442418,60149,382269
0975c22e003b13fe39da6eebd13b7bdd,28,27,25600,13546,12054,30,25,22883,11400,11483
5f68f386afdd2fe8e4e514d33af141e3,126,96,428537,91401,337136,181,133,580887,80883,500004
b3db143e54c6e5a7fbc88b99569d8cd1,28,19,9031,7456,1575,31,22,17329,4382,12947
ece0d072e2e5417df5a524bd9946cb71,39,34,48891,16287,32604,40,25,46362,14030,32332
13476e609d9f43f03b585510a2bfceb4,74,59,83579,24836,58743,59,51,94868,36699,58169
1a9629d364df9240e2109f409345fedb,40,25,43848,20954,22894,37,27,45911,20679,25232
3cf05c2174a201b5e1638cd1eb78790a,58,39,59289,21861,37428,49,45,61170,20629,40541
14b70ad85487c1b60849858d0deebfd3,123,87,224603,46321,178282,153,131,366921,69715,297206
af975ba6a67c81f7485df9c25e095d64,26,20,7039,2915,4124,27,18,8765,2401,6364
f674fe0be5f301a6ffd4260fd008b59d,92,69,123505,30366,93139,77,67,98505,28503,70002
b482418889743720478f52b7ebe89249,25,20,16202,6609,9593,34,35,33870,11000,22870
1865dc0b962d4cd1f02773190efd7d86,36,25,50961,22711,28250,38,31,50152,24002,26150
e67acaa570f11b4e733d147d5d588bfe,55,42,79751,26072,53679,51,43,68680,31934,36746
a884f9f525839e2a907007da8e6a6015,50,48,91680,51238,40442,51,53,116149,55581,60568
8f2c80c9df6070c23565dcc1146f889e,133,91,348292,52905,295387,151,87,307960,52783,255177
aa6a1b6ad23623c525fef9264a46c583,106,79,238683,61262,177421,79,58,194740,60422,134318
6ee0bf26431d7fd5d4c6072612128350,70,60,110449,23855,86594,87,68,105412,34728,70684
c26d23faf7894ba1b80fb1745f620bff,142,119,351689,74522,277167,145,85,290240,96105,194135
7888b40666da27d9cb7560619fe5f0d6,157,128,435879,114863,321016,170,135,449719,128857,320862
a1fa417531d7920d762db253f833e3c6,31,23,13120,6270,6850,37,28,22773,7438,15335
24796d7e776bea0ec4721bff6bbb4297,11,6,2017,1311,706,13,12,3675,1058,2617
4283dbd55f02f526cb04f297a58851ea,69,57,87338,27234,60104,89,68,95737,27462,68275
0ac460095676aa3ab7cf3a5f53623819,54,46,81271,18540,62731,52,41,58117,19698,38419
a7edbb96ae01a52985496c2b9606c1e2,45,36,57406,27814,29592,46,37,89125,28765,60360
421cb7429d80074dfed07c0b88f98360,59,47,138709,30570,108139,53,35,82823,25393,57430
d841c18384751adb42a724ffed6ee055,19,17,4006,3435,571,18,17,5240,3459,1781
5cd142862ad6166ab6a24f881d9a6935,104,66,252678,38522,214156,110,82,181149,52803,128346
58c6a5a1ba3189bba86622551df1db1a,85,75,118143,30307,87836,72,56,84782,24057,60725
0db8993754a709c4f83b18606109119e,158,126,614687,134212,480475,190,146,637200,149747,487453
54dc6f9bffc9ff0789e4ca716ed6b6a2,70,54,105543,26059,79484,90,81,130452,31953,98499
cfb820a394b704f3a58aff869aa6ad89,29,31,26366,9670,16696,35,30,27138,9495,17643
c456bd58725650ae6544a65da72490b7,69,52,83780,35448,48332,63,53,80981,28236,52745
7e7c2b6620dde7294604b9173b9fbbe2,111,81,205478,39894,165584,90,75,138259,39001,99258
5b44046a38f046f528a953ee1090e0f8,94,72,115206,32492,82714,58,45,66419,21239,45180
ae9e17f7d284626f81549200f2871993,23,19,17986,7122,10864,33,25,33116,8202,24914
fcd3dfd1d2542cbd893d92a7f3bd528b,41,37,22251,9916,12335,43,28,29418,7328,22090
726a53de799e147b6c9351aeb25b75ec,51,38,43900,10614,33286,45,36,29186,12847,16339
adc1d4e606994d92e1b5844ffdba1c3c,69,56,93818,33130,60688,85,68,183204,28789,154415
c4690b7773f17580ab4d073d8309f286,117,96,231252,80240,151012,166,142,366955,78825,288130
0dfe59ec51681e58cc0585d40f984fb7,43,43,35809,13886,21923,40,31,39480,13138,26342
11c27ba05d2b73516ca3259687453af6,73,62,93215,40502,52713,59,48,106552,28502,78050
cc8ad846b31cbd64498c8eee3adf103e,146,110,500726,131217,369509,136,104,414026,131346,282680
e8dcb864c0426290d8837a489f77c3f5,14,13,3009,1474,1535,15,12,3520,1087,2433
616608ec4ed8f5848d71d0c1fbc12e93,136,105,426707,103249,323458,176,131,472287,106253,366034
1b524a71a21effebcd2e868c876c31fe,76,41,106896,17098,89798,49,46,60387,24433,35954
fa50dc017e0f244aa93eeaaad5df29ee,21,18,7292,3294,3998,22,20,5875,3930,1945
67bace29a2720f911dd5dbb85b0b2dc8,112,90,173413,38947,134466,84,70,167463,36570,130893
24915cbe5c06d95f282894140efa59f4,80,64,120507,36690,83817,80,68,113713,43574,70139
2158e96576f79a3d1a236acc5e215075,128,97,368075,80420,287655,134,104,364404,76967,287437
665e0f78690baf5c3edac1491e9f3bc5,65,49,117048,32636,84412,115,85,169531,35081,134450
a8b605163f13b17fb54792c49aa6ec07,29,21,15592,9026,6566,26,24,17887,7611,10276
bf81ccfb91189e52b53d7932ea46a1cc,39,36,37792,20939,16853,53,40,60744,17322,43422
4c5355ed34da3efc3eb620a20aec194d,29,21,26756,7917,18839,27,24,21798,9017,12781
09b2c206fc4533ee943424e471fd7e74,92,79,160521,55793,104728,124,89,243504,50913,192591
d09d177106c8ed0eca47f1e3aaf9c8ad,25,22,9693,6322,3371,28,23,11766,5855,5911
4db96bf452a78d84d7d53e6be60a4061,65,54,86178,34527,51651,57,51,74944,35215,39729
55f3faf7c0c058367795b93a23f38c3e,146,94,379329,92332,286997,140,106,343728,126747,216981
1ad16eccab09ef0aed83cbb6db3e834d,96,71,273266,68755,204511,91,87,191050,80769,110281
2b63dd394998563d6d76a4fac505cb17,136,91,281191,44396,236795,102,74,181743,49446,132297
3b5808c80b7392b60a71f52209370224,54,50,39339,20990,18349,64,50,80293,18230,62063
2d446887e46289e7bc590de706ff744a,153,111,500537,88824,411713,135,110,389622,87923,301699
187a60ad67d822ddc6123be837a1bb59,105,85,268072,125415,142657,158,140,499424,114278,385146
485634026c6a2666b3a29d19df4b5502,202,139,839034,181045,657989,216,144,904464,155931,748533
110c7e1a7d9376acb2c0e8c95081ddf9,112,82,168935,33400,135535,79,80,101220,48162,53058
4b69b2d612267b4fd9c41fe6bab1018c,42,34,71118,25573,45545,38,32,63179,26306,36873
8ede5b8691364165a628890631acf187,12,15,2291,1622,669,13,15,2671,2048,623
9ec49b4f04277d6dd37de9abc4c5aa13,129,98,490103,120397,369706,126,97,486187,138393,347794
5d8641af3c6d8b6045bbe428545d3221,85,69,133220,51799,81421,98,67,172410,41211,131199
d259c9c8ff5521ee6466ca018ee27d24,27,15,13444,6130,7314,21,20,14571,6600,7971
608ffa99fbb76555e9e693510aba2b49,75,59,77134,22371,54763,60,45,62274,15006,47268
6703aba64ced99d1784ac4f32209cb81,129,90,259508,37759,221749,101,91,187452,60358,127094
521d71e69e623a3dc6f167d26f133bed,147,117,318879,73114,245765,147,119,450094,75828,374266
4d5344d9829b2b2bf5a50732301bf750,146,99,530013,95099,434914,204,129,714342,104891,609451
56479b53abed854e422c029f1e43fb15,134,106,300618,59720,240898,138,110,389219,88472,300747
babb4b0c1e89f36535680eda45798bdb,69,65,103996,27484,76512,51,34,44632,21907,22725
2fa66aaadb75d3392d18f862d207d6ee,176,136,751876,163936,587940,222,131,852470,165775,686695
47ca6521c839858413434920ddf6ed0a,96,76,180420,41474,138946,128,94,237886,42182,195704
df308422fa9df2fbeb1b8aba8d9c1453,161,113,623670,110294,513376,160,134,756257,112723,643534
9e1b3ba54685a1e721b3c27e1dd6b3b4,105,81,191504,38637,152867,113,86,166147,38009,128138
a57b1f5530187f0a20ec720bb973a0c7,115,74,166358,32192,134166,95,85,157711,45012,112699
efd68ed56ca53842450a1485c2fa889a,73,61,96354,34244,62110,88,54,109215,26979,82236
f82ec8725d279097b2fa230f5bc01d2a,26,23,8121,6466,1655,25,21,10725,4387,6338
c2bdaf153feb352ffb78df792ecd2152,27,21,18722,7406,11316,28,18,16293,8645,7648
9f52dcd29f9a198000aba8652b5b9b22,188,124,438035,94468,343567,133,95,296145,84250,211895
e61b1482fa4f0378760403b5af156ab8,198,166,1073246,181503,891743,182,122,765759,160607,605152
2ed4ccd674730e5dc9b0b6dfe0008d3b,40,31,34618,14435,20183,42,29,52308,9900,42408
f1b2997a5275d36a735d943d8c201650,85,65,171757,36657,135100,68,61,137875,49982,87893
e7306e30af0231890ea29d87d0d5c04c,62,50,78459,24025,54434,40,37,74300,20851,53449
4c520bc244da26881671eec213d68fae,180,138,782738,152818,629920,176,138,911306,158652,752654
20349eb5b08f2d2a5ca8a1661e97dbce,31,25,33883,8295,25588,34,25,37776,10225,27551
a38f6be530986c4dee914187214d1dd1,20,13,4307,1746,2561,25,14,5396,1840,3556
639d2c2c1bb046d5b7dbbfc6474ccedc,42,37,46593,19703,26890,50,33,62663,17516,45147
df97c58f5b56059b48a41dac2cc05e39,129,95,207752,35435,172317,71,52,111635,36746,74889
de9fcb867a1b2fc52b9debaca9d19bf5,102,66,180395,46712,133683,97,88,132687,55854,76833
69ff6283840a69398b9af264ded7ad26,94,83,211876,67737,144139,82,61,229171,65880,163291
dc7568293490d2f76ade3cf03a98b0ce,29,25,15587,6493,9094,31,26,18818,7069,11749
42b9342006d85ed417bac5e9e6f551c7,136,93,315981,96216,219765,153,129,346815,75172,271643
ec63902397e6c4b4e886d19aafbb9595,49,41,55503,31147,24356,67,47,100767,21353,79414
544049a82c03ff2efcda5fd5dd5bde0f,126,62,190559,39116,151443,74,55,100522,48380,52142
48515c16ab603315461c269f86f74c78,144,117,516611,107167,409444,146,99,419473,88941,330532
371323255e48b682d8a676821376252b,177,131,678882,116279,562603,177,117,549153,120224,428929
33462396a3ac0040977a4d3c663301f1,60,41,60372,17528,42844,49,34,66970,12486,54484
a5009fed828014d2a458d8bc86e7504d,114,76,317704,83360,234344,130,107,342906,102679,240227
22bd10b8bb64bb4f63d3c1034102e9be,46,44,76337,34040,42297,56,41,89788,23682,66106
4513096a7669dffd760f098e08b6aa61,103,72,175714,31843,143871,73,51,95939,29030,66909
65137110796c646dd0228a6006d25b7c,176,109,419962,117873,302089,197,153,619916,133673,486243
2790535edd1eed007be177d2dac90722,42,29,56009,16619,39390,48,33,39155,17320,21835
76d49c12893dba44f932e0eb192bb13b,27,22,12550,6072,6478,23,19,8683,4675,4008
7493809495bcb304ab46a3a3559c17ad,180,152,748828,163359,585469,165,126,829286,136961,692325
8fbede6b482fd803b192f7eec365d90a,163,129,533803,76292,457511,152,111,457029,59360,397669
d9367091cffdcc1a79d6a0b4b0e581ed,119,83,184396,32242,152154,92,59,133720,30831,102889
f8bceb15f3724a06a7d8b1f300193123,48,44,76352,28913,47439,63,45,139728,24379,115349
2bdbfd4d3be106587bbadfd0a1d6160d,118,85,271618,65228,206390,143,119,442879,61439,381440
a55229471d5acef8b305e7984874a578,166,136,581237,172053,409184,165,134,664630,151743,512887
4177fc2624a6894330ae900ece63f8a7,118,71,193608,71209,122399,94,59,191023,48705,142318
f293e1818840ae9c368f2320321cfc47,93,70,138018,32469,105549,68,45,94115,22427,71688
3cdb5ec6388ef08954d0d98439753737,40,30,24500,10866,13634,49,38,36242,15230,21012
bf7b18549e3d3d2947e9f08ffdbcdda8,47,38,44194,15366,28828,40,39,36828,14472,22356
34c7b549f208afba9f713befb14eb225,0,0,0,0,0,0,0,0,0,0
30c5dec6a272d6cd45c67fbe2017d7ae,76,46,80590,20832,59758,73,49,87908,22427,65481
527c57467fd1b6eba96de699d8bef16e,48,33,56269,16034,40235,58,50,60026,20765,39261
1571e8a5e2a3533eebea98fc4b9f7bc3,40,31,26927,14882,12045,43,37,37467,11325,26142
3c8bade01ee57adff1d4db0920bb180b,96,84,116984,29244,87740,95,90,108169,37985,70184
89972137a76efd597f61db7a140d6833,64,49,69115,18091,51024,44,29,53446,8629,44817
21d1dfc898396333363ddadfc9e4eba3,57,45,59154,15306,43848,58,53,56919,16047,40872
b3f6af21b70711da08dcaf483ba59b07,29,27,21180,9745,11435,33,25,24754,11246,13508
90b7c93a4a6bba1b215dfee6dd781af6,144,87,312434,88063,224371,131,99,317116,92361,224755
d30914f0506bd1e2de223400166ff437,62,50,69927,26171,43756,67,40,78062,11299,66763
b7aabbb684633deebd14a5ad4e10731b,101,85,262721,78750,183971,172,143,477852,91857,385995
993ca8d4ca818cb3dc74ce24153aee6f,73,55,132360,20771,111589,62,47,78929,32275,46654
d83c6666baee198b7d222cb24666b84d,121,88,291511,44364,247147,123,106,315127,83048,232079
c5aa140886c404022fb653f509f3898b,28,25,12296,5360,6936,27,23,11587,5572,6015
520b998a482cdf9fbde473b33018b4b9,45,30,40461,13044,27417,38,26,39443,15419,24024
660d0c0f9d71dc05bd76583e385e0dd4,62,58,95485,31605,63880,74,58,120205,38696,81509
88496f8eac278f2ce0b71b50e70c8192,58,41,107912,22074,85838,72,54,55990,26025,29965
70a4d2d27925c967f40e28420a7268c3,140,110,480118,81040,399078,147,114,324017,69158,254859
41b4ca5660b98f248685a9a6dafb4bd8,7,5,3592,1112,2480,4,5,1102,1366,-264
8c59440242c357f5b62c4613dc081a8f,31,20,17352,6497,10855,26,20,9805,7159,2646
aeb47ee436461da3b3657f0ebb66a0af,65,47,86566,25184,61382,87,71,108072,31671,76401
fb307c88ba81649eb64e233a6569691a,14,6,2517,824,1693,11,11,2508,1928,580
aac2fe31930cc750e44aa5d742cad656,98,93,220980,79730,141250,114,90,264538,47874,216664
372e7f56171b3ee2d769e550ee6825ff,101,82,202121,64556,137565,110,94,267992,50616,217376
f0bb110319e79fc3edf101483b09100b,126,94,474631,89921,384710,138,117,563340,115171,448169
4523d2524eb65940413e41fa559b4617,107,71,141952,37749,104203,82,56,131042,39018,92024
74630e7dde80777868f3adf94a843484,194,110,578795,89420,489375,141,113,530784,100464,430320
eac617c560691d5673942497657b9a1a,53,34,48915,15753,33162,45,38,59504,17664,41840
5a4f90b036fc6d5191769c55e79289cb,50,32,48455,14833,33622,62,46,58377,13805,44572
b284ffc8855a13d6bd42004fd6cb16b8,22,19,6266,3168,3098,20,18,7614,4376,3238
93adb322b1be2181930bb398e195cbfc,27,23,12184,4647,7537,25,20,6343,5918,425
0816abbdfd86f2ff1b16594b9d2114ae,52,37,46349,10861,35488,40,35,35833,19745,16088
0b69c7e9de2f4eb884f11c2b33b5a910,21,19,5653,2746,2907,20,14,3695,3139,556
a9233c3b05d6bf37e75893eca5e33d6d,62,46,89208,24084,65124,68,42,84626,24738,59888
93f872168b7bb32b4cf8fb5306cc5c47,87,74,180254,46891,133363,112,100,254722,51680,203042
5f4894da8d19637c5294c0519c8a5706,94,84,163853,39434,124419,70,58,131042,38739,92303
4a94855d17f3d459312607ceccf83081,45,25,76491,14468,62023,49,30,82259,20293,61966
0df681b86b2cdd7f40b29b8017fbbc5a,86,54,101206,31262,69944,96,90,153119,38375,114744
c44d812b93179c36bb3086017b4a7975,72,54,74477,21938,52539,63,42,72417,19625,52792
d5119bcd51bcb6492ab890305c282a1a,113,82,181605,40680,140925,144,100,259189,46687,212502
b7169e9157828d655be167c330da323e,162,133,469661,76780,392881,200,137,560709,69840,490869
07ed60b7c69b063f391939d0979d2121,113,79,203699,33024,170675,110,93,188219,61421,126798
79431851382410f10006d8eacfbfd63c,127,92,255085,47367,207718,112,90,246547,56870,189677
61ffa251f7c06cac49c9d9c0bac485ba,166,130,510709,115110,395599,151,121,490253,93936,396317
355b480d5b4effd5ab8b3249cb313e40,37,21,49243,4949,44294,38,27,31815,10385,21430
d0c2cef3ac878bdb33a6cfb1b9a7eedc,89,69,248523,53693,194830,132,52,219310,53062,166248
55c496ccedfbc54e8cfc65a16d5c32f1,175,118,757727,153065,604662,209,158,858481,154312,704169
cffcd8a54903cd3288fbdde0c6a26b72,137,86,281119,54299,226820,144,96,340540,59785,280755
f7d602f501d716f6fd2ccea07758b75a,150,111,621254,87425,533829,162,128,526313,78360,447953
c8d9d34564971a92c4f7bb3dcfafbaab,79,58,118003,42340,75663,57,50,86436,36790,49646
c8f088d099f2290b9423e7ed830d7356,87,67,171153,59800,111353,98,74,207194,44229,162965
248e13244a45114168a006b6660a088e,51,41,43517,19591,23926,43,37,40095,19879,20216
e2c9215bdd18ce416f684f953f61666f,79,65,168532,39694,128838,113,89,188132,42236,145896
a8ac40a8ca9b6d3bb3e447502eee744a,166,116,522203,75354,446849,141,121,401683,90827,310856
ec5be6abc9ba5d5af4e710f30d424d3f,83,61,124554,43214,81340,96,76,176848,40049,136799
4b61b8cfc2af87e2b17364562b4d39f3,28,21,8882,4050,4832,29,23,9481,5503,3978
b34b6ff57cc5eabd46620da7db1e0a18,151,124,326059,68224,257835,155,113,353364,86651,266713
640372ae2aa5d6fa65aba04d156196b0,143,110,560304,90946,469358,156,127,398741,123778,274963
6d805d4f21abedc9db52e0f10529dd11,77,59,88368,20838,67530,82,68,98042,20159,77883
5a926205c740ab99bd2184a04aba1710,127,92,373695,65837,307858,166,117,533176,82399,450777
d4521be5cb2bb435bac56effb1091efc,141,114,348845,61055,287790,159,121,357331,84012,273319
81d319faec4b8efaff6963d7a13dc61e,40,30,31641,15956,15685,42,31,38003,15867,22136
5ddfb021ef7ce7a8925041026afc4207,118,99,192568,37768,154800,88,69,167356,34391,132965
b8c0f74927f732a693e14e6b670312fd,161,118,548060,97171,450889,180,146,598215,142176,456039
6477bcac0e4ba489d1328c947e1a42fe,38,31,43624,13735,29889,40,29,41570,18616,22954
1fec7f38e88d0eaadb375d2efc910ba1,127,88,284458,64463,219995,124,71,294648,42590,252058
992df68be667fe19bcb42e8640b1616f,193,162,790457,172969,617488,164,144,593310,165117,428193
d04423af8fd7d99990d5563649b238c1,135,115,370873,90630,280243,150,119,370984,74355,296629
b6b914fa33105d1fd36468c68c46b8c1,34,26,11544,4543,7001,28,21,16517,4695,11822
8d089c752047cf827d4cb843e6858938,32,21,25840,7926,17914,38,27,26636,10953,15683
50105268f98b1103ed926cb2cd57532a,172,128,621619,103428,518191,172,142,721523,166240,555283
51bd3fa9e4454daa6b27fb9db6acaf90,27,18,9104,5663,3441,26,17,13317,4205,9112
970ea08743782f5354f1583486e67e39,20,18,5254,4665,589,20,18,7411,3878,3533
a5fc70c178b41f49d128bffc7303784e,48,38,67724,19053,48671,55,45,62493,25818,36675
3818f9597d5327ae5892e91dd8e8c821,156,120,455620,99081,356539,150,111,532712,143462,389250
9f5d69623b11578fcf4b4c23700e51d1,181,125,775097,120953,654144,152,129,577052,108115,468937
2b23baa4ee7e0d93b57c62d7820ea0d3,28,23,15065,6585,8480,38,27,24375,7676,16699
e3b0c07e87eba5b9b6d176f72c65a57c,87,78,174867,47264,127603,102,88,193321,41688,151633
c3de480e64a73b481c436fcaff240069,45,32,38136,11855,26281,37,34,25617,15004,10613
e8f912490b4086ba635963556a19067b,68,62,92676,24459,68217,70,54,90404,29032,61372
e62808aa57e1576852fc98be17e7c2c2,46,31,34555,11368,23187,29,28,25301,9261,16040
362a97238eac8a4393c3c34e032268c1,136,79,489520,104565,384955,136,118,493992,116913,377079
51b63897bd022070a9f089c408ebd172,43,24,79898,8967,70931,60,58,74360,19548,54812
8e26828a2c8957c804da7aa6742528c2,1,1,443,345,98,1,1,345,443,-98
0b9b269870d03ee67da989213afaf930,86,65,154674,34334,120340,92,66,161590,30712,130878
a2808c93bb514c36548a3886e888d34c,155,113,615566,122894,492672,142,108,587974,100943,487031
df3eb3e78cc88da716eb8fff1581ad47,55,37,64370,21064,43306,64,50,115382,24492,90890
ef3872f31df15b55b4ad332a546952dd,82,66,141451,49487,91964,101,83,209141,50112,159029
2c7dd1b6cb84d057a31d506fb2d9ea4b,155,114,339468,93300,246168,113,98,315917,97310,218607
a02dea392771a1e5d7ce67702af0eaa6,193,141,878846,130768,748078,166,132,564420,144656,419764
74cedf75605de5ec7437d7f36d627ec5,52,43,59270,26491,32779,74,57,113751,24669,89082
2742a2a83e9c3bc600a6ed349d1464a7,63,57,131892,36414,95478,61,52,81927,25712,56215
eac3f34d46434129b14548e4020ce1a2,145,123,459787,77516,382271,152,126,352241,81496,270745
30144a65d4d15ed54d3fca196c5429cc,31,23,12221,5440,6781,30,21,12615,5798,6817
92145f06ebf73c910d9eaec1b59beac8,130,104,456095,97087,359008,112,84,270731,75371,195360
3a44ae9a281f4bcef784734248a323f7,202,139,608189,118168,490021,168,119,541396,111451,429945
fb56d6fd13db2b0ee601a7cf4d7b8605,80,63,140040,29447,110593,80,61,108856,48122,60734
b341f229e2a9a4cf405e59c45035f5db,167,138,701361,157463,543898,190,117,983545,149383,834162
7e57d570a07dddc85cfa8c6bd914184e,93,72,191967,58041,133926,139,109,304484,60245,244239
2d11c4bd8597eca7417e127f13d17085,172,119,616222,159492,456730,196,138,751816,130062,621754
03831f2f53ea034058f4850db2294ef9,15,19,4574,2760,1814,15,8,3755,2339,1416
51bce9bfcf5a5aa7188f1b30c2270b74,83,59,136785,41696,95089,78,70,142485,34835,107650
496b8e45443799eebe47144142af2df3,135,103,312994,75289,237705,142,129,373356,67373,305983
b5322000cb5141463ea96d66169f7318,120,105,309260,50578,258682,100,94,247981,81132,166849
f01a4286b49e1ebd853e13598e030249,94,75,159550,32787,126763,79,61,121157,31821,89336
e13b1c803aab19d3dbec54f1beec19e7,44,29,40211,12426,27785,50,53,38859,20384,18475
73445b68701be60563c5f2ba65ede3f1,60,48,78239,12864,65375,46,36,36408,10580,25828
d594a148ec998ff3fae5445ed62c0908,39,35,39628,11715,27913,25,23,21680,9400,12280
bf0ba153513ff9fc6fe320613c35f860,126,99,427222,143384,283838,192,134,645022,107961,537061
9a4eb636634a2aa83502b84c5f72097d,54,45,63873,25227,38646,52,40,57637,22099,35538
010fb42fe1a5a5a7cb703b053cbf1de3,14,12,2224,1137,1087,12,8,1996,479,1517
6aa054dc26330f798d010be78d2f4d14,87,60,180025,68651,111374,109,73,215555,56046,159509
74780cc1325eff175924c5f222e5c368,135,98,317860,82584,235276,135,100,336511,83786,252725
392a827287467c6a1efa0b6d92402e19,44,36,40635,17962,22673,66,46,54852,19973,34879
b5956df7060844062a0621c471a1d171,43,30,50463,11910,38553,36,32,34124,16144,17980
2c4247f13f5209d88461c80c2921c6ec,102,71,231844,87586,144258,96,72,205699,72298,133401
274c56e2815912ed5e82d54925fc8dce,126,71,259768,66719,193049,132,110,270386,89284,181102
ab110ba6d55bfd952f08a508d1da8d80,118,80,235693,46989,188704,88,83,185190,47156,138034
f141d13d8022178a5fd1d8a05ffb82e2,75,65,137436,72873,64563,109,71,205868,57544,148324
22fd719f356948410b5b7668f2d193cb,21,13,4166,1609,2557,15,10,2963,1133,1830
bc720920add4b4ed8afbbc63a62e9e1f,37,29,20021,7867,12154,43,36,28334,10045,18289
3b905c443f1aba14b18e646c73e5d140,25,16,5787,3335,2452,23,17,7237,3456,3781
71671e9630415db98e480d86d7317a83,100,80,203065,45620,157445,84,76,154287,49581,104706
13edfd5b99f86dffaf5098195d24e909,46,24,37528,19432,18096,38,33,71428,14222,57206
b7d053ff57c4bd87a6053ac55635cd06,149,102,349368,62054,287314,121,85,268372,75493,192879
5b6b0925a65ec278d63a3bd58ef25faf,46,46,92292,30249,62043,72,49,130142,33263,96879
f7b98973066e545c4d14ce704656fcc2,107,94,252179,68279,183900,140,126,383686,79334,304352
461d9f925f4d3a5547bfcf3aee58d79e,42,31,35017,11774,23243,43,29,49756,12889,36867
1cd4fd78b7783ecfe596d8a4dd30a632,95,68,196544,47295,149249,84,63,182895,56748,126147
778f876be46b0c4b389943678ee2569f,39,29,35049,14631,20418,44,25,31770,14490,17280
27a8535c85bbefbe51ac22efac92fdbf,40,34,48954,13708,35246,47,25,35000,16910,18090
ae4ff2351f3f8bbf3808c9dcb15cfaa5,170,131,594145,96207,497938,184,149,669391,116756,552635
8dd6b293d37f1a289e3dd67e7db1f602,41,26,31817,10444,21373,30,29,19559,12022,7537
b5770497d59df5c685f7d214fe3b2325,76,60,106917,34167,72750,78,61,153079,28554,124525
89bd4fa0c62a5da5a84fba75983ccabc,123,102,287609,50590,237019,122,94,286319,56119,230200
9ccaf678b79b920da60459276b65dcfb,44,41,51141,23519,27622,64,41,81374,23699,57675
8dba16dabb6d2f3136a9b98a00fc765b,32,25,32564,8655,23909,38,23,22243,6343,15900
abd8c8a3cd8ad9c7d756fdf9315dceb0,100,54,170211,24578,145633,68,54,80216,29910,50306
8248ce88fb5839d558ed0d6696d4f769,90,81,187862,43405,144457,80,62,164871,56135,108736
948812c646fe4dff66af3e0aedd8311b,86,68,138065,22362,115703,68,56,87427,24630,62797
8d54431e0245f8fe8f040b2efe19609d,29,23,30833,10987,19846,34,27,26352,12689,13663
3999d687f92eea2567384a7806a8286f,70,59,132884,29264,103620,66,56,88400,37814,50586
d7b849f18bc09592e78131cd113be8ba,97,75,223520,66163,157357,118,90,305834,63411,242423
ca4e672a51f2c0207e47bfea78cf8b56,175,134,460083,78256,381827,90,76,265735,97155,168580
cb6071a560ff67b04cdb52c1b235817e,102,97,161850,42424,119426,79,64,132224,32466,99758
dd1ac2fb87dbba88e26f88ffecd8fe28,144,120,510953,79621,431332,149,125,382080,110132,271948
13139ea714c915f20701fa3c61958fa5,51,34,59217,15491,43726,52,42,42719,18230,24489
9e3a77d1150f1fe8f706a423241376ec,108,73,203239,53453,149786,119,75,208071,48256,159815
5c31ec544fac77affc85a5c02fd55a80,117,90,354040,85411,268629,151,109,405127,78617,326510
d8af65d5a6c1544fc49786a874e8ede1,134,103,357402,86115,271287,150,110,317260,87944,229316
0db589ee9ed2c0dc69666004ef90baca,143,117,415484,94385,321099,166,116,412031,100585,311446
5f66644585ef809ecbba382ecf02f651,34,26,21240,8384,12856,42,31,15746,12785,2961
e85e9d206f34ebd3350ebdbb8f26303b,46,41,50042,18612,31430,53,38,63831,18077,45754
a9abb05474719970fa50bb9d367c03be,34,27,33634,8117,25517,29,26,15483,12729,2754
9a2251f4e138a282681c0e2bffc49edb,171,115,332787,42729,290058,116,94,262702,66444,196258
4d99add4e49739c12c260112540071b7,95,65,151252,37896,113356,112,86,195157,37227,157930
115fc19b5feca06c14441eb0c29e2727,89,67,137214,32391,104823,97,78,191666,34759,156907
40b8196237421686be7ecc9844a776c0,19,17,9320,4214,5106,23,19,9110,6278,2832
921047ac8938e79c9e0912f39b9c316b,149,105,417812,85802,332010,152,140,391804,133408,258396
98eaaefb8cc8a9166f5637b56d5b943c,73,62,138854,47024,91830,126,96,197830,55834,141996
94e3ef7cd1aed2c63c6645025162444e,22,22,7656,3115,4541,30,27,7020,3565,3455
ec513f74828e0eb8a09a513c0d2eab1d,190,144,1327319,259248,1068071,238,165,1295465,291462,1004003
b60a035ea3601edf6f8403b4ebc39c78,74,58,154625,57038,97587,102,85,190601,53159,137442
bf202058dc193e6540afd092528b9a42,15,9,4536,1439,3097,13,14,2308,1614,694
77362cc2dea3e3d4cce8b7005a95f5cf,54,46,89781,28808,60973,63,40,80676,29159,51517
9b66e2fee7b99edc85f096acdf0b7707,65,60,123850,39281,84569,91,84,157064,44721,112343
036f0b29be0827aa83756e68480527a1,58,45,92599,28779,63820,54,48,120132,24546,95586
be5371bdcbebc97fe57c0e36f57f8681,33,25,28233,9477,18756,39,32,29375,15428,13947
4713302ada7fc8eda6ab8293ef2a76d8,40,30,42112,14177,27935,46,35,38400,18166,20234
b2ddb269d322d1c87edf16c58c4fb1af,99,76,221052,85057,135995,126,102,336165,55537,280628
ddf6cb240c332460fbd715ea0eda6450,60,54,89036,26592,62444,68,55,80810,28781,52029
470bbbfa2033407addb3ac70a4578b68,35,25,39687,11763,27924,44,29,37531,15074,22457
963a12ab8d645bf4d55ed7b92f52b647,89,82,153940,38989,114951,126,77,143065,47176,95889
f06f546b1de7085d0f8efeb1695438c7,182,105,719810,136537,583273,163,101,766145,112501,653644
fb3ada81f8a350ea5bc3cbbe859276f0,116,82,224381,51119,173262,113,76,171255,54156,117099
c524e200bf27bdfbe487791d0063d602,160,121,330881,73816,257065,101,90,207879,98210,109669
2ae0c690dc8ee8cae779ab5fb49e464b,30,28,18897,8535,10362,27,20,17034,7430,9604
032c1fb0cd908c0a78ae7c1645ad5c97,97,76,166489,37900,128589,87,68,139250,39288,99962
d2fcee925f4e96d8d8ed369736091a7a,41,30,25180,4834,20346,28,20,14022,4801,9221
d115bcbb505190db2b4657e768744b07,71,61,124708,37109,87599,104,73,132931,37146,95785
906c46f478c6c9c4d1cb14dbc6a2eb40,36,28,29451,11674,17777,31,30,39899,10779,29120
6a75164c7766ed50ab2078b652c5f41c,67,47,82235,13880,68355,50,42,66529,19423,47106
e3a42a2a5d32c8565fbf72dc63efa7b8,60,45,75983,32770,43213,61,52,87668,38231,49437
176ea248de17b19cdc1e6e0557e8e2b9,155,123,489008,78948,410060,107,102,329823,105532,224291
bd986374a7f90ca4db89378bbc78346d,44,34,40696,13521,27175,43,36,37773,11123,26650
b3daa81fd3fcd762f0964dc9eb6bc36f,17,18,5634,1968,3666,27,18,6864,2406,4458
26ba0e9168945c12ec7c4c9c50a0eb94,56,43,51246,20973,30273,69,45,60343,18188,42155
a6daf6d9de5eec96f4ce5526c2df6050,19,12,5720,2284,3436,19,14,7240,2204,5036
02bcae6c1505cb33a11df2a83b13f9f0,26,19,13068,3866,9202,26,19,8544,4593,3951
f6e77a9d5ea49801e14bbf886bce0c24,156,96,365213,106831,258382,170,129,426457,98098,328359
46c94cfd815ba628d2cda139a6201de2,6,7,584,887,-303,10,4,996,95,901
b228ddeda9cb59d2a51668c469226f4c,92,76,159240,45845,113395,112,89,177540,36449,141091
acdd5f4b3b0889adbaf25d6a1779a521,52,41,79552,25218,54334,40,36,67421,24307,43114
7eca18f4a9ae8863c95ad6cd3407164c,123,94,208747,43681,165066,117,103,242020,57196,184824
005775f40c4fab2b7d20483d21404f9a,117,96,261793,65950,195843,101,88,218862,60633,158229
90f979c70f8c86714cb494b6216272fb,35,20,24946,7854,17092,33,26,25778,8240,17538
72e9854882e4669e7f4a927b0496bff4,53,42,78870,25181,53689,73,58,82053,26054,55999
3e85a8923cef1b218d3d835d9541fba3,114,102,302944,120705,182239,158,108,493290,88203,405087
b34757ba84e9404f45499cee1b275a2d,102,68,137445,30038,107407,85,85,120530,34511,86019
8aa60842c548fac245007556df0280e5,20,14,4549,1911,2638,21,16,3978,1668,2310
6dc6d69e22292aa3950aa9fc439ab53c,123,110,426211,75189,351022,112,90,239989,73743,166246
409285160236e590d009d6ead437167b,69,49,91864,20127,71737,85,58,102830,17364,85466
88595ecddc226a80add539d3abf23666,119,81,238028,40121,197907,99,62,189954,46615,143339
6e8e62cd793f5a39c7274fc4118b039c,146,120,429181,106273,322908,121,99,423886,73008,350878
aa8af9792157ce80acaac5f3b251e5a8,29,25,11735,3920,7815,24,19,11207,4147,7060
8871172faadcbe3351b6e4cb29a74f81,25,15,9753,1864,7889,27,21,12064,3172,8892
578a77b4e7ab919a640bb644586a66a7,19,14,7719,1570,6149,25,19,7899,1902,5997
c44b9298b5589da0d554ed7bbd0a94cf,59,46,58805,21115,37690,54,45,66622,21587,45035
7185e29ba3fe7c3fffc922cd9b39b91d,51,40,52554,19908,32646,43,33,50796,16388,34408
1870cd8663bece16e420f52691af32a2,57,54,94517,33509,61008,51,37,53889,20659,33230
8139a05cc6b121baec7d717f8e1c5026,131,105,324488,65885,258603,133,118,344273,90172,254101
48ee39a1dc4b823192e26c5360363f82,135,107,337371,59275,278096,89,63,180877,59229,121648
199b0cc7612688e0c9264d70c5607215,124,87,261640,73671,187969,93,86,162483,51601,110882
fc6e668590887f82b6e8cacea08bf021,192,148,935873,137952,797921,234,177,925140,148250,776890
5aec04a875389f4477a220e9f5a3e3de,75,72,199774,77419,122355,101,94,305610,97140,208470
a5eb64057780632d6abc5790516aaf8b,19,12,8378,1669,6709,22,20,14970,3876,11094
6449fb2c247d7af57726df5e76c36917,108,95,302632,78819,223813,106,87,223520,75040,148480
45842254424f3eb74c3705c5061aa02c,3,2,320,276,44,3,4,306,350,-44
503c3e346e2d3538ba38f183cc65e03d,69,48,104729,28979,75750,61,51,82090,21728,60362
45ca9432c6c091461e3c61cc2d6a00f7,117,81,239464,37871,201593,91,81,151208,50545,100663
6136f06cf2312d52da29dad50820ada6,176,153,673374,159832,513542,216,148,625809,128035,497774
34cd390ae2baaac0c299330c92f79ae8,135,110,425046,87279,337767,161,104,424138,69746,354392
ad9d21b68a466ff51685edc53d09aea5,43,33,72802,15745,57057,48,33,49721,16282,33439
a6c075fccc3f5863b8c18b7cef8c8997,168,122,404844,93054,311790,110,75,320460,95064,225396
be795c9a2aac6ffe19cfd60c07cce0d3,183,129,717908,122295,595613,206,162,789849,134421,655428
bb39c5b5626657d2201254584a1a9bff,144,113,397855,81675,316180,139,112,344647,79675,264972
d9fa065d8cf21b0942c615cdd262a1be,74,64,136689,39552,97137,58,50,98927,33826,65101
f7a95297199e242122f9dd2c289afbf9,31,26,23571,10421,13150,39,30,29869,12017,17852
13984a9d6f0fce82d98949a385fb5a9f,189,139,459381,83005,376376,172,131,386472,59940,326532
7f958ea5bd9b50de02cc5cba2e129589,21,17,17049,5903,11146,27,19,21423,5935,15488
99b2e978387e6f2e3db4f8515f2cdb85,29,25,10983,5844,5139,28,21,9668,5590,4078
0ad4ad2e6fa5f7d61571685d7d491154,227,162,1205027,193320,1011707,199,148,824622,229152,595470
ec0cddb5d7944c9fdca902d4c124c1f3,105,90,127433,42322,85111,104,82,144974,44994,99980
6cc0668733a821ffb9ce2b04f238250a,48,43,43416,19929,23487,46,33,48361,10712,37649
c6f7a508f6a7ee37c7eb26b73ba15bfe,67,59,157975,63582,94393,60,50,83511,65256,18255
6b4691b03ef963f42172f1b0e7424ade,46,39,91761,24906,66855,49,34,83190,23430,59760
29dbe8dde3515cc14970c8bcac8135f6,192,144,529644,94420,435224,117,93,333842,75109,258733
5c16af3fa39105658c7bdea3d1c1ece3,52,48,37836,12343,25493,41,30,29537,11286,18251
e756ea3c66e6a5fc182380381d1b139a,181,141,426426,99797,326629,150,103,410074,64045,346029
815b4860daf9b8af119ab7d4ea667fb0,26,20,11562,3996,7566,26,19,6509,4316,2193
2c916c3897e8e12281866cc882063de7,150,123,462306,88445,373861,147,119,430759,70424,360335
41951317da262c92ce092334d13d67c2,116,107,238364,48451,189913,90,79,164753,44615,120138
b4c880fa510aadc3acc922b39fe026de,94,80,220712,39876,180836,105,93,208034,51716,156318
3e676778807c11c0c4baaf932c9d5d83,24,21,7402,3433,3969,24,22,6697,3952,2745
fbd130bcf321b71bb5e85e86fc8d24ac,56,44,152067,74249,77818,132,98,288276,77354,210922
2d194018bb57df3a433e34bacdf0179d,161,125,306758,57913,248845,133,108,284408,66141,218267
89f4adf5e2943831af16383fa9972681,62,54,83259,27698,55561,50,32,71844,22157,49687
e250544e7f65a7b0966db5abf84b4180,140,115,320325,83384,236941,147,116,383753,98141,285612
906eb05ba6448e4d10b934d5b4695bca,64,59,101492,23318,78174,78,63,86354,28720,57634
ac6a57263235c7f9e322510022b12d3c,23,18,11012,3414,7598,16,19,8380,4491,3889
7da35f36043b2a0ccff4174b3e74b3c0,26,20,6482,2575,3907,24,15,7186,1668,5518
2669e3a0f5033206e98e6242acd43838,113,85,271821,76447,195374,123,106,309958,71515,238443
3ce020f3ec6d4783c535a498ada51b0f,126,91,248999,48459,200540,146,123,395352,48854,346498
6413f5ed61b99737b2e7cbfd2bd06f68,211,139,906249,193367,712882,218,156,1168932,154702,1014230
46be09ee9eb37974e860f45e887821a4,127,96,277869,59664,218205,110,74,222364,50339,172025
d888645a4bb3485d088eb5e6989b1957,139,127,424177,76794,347383,156,139,613716,91585,522131
8a1125870f5ddd57de57a45b1548cfe0,156,111,346782,58425,288357,144,129,354043,100948,253095
edf6535b133b7d0ef39e1feea2b6737a,23,17,9412,3159,6253,25,21,9133,4123,5010
5360e29c474751e2ef845dae7f25f30c,157,109,693200,127603,565597,228,186,884380,126693,757687
b0d2195212958bce774ba60626811397,55,44,65868,20055,45813,48,35,40045,12425,27620
f5124c8010ff81ba7c1a35c4afa190fa,239,167,1127609,192229,935380,198,152,1080664,237170,843494
f3e67f7708e632244be98ea6021a7850,93,74,130174,35036,95138,59,38,99765,35312,64453
f6f904cf19c05d1af69e00ffe0ced57b,133,61,165436,35463,129973,99,77,145528,41591,103937
310fe39621855e2ebc68e4a24f6aadb7,104,72,244649,47495,197154,91,67,176385,48389,127996
5df193d6bf86cd0453e37bcd7c0c15a5,101,81,191345,58548,132797,87,63,192028,60561,131467
56cb0948fee74c4fa8fea7c0859776a3,78,63,115280,28003,87277,70,62,99093,39319,59774
3432977e7dcc6c6b77837e65cd662d2f,28,20,14126,7285,6841,24,23,13672,6581,7091
3f8b02f83a887cadfbf673285719d5c9,44,32,37236,13550,23686,41,31,31020,13906,17114
1e1983e7e2ad7232459e47941c462be1,187,147,655525,104793,550732,193,159,696252,100925,595327
a2d9d2d2094934a2bc26651b77210e97,144,115,373226,103382,269844,205,141,536796,96073,440723
5b0a95402415fcc9e965fdcc423c8694,74,58,146547,31834,114713,96,83,134700,40238,94462
059f5e786e5bee78b465463f5c2bb234,51,32,65666,21434,44232,46,37,54583,23712,30871
f0e19d94ed51781bcd50910a15d7b8c9,30,19,10557,6201,4356,27,21,14075,3917,10158
b438ad60e341394070b4233496a4d92b,66,58,149844,49394,100450,128,79,205413,59302,146111
8cd85777daa0535b75965262d7ea1924,142,104,331045,97403,233642,149,124,383904,91151,292753
62674d50c6c9468ee3fedad290fea6b5,39,20,52242,17674,34568,32,26,44367,25747,18620
34e2e3b5097eb711d413299c4c56a195,143,110,349342,79448,269894,102,90,315022,74706,240316
baa77605aff08c8231169b75d0db8888,28,25,21753,8972,12781,29,26,17075,9483,7592
bbc07df50c552fc7f9e2cb8f91147f64,35,32,20884,7584,13300,39,31,34173,7428,26745
f31eb746ea13e7a1ea6bfee7feedff5d,96,71,211323,53004,158319,99,82,197806,50084,147722
5d781511207002d2f6db309327d96dcf,188,138,745795,211043,534752,199,146,816738,242595,574143
bd13869455ea21bbb18e57f1c3b62a0b,155,110,458576,112596,345980,178,142,511330,91809,419521
1c6da28836b5e524b45891e91291dea7,188,140,797318,189804,607514,186,140,907424,222489,684935
d176fcfc83f045b1ab1e23aad92bbbe8,118,104,307544,74641,232903,111,85,258197,69058,189139
c9b97a92110fb3ab1112661b6d519f36,59,43,56968,15921,41047,38,28,41034,16242,24792
ed5a732831b4cdb54d57835ab25fb160,44,33,32003,17129,14874,50,41,46887,11878,35009
a042b3784caa068038aeeb2ac30bda54,42,30,38461,13568,24893,44,34,47579,21000,26579
a78d0149ca26a6d41f461cf730ded66c,80,66,125211,56326,68885,64,50,117723,35064,82659
0f6deb3c02f1177c0abd392de7c42095,28,26,24458,13444,11014,29,25,30430,13403,17027
8b1cd062f52a25eedafcb28feb1aec22,63,55,101191,24091,77100,73,57,92201,29818,62383
b2eed3d09403a40b49db25946567eada,46,41,37317,15305,22012,44,39,45284,15866,29418
92944ceb1850b48b9988882d20fb4bc4,94,69,138899,26773,112126,106,83,140008,34950,105058
ce386a97d814ea447400098b0fcb09c1,101,74,296161,80239,215922,126,82,303021,98338,204683
b454289b0679beb3a6d391cb7bec588b,68,54,109226,46356,62870,100,88,195847,52428,143419
01155a3696e1460f543eb520602ace9f,129,84,290345,75875,214470,133,97,415658,94049,321609
a9b3b15354973a8c9935db3f750b7d01,55,44,67397,18676,48721,51,42,53512,22165,31347
bb94b26ca92a105fd39fabb82d39a96e,78,72,115245,44432,70813,79,62,135151,38718,96433
2e06712756d0792d732043ee1c356662,131,100,328151,90549,237602,151,117,446479,93216,353263
45e3b8b6704b1ba0a8c4da69c1485995,107,82,187070,83346,103724,141,107,288119,69828,218291
73ec8610ea14fad9ea52e80c2f8b6d45,111,84,322500,79191,243309,119,107,358602,80029,278573
fe3f70a3f46c36230d3e2cb84c7d94b3,50,39,64944,25599,39345,50,40,56215,19398,36817
75a8109336d83d81972c52fd7cff51c5,47,38,62741,28064,34677,97,61,141638,44847,96791
581c9fe4c7a1a57455c3a44c9851096c,165,130,463200,78887,384313,126,101,319539,91957,227582
a827e7e6836e5ae89dfa203b9d9045bf,74,59,108708,36593,72115,83,73,118591,37030,81561
438a906e86c799da3491dfe105589929,56,46,56103,16383,39720,65,47,70335,18769,51566
42d1fb24de9773f79f606f9203381c0c,99,82,259390,93290,166100,166,136,496363,97961,398402
4c0824d1b719a1c07f91a8ad6ea2528f,48,32,39564,12117,27447,42,31,44345,13632,30713
b920d8c3d8c85ce204a12ac43e05e7c7,85,66,168515,38378,130137,89,71,148852,35938,112914
d15dee4e116179d17c4ec8791af05b51,58,39,69186,10107,59079,58,45,53751,23975,29776
9ebc0db555def20776c0fa49b94cc94c,39,32,32307,12938,19369,42,36,26027,13828,12199
05b007a91fb02acc22f375076c5fdd8a,148,105,468418,86051,382367,176,121,468715,109125,359590
d4422acecfbb67e1f76d47104242ea34,7,8,403,1283,-880,13,6,1659,326,1333
9e420d255b4e42c39be2d1861693a0a3,123,104,311144,94202,216942,97,83,255829,76872,178957
943b089c60526275f5fe101db770d824,151,112,476127,88807,387320,181,142,526779,90165,436614
60d3c4491ba34489983c52d9ae18f517,215,135,581664,131690,449974,159,123,530105,188765,341340
2279456e2a0fc9800e71818cd9afb227,82,74,140470,48920,91550,74,57,123776,30721,93055
a0f8d15b5d9c04e422ef6f83b2679aff,108,77,146163,22178,123985,114,89,165084,35520,129564
d8dff59cfdf2537b945a26d884a94e95,25,17,11465,6421,5044,27,25,18843,7632,11211
2578aeba749926afdb4a3f8a827a5e12,35,34,29378,12105,17273,40,31,26773,12121,14652
a79c464597d56083763317eef7d04f23,23,18,8100,3456,4644,26,19,6622,3421,3201
94bed0afea3619cbab2b89348818532b,48,35,52577,14873,37704,42,34,49840,18255,31585
54b496dcf47b2c5560c1687883c32b57,147,116,402838,85192,317646,177,143,669756,72256,597500
6f79a38dc7321db1aec3425f808de74b,160,109,424882,82988,341894,156,101,446964,65929,381035
8bd59c2e88832a5c5c2be84cb280ff0e,17,13,2833,1408,1425,22,16,3541,1602,1939
5664bf4164db3a00f948b0849052cc7b,50,35,41796,12770,29026,39,31,42226,13420,28806
8452f1c6f90d152d44e400ae5db3e51e,70,55,118302,36589,81713,68,63,116261,36405,79856
b12945003814d7b09e6f4d46effd2ba7,40,31,32403,19545,12858,40,36,36976,16696,20280
94123d88774db912ab464e7d1624371d,175,138,676273,110896,565377,160,122,616417,112630,503787
4c7b2fcf974c583fe5cc1cd35be2899e,75,63,102634,28065,74569,78,54,72432,26853,45579
f2b47f374fbd160498d2e495ad730705,174,136,742674,121738,620936,166,148,798636,147385,651251
3ac1be557e08eee48aa323b3c1dd0782,59,40,55359,38005,17354,101,73,136943,28958,107985
2609e921205e49b9bf8a09c4a660dc29,48,35,46077,16122,29955,59,42,62852,20894,41958
ad233b38e0642b4a7e82103619ccb850,102,90,152662,31710,120952,75,51,77786,22355,55431
dd9bcf66508d7163013fa743e9848f00,88,68,187986,75231,112755,84,74,198153,60888,137265
66f4610fe16a1e55de4a06fa4c620d55,77,57,151867,31602,120265,69,53,120275,35220,85055
ae415f9af9718ea4d06c569923ce5fa5,114,86,301220,52875,248345,119,111,260394,69244,191150
114a8fe6cad89f72aecb2ac931d50f83,8,2,548,148,400,5,3,468,166,302
b1a8b0c14c15df4e90509803680f9664,113,72,289881,68818,221063,122,104,287112,81067,206045
8dcd83b44a546aee24a05aa4afb3fefc,79,52,170953,35178,135775,70,56,135716,33498,102218
8e017af13caa16ed80be17de16aaa456,29,21,24757,14625,10132,35,31,42479,12302,30177
e1f9afc4d36db21a655c5c0c8efde6b5,22,16,8030,2199,5831,22,17,5339,3296,2043
ab4f6517952bfb972af105ae93c79593,147,109,351844,72516,279328,155,110,326293,73792,252501
c27b4ee268ce30c8265338b51587a169,128,74,175924,38636,137288,145,91,221838,42602,179236
a87a00e69ad3206c2798dee38a293d13,40,40,54276,18308,35968,35,26,46135,17384,28751
9223f038969ac3c986bfea8a75dc0bbc,31,23,12328,5548,6780,35,27,23721,5916,17805
74d9bb008678028f7d0e1340e12c5515,78,68,84744,21991,62753,80,70,98931,29629,69302
f013a416a69f9fa50e8015aeafc0034b,66,50,115533,25484,90049,60,48,103860,21065,82795
f2d4a69cf9ddd31725760b5ba8f3082d,44,33,59291,29835,29456,60,49,154171,32106,122065
ca9b82137d5e53bbf679d5ed8e2cc49d,55,42,39203,12030,27173,59,55,59337,17963,41374
5a53822255d773ebc7c3c5bf1015e3f8,43,35,46284,13179,33105,59,42,80035,13177,66858
3eb060ada3e3b7839a2cdf27e7b631ce,149,114,353946,103646,250300,166,135,443187,96658,346529
cc565b877d67c7c08d547b255920f60a,100,80,234618,56538,178080,112,86,247561,70863,176698
86259682122c690fcc87cc1e29bc300d,41,35,46928,12239,34689,28,26,32878,12750,20128
a316a6e52d7fa9eab13c8d37c660d70f,44,31,38478,13298,25180,56,38,58028,15144,42884
8d1d6ab208a10fb9b2f65cea2a76527a,97,79,172503,32686,139817,83,57,138970,28505,110465
789da8a625d2b24a631828d57c86428a,223,146,763174,79393,683781,189,116,504597,69595,435002
83cc0c0d4cf8e2d0cbd94939034a110a,45,37,45864,11835,34029,32,24,24135,10438,13697
680e420525a987e15c93755c5ab0150e,190,143,621763,140987,480776,174,118,563626,101763,461863
09d52f889ad1dfccf00b1acb884f1d94,138,115,533677,134687,398990,158,107,499398,141034,358364
8209251d6bfa5557add73216538d4f27,31,33,34648,16680,17968,57,34,55739,12447,43292
b79bc344f7237235df900d5e80b150db,36,28,37012,10620,26392,38,28,24848,15360,9488
5c59755bd04dca1bf77c5b0762ec1fce,42,33,39185,13903,25282,35,26,26403,12533,13870
14dab4d8f13a3cc24382f7d3a7b3a3c7,34,29,32555,9399,23156,35,28,22352,10187,12165
6487dc0d6bbe7dcaa03cf043688ce01b,209,149,919027,170678,748349,235,162,984432,201973,782459
43bbb19d3c5922d9a00837a4c0fa219f,96,76,190436,52926,137510,95,82,151783,43881,107902
72996385eb0551e8946a6d977f61c5e3,156,123,511089,152554,358535,177,136,524444,135043,389401
ae2281de538e752a14caa23b432cb4b5,144,113,486729,120271,366458,165,110,505091,115230,389861
5c66903caf0d4203f912483b22b35047,114,87,163558,57278,106280,120,92,227806,65265,162541
8f4f00a548192f52ee6279a06534abae,70,48,98007,37927,60080,73,54,165120,32551,132569
5526add92fe33683000cc7be11c47175,93,71,193572,56970,136602,108,87,241107,44396,196711
0c7f285c589ec8ee3d52ea3d95b66c22,78,71,130638,27833,102805,75,62,96250,25417,70833
396c82b2c5c003b5d3902a60e7b151e0,158,128,403405,73922,329483,84,75,191340,77775,113565
b79aba332f9aa9e9f2f6a4eb7e73b10c,71,49,119427,45569,73858,88,62,177286,62691,114595
c844302f3dc0e898c2e67aa6216ca073,36,46,54563,49213,5350,110,73,227801,29863,197938
8541cb684c32bc866c900fe8d07e7c76,85,62,138408,30690,107718,66,62,96701,31134,65567
86e89f1abfea0d6c4bc3f0ef2edffbe6,127,94,305863,59088,246775,155,131,396864,72351,324513
e04bd081fe10f635f31b5010906c9bdd,24,22,9404,3288,6116,21,17,4380,2358,2022
bd7fcf496d486fabdb2ad85b87fd17b1,141,108,496016,130258,365758,172,126,548764,110498,438266
4e9a98fbe6a6d0e8833e65770b89ebcc,198,133,635368,101876,533492,152,106,513347,82173,431174
43e6c7042f3dac10e8db5a4c87ce8051,79,56,105709,27724,77985,76,49,113221,24817,88404
b2857ef8552adeee66e5ed865ca32e6b,37,26,40262,9405,30857,54,38,53359,12633,40726
917b54d91df16d2eda74a076937c7b87,124,100,307718,65010,242708,148,124,418083,61092,356991
da06088c4f0679af5661ddc18b8dbe7e,181,127,725272,117809,607463,200,146,904712,208702,696010
640361a95621e4d6bf07d0f5ca1fc9f4,131,95,346313,82926,263387,131,97,315706,99547,216159
0f99830ba9ca531f0ca86991f3bdd009,66,44,114391,49477,64914,79,72,142945,47246,95699
0276b2d7e09f4f00a2da34f45190bb71,88,48,90844,22456,68388,72,39,83054,21921,61133
d61b5f823203b7a4ba43bd204a378447,98,55,136998,32985,104013,97,67,131062,31339,99723
3548de913ef34a4052a4278e7ce715c9,77,58,85478,36777,48701,103,62,148345,24563,123782
19abbd259631cb5cd8ff0f25499cbce4,152,118,361478,61502,299976,126,116,375713,76750,298963
2805755502b61e965a59ff8a27f81204,108,76,245283,49655,195628,98,75,179452,42621,136831
f4666599c57cded9a0e6a4beb1c312ff,118,96,303124,79110,224014,114,92,215261,76716,138545
f859f783f3092620c32ca44f64512642,101,81,224785,46920,177865,95,76,202554,47934,154620
5fb9470ccc32d7c8ceba25079311d456,85,48,102664,26608,76056,79,57,82669,29668,53001
bc199324566926ef151859d37d6667c2,21,24,6208,3354,2854,30,22,8088,4329,3759
2b2e90330cc7ce023059f4a0eedcb130,150,118,697109,126280,570829,159,131,651189,126762,524427
e11a30c4846ddc95f4b04aaccb88ceb1,26,15,12490,4766,7724,21,17,11077,4515,6562
9c784b1d3302ef8673d3b443b2d9d7a1,74,67,103490,27079,76411,78,48,66986,23160,43826
bc6b39fc607017a97e6c9d6013989f26,105,62,155253,51736,103517,93,71,145139,55795,89344
8205bdb8e395e31cf82801bd889b3015,26,34,15808,5599,10209,35,24,20441,8388,12053
fb8a78643badf7d50939cec3f4610239,50,39,42275,12053,30222,47,40,50187,11261,38926
7fbc80993a391a7cde9efb79bd8889db,26,20,15462,3763,11699,23,20,9611,5954,3657
268ec4ea82820c1a1b972efb2ac563d2,32,29,20017,10009,10008,39,33,28285,10264,18021
72bef02c31de418c2ac4671a778d6ded,61,56,85598,39303,46295,64,53,88429,37188,51241
24805c617552ac6bf698754bf28a6f84,47,35,47390,10374,37016,37,24,31302,12022,19280
1af5aebb977d7b2b266a238d05f1d314,80,72,127636,43099,84537,110,91,203601,41581,162020
f174bc4ceef7076e873e0bf8cfee1b6e,35,23,22119,6400,15719,39,28,19953,10059,9894
8e36c38f0b6ee504ec6c2a026feb33f8,87,52,112397,15216,97181,63,46,88835,22033,66802
6c22c0d35a593113a36b1dd89da3a911,16,11,1803,587,1216,10,11,1538,1245,293
760778bbc87a27989cb1d43f5ba3d1a8,43,27,59570,10479,49091,38,29,38568,14961,23607
6323d4d5695e80c6f3b03b3d6dfffa7e,21,22,11543,7336,4207,24,18,11750,6041,5709
5f43763a34c83ad5597999ab37524e5c,20,16,10944,2936,8008,20,15,7973,3132,4841
039403020cb5fddfdf255764ad847ca5,41,30,42665,14731,27934,48,35,41884,16265,25619
9b7ac166dde13c03a08ff9f6be7732fc,110,94,269151,44052,225099,101,78,205920,47964,157956
ab6017a0e9cc98923e69c7ad8e57040f,27,26,25898,8314,17584,32,29,12308,7544,4764
81979b6278254d7a9ecc6425b03cf6bf,61,45,88113,45890,42223,57,36,94242,29126,65116
c5f87916021bb4bea9d1b186b430a231,91,69,170404,40193,130211,92,83,121700,47399,74301
980e2cc6256ac3fcd1d0af5610bdba80,55,49,83656,64716,18940,118,104,246014,58159,187855
78139d158ce46a7788af14de04a3224b,109,79,257240,28741,228499,98,81,216908,34401,182507
187349bb95f4632d9ecd54daca2f30cc,116,90,237983,53407,184576,115,96,252242,51632,200610
31f5606b95719bc05bb07591463c1bbe,131,93,273292,65466,207826,158,116,389611,80555,309056
8f8b73be6ab4890b764bc192d534347d,73,53,88547,22119,66428,81,65,83795,27760,56035
442aa1767cca1d3d97a95c3be5919df5,85,58,183298,45138,138160,100,82,214369,56707,157662
ff02fbd6c85cf35b5b1f4fc874d00e74,77,67,87216,27272,59944,83,57,149862,31031,118831
528c4eb30e23345c0c3f51d7325a0aa8,95,72,173124,47018,126106,98,84,166500,33867,132633
f0f12fc422a73f049537f1ba4e59f35a,139,102,303796,63197,240599,111,75,223163,81917,141246
e44302349f223dde5e675e16d0ea979d,23,23,13918,5909,8009,38,24,18170,5888,12282
a77e6766ea55abe988421803fb2e3e69,133,94,265577,45083,220494,146,118,253110,78969,174141
0d86a1f7ed5588a2fe41e07ba176edb5,39,32,31322,13374,17948,27,26,28914,10189,18725
9ff5d3290846429d3856e5d2a7949548,86,68,115807,23296,92511,89,45,90388,16755,73633
46672f4a4840041a3c52b7135e3ea340,31,24,32630,12803,19827,47,32,41909,13303,28606
bcaf70b37005f5b0ea782a58a615e6aa,80,62,173010,46750,126260,71,62,126775,51690,75085
01545f38429d7305002a681beaad2df5,157,98,359127,70508,288619,138,95,396916,93410,303506
c2db9dd3bbcc8088b3dbf7bc9471c4a8,55,37,64057,22568,41489,77,68,109114,24180,84934
03cc7843f7cbeb9ae6460655baeaec30,98,68,104275,27373,76902,59,45,114412,18740,95672
1256e357172e95b202794e17c19d83c6,66,63,128116,42117,85999,81,61,117326,37061,80265
3beda8d03f5d57f1fa5dbf3f2192243b,102,81,344512,95224,249288,126,83,315969,81667,234302
7e2a46ac0753e740a0c8de2164df2067,115,76,232453,47008,185445,130,94,285773,31662,254111
a3a73767418225f2669265f4ca441fe3,119,100,281585,68429,213156,88,77,224490,48066,176424
281e02cbb4486a45940a7b10511714dd,39,27,29233,9012,20221,44,32,36748,7022,29726
7996039371f1e1d57cc03a4b7f20ccd1,141,104,309495,50895,258600,102,64,175895,40863,135032
f83e0efa259e63ff7cf6b1916bb73f2b,44,30,29421,9694,19727,30,32,22835,8390,14445
e3ee3b4b9ccfd97880eb20c1a73232e8,26,23,8872,2993,5879,19,15,6666,4118,2548
a6fbab2e2c22ec9076d9b4dd62cc4595,123,94,308254,52374,255880,169,129,378608,69753,308855
9e26ed63a7d232a3e3811323e460af8d,41,32,51112,17054,34058,45,36,63816,17336,46480
6c6fa15f2daab270131d5d6e2075d648,186,140,655860,108341,547519,202,139,624851,96566,528285
f4127cacbd69e2b89b461a8a6cd9f5af,89,68,160837,30821,130016,78,67,149850,50512,99338
a3a59e525755703318cd14b2b98ede78,94,67,185934,85327,100607,91,53,308145,59113,249032
a55687b9fbffc9f2741c320ed6d4941b,109,89,172761,51121,121640,109,88,215891,62889,153002
2173aa831d52302b419187315b05b4d7,33,25,14622,5349,9273,34,29,12758,5002,7756
3955d76a1f90e19754036ba7670de7be,43,32,33405,16787,16618,44,34,35116,12308,22808
b2952703eb5d7bf90fe6015c0cece89d,151,129,319982,63080,256902,121,96,264935,69062,195873
5432968e6c58aef5c6522a11ee953b15,41,36,47240,14158,33082,54,46,77205,19024,58181
163bce313f27da288561bb4cbd495c5e,78,69,108397,32185,76212,94,71,124435,28613,95822
390405a9ef841cbfa4237be2d965c793,89,76,183132,46738,136394,57,45,91744,37380,54364
30fd0d9ffdca92d2f85b189c39434929,124,104,279129,71984,207145,63,57,155436,73382,82054
f6bcf729045168e9fb0ff321e6539261,88,53,164540,69929,94611,118,86,309805,75085,234720
d261ca7904a4338569b1f23180c02d12,68,54,112256,24003,88253,67,54,83929,28339,55590
329bf5b9b41f8813ca0cbd555fd0e590,17,14,2924,1566,1358,16,12,3672,1198,2474
3f9d63db6483cdaef55bc5bb07230a5e,124,95,315445,70322,245123,119,90,257280,68470,188810
920062b42318e9d17488e5ce13b2cc03,123,87,499260,204453,294807,150,117,489952,120482,369470
5c8c35139934b4ef8f3ec181ec542a7f,141,111,355304,64046,291258,125,84,280920,68871,212049
4a30fc7c8d90583a5b041a0ca84cf5e0,174,113,411326,81376,329950,160,122,549911,80878,469033
fc94c90c95c7713005b3ef2cfe62a94c,78,49,110531,21156,89375,69,57,92219,30825,61394
ea58bc5e60f6c9f91d3578dfaf6bf04d,54,49,104523,29808,74715,91,65,134639,38053,96586
75dcc9fdb4e35886b00ce1ba9d84a895,42,33,45839,8841,36998,33,25,24700,14426,10274
698a15beace3584addc9b4ee45a75638,115,99,206782,59757,147025,130,99,249674,52275,197399
11234bb2162c44362afc6a4a00ebe56b,96,73,164149,45207,118942,97,76,152419,46441,105978
ba016b19d4de0ecfe1fbb31b40aaa8d1,82,60,125378,65256,60122,123,91,227991,75070,152921
d7757de87f40a3c6cb708b2af6317623,155,117,437750,98300,339450,188,138,638272,127731,510541
f0034de78729934880b4d4f59d455d3f,40,30,33729,12402,21327,35,25,30257,15345,14912
e4c99fa108a6180aff08257e5bf7ca41,48,29,54407,15515,38892,41,31,45132,23191,21941
c913a89ddffa497835769c99b24b25aa,107,85,229698,55013,174685,99,74,155938,43378,112560
4b113100861b99c04fc270ae18807700,133,112,305862,88531,217331,140,114,337292,66603,270689
f86cc178e1ecf0c17509209ea6e3ef49,160,114,442163,68497,373666,152,127,425514,82433,343081
421beec51c4acd0282ac03c2e9569aeb,25,20,16324,8753,7571,32,21,23974,6432,17542
05a3dc10c8aebffb26ee776fae616916,126,99,431662,87482,344180,170,138,438835,76145,362690
8e62a73759ec6a4c0670ea7acef871e1,138,91,406169,119710,286459,157,128,481186,78406,402780
1f21f16824bb9fca40a69fde261aafd8,87,62,174011,25218,148793,100,69,173897,36394,137503
49d8d2f8f23138d49072b40ea3fbcd5b,160,108,779284,159087,620197,183,140,749706,175973,573733
a0c23524bf4cd787fb6e9b6c6d668058,103,82,177212,34693,142519,139,108,239556,45443,194113
375cc3cbb1210476343ddaefb51ec043,181,120,529647,139402,390245,193,131,680689,131488,549201
c67b6ab5ae661b9d4e328c205d4e4816,68,55,123685,38499,85186,90,66,150791,32417,118374
9b4c43f9965b471ff87f40d47451c240,80,63,177051,56213,120838,84,82,209768,66323,143445
b0b17fbe9393ab2919a6c1fab48333e3,24,18,6482,5894,588,25,20,11488,3220,8268
977a1db0b5295f6f463abc20d16b36ec,145,101,502325,118861,383464,122,101,484815,126602,358213
67763ba6ea46c7614add2a2f38e76d45,4,2,599,268,331,2,4,268,599,-331
3e260e7d503da8eb5e9d7321489eba55,35,26,22961,8422,14539,29,26,21507,7028,14479
29355f338e4ee84c68dcbdcb3858374c,131,106,371475,137809,233666,131,107,431025,113431,317594
d0b103e2548d7281e5374fb6071b28be,50,43,63317,12550,50767,63,54,55978,24547,31431
052d0e44037cffc7b437d1555089cd2c,176,130,579900,98890,481010,139,95,424430,110564,313866
94d83308baeae2a5a23824c710d52d73,84,50,85945,24655,61290,79,50,87085,28903,58182
7a69ab7dd2fdb183f127f55a698ef5df,112,88,181224,46140,135084,100,73,181155,29230,151925
cef3958c84197b84c6d06129fc9b7a0d,25,19,5608,3107,2501,20,15,6747,2489,4258
3dbc63f2bf146f40d3713ec5b701a8dd,104,81,180010,50034,129976,101,75,198579,39647,158932
6bd9779a71650348aa3cd75f45278bfb,116,92,287738,58096,229642,110,93,204690,75686,129004
d4f6592672c7afd8af47f6002d54ccd8,76,59,137805,40811,96994,63,52,104877,39741,65136
9376a283b50779433de829c79529fe2c,107,59,287070,83838,203232,166,129,391128,86250,304878
bce2bace8b61980d282c9f6a9c69ef9c,156,98,434664,62433,372231,184,132,566308,118103,448205
dc00c2964363b0344a4891bdde235a44,36,26,31534,11963,19571,32,23,29298,11881,17417
d75db83f7857720f851a302b00ee6149,107,79,218781,36067,182714,116,90,243062,53506,189556
1bbaf6d71e197ebf96c6afa3c921000a,123,110,285130,100691,184439,106,84,278043,80594,197449
