match_id_hash,r_num_damage,r_num_damage_taken,r_damage,r_damage_taken,r_damage_net,d_num_damage,d_num_damage_taken,d_damage,d_damage_taken,d_damage_net
a400b8f29dece5f4d266f49f1ae2e98a,20,17,8736,4242,4494,18,11,9445,1555,7890
b9c57c450ce74a2af79c9ce96fac144d,66,46,69765,21203,48562,70,57,46818,24459,22359
6db558535151ea18ca70a6892197db41,1,1,70,68,2,1,1,68,70,-2
46a0ddce8f7ed2a8d9bd5edcbb925682,40,32,50381,15246,35135,59,53,69031,22808,46223
b1b35ff97723d9b7ade1c9c3cf48f770,26,27,37913,15867,22046,42,36,54223,9404,44819
19c39fe2af2b547e48708ca005c6ae74,23,19,5345,2816,2529,19,19,8773,3460,5313
c96d629dc0c39f0c616d1949938a6ba6,61,44,119781,28450,91331,53,39,90519,31680,58839
156c88bff4e9c4668b0f53df3d870f1b,61,46,57878,21552,36326,49,48,56750,14269,42481
df50f738c454d430a33b2bf90cb9ef1a,51,51,45306,19136,26170,61,41,71453,11535,59918
7469e9440ea3d19b211a484647c7126e,95,53,113237,33039,80198,79,56,120648,31290,89358
0aa1c6d7630433a93fe42da5ac810368,101,88,279784,81289,198495,145,116,365237,57460,307777
892b5d40992e4b334e159f99b2bb55e6,40,34,61519,13176,48343,50,36,50743,17092,33651
44eb0c077ca68678bb9bfead29e9c455,95,72,189628,46920,142708,129,113,254907,45134,209773
eda82a5a0ae96848e73929c643925633,72,56,114016,26933,87083,71,55,112535,24493,88042
ab3cc6ccac661a1385e73a2e9f21313a,59,42,67030,22004,45026,51,38,72194,22461,49733
a3c3892648b873bb869dd81ca0f62286,4,4,387,422,-35,4,4,422,387,35
34c81a8faede0d8f1f87dcc6ee824658,108,93,226274,45833,180441,131,119,260037,57155,202882
5feece770ca79e5e8cd8052198b3f533,149,116,586406,134343,452063,153,121,503035,188928,314107
54aaab1cb8cc5df3c253641618673266,49,39,72741,23359,49382,54,41,99694,21226,78468
c95069179039952da9db7635ee22972b,168,113,563417,99031,464386,158,129,512899,127012,385887
8f56cc2468ba5c37edb79f3a7b4af6e6,140,101,404755,77110,327645,172,137,515775,111536,404239
171d8515f371cdf5d03c44575cee70c7,51,36,56954,22680,34274,40,36,67367,19982,47385
44cdded6d3311134563f743eb77685b2,68,39,80148,23595,56553,77,63,100481,33803,66678
086e5ed8fee6258a3b6ed9127f833573,189,132,456457,94378,362079,108,94,323347,109321,214026
b6f39b49177535c9417eecd8c696674d,33,27,17668,9879,7789,36,26,26492,6584,19908
8ca9e390d39160645953a682a8d6f225,17,13,6854,2346,4508,17,10,7605,2384,5221
4b6e4e511d399180776d0f23984466b2,126,82,287534,53063,234471,132,99,246589,54509,192080
fb4860c8425b62dbe413214beb6650c8,81,69,106114,30527,75587,90,64,102648,33393,69255
06b147af8683a7973e6f431c412448b7,47,35,52834,19632,33202,71,55,125813,20861,104952
7d30c0cc9a54fbf92d3fcddcab73d794,122,102,276783,56860,219923,88,80,242823,42601,200222
64ed11373bcf2cfea7a60ede637b70d2,164,147,457635,97148,360487,131,108,329385,75183,254202
95a57e13d66411aa89e23c2dafa116dd,70,58,72652,34611,38041,86,76,128969,25344,103625
00a7f372afae35b59ce3819155d95318,175,141,764602,167608,596994,212,132,920106,153227,766879
bf366db368cc34b63235973dd3f50b0b,65,51,113357,40796,72561,57,45,111592,38540,73052
70e55187a655b6daacbf58a832d662db,18,17,3097,2974,123,20,15,4411,2045,2366
a26ea6c7d63eb1df557dbcae742b4705,60,38,89332,36617,52715,68,56,120385,34218,86167
88f9976aa7627b1f0d3e60d4b0483956,68,53,89245,26439,62806,76,42,113038,19479,93559
466e3043a03c98361c311c58d0ecbbf1,58,50,61209,35241,25968,96,59,128058,25395,102663
52691d68dd7b50eddb3092220d4aabb9,113,81,298853,64711,234142,118,99,291950,64414,227536
73669c2af74776b891fb94a1d1099d25,12,14,2388,2791,-403,17,15,3479,2192,1287
fa72fbcde4aaf1023c3df5dc7d739674,25,19,20615,6145,14470,45,35,36367,9637,26730
7174c98d3b2e4ac2b9f5947935cbdd52,60,47,99683,25395,74288,87,66,106745,26668,80077
3c666e1759bfab4467d11010983fb13e,0,0,0,0,0,0,0,0,0,0
4a0fdc67b9a1e360dae065ff12fade95,62,50,80005,27751,52254,75,67,106857,26370,80487
ba1e963ea091e6af635dedd4ad2e9bbd,7,1,1157,1,1156,0,7,0,1098,-1098
86d60b73cbfdbf0a6c291dad12d967f0,89,61,168301,65391,102910,97,71,263053,52308,210745
de41039149b7635840f90fc302548eb5,68,55,92408,36154,56254,69,48,92943,43675,49268
28497cb3f04d45a272e8b7ed9c7199bd,81,65,130102,24823,105279,75,65,91610,37373,54237
bb72d40b170659cafee461fe458b5331,52,32,55730,17198,38532,31,27,42368,11664,30704
5b26efd8f4573da98d7a53e6eb3bfcde,122,90,260403,72719,187684,103,86,236870,66445,170425
9360b6c02ab8b2c1ffc719423c1ebdb0,40,31,41166,15112,26054,35,20,34627,8807,25820
512c0d7cf0312c0767603dd77dc42581,35,28,22866,12258,10608,35,30,30191,9839,20352
7849266871db9c0605bd33872a7643fa,76,56,101406,23276,78130,55,41,54492,18733,35759
fb5c712c74f8317689e7082416b90b77,173,138,434992,92403,342589,156,133,514752,101620,413132
185cbad860e2632dc088d756e3e61a1a,187,154,859977,183046,676931,207,151,788214,152397,635817
2c6ea5bc1788fd5efc72fb741bb4f3b6,182,149,614045,134969,479076,168,129,726085,132043,594042
9d59ca0a4cb2514d10f5932fc2007bd1,19,15,3156,2875,281,21,19,6977,2693,4284
2f07b1315b85521f9641dc4dfb72b4a0,83,63,199006,63931,135075,133,94,335945,52468,283477
dc777a69b5457e32f635827d5994ac20,44,36,36918,11154,25764,39,31,23570,13548,10022
e4bae80d0f728c1198c57c6e9de948a2,52,35,40557,13719,26838,40,35,28771,17751,11020
6d8926b8ad2843de397b6ef560b53466,160,105,470609,87541,383068,169,118,396966,76354,320612
5c4cd7ba5f0b31ded435690a2a596981,12,11,2031,1193,838,13,10,1920,1306,614
ee0df626563ce0e39d5cd039caf141ac,171,126,477789,106746,371043,156,119,607285,111812,495473
192f19f03feda5decffa47a9fbc6ba63,62,56,97240,27439,69801,59,46,56099,25935,30164
9a4de866c4e057ba4cbf1c2d79210e41,52,37,65851,17462,48389,53,40,59862,22446,37416
f0cfe3b5e56e8b2f0865dfb4be2ba23f,129,110,286098,57342,228756,150,118,334265,61689,272576
fc817a3b4a4cf8269fa295c786c0b9fa,111,83,231843,33724,198119,123,99,209348,38180,171168
99f889e363118fc49c6c632aad683f18,144,106,363018,67367,295651,136,111,479125,59838,419287
9be7e4163e437ce3950b8d42b0c68756,24,27,10919,3970,6949,29,24,8902,4905,3997
981a0ab91d4648f75ed78f4173e8d201,211,144,724945,132602,592343,225,159,903632,158347,745285
c59f3f76dfc3a02b77f3d2814d9b4122,50,43,32592,17855,14737,52,37,53184,15783,37401
378200e56bbb733394b45a902c0bd01a,127,97,250710,39181,211529,131,102,212816,64872,147944
a0d7a946c3e51ddc96ddb2c9348f3871,108,80,196493,45011,151482,139,105,289267,52138,237129
67bdabee790d3cf4dc8663d1831beb53,161,123,619537,93437,526100,146,124,442620,93647,348973
f3398a77b495428fc23e7621af06a027,63,50,121363,29977,91386,55,41,95479,29248,66231
175ef2d5732f4526a08fd7352dabc27f,42,37,36854,22381,14473,46,34,58271,15789,42482
425871da01ddd66e3831fb690089b889,101,85,213371,79243,134128,149,140,378059,74875,303184
a7808f7dc01a959e29c4946cc98e775a,12,6,2453,1205,1248,9,8,1447,1471,-24
5b6190e89e6947e064c1fd426213f8a0,172,139,568888,88651,480237,167,124,520989,57676,463313
85519e14c42ea6a02d2d8c73a63d6b66,149,92,682303,120624,561679,185,153,574810,140505,434305
c43bb03dd85deb8bd927921bf8598a36,120,91,343327,61649,281678,113,87,284936,70151,214785
99386fd5fa5cfe926fc4344da562b1d4,71,46,117144,28558,88586,63,52,67833,33063,34770
0c189819d5bf45f817f77693f941371c,188,152,873167,154367,718800,225,166,842416,176522,665894
5673bf13c6ecc771fb56ba93789c71cd,12,10,1677,588,1089,12,12,1000,1478,-478
2392185f7a1b6fc35f761d2dc34423c8,92,55,171459,23697,147762,52,45,70796,32751,38045
4cbe5e5a1a2c1389d549d04e2e018a9f,63,48,116789,22628,94161,77,59,131106,26892,104214
064522c97acf0d4b095d038c663374aa,131,109,343084,80953,262131,109,95,293250,84995,208255
1cfa44f46b5cc24d38723894ff4577ba,59,35,52250,10072,42178,39,32,28781,8978,19803
6f11117db84c0585ad2e792aeae191e9,29,23,15519,6469,9050,36,28,19876,6648,13228
722d71f25c1d1fa1124580d3a78e458f,99,63,163303,57375,105928,80,71,118162,48975,69187
db13e824e8c7f64cd6cdd783437d1b5c,113,96,267107,42868,224239,114,87,197621,34896,162725
05c46e17555a38bf054bdc9d207f1cf7,138,100,330422,55440,274982,143,105,337862,69398,268464
1e4c98abfc97681f46916e92502ac2b4,36,36,29177,9183,19994,44,35,38017,11016,27001
7260c8e6db4177850c02fb9825095f5c,52,45,58745,22521,36224,57,49,59689,24556,35133
538af79dd08dc1e6e278c3709bc5a665,27,24,13222,7277,5945,21,18,11827,5436,6391
66a8e40f604d9735d4127d66a46e1b2a,191,140,746061,109937,636124,151,109,539597,118770,420827
f864a881742e71db5311fbf0bdc7af91,99,72,358240,69905,288335,130,101,396521,81174,315347
66bc5c7f6f510ff44060240f01e94365,57,49,63547,15850,47697,53,47,56127,20359,35768
83097723ca023da3b686e71bca02af03,69,50,75961,20743,55218,72,59,85503,24368,61135
79a0d4fe6ea6e1de856aa20539d5613d,38,34,26345,14354,11991,41,29,35826,9957,25869
0e8d0c9fee551abfb47e522f76019d07,30,23,19066,7356,11710,29,24,17970,7291,10679
3ce2d282e8bcdaad73df58fb6017084c,15,20,6617,2353,4264,23,15,8944,3292,5652
7b3a012c21d254b9d85da3f74d78eb81,101,69,173454,38560,134894,58,48,137075,36464,100611
0087083e837c64c85a3b350a03aea77c,111,85,311388,66698,244690,117,105,326462,111640,214822
ad02fe6d15cf998d5cb8f4e369baa559,82,74,180113,40222,139891,89,68,145117,34651,110466
b1484adbcd7d87e617b8d54be560e27a,60,41,91539,24803,66736,58,56,90554,32263,58291
d818ef51c0f27ef602802a4615c8d413,44,37,30876,12039,18837,36,36,23834,10920,12914
e3b48a70597706fae9bf451e6c84e42e,200,124,518196,79824,438372,164,134,429154,85716,343438
a1cf47fe00e1b5083147e651d7e90c2a,107,87,164800,32194,132606,72,52,100294,34999,65295
cd4a07c41ec7a3f1938505328c734764,242,148,934608,94414,840194,218,181,1223436,134455,1088981
10ca3074f6f359f541d9ccb3c0bbb836,85,68,170705,45639,125066,91,78,159200,49576,109624
0d3c92c117eaeeadafe8e16453a66ad6,20,19,9890,5790,4100,22,18,14232,6451,7781
725df7955b077ab96954a6f27572c692,29,24,20009,9403,10606,33,23,26143,9145,16998
70a53f7135bfa6294db4d163c1c60a80,89,69,103171,27334,75837,76,55,90609,23311,67298
0ee9778bef0831ccc9a2685c28963268,135,106,486623,79389,407234,172,140,483259,78061,405198
7b10e0ca4a9d71ca1c5085144269d1c0,38,30,21971,9358,12613,40,25,23567,7190,16377
e659fd86dcdca602465475e9dba40c98,108,100,276955,49994,226961,116,97,215032,53811,161221
805ac9c1a76befe4315611fa555fc835,106,73,147325,47440,99885,128,88,213440,39444,173996
9b2c59c8277387ae5d6ac8c9755c66ac,35,29,30789,11818,18971,36,31,24763,15226,9537
2dc398548084ccd59cb99d297a964b11,50,31,43975,10542,33433,34,28,26719,12270,14449
8cf72eab00224d1c49308db67726ab36,124,92,262428,61780,200648,131,106,234385,69383,165002
5746237fe7dd146dc771457ac919c774,103,83,219857,43439,176418,85,83,167491,41792,125699
74e9fbfd6e7b3152a23aafbbdc96095e,80,62,120110,35004,85106,71,60,120419,38173,82246
ebf87c7f5a6d80a969c5e2747a2e820a,24,20,10829,5975,4854,30,26,16035,5365,10670
63c878a241d7bd4ba730f2043e34aff2,116,88,273356,72832,200524,98,78,231660,78708,152952
8a03e2a2f073bc64a78abc17e1791d7b,66,61,99284,26939,72345,64,53,79134,28521,50613
3370cd0dd51e0d559e01d0c7eb83899c,52,39,48550,20276,28274,40,33,35510,15657,19853
32fbdefe41f0a4ab5c2d52075d41fc11,47,36,48802,18353,30449,47,42,53916,16574,37342
5ed1a446802e6a5568abab8a9669dfc8,149,106,349541,79240,270301,153,119,532973,100934,432039
64b048f27c482eb0326e35f5b45b18fa,100,49,177358,51245,126113,110,61,219999,65168,154831
c413766ca083aa9eaacb7f034b9091ca,68,65,121168,68550,52618,117,91,265504,45693,219811
016d9bf9e16fe8fde4b3c131defb8c92,117,67,149718,27577,122141,58,42,94455,33404,61051
f763abaead5fb7927eb0a5d82fe2ba4d,35,25,27926,12618,15308,49,34,42008,8739,33269
9eab012f84c7b1f1919f72561d651d5c,70,50,132203,37671,94532,88,73,119684,45183,74501
1ede8f0feb1e359b31f22766bbe0b16e,53,43,91349,17566,73783,53,44,59867,21471,38396
b455849cea4881f6cdb3ca81390d51b2,100,82,235129,82223,152906,92,71,294407,75906,218501
f4e3d0f8617e8199afbdde8426608d68,66,49,138536,53309,85227,53,39,105850,46846,59004
472940077c7210694e8fcc39549db64f,33,24,43820,7749,36071,44,34,46189,10681,35508
d301b179bfb15dac34fb7d2069618848,173,113,498961,96667,402294,115,76,289270,117987,171283
7660114b72980b7f221c77c027d84df3,36,26,31081,12883,18198,35,24,33467,11318,22149
31b1133d5e4f20b046e5e0e93ee46ec9,48,42,79591,16990,62601,60,41,80737,19295,61442
f9d0300634ffcf8524f167fdfd737f9b,36,28,41178,18056,23122,43,28,37359,16224,21135
4187345a1502af2e1ca95e4a50b4ad69,173,135,903470,165166,738304,200,167,1001684,173322,828362
0c9e71953f91ea8de1f48121ab50afc3,48,38,30275,11522,18753,30,34,27849,11439,16410
7fb0c59ca677c3a175d8161b8cb13171,76,53,120946,22163,98783,81,58,123480,25572,97908
010bc4bf10a83615d964bba1ccc76ee6,129,118,345014,123550,221464,156,109,452488,79766,372722
3e4dcc124fe29202f416bd9bd8f04fa0,61,52,62801,25679,37122,54,43,59486,20409,39077
fd3431257370562fd1f73739885fb3cb,136,123,464298,117859,346439,184,145,528107,109468,418639
479e0ad44e584c0a8fdacbbc225a37df,59,50,60116,19433,40683,63,48,56713,18849,37864
426bfc428690bd0b654ed9c356751569,29,25,28761,7007,21754,25,21,22989,7728,15261
6862606271bbe62b5834103a78fb53ae,74,60,124762,40824,83938,84,88,147470,32210,115260
14b7d952e2b56c958d667be1f39f5449,109,74,153403,50655,102748,84,57,154344,36664,117680
2ba3224bbc1555796df897686e14b5a2,83,69,144908,36252,108656,97,83,163536,33206,130330
f6ea95c12693e23be626c7571e922e82,63,44,71101,15616,55485,48,48,48139,19127,29012
d4b157ff19199a099781383fed871827,28,24,15233,6666,8567,32,21,15210,7317,7893
f90b9aa9cf5121e82b135e17c6ec32d9,117,97,285917,61040,224877,111,95,412711,77223,335488
0466d4054a8a97f5f57155e5e64c1835,37,33,31467,18997,12470,41,33,35130,13508,21622
fbd6fc91cead51e3fd636ff9e773971a,79,57,79299,31888,47411,72,51,105132,24012,81120
3e1cb18af167d5c2b308f20e14d6a1d3,26,19,11863,4570,7293,26,22,9574,3798,5776
145f7a41cb72d100295a77d34449c7a5,64,39,51390,17098,34292,62,53,58425,21072,37353
26711191d93e8c6e931d05205d0f7fae,129,97,202522,62487,140035,87,74,140894,38591,102303
1c25f2b89164efac5a21210ef7b1401a,118,96,305280,62335,242945,127,107,269969,82649,187320
e97946b45942561eee3c883fc3620312,168,123,549628,118171,431457,199,142,698891,99640,599251
dd76829c265a4ba157999150bd1bfa59,170,135,451487,85997,365490,90,79,230221,108593,121628
4e1c417fd78deb193c08d3c9194e4b9c,36,32,19691,12036,7655,41,31,31701,11060,20641
821996195bc1fb30e8db37338651d8b9,130,99,298128,63829,234299,99,87,160713,68737,91976
46deadc43f0efb0b7fc3640570b46891,4,5,711,1311,-600,5,4,1311,711,600
f77e8c3c5125cbc2607fac2c26579ec1,57,43,43125,12612,30513,39,32,23616,14327,9289
ea161e11da4611f76e592e3a2d64f253,37,26,38922,11174,27748,33,26,35667,14092,21575
27796de9f4734fd5be9bc17fc8ba4c7f,149,100,398540,93709,304831,125,83,373867,113726,260141
66569c243b1aca38af58bfdcda654270,117,96,202263,71503,130760,128,102,224579,63753,160826
e92e62b67fefc3c141654f4cdd456ceb,52,42,66136,25439,40697,52,40,49060,23033,26027
9e2a74f506de0d01f9aafa8aae5e92d6,170,127,358387,85421,272966,102,88,245500,97936,147564
a414c7c2db5974046783e51d9c91cc75,116,88,291510,79173,212337,198,148,524302,115494,408808
6c3538012f41562fe32a1b397252ab8a,140,125,388672,80064,308608,129,100,267977,90852,177125
c4ec635e97e638b31fbee8b41351571c,28,21,27458,11998,15460,21,16,22539,8488,14051
7dd4918869c16efc9c8527391190eadb,53,44,79977,19944,60033,64,52,63965,25829,38136
8a5b78b997da877c096f7562c9055bf2,140,111,254709,57268,197441,168,114,315809,55089,260720
5174a13f46a5da74e352757ba4f153db,115,81,271374,48327,223047,139,103,429335,62286,367049
ea3bfaa08b0434a5a49b73f54e2fbb48,150,114,356378,54342,302036,131,100,390511,54207,336304
31a0cb339bc65d31b934c7febb046b11,63,48,78912,22028,56884,70,63,87866,31211,56655
bdf63399b9f40c2c7468c6b6dd7f6dba,100,83,245908,66518,179390,118,90,263700,40307,223393
fa299fc1a4cf09fcd059a14efc5be57b,94,83,123861,34059,89802,94,76,126701,27662,99039
0c2621c8f4ba7ba2f69bb509bf464188,25,17,10051,3869,6182,25,23,9054,4964,4090
45981b3c411cc54e2fb223b14d80c50e,176,146,656897,134950,521947,164,136,587772,160551,427221
6bc1f7cfb85a3a1ce2499b3551f033c3,124,95,262038,82645,179393,149,109,370833,65971,304862
1ad7b78baa8bef4a1a5c63618eec3db1,107,87,187512,49943,137569,98,89,158789,61888,96901
4fed1358c64e16de48ac89239b70d34b,52,37,33185,16747,16438,49,38,67794,14887,52907
e4bbf14fae3a6cfd9b7166e229a95c1d,111,86,306804,121893,184911,139,111,398360,114841,283519
aef47b238d7a0eab38d7607bb47f1f9f,30,20,20007,7231,12776,31,22,20007,8278,11729
de7e6cee4f3b21730b45ce53d53d0a15,169,128,406470,53519,352951,142,120,384882,67581,317301
e38161118300164767f121062bfce7d2,19,12,3417,1510,1907,20,17,3037,1825,1212
28ff73e3c8c30894927540e6eae5e5b0,127,76,475106,84794,390312,204,147,641196,124159,517037
286db67143d193feba1a54ab3c428d44,146,114,357741,98483,259258,149,102,319204,78085,241119
8224f5b34b1bd0ef8506aab25323fb02,74,53,84701,24486,60215,79,60,87846,36531,51315
b47b0bd8abcf5267755f2d15b7497126,66,64,74859,25025,49834,51,30,58757,12755,46002
fe71bed4ba371289748188b7063a328d,118,97,318031,90978,227053,105,71,277640,82647,194993
e5b286fa3c2280ae59c0ff037d224dc3,70,46,136368,32431,103937,53,43,149494,20751,128743
392c7d590ad98921dfc332a33ed0c31a,120,87,305564,121274,184290,157,110,478906,114829,364077
cc0ec03becbaa45fa9ada0e1a17a20b0,167,139,706209,132076,574133,164,129,505773,118401,387372
c84253e53c3adca1f8503ce7b395c8dd,21,15,4209,1748,2461,19,18,4739,2083,2656
bab3575d65310b2595fee1a39bd89bba,202,125,531521,89600,441921,139,101,388618,111953,276665
af003223961c99491db921cde5266939,82,67,120621,32106,88515,54,46,73245,38560,34685
a02c196ce995b9c6a8063fddaabb1477,100,74,211364,45967,165397,119,98,240782,47587,193195
d9b103a0e0b8737dff4b447a3695797f,35,29,13292,11160,2132,34,29,30814,5655,25159
beb246c40bccb39568237c22d7111db5,228,186,1128526,128257,1000269,206,159,814464,164024,650440
3a44f60bb3fb060a9fe577f57863e040,26,17,5783,1765,4018,21,20,5091,2808,2283
b3fbab3f691e272463191689de373c6b,163,116,373191,69333,303858,103,83,203072,93013,110059
268fe6511b44a03324567b501dab3cd5,84,60,139307,34141,105166,87,61,115379,22138,93241
b937cb93a26c4555d6ebea1c7485954d,21,25,6716,3208,3508,24,16,6920,3461,3459
7b7013fa001801db7a8747a28a2444bc,124,91,314337,103884,210453,157,120,456623,152126,304497
3f8585570999ad627a78ebad8154a1cb,224,143,645506,110691,534815,155,128,506106,110370,395736
65cb39781bcab33c5424cc01519f0d76,81,70,148425,57185,91240,118,96,280027,69806,210221
a5c10d72f7f5963db298d1941fc2983e,48,37,51326,19594,31732,40,36,51647,19640,32007
76402e0c2ed9087128c1909e45c8ab63,88,78,141234,37633,103601,112,90,194731,27068,167663
256929a6703fcf148a517e28212ec4a5,147,101,350293,49906,300387,154,126,347970,71114,276856
b7cadbcde9890157b8095e8b4b7be865,21,12,5519,1619,3900,14,13,3635,1956,1679
a5073cd096c5bdf39e7d70967fc1308f,40,29,42205,14729,27476,37,34,38830,16485,22345
38b02dc4fe0980499575a571973c685d,25,20,9961,5071,4890,25,18,11643,3357,8286
eff4676ed5fa447bcf2f38b3b984d146,13,8,2440,699,1741,12,8,1252,562,690
0d409a74fa1b28732b4be32bce57de03,132,95,338462,77320,261142,170,116,495145,80899,414246
b45303a7c32482ed144c19caede15e5a,2,3,378,328,50,3,2,328,378,-50
6bd07c1f8c559366bfa713f58aae4237,137,99,421746,96199,325547,151,126,461380,105357,356023
58c64ca512859cd04ae85576eae06ad0,6,6,802,339,463,11,5,1124,501,623
2a8cfa86ec3b30e850b1f0535c99423f,21,14,9736,6275,3461,28,24,21299,5052,16247
50cca51c33f1e9e1a42ca6a2710be5c8,20,14,7440,3073,4367,28,21,7232,3024,4208
9900dc79024e093f0b9056052f1da0d6,196,134,622645,128634,494011,176,130,636471,119252,517219
269100ae152b0eab85527c0f3b85698d,111,73,223453,43150,180303,129,106,225474,59651,165823
19d9745159fdc0ed5cb0de03eeecb6d8,44,41,47751,21962,25789,51,31,59116,12167,46949
37c174c8b2994747ea473c5ed2806602,104,83,202619,67629,134990,112,88,235909,65863,170046
2e25bb7ec562fc5bc5c380e678f52728,172,148,566050,110842,455208,146,114,533864,90836,443028
4a33b141cb7c95b8dc9307b83d65a38a,129,97,347199,107940,239259,139,109,362969,106544,256425
41ce21895f17289b4950d2fda3c4840b,77,62,195780,47257,148523,90,70,170086,53738,116348
6ebf9cf9e5b41c7909e456701a02d360,142,92,253842,49640,204202,158,130,370875,67880,302995
db26256c3b6110de1eb5c4767ce4ab7f,110,87,181282,37741,143541,105,97,158235,41541,116694
32a2f85286a8c08697d149f6f2cb70dc,88,65,156446,49956,106490,71,60,160488,67702,92786
a71642198d0c13d728a69ec4c78822eb,31,22,17124,8785,8339,31,30,18125,7873,10252
6915da2e9f80b2e2dd52d70b0da83d69,173,107,427856,111132,316724,133,93,365692,100202,265490
3490fee5a7788580c590fa7d0e093fd5,30,26,23944,9546,14398,37,30,18943,9347,9596
176a66aeaf8d469a1cd611495e45b552,141,117,436073,60919,375154,149,106,285456,55651,229805
1a2d413193660a85ea7e1a30b15e114c,2,1,322,38,284,1,2,38,322,-284
5007552953e0186492a0ced4887f8ca3,100,75,184121,28194,155927,75,66,109810,42540,67270
fc9d9971626811d8f030658c5364c954,150,94,454758,129866,324892,171,103,402034,107822,294212
a67e948605ea0bd87dbe4296b1fff71b,88,58,165143,36101,129042,97,67,174332,36015,138317
c0f243c3357bde1b86f80bb3234f75ef,116,81,261574,74817,186757,140,96,253455,68214,185241
016b8834fbfa7f3fb35af9e717e0ac88,186,168,620422,183901,436521,157,119,665352,116171,549181
1c2b9621224c47a35c535e148c063282,116,80,216062,43288,172774,85,47,118041,46400,71641
d881350b21966eac19058631b3649e8c,38,33,33034,14962,18072,45,32,37948,14419,23529
3843706882db9886150ef62d6f9a8c2e,121,88,259710,67392,192318,142,102,346016,48629,297387
5037abd7f3b63f55504b673543bc0061,46,40,62457,22286,40171,46,38,47716,19630,28086
8d24a69ea600421e4ee1f58ac65a258c,83,65,162214,53267,108947,95,77,200302,50199,150103
80ef18a6b007097b453d5439af2a7fd8,88,64,146164,40932,105232,106,81,238565,44439,194126
332e70cc18aa4e1305cdff944f71f9ca,13,13,2181,1572,609,12,11,1830,1809,21
27f84f3e190229b68e839537786ef036,97,77,170204,41741,128463,100,65,174997,30925,144072
430a5b1efde5ac035b6e20fb4bcdfc0b,152,96,358415,72193,286222,166,112,434101,93503,340598
1fe5cff3fb0a46fdd6b0d4fbc73b36a9,30,28,43733,11647,32086,48,26,29960,16049,13911
4a7b87106b087d95a8702eb7f297aeb8,79,63,175328,55099,120229,100,72,253278,39720,213558
51f3afe8caa5acb37df0332349b41118,169,118,478461,68464,409997,126,90,366346,87213,279133
2f43464e194daf13040145156329a85a,177,128,493077,117037,376040,141,99,385122,141641,243481
48a90c042d2611dfcbacb84a342d5fb6,65,56,91244,23290,67954,51,44,95165,28293,66872
b62cde8f18f9929c3bc152021c96c065,106,72,130178,36586,93592,87,76,127453,44943,82510
967aaa92c33f2a35a16819f13b8c2cfe,199,140,883251,117274,765977,148,111,584998,129231,455767
382d355f0534cc601ef9e60a99c3ac09,120,94,332351,80585,251766,136,99,273257,77566,195691
143d7bfa701870c6065a667f3a7daaed,96,89,206465,72747,133718,106,76,220713,72263,148450
d881c46fc08bf4db47637be04603d733,117,79,326327,50712,275615,96,73,169251,70446,98805
ea4013ff3dd91d38c20f48b50af5fe3f,25,24,19870,6090,13780,28,19,16775,7852,8923
7a66306f67cd0b4f2b5db56d56d9cee9,196,114,576122,142676,433446,200,121,528614,144458,384156
f8179ec212c6cdce11f7b6ea31b4e2e8,129,86,401818,73461,328357,114,75,271095,118646,152449
ccc7a92f66c3e50aae4337e4130f129e,59,40,39869,18417,21452,54,41,47991,15157,32834
e7203edc3090d25c1b598973c3b4319e,74,47,95985,22215,73770,51,37,65066,23724,41342
aa0f9e8136cbcbcb3fabbb55fdee91af,146,91,405104,89363,315741,146,114,505686,93396,412290
c90e0296af0670931629758188e86a68,67,57,96972,23544,73428,60,43,85872,26840,59032
2d834c67f70fc56d15dee59c31277439,119,80,252977,77651,175326,92,96,217279,63396,153883
f79df2d9ee2a540ef76e385723a96203,92,61,204375,61586,142789,105,93,222634,63613,159021
f63ee445d75e6369d75af3fa017c0c64,118,93,275383,70967,204416,131,109,307252,78284,228968
e24b4c5d7a2dee38693a11cbc89c2c53,29,26,12028,9168,2860,28,27,16725,7002,9723
2ceaa6db32aa66fb840368e72541a503,212,159,914161,130817,783344,253,191,950843,201020,749823
658e7f29180f2a000f4f4b92f8d1fa76,57,39,59554,23181,36373,56,47,61083,23604,37479
8884cbfa43dea039949443be25b6b555,38,30,27353,12349,15004,37,35,33615,15559,18056
141f7b617c8b88da3efe0b635c826961,95,75,258588,48569,210019,113,87,274433,44700,229733
dc2f79e7c3c62ce4254cdb820fc710be,58,49,111942,22410,89532,48,44,99744,36399,63345
f3faeb950682e829f544a07e76eae585,16,8,2523,531,1992,11,14,1554,1368,186
6dca6403b6f7821c630a51ae39d81df4,27,21,10748,5427,5321,23,22,10503,5336,5167
9deb85054ab19982dc5f15d989182889,114,89,378218,109980,268238,132,105,420390,139108,281282
15f0a9da2b319359f1f13ff55affed73,96,76,164393,40439,123954,80,43,91898,26673,65225
73c4be19e47602e6bf5f9b56241d7b80,19,11,6134,2860,3274,17,21,6240,3503,2737
4dfc674ce768b2138ea703326c19f03e,81,56,112952,18782,94170,63,46,94731,22146,72585
5f359139fc6399d1ca03624ca04e4003,167,138,682765,153788,528977,145,95,515211,132853,382358
cfb7c889a0da5179289d743cdac7d0ce,41,30,41267,14005,27262,41,29,34539,13988,20551
127ffbe88e68fc8da82f32b4b7e03633,27,23,10654,6153,4501,29,20,12550,5304,7246
2a1d4ab45275500baa37f00c3475d7bf,49,31,46102,8751,37351,39,43,30447,14761,15686
9b9d341fe9d8825c52c61ec569db5d18,149,121,497959,84727,413232,160,124,543880,89718,454162
f6fe5ab1ee83f222101d4277b2c331f2,21,21,11611,5660,5951,22,22,11853,5997,5856
47fed371f15a7dc6d43086fc277c0219,92,83,176606,62625,113981,110,85,215115,34699,180416
cf25f8486f84fdb256191a8763a7862f,87,77,233104,71332,161772,126,87,315342,59440,255902
e4bdd463742505dc086538da267c2389,80,60,146943,54062,92881,72,54,163313,51476,111837
962bfa61e7d3898369599fdacfda6ae5,33,26,20542,6611,13931,30,24,15735,6799,8936
4190ad326531011468394bf573dd864d,62,52,92575,34302,58273,95,59,136640,25623,111017
f7c0cf3232c7d8437e13150cb172a978,61,50,53723,19471,34252,57,46,60677,17283,43394
d99b6c17b41e568629732d9c90c12925,106,68,272868,67605,205263,148,82,343475,69594,273881
2bf353b6c72c7e52e4f72ca6d480d649,201,127,582366,128885,453481,135,111,479410,119166,360244
48aeed38ce0c46c4a001ccb78893a782,212,163,1050371,151650,898721,230,161,1156309,147003,1009306
ccc1d103c5296e22799aefe3a24e8b22,110,99,171417,67580,103837,137,104,287262,48984,238278
d8938ee35236455be59cf0c7c01dca98,84,77,221100,70536,150564,150,125,363383,89293,274090
002f0606307d1c6a8ce8f758bc4c393e,75,60,161882,50148,111734,98,73,183106,51124,131982
d1e2d585035867ee6e282c28a7b50b4d,121,86,232537,50404,182133,101,74,184756,69626,115130
3eabf3dc40840216eb9e1fcae670fc9c,105,75,243990,48143,195847,84,67,151636,53208,98428
0fc18a053ec4d6b8d47f6765138b3abf,60,40,91961,21425,70536,59,37,74715,20032,54683
1571df25856a6114a395a8a99c4c9f1f,106,89,279149,66637,212512,133,97,392989,87468,305521
3f4029527b7dd629a7aab0c4a10070db,64,47,75722,22901,52821,45,38,61710,20010,41700
f00260a04b263213e3ea9acecb9eb625,116,82,241726,57679,184047,110,98,224105,74321,149784
c6ecd2e4b3b41719b9da85b7cea2cab0,137,90,223089,43067,180022,146,106,315812,52594,263218
0e0a37be3f8181e22726d43a20fe727b,104,83,200693,33976,166717,106,79,178985,37060,141925
b575726ca7b2a4ae8c65d433caee7031,70,44,136136,33703,102433,82,64,119195,36331,82864
54db5ff9e4ceb9fece39dd114d34133f,30,19,24116,8276,15840,25,27,15451,8414,7037
9911683003aca26475cbd8f5cf70a026,88,67,186192,44643,141549,108,94,217319,60153,157166
b5d94591057ca6f54f74e1de0393b6c1,98,56,140310,32566,107744,130,114,295527,52277,243250
bef03b606974e105133405159afcc79b,83,66,187069,47862,139207,99,79,179367,73111,106256
19c1b810b3564d90fe329c06fd6aadfa,118,72,288152,124639,163513,136,95,271947,85735,186212
acd92e424ec601e174b33e2a5ababca7,168,112,594420,134320,460100,166,126,624900,154629,470271
256663776a4981e3a28b1ea7a9354cd1,207,151,736714,187402,549312,217,146,905772,165149,740623
4dc478bb52709f45d0f873a8b465841a,169,109,316197,80412,235785,132,114,415528,92890,322638
55ad79bab535399be546cb7582543c50,105,92,250436,52455,197981,123,85,281983,45065,236918
7e9ee83a71001fec75bacbe4d61b2724,20,14,9155,1089,8066,17,12,5258,1479,3779
d25c4c9a96c6fb228325567c35fa51c1,196,161,596384,132582,463802,176,106,443460,117293,326167
459d003a1e1c354d957715f00eafc5ba,150,104,318576,95248,223328,115,96,297749,99357,198392
0e88e491feecdbd48bc79838a8dd42c7,4,4,160,240,-80,4,4,240,160,80
de42e8a532ec83d1f3cb4fe3ab5cb7f9,83,64,146327,50104,96223,104,92,151862,49825,102037
51d1608d5d667f067fd5fccbdd8d1708,172,119,512639,184744,327895,216,156,748406,152352,596054
b197da66e9cadccde114276067812833,172,152,667406,97226,570180,173,119,503878,104011,399867
0d53ea909761f110538fd91f1ec56827,46,38,34911,11664,23247,56,46,36832,12937,23895
f5fcd6f0d0d3f7d6d381ae4615913246,22,23,15523,7170,8353,33,24,18111,6168,11943
4dde40ef95acad814f841aa904852d7c,22,19,4536,3618,918,29,20,9316,2627,6689
c9eb02449db417696b713753ce4ab29a,61,41,58536,15294,43242,46,41,45300,20028,25272
8131061a5ff47b3e7d4a288691312e40,100,79,168256,26894,141362,66,60,119610,35964,83646
7ebc8689220ee04c824839225885c65b,102,62,189523,29305,160218,93,77,159633,48183,111450
b974c90b43ef81ff455a715ef3c9d66e,134,97,403575,124737,278838,214,149,647757,72439,575318
15e3763a9ff37509edcbdbc2368fba88,98,76,177908,48410,129498,64,50,133007,36721,96286
1b5b4760c8224c1be6556eca1b116404,153,86,436042,66856,369186,186,135,475788,74489,401299
71f6335e0336d1594b8b3ab8fc9be861,72,56,122702,21113,101589,43,31,52172,23867,28305
45b318c7afefddc4336188732b812be0,57,44,89987,19019,70968,47,35,43547,23663,19884
cad7b9cb5da81b01f35edcceeff0479a,114,93,355196,63293,291903,176,143,552285,105347,446938
85dc156b544c955fd3784bda48d3d256,34,25,24169,14876,9293,45,35,50945,15422,35523
7ae4e953dd91048f87aa8a99c02affa6,29,27,18046,9095,8951,31,31,21326,8544,12782
bba0c1b151a9f253aee00a912cb8540c,24,20,10450,5377,5073,22,20,7793,4770,3023
70d55b0103eb2abfcc5b4254b6e5f640,105,81,214904,59203,155701,102,87,203930,55659,148271
d2ecc0ab51a05ecad6850bf8ce2cde9e,24,19,9145,3942,5203,22,24,8816,5028,3788
4eae28b2aa9cc8013f4ec89f96b289d1,45,32,39099,10504,28595,38,35,30551,11425,19126
74a382969bf4643e186cdf69e332b22a,47,41,48182,15867,32315,47,34,50773,11493,39280
df4eedeab2039dd3583be3160756bfd2,48,37,70998,18592,52406,59,41,75308,18408,56900
dfd38d2c175f1ea812c6851caf80f832,114,90,278361,91060,187301,130,107,315309,73778,241531
2ef6ba28b7ceb5ec3b162fd7074d45eb,69,48,82940,23650,59290,68,64,95195,23426,71769
b0af18875958257ff3c935269278636a,60,49,90114,22095,68019,42,34,61160,20776,40384
bd18ff3147f0a47d5ec8f6fee31d22e2,59,52,116207,33887,82320,53,41,58388,33031,25357
6ca41da8e5576b5b472a93fdc2b13768,153,101,373778,63068,310710,124,91,331385,77773,253612
768dfa7b47c4d77fdf0c4b2b2e522e50,166,137,482879,79449,403430,155,120,483596,76974,406622
76537899a81b7279b55cb632c92145c1,45,37,59289,15197,44092,59,42,51392,13252,38140
04bb8538ed68d9e969b598a17b8e3685,102,89,235044,66256,168788,156,124,419422,66641,352781
2a52e2735d47201d29370d1936704d20,104,89,202077,60095,141982,148,104,258374,50872,207502
e7091926ebd92a9645f30c51d5dffc69,141,108,360704,75848,284856,143,92,363133,63012,300121
e3353c3b133cd541087ee3ea8b667739,148,103,514308,105521,408787,137,116,537219,91363,445856
f864454e2461ad959b8d57433d27a7f0,88,72,328651,91412,237239,121,79,296660,96108,200552
7999a4403b40e1c0aa4fbd07ffacd50f,72,54,94712,32930,61782,87,69,123165,34560,88605
c249f052dcec8b481c5f226aaa9148fb,20,19,13897,5875,8022,23,20,12773,5302,7471
05d8612536c04307b54eb18c1b9e2c10,76,49,133123,23587,109536,81,66,205046,38227,166819
a8802f84f74c4bd1ed14be6ee54e4b1c,15,15,1955,1417,538,20,12,2702,1318,1384
4000949298b2588a9d043299efbb88aa,147,130,336138,62818,273320,163,127,357448,66282,291166
ceaec1f1d4e6a27e3085d9577d074323,119,86,264829,88473,176356,148,100,341584,99840,241744
42042ddd7e409ef335f6477bc8e0c17b,64,41,105313,23205,82108,64,50,86438,33776,52662
8c5bfacc78c87739088e841c094375c4,106,86,253757,58956,194801,94,79,200643,71611,129032
ea616b5c7e10c9da6733889ce2a8efcb,192,134,655563,123817,531746,191,157,745532,135443,610089
8c1f2e056aaed68c89b2e2c824799d73,88,60,168603,60087,108516,140,116,458289,72927,385362
dd00b6b31665551f2c3588f881317d84,17,14,8218,2535,5683,22,20,11064,3912,7152
f00298cf7fe6ab211be89bb03b47f504,37,31,21226,7341,13885,27,32,8827,9118,-291
424a64f6acf84b3bd9cd29fe9bedd6ad,114,92,265386,51204,214182,114,83,246022,40789,205233
e6c35f367f7e11b92a55d13ed03afcd0,74,57,149478,40098,109380,76,70,144771,48234,96537
c8c0ab514a65f83821bca7355d87cc4a,174,112,585415,77953,507462,153,110,560862,115851,445011
8e855950e9a39a4be7bcbd16bd9dd065,151,100,457439,127969,329470,161,120,489544,112643,376901
5489c0073a09be41ac9e24945dfa8c67,43,36,44363,14197,30166,34,31,33345,11043,22302
f6197b6396255e781432aeeb0a292baa,115,89,343835,57844,285991,103,83,259424,47999,211425
fd64860038182d9ea4ad97094b06faa3,88,72,157821,41954,115867,142,120,314995,38494,276501
2e745c67f04cb18cfe3fcc54e5cc2875,184,152,697541,121190,576351,181,143,869628,128647,740981
ab083bfa47e29df89f8e6e4397782e5e,48,34,42873,16858,26015,51,28,39737,14117,25620
e73cd9ece2e74a9f33fb3a059ffa47d2,24,13,9092,2840,6252,28,16,8783,4129,4654
56895693061772ab7c7225dabd9dadac,7,6,747,737,10,5,6,565,575,-10
a5c8d8ec8a4a13195a03eaf52bf52408,129,110,319656,83750,235906,174,117,450269,75009,375260
d2b159afc02bf4eeabc4015df171022f,163,96,292477,45968,246509,116,84,231486,45019,186467
e3c0f2db8a703c0577afc9d712514131,6,2,906,121,785,2,6,121,906,-785
a927d94d1bcd8e1718015f1600a92dd9,148,110,270298,65450,204848,96,72,146446,48933,97513
77ddb0ebfd493fe95e25c0832f4200b4,63,51,103736,37945,65791,72,51,100695,43179,57516
64bead429de2fb50dd5fba054cd35e7e,82,54,110113,25477,84636,54,43,91523,33025,58498
1cae5ff5d1740f4dddae6e3bfae2fb73,89,63,119133,33278,85855,72,65,117505,34509,82996
5e266c9e45351a6fa682bcb0c83ad39d,106,86,232574,67709,164865,79,55,159996,70927,89069
5cb57d31a3a03dad454692fb6866b565,31,26,17345,9928,7417,32,27,21435,8306,13129
d987e3ddd897b795aaa4a6ab83fdac45,100,58,174216,49818,124398,96,65,226691,45610,181081
addf5de4066467e4fe6b989018f5dd40,95,70,200891,39110,161781,101,94,223074,53584,169490
c9a0c12a9e6ebf7da054a37bb115d63a,107,82,213164,59685,153479,129,99,281017,55627,225390
c374c7652db409098d0536ceab4b840c,25,23,20247,7460,12787,26,25,15786,6551,9235
52b46c3e23280d8d477ca097f99fc8e6,55,29,46543,11622,34921,41,36,44218,12143,32075
b8925af5114868d52a8780801de0be7a,18,15,3178,873,2305,17,14,2755,1718,1037
810d199f10d63e7e37f4995c811ab9c2,60,50,101917,51996,49921,57,46,82744,37247,45497
7481693b40d844f86d822f54b26a793a,77,59,89378,22802,66576,88,63,80024,23578,56446
e95d22270b5035148d4119ea61281b52,9,5,1555,423,1132,12,6,1316,638,678
a8dcbfca3a54f9123ead128175eb47ca,44,28,44817,12992,31825,42,36,55670,20917,34753
a1e77f8fcf7a646432994e9621003bd5,17,12,7647,1823,5824,17,17,5079,3154,1925
bcca4bb385edc6f41701b9973ad94031,157,111,471086,37849,433237,121,95,240023,66061,173962
32458686001a090dd31d343be0bde7d1,128,111,370664,102126,268538,159,114,479040,75310,403730
15d296497056608f996bcfc18bdc6c6e,152,98,475299,67056,408243,124,70,280160,70559,209601
2ab3f3ad6293a6148529ed7638973b3f,42,34,23300,11636,11664,38,32,25303,11612,13691
9aed17c621da6b7f12db8dcfe5c8e4b3,83,71,168354,44810,123544,86,67,159651,41637,118014
5a9884312f7f681fcccb9eda4988a256,36,23,16810,6217,10593,28,27,11824,7730,4094
a15ccf3e020d5622a4d2f742621a88fb,52,45,71800,43265,28535,104,65,213315,29957,183358
cd9e77dacd231c34f6d4ab00beed2d97,199,168,573070,112325,460745,165,123,506330,97529,408801
256d501cd1a3443353424f28694cc229,42,32,52081,10111,41970,37,37,16717,13553,3164
b85076d5ff3d7e4a46ac7bb1b942d00a,169,94,724584,117633,606951,177,128,544981,134753,410228
d946c8fb0328503a0211a7d8d754b88b,106,86,226754,73975,152779,114,83,226431,53848,172583
f7e00ba284e6ffad003cd9e44aea4ad9,81,59,113358,25638,87720,91,74,138334,29229,109105
3c4caf23c595a9c2310eff087c69806b,66,53,84305,32891,51414,90,72,110201,18155,92046
3dfd10252b81a9c3bfe9421a7b0618e7,44,34,57566,18952,38614,58,52,72451,28867,43584
be9a8bb7a37c95cdce6ad7a32064520c,62,40,67632,16715,50917,60,51,57378,21116,36262
82d54d36fd0b211b492c0ae8e185e6db,123,83,249064,67339,181725,156,114,292485,74845,217640
f383777b80935fbdb1dbd997c5e35edd,121,81,356997,75044,281953,161,116,402839,102757,300082
9936eab6620532c81e79e47657d81317,37,38,41270,15502,25768,35,26,30795,13212,17583
1ee4d158a18aac0b18093a2084cc67a8,118,92,415476,119562,295914,139,112,537149,94309,442840
998c46074ad02dac341a28b211eb49d7,78,63,183923,79115,104808,123,109,335306,69328,265978
7ab51ebeec6a40b7326a05b1ddb48c3d,40,28,40834,9754,31080,35,23,18151,11629,6522
4fe77bdc469ca36261ed7d6be2fc5b77,55,37,60669,27004,33665,64,43,75934,24870,51064
3a8e2fd2052d00e3bc60ad95e61bb0c7,198,141,662709,198734,463975,201,145,1056176,188593,867583
3bfafce2922662699843a6faabaada6a,18,10,2865,1473,1392,13,12,2483,1969,514
cb8782d6c6bc0398c228625c20617d04,3,1,219,99,120,1,3,99,219,-120
f6bf05ae574962882613d6d4a484f94f,156,105,573797,89110,484687,166,142,531561,95484,436077
e494be6e55a60451dc75caf46d5cfc51,13,9,1299,1832,-533,12,12,2125,1135,990
bb363351591d8aeb8f6186b6b749801b,159,120,468097,121422,346675,160,116,468657,96667,371990
2dc0ffe8998c5c9f9c174c55fa5ddf92,5,5,786,1065,-279,6,8,1080,836,244
ebdce0254ca38eada455afdb10db595d,65,51,133256,40185,93071,85,69,117462,28879,88583
62dcef955977e1cbdfe6a6831b542b01,46,34,57383,13011,44372,45,39,39654,13046,26608
fef511ddcebcf16043bf7be1d04c20f1,122,108,317317,89746,227571,138,107,303840,71198,232642
0a88e5ad93a324493689779e0db31afa,4,4,821,351,470,4,4,351,821,-470
18cfdbf55cf1212829afce951cf38457,131,95,263704,62489,201215,170,107,327198,66251,260947
814279f26875d21d4982b92831ce221a,74,61,106765,34294,72471,80,56,95665,37299,58366
0deb0895c99d4c66781a98e7437f3684,152,112,417164,64918,352246,157,108,339571,83022,256549
75d6bdd631b3573f6f7ecf8e48eb0a71,98,69,159303,25991,133312,96,77,161135,33736,127399
dc01a18a241363ddb5fd98442d5e59d3,65,55,61751,16889,44862,37,34,60966,13682,47284
b6a634402bd5612ce12645b3387ee99a,61,39,68397,22032,46365,61,49,53098,21485,31613
b850a8a7931c7f5497db7c31711db8f0,60,47,67483,30114,37369,70,38,115458,23505,91953
02a5a8e11d244b45c5bd9112fdd6f865,83,61,158452,42846,115606,85,61,148529,49010,99519
7d2f445104b2504fc20e7d7961c6dc02,103,69,263531,59332,204199,107,101,277949,80403,197546
22cd57bc2e63903f4e6c022c4b75436a,86,85,158317,38989,119328,84,67,107372,37897,69475
ddf25337494f16622ef9680e6cb8a99a,130,105,250770,80695,170075,97,89,231773,52833,178940
1fde9239e381db51888d35fe0791a98e,51,39,61091,20663,40428,58,44,51512,20173,31339
29ab2760115a214e1f0ca0fcd4b4358d,128,95,274651,51672,222979,154,87,283091,62026,221065
4f661b76fd22396698657fb49237b325,42,32,31767,10832,20935,43,35,33961,9151,24810
58c28442aa513b84ff5efa94b9e0c36d,144,119,470613,105228,365385,140,123,338896,109728,229168
d4d269672fd2aaff9a357a638b62bc34,39,29,27875,9624,18251,41,27,26335,10804,15531
18cee81db16515ad410bf372aa4c9bc3,47,37,41451,15422,26029,46,43,34615,15828,18787
5388f9187d29f2918502f06fb0bace6c,136,88,680886,101308,579578,183,143,808106,133244,674862
e7c024fd8330beec187a5c4613715e50,37,26,26994,10047,16947,31,29,26805,8309,18496
c928e1eabb348ea662e6245fafd3203f,41,31,40112,14146,25966,43,29,51195,11252,39943
0f0ef62935d44cca47b00e9f7ef34264,111,91,254864,61840,193024,152,115,284328,66306,218022
e26673099f139f92206ec288fd5d996a,165,114,446238,79755,366483,147,104,480398,71824,408574
d06014a18ecd0ba86a9af6f52de32d9a,119,92,451326,178318,273008,179,135,626997,185241,441756
10c9a86d778d07e333419976294ab060,39,30,24601,14299,10302,36,30,29976,10059,19917
7867d64ebdad9bbb1edba18b0bcd59a3,147,109,307997,72453,235544,103,63,194092,73728,120364
cbccdee860f3cfccfb006bc9ddbbd6aa,91,71,131292,46385,84907,132,106,260093,31410,228683
d89285ad2f4ec284927b623a25668aef,175,118,430718,80813,349905,117,92,395406,104472,290934
a4b47392ae67cd2663cfeaf2e83b3bc5,53,36,46257,14374,31883,57,36,56945,14363,42582
10b591bcd3786a6b62242619d4255023,126,82,235144,48230,186914,107,85,216953,53915,163038
2dc7ed28fcfbf509945aefa628a9c272,132,109,367000,73668,293332,151,120,390475,97743,292732
3b4fdc07c4da5c5d31b828a7f5e8115d,56,43,66834,17597,49237,39,30,34131,10761,23370
37a2b2c7ee80e2d918058a9b61911f29,77,72,123382,54247,69135,81,62,133034,43146,89888
a6c37dc1228f16fd582648c2ddf191f0,29,19,12410,2976,9434,26,22,8670,3969,4701
a277922d370f75a288f182c91ab17a3e,61,42,73642,28100,45542,63,52,84715,30412,54303
2a5d0243d5c8b6f9771dbdb33ded36b2,117,83,296705,41711,254994,121,107,284712,63836,220876
ed41c1674ca414a82c68f0684a6c3e97,38,29,42030,10911,31119,58,40,41666,12841,28825
a7eb041b9efd15bb272c1a63e9f218ad,97,70,190356,43211,147145,81,59,151777,48476,103301
6ea0067325b7f82a8bd9e726d81267d7,155,108,469417,95035,374382,149,119,419574,91778,327796
c6b57c646c3d1a7afb33ed0968712746,86,49,102798,21892,80906,55,51,102622,23312,79310
f81f1d24fdb9bedd39f6739c93a32d50,44,35,48989,17769,31220,56,42,52656,20325,32331
a9da1ef379445fd1e7bd52d7208116ba,169,133,611975,160050,451925,170,111,549557,136812,412745
8ec3464f4ef7fb20175205e8ef4312c2,23,17,10452,3651,6801,19,17,6181,2409,3772
39ccc1a298dc7866d9ef0411e75a95e0,190,135,776934,151662,625272,188,150,818539,146051,672488
562e7e2ca2acd92b202cd84f4301e3f5,140,98,293077,78854,214223,140,110,271322,70347,200975
5d5f7267d2703751bf93e94c1decf554,15,16,9410,3033,6377,16,13,9048,3543,5505
6168dfaf263322b4830200ee89243c6c,22,17,7368,4616,2752,22,16,9920,2915,7005
bb2b4431f07ec8a75181b7accacb1f85,71,52,106038,27282,78756,68,51,75737,27839,47898
22b6b794fb5138d8c4b23a9c01225859,91,74,183466,48940,134526,79,57,171512,43644,127868
453014c22c5f2abd74587ccf729d1500,5,5,963,530,433,4,5,589,963,-374
980e19ad59fd14b3931c3995c4e401a1,21,11,3711,1184,2527,15,14,3683,1552,2131
b9127e01269b65c2b82cfb70b7eba5d5,108,91,225943,69545,156398,133,104,390316,61459,328857
d678d2c2d0811273e9555ac69d101e1e,126,98,351172,78609,272563,119,90,384308,95605,288703
5703e102b7a6131c7b7269bc0ade9add,122,108,219680,54757,164923,154,116,312113,36948,275165
828a929c6a4b1db14f57722ffa20e966,167,126,716399,117050,599349,180,121,721810,113186,608624
c039a497fbefc4f159a2f2aee688a0d2,58,41,75954,16448,59506,40,30,59861,18811,41050
7831d66ae01a0bb6c007873cb6f9a8f8,49,35,48862,8953,39909,56,40,42709,13494,29215
4f541a4d58e5bb4e2c4c518ef84daab6,150,109,580376,112343,468033,161,138,747994,129423,618571
c2eac7ce55c464c9072769635be92f0c,159,132,578987,104725,474262,153,124,451881,82114,369767
4695821314d64a01d6a406a4add5901a,40,34,24370,9453,14917,46,42,28995,9063,19932
7a499d33a05dd728c6e76dd480cf9dca,55,50,63475,22601,40874,44,37,53434,20076,33358
c6ef0c90032811e15739a2ee7be08b14,138,95,365802,63549,302253,111,91,258936,73167,185769
342197d22ba8ecf0f75c20399f6eb808,115,73,232880,43372,189508,150,99,292475,63838,228637
fb23258ce693b86ebaa285c56ddf2294,147,105,308926,59479,249447,126,95,324663,68580,256083
ef64090cb893dc7f4fc8ea41b7e36e34,114,96,291286,97528,193758,168,123,501725,121341,380384
5d2440e4edf118a41019b8b57dc64410,124,97,252321,53776,198545,108,84,179703,50488,129215
41abc90bd8d773a10e5203c636354b28,46,30,34203,16064,18139,63,37,55748,13465,42283
82a2ace682fd612260d317f1c64ff691,147,108,342982,72808,270174,114,91,207587,67972,139615
fae94eba8c8816c1b0b3286b77154609,51,39,66067,19234,46833,45,39,54602,22882,31720
86ee73d5f245dde9df6f5e04ed36a261,96,76,174524,44363,130161,105,98,194741,56519,138222
4feabe133d65cc699b4e6dcadf8c083a,32,35,18879,7795,11084,37,29,17917,10411,7506
d4f6a106436759b6b7e066f67a5ce929,177,135,956265,251231,705034,188,156,829993,147841,682152
75112757bde649d5cff1c7cd4f1275c6,157,105,483220,89199,394021,131,111,447972,102350,345622
ef88bb58611b0b685e8cfc1074a33eaf,67,70,103376,44317,59059,82,68,120060,37275,82785
c58a609457e1761cd3429dc41b34009f,182,141,568488,109374,459114,118,94,346023,110501,235522
2e02f8554bc8d9bbeb3569aba2392273,127,88,231500,29491,202009,103,86,144256,30002,114254
bc1a865cc73cef52985d080c7b00d210,32,28,18776,8993,9783,27,30,18160,8412,9748
4bb067a58b91add93528dde4d3bae794,101,80,270924,110755,160169,171,132,443541,76161,367380
13b661839f0d2af9921c954057a335a2,64,50,100758,23732,77026,86,76,87039,25478,61561
05049948320d5fc87598d6a918b8b6aa,175,133,488631,103454,385177,156,115,406829,112089,294740
a07887f9b71f71409e6d127792e38b6d,183,118,521018,91133,429885,162,113,443062,121185,321877
0d23ca5219fe12f4611edd46f5baf063,62,48,103950,17189,86761,59,40,74362,24308,50054
103fc52d79efdfa2f81d1136792c7fab,32,22,22881,8831,14050,30,24,20032,10928,9104
b8cd070792a3c9062107eca63909563d,99,88,163600,54729,108871,108,84,234126,39958,194168
dbb2c8e34d7271c0c42c14183cdab74c,102,46,140765,39007,101758,112,65,155788,44544,111244
e18d396b794fefa89d3645dddccb5f7f,99,67,299337,71867,227470,140,100,308839,115785,193054
d0c6fe42205baa88cbe450ded45e26ae,31,17,20267,7844,12423,22,23,16193,8013,8180
24a1a969bb4a1fab3399d44a800c48db,97,73,172056,101949,70107,140,91,289566,84743,204823
b14251e4b9932fd82c540341b4f44297,121,86,282588,43257,239331,120,88,281817,61962,219855
ca2fe87341dea9befe801866749e3552,33,34,30188,20010,10178,45,39,45627,13039,32588
4c03056d08dfc7313000b09f87741453,158,115,712695,164434,548261,165,118,646852,200121,446731
405967a0527bc5ffb475fb51cd00b2b6,90,82,216288,63836,152452,94,79,231179,80479,150700
0ff8ab59e66c413f1f60d73fb57b3ba8,36,28,40599,14381,26218,38,27,37763,11580,26183
534fb80d390faa65b392fe20f7d2db9c,5,2,867,334,533,2,5,334,867,-533
b1ac3e8d2ce158d3124d3ba39a13cf28,28,18,14204,9128,5076,25,21,16360,8579,7781
5e4eb67e59259e41faf6a4ab4ca7fe67,112,82,259761,124835,134926,164,133,626892,83243,543649
491d4a4195d3b6d885de6803de4fc23a,81,64,137761,50181,87580,116,93,240993,52835,188158
2b1f420cdcb6fa082e9b937838bff053,127,89,323542,75279,248263,86,76,307466,77646,229820
df5cb12b16ff6aeeca07d17425b81731,50,36,51850,17765,34085,35,25,46974,12028,34946
e60372f3a73289bc8885bc83958a1c05,99,69,201467,58583,142884,103,69,156523,56997,99526
fcdfb698b106093202c47e856cfa42ac,191,125,625706,176753,448953,190,154,787667,166904,620763
3fb2bb7c9ee8f9d883e93ffb617f1d97,50,29,45859,11806,34053,39,31,30497,11068,19429
1cbfbf448a2db627d558b9df2540e62f,190,140,696569,148887,547682,183,114,595596,87574,508022
bfbd1719c0ce20681c715662bdc974c3,52,34,54524,27913,26611,50,46,91206,23746,67460
ecd5a67beb4d56cdb3f93f99f21c1ae0,25,22,13231,6522,6709,25,18,12378,4481,7897
cd5d844a75becbba3ed8b42600c312c9,127,117,460418,73967,386451,138,93,334483,91202,243281
ea77bf844d34ccc98cebdff7aed302a1,29,20,15182,8896,6286,31,27,17713,7169,10544
2f0ef555793464930ef5c8b6f23124bf,34,28,25849,10239,15610,35,24,22811,9290,13521
b4c74e5d8d94898111079dd56bf6f5ed,62,47,108400,40900,67500,68,55,148009,34499,113510
fb230a6cd3957e213d699c3e426eb90a,107,78,323056,67936,255120,164,110,377741,72217,305524
b0caf46c7936e3dbac3716cb052ce09c,198,147,710056,129620,580436,222,155,575779,113107,462672
6b12645c2ce345e94d2dc4a00ddc5688,172,114,503217,70706,432511,137,123,474033,94760,379273
28dabac949f92bd6b19a431b62f77549,136,98,305749,41964,263785,103,76,158540,46814,111726
f8df916c078a479686c605aed31ce86c,34,18,41367,6362,35005,24,21,13951,10538,3413
7989b1313923f485ca7432741a4ea11c,40,29,40577,15514,25063,45,34,42945,14357,28588
339cf9ddb165af8a84c661842a3c2945,18,12,7005,3156,3849,23,15,5111,3019,2092
e54d63ddaec3d90dcdb05d17f4f4b91c,165,97,447984,68982,379002,116,83,275934,90127,185807
fd471e336aa0d88293105ef4501999da,165,97,517058,76385,440673,165,133,487360,135842,351518
286d644c1633edaa2ff00f86ac27affd,104,73,252717,80214,172503,148,109,430327,59104,371223
19a04e1806dfdde4b52ad8fc79ab1bda,182,145,1048421,192633,855788,216,132,902491,170531,731960
4425bd96ee0d9a72143350d26f848474,138,103,264398,55341,209057,130,88,192786,49510,143276
30306f2ac6368a9f41a38f22b5ba997e,19,14,3839,2269,1570,17,14,3676,3246,430
d14efb947c52d7a9f894b20e1f0c6eb8,40,30,37912,8072,29840,41,30,20812,13096,7716
2892f8adfac23347a16ff7bdbe6eb6c8,174,101,339880,61412,278468,96,60,189102,70900,118202
c8fe34d9b112b614b633f04ca0a8fba6,36,30,22897,11822,11075,31,23,28172,8371,19801
bf6bcdfe2c8ec5b308b7d406aafb0041,89,67,186468,46071,140397,106,85,201071,42113,158958
5b2547841a39811770913e8a96b942cb,82,60,171488,50056,121432,99,91,184942,53959,130983
1ae9394b7dc7d20238c2be5c2f8f66e8,120,102,278678,50880,227798,99,78,266710,51132,215578
73904b59ceeff7ae70c127f051a07faf,0,0,0,0,0,0,0,0,0,0
48b2801775b3ff9e8305f959c0b1e893,42,35,58757,16132,42625,45,44,75433,21289,54144
1ea6b2c64333e055c8bf209df7500d52,66,55,91770,29140,62630,86,71,115565,33770,81795
21a78f9e16a3db6d32a68de885ef4578,54,34,76336,16107,60229,79,55,104106,18510,85596
04787e36f8adfba21ea2bb8dfad2fd95,128,110,433217,125022,308195,131,78,370350,94293,276057
de94d9baf801ae9e3060a610e0150a2d,110,94,194621,35130,159491,76,68,117046,35974,81072
872ec3423971a5b4f62ea6484138f255,82,66,176478,39806,136672,103,58,127039,36701,90338
97114f982ece53d1c3fc3ea79e446bc1,143,109,403847,121815,282032,196,133,679602,123575,556027
15ecb26bb40307cf942a01d355f82b69,178,150,523001,100762,422239,162,126,437662,94448,343214
205c201d2ed8ba6dfd939bbda1236d73,65,51,118182,28321,89861,80,70,162681,27117,135564
7c2a5c9cd5b43b15dc4761c5d8f0514e,45,41,42236,8813,33423,40,39,23257,9744,13513
6bb756f0bdcb203f0a027010599b44ef,38,35,35743,20005,15738,38,41,38779,18271,20508
504a09decd75cc5e43a3b5f7d0822b8a,119,91,205187,65460,139727,113,51,182695,40974,141721
44f63944cb8834239f4a7db71668889b,29,27,21338,8294,13044,24,26,18394,8714,9680
6301416ce90bb9c5548538decd2854dd,33,25,22917,8951,13966,31,28,16538,11264,5274
cf26eb4439172d6984e987bd8006280f,71,60,110430,28416,82014,97,74,168982,21833,147149
c818ddc2c01de5a2898bbbb6bd5452df,48,42,62466,13286,49180,53,36,49900,14958,34942
0c8039832acc3fd98e2f1f5f29f5bc94,31,26,22134,7759,14375,34,31,22528,8359,14169
d0a1f5390cb5fa4ed160153c73cebfc5,191,137,498182,112957,385225,170,148,571241,115716,455525
4f7d81f1e5fea3a8e63b6b3559213fe4,113,88,206540,43252,163288,105,78,168757,45746,123011
ddf08b22582d464c262155a81ff228d5,144,103,391098,69672,321426,110,94,262256,88949,173307
9897fae571e7cb8b442482317707239f,23,17,7188,4398,2790,21,16,8179,3453,4726
ad673578360aa313cce235a7fca3a5bc,108,84,229981,60958,169023,126,99,250351,65203,185148
8e7d4f0b11b90c568c98b7ff7d590907,148,106,447548,100935,346613,167,135,708950,128426,580524
a3b45ffaa7248d662cc731c8f93cb264,3,4,185,368,-183,4,3,368,185,183
04b2b9f173c108d55aecb2fecd33efd2,143,111,412134,131476,280658,125,98,325586,69686,255900
9507c9ceb01d3a4949c471f609ce7beb,94,73,241411,73764,167647,136,107,340778,64514,276264
26673212b1a8a3605648057c2e5efdbf,105,77,138653,44173,94480,89,76,158745,33636,125109
5465496399b8f12b129a9536a7f55a5d,25,18,9778,3598,6180,15,16,8237,3949,4288
eb117b2606d6c83cdc89dc8071ccc259,162,127,631698,82308,549390,181,115,515031,82717,432314
b6a14a0a7841df5583456dd8bdf37247,47,32,38612,18398,20214,49,40,80597,23274,57323
87ea6d4e64d6cbbdae3832f43d3414de,93,59,140022,28175,111847,89,69,123812,41733,82079
118a41351ba7f923f5db8753eedba77a,56,45,51983,17726,34257,47,38,50041,13645,36396
9a5097b20d0845b5b1287e67785d3147,128,88,272849,62523,210326,135,103,267062,58783,208279
50af084c3c8d961808f11cb08b140862,16,15,2420,2135,285,18,16,3287,2378,909
4474fdd289bad427cfc47fbda0b614d1,157,120,404043,92621,311422,153,115,533813,81413,452400
a0449cc69d776f024b102eeff66a550f,65,61,130548,34107,96441,69,55,82387,23175,59212
58e75cf312de926700e05781fed0213e,33,22,22914,11211,11703,32,26,27131,9727,17404
3dbd71127b85a9fb489405b0bf8f5303,131,104,420470,108038,312432,165,110,430947,104190,326757
ae1190c452ee42333a3f5d3ed9d48ead,53,39,84335,25504,58831,66,50,101014,22556,78458
d17b445a4aa6645f13b862cb71a6878e,124,99,366397,60200,306197,145,115,375175,55793,319382
80e8b1359ee89a3dcc008bd4dd02fab1,97,74,220438,53832,166606,149,122,284066,59509,224557
e3ff22212e13f7352ffd725d494930b5,2,3,187,237,-50,3,2,237,187,50
4adc5cab20c14d14652ccd97ebccc504,106,50,142172,21063,121109,87,58,91132,28229,62903
cdf9fba9a34e07a3f3eb553cf1915317,98,78,191856,75774,116082,97,88,238482,60338,178144
4d9184d906ce6bc0a0996b718d18829b,194,130,911304,143086,768218,170,125,670674,174128,496546
0db7ad957a4a8500b5ed5a5948ba8e10,128,107,432455,79905,352550,162,142,541687,122090,419597
014749726b73ff14b5532833ef98e9b3,24,12,4336,2265,2071,16,18,6056,2921,3135
f266ad5a3b3621d44a3673963b62072d,168,117,332239,93079,239160,148,107,335388,88310,247078
02d2bf52d61d7c9ccaf1ec9c9c305716,65,57,78164,19079,59085,87,72,114217,21408,92809
223c6b3934164a70f296f21526fb16d4,46,32,32057,13148,18909,42,36,31300,13767,17533
470f6277011ac02ae7a85eb732bc9e3d,10,11,2025,1561,464,15,10,3033,1062,1971
b39ef66c5f4db17a4502e44e4bcbf9c4,29,23,16427,3686,12741,21,18,8875,3445,5430
73b4b480fc4af323db55731dd876fb0c,118,90,251734,103158,148576,183,120,450398,64694,385704
559dd59fe20a7c66dcb3a9be62c19aa4,145,107,633567,96143,537424,137,115,460727,88334,372393
6f069b4163eb9909ee0082f2724e48ba,75,60,91050,28534,62516,80,60,100178,18925,81253
f9d42d1684d2c4372a835bccf5f5d2cb,66,52,108461,24875,83586,64,48,82204,33316,48888
b77d233a511099bbd9ce59964f866b9a,171,141,475585,105329,370256,138,103,312239,88045,224194
fb2fa20ae86dc17302a596ae68dfc017,26,21,10681,3991,6690,28,24,13813,4692,9121
63dcd473861dbc496ce503f1dd5bdf6a,69,57,83628,42804,40824,85,76,160604,39742,120862
0d6a02bb4d4a57f65b02b3c18edd6a2f,54,42,49095,11772,37323,30,32,22617,10673,11944
a6c2dee53f8f8f72b82706993b0c241e,68,56,136353,30566,105787,35,29,56850,19304,37546
f29c8836d799bc14f6c240ad4052732c,205,121,819801,129776,690025,172,119,816872,158097,658775
e89c5fb5f5f597eced04bf8457460d00,188,148,927332,126806,800526,212,168,851095,157817,693278
3b3e48f5d64af0c3d770f386e9a76cf4,34,23,22871,7307,15564,26,27,12116,8777,3339
d3bcd75519311a136655e1754604ca22,156,117,665764,139117,526647,163,141,665659,108526,557133
3211e9e6437c81a8aba204664a8ca2e7,153,133,536481,100770,435711,183,148,558015,73741,484274
a4082ee811b8ac076ea9361001b42ab3,122,96,247863,59482,188381,166,116,305980,40188,265792
193b51c630bcaa733fe30a59f3f62227,62,50,74982,17786,57196,74,50,72665,21070,51595
d271146fefaeda73ca58a72f6380646a,150,127,376785,79521,297264,163,117,462076,82688,379388
0f0dbdd96082bfd872b23f11d9775bf9,88,80,247840,88142,159698,107,98,296741,66788,229953
73d24f994e965cc3b355ff2787c317c6,49,40,48573,17257,31316,45,34,41372,13628,27744
457336498aa97a4c360b98a710329a3b,107,79,230630,80778,149852,146,95,314397,57640,256757
d801ed6a31efacd23428b709a0477c18,142,117,416933,137757,279176,163,134,561277,95656,465621
f7182fa5eccb910396ea2c12c9c8dd9e,43,34,48887,11578,37309,32,27,20586,10990,9596
fa506f2c1152ee1acbd2b059077c7513,46,39,31365,12444,18921,45,39,35390,10233,25157
5cbfd593247b1460667220e7e111e493,106,83,254047,70362,183685,184,109,361471,62348,299123
874cc96b8e2242af772e5debf1ff8171,0,1,0,120,-120,1,0,120,0,120
8d0766dff812211cb3944b9bd503bdee,56,39,101682,20092,81590,66,55,74179,25504,48675
7ae05c75a824f436a6833692a1ea7636,140,109,2422713,242205,2180508,229,174,880201,264837,615364
a22a30bd46d7ac849f70528382bc17b9,78,65,132807,39100,93707,84,58,128151,33554,94597
19e46ceaf9396126417ccbe681764c21,35,23,20424,6893,13531,30,23,18161,7099,11062
b566015ac4342e6294d4f47c140839e1,30,24,16936,5596,11340,30,25,11819,9453,2366
2542af2ee2952bb4f55c970340ae777b,68,60,119539,38113,81426,74,55,178855,34748,144107
d4d0c018299713fdeb4c87c75e04597b,44,37,25680,14608,11072,41,40,27846,13918,13928
548855e9e7c85ead05ea9d9ba4ee4cb3,122,90,223969,33941,190028,78,65,117280,29999,87281
c5142ef9e7c32132c2b04c1e5e918f4a,87,63,111771,20800,90971,120,66,137461,26076,111385
0f6c4374a18d2d50f914b802f0e16eff,109,81,183644,38883,144761,89,78,196789,44351,152438
65ad14163da195e64900eef328dbaf4d,42,34,48004,7933,40071,43,39,42510,16097,26413
1382e0e725ebf5a055d347ae0cfe911f,54,49,77287,31124,46163,60,54,82532,28702,53830
53a56a4f55bc87fb356a7c41ca4671fb,21,17,13116,4984,8132,20,19,6497,6145,352
972006db6c50ed9440b3c3eb30f0eb14,163,138,557552,86989,470563,154,116,470504,81149,389355
418dd963ee8db2d335fb841447d0ba29,172,123,583300,110925,472375,159,130,661469,135341,526128
bc99603e5d2316c33dd665c36405cd89,119,77,212641,39640,173001,118,77,193223,55698,137525
7d70243f1bd16519e61c8ede78ac14e3,153,113,497728,111061,386667,141,100,426953,124077,302876
087ed9743ca48d1d282cb929d1122cae,82,41,86426,27645,58781,57,43,59889,34728,25161
e800ea21611d3838d6a4f01c39953606,143,110,443609,94540,349069,108,92,287354,105138,182216
5de67f328add914bdff7a8019fd12f08,37,35,28142,14403,13739,39,23,30662,8102,22560
46fea7b30b8d5238386302817284992f,126,90,246775,76856,169919,146,109,307867,63596,244271
478929fed4928b19bdbaedf12f79610f,111,88,191012,45813,145199,95,76,127753,66633,61120
2d922968bce9d072d478908163f273d2,50,37,49229,15547,33682,49,32,66482,16246,50236
c9c1fcd4c1a020c9e39bf4a6c731d5b8,198,140,722915,173657,549258,182,117,556007,186278,369729
257558a35392b7e5f75123f9cc3ea51e,55,53,82440,18648,63792,108,73,166377,26145,140232
2b84be87f217a2e2a48a9f0de2dd5689,41,35,40371,13828,26543,33,33,41949,14057,27892
7515d9648df1227ca4b6bf4a64837284,134,100,368007,51682,316325,136,98,375816,64369,311447
192b5b1efa2f9ae54683b96c5961fbb9,91,63,199444,107774,91670,93,74,207819,62593,145226
1d055c93300d84ca8bfc2a48fb1a638a,162,123,422711,95930,326781,169,125,424627,93073,331554
2c9b688ca3a4c564fe418dc8b9b51453,76,63,189755,68108,121647,114,92,299381,55135,244246
a79471bd3b09b9a2d36bb1b85772ec8e,82,63,115402,46475,68927,96,82,205247,40464,164783
568866cceb39c33be44d858fb547f7ea,160,119,545772,139046,406726,150,137,635182,131618,503564
98bd36856facacd0759377bc8f1fa2af,22,23,14092,4301,9791,32,21,29768,6025,23743
e31a0308f416da312b499ea1211ce77d,123,96,326565,64633,261932,143,96,338404,53722,284682
7ed355e7cd7f7dea67d13f6e49d8c82f,105,81,172286,36876,135410,112,85,175691,39785,135906
5c659aeedb3565dea687949e09b982a7,54,42,46479,11552,34927,42,31,27048,12370,14678
caffb0a9f1ab493740b04c088b47e244,83,82,139442,50803,88639,103,89,194333,40969,153364
7e36eeff3b875b4a9d8120a9acfc1008,108,92,180824,37598,143226,75,70,130683,32878,97805
b255d83f1f409e89d9162acfed3d1b09,128,92,389084,137672,251412,206,125,457454,132935,324519
9f345205b3efc990d0828598d46db8c3,74,47,112119,34407,77712,64,48,92734,39487,53247
cba854161b9394bd090977f47ab70220,146,118,346572,69550,277022,171,131,336201,56511,279690
577a6a301f3ddca54d810305b2a97cb5,35,31,34008,20818,13190,39,32,50572,17167,33405
faabedbb7f6755dfbf111ed101ba9fc7,25,21,17175,10155,7020,31,22,34927,7583,27344
73e017ddcfc70f451307a95acc7c0f98,72,61,107427,26826,80601,64,46,87472,26864,60608
7cc785110e65cf23fbb709fff628b0a7,15,14,1733,1870,-137,15,10,2953,606,2347
ca0b6e706dab4daf95c8937574c16540,102,77,140125,21561,118564,69,53,94546,24311,70235
04da08eb622573e71687653a81c3a8f8,106,74,239595,65466,174129,109,77,300253,65371,234882
f377c842e018e0c76cb0f8dc22a35f91,105,82,174078,41704,132374,120,94,207839,38586,169253
145e2f35a2eada95c2d8610e2fd594da,30,22,23907,4778,19129,36,31,26465,10501,15964
4fe20a62c3ef9efba9804003954704aa,43,31,32992,14522,18470,48,37,42971,11705,31266
31a3ed4665ea313312bb69712972b9bf,83,58,130831,43092,87739,80,72,121858,38085,83773
f39c7bb0a269456af572433571f4bc40,66,49,101556,33850,67706,73,55,106832,30642,76190
abb2797db5eff012446492bb78b7e815,218,151,753037,165658,587379,190,142,667959,150955,517004
9e5da8cd6ea3328d51fbd96e00dfa43e,118,85,319448,74440,245008,130,91,341297,67259,274038
55e0a998ed0c806613884b088c94feb8,44,35,44198,14090,30108,44,31,27614,13617,13997
8ae083451c6addc2a604112f369efd90,50,40,73307,24024,49283,39,34,54662,21361,33301
cb6ce1b43b77b198c7765aaf5f6e3b1c,52,45,43638,16519,27119,39,32,36139,16293,19846
c8c4d6118f2807b871770bd1604b7a22,17,13,3129,1179,1950,17,16,3342,1292,2050
3d948f870618b0854ab0c07f478e0704,71,61,142656,31915,110741,89,67,172535,34057,138478
af1bd41c5c9cbb9083891feb71068bc6,86,67,173309,52981,120328,84,63,150222,41995,108227
aeaa3a3aa9dd32c91cb3ea0815aa6244,150,103,421253,103824,317429,119,97,479905,96413,383492
9b7e9cfc50a8c339a251fc7dba433ac6,78,66,93850,19967,73883,86,61,96739,20270,76469
26e9d8f5e5787f47d0803b989c882da7,258,171,1887342,199565,1687777,148,121,1067965,201918,866047
e4d2d528a78998e9b9c01a148eab11b0,51,47,52039,26680,25359,90,58,116908,29874,87034
382f49b48f4dcf5cca81ccdec6cd2ca8,137,112,356581,89542,267039,131,106,381228,109510,271718
63cf98fcca09c07bfa260457bf7ba68b,84,56,152465,46402,106063,98,71,169322,42864,126458
66b610280de896bc37d48b46fba50185,86,68,155377,34762,120615,76,65,131180,46824,84356
ad8ac2b6ca4e032124e07186481e1dd0,162,98,418452,104527,313925,103,74,364969,83886,281083
437a4d8b80c1a78ea345852fbc134da7,61,53,90800,35698,55102,73,63,106031,30143,75888
667793fba45f5d9b9a2f6e732c4e675e,52,45,43492,19730,23762,53,41,54828,22013,32815
7faa25ca2ce51ff1bbd3a30b41d06fbf,161,135,377777,103169,274608,187,133,593056,81585,511471
5221f7d20ca7d2c96d7917c935cc4855,108,76,202175,45662,156513,98,70,153940,40953,112987
93422c74a337099b650dd5690dfb5bc4,131,90,499779,124929,374850,151,109,489767,126697,363070
5b6cff8ebdad093b518d131e3d0404c5,161,128,516448,78319,438129,196,146,686614,117145,569469
8ddedac12b0e3b3277a625acd82fc5f9,76,78,128572,34030,94542,91,60,135866,33700,102166
7993c2cb3aba7b659a794a76a35fffdf,35,30,28432,11374,17058,25,19,22245,9844,12401
9ec2439965efac73ae84ab3fdce2ab6f,150,108,352974,93374,259600,183,128,363137,96133,267004
30fd8ea5f4c2aafa194c34b73e654390,35,35,22912,8798,14114,24,20,10282,6069,4213
32e86a26dafee089085214134682b62d,47,27,35974,11980,23994,33,35,25889,11082,14807
684129edb72d122095e10042cd348908,48,39,46572,11860,34712,49,35,41950,15868,26082
b2e3d55210d82880c622fa6b7bb5237f,16,10,5622,1793,3829,16,14,4395,3446,949
07f69e90c1b4c8682e426d23333a2daa,43,35,57965,22328,35637,44,32,63208,24956,38252
2e41f2c3e7ad80aa8c57ef503d10b945,130,100,302631,60582,242049,120,89,328272,56619,271653
3295c490e39658145c1b25230275c454,139,111,316224,46528,269696,113,88,248164,41041,207123
94152523210a1ad2674949cccffeeb61,71,59,120583,31993,88590,63,51,103489,42929,60560
a6db8c8b7d81dab0fbc206ef4aa256a9,97,84,129818,33537,96281,96,83,142301,37524,104777
f1d1d09467eeb7da136aaff83aae90d8,189,132,535969,106435,429534,166,105,324318,52655,271663
a9477d8038a4ca0325cb378f99ce02d7,195,155,767810,136153,631657,182,137,853289,106883,746406
f466c8770ce86f0336263d67694c4eb6,124,107,440109,90210,349899,192,149,618268,103668,514600
dc1a7546613b7d760379d3e9f17d9257,170,104,470506,95507,374999,160,127,435530,116645,318885
e8135d9e40ee4f8853ea8b49bd1af691,139,96,315331,49080,266251,131,110,315026,62180,252846
3fbc9475551f992072590218264a84e1,96,56,128107,52434,75673,99,67,184231,47119,137112
d57c0843ad46ba7dc00599aceccbf232,58,41,53814,14393,39421,47,38,48604,12985,35619
cfb17491fca593f62bd21aa8d576a4f1,3,7,386,620,-234,4,3,356,386,-30
d86fe567389c5f9fcf2e86c5176a7e8d,171,138,743074,178560,564514,230,182,1338346,247460,1090886
f62cb5a31a6001b3bbd33ed50b682cff,98,71,237388,76995,160393,68,54,186212,78876,107336
5e3001363149e4cd70bcdc6717eb5e7c,168,126,695405,105438,589967,170,126,834886,115823,719063
5273b8eb7a0fa0d2b6f7e1724f306ad3,114,97,254019,71029,182990,158,109,312367,67419,244948
a72bc3d777a8eb0cbf7a77ce6c8b3484,141,107,580672,112707,467965,153,120,634483,102741,531742
5b5156bea4163d1a39a7a8bcafbd5941,118,81,274658,85207,189451,163,99,367025,67582,299443
b03a4832b2acf97fba64e5376cbf7485,158,120,556164,162754,393410,194,133,669328,146076,523252
abb26e94425ddd5c3a5cba6e555f6c32,203,158,978735,154317,824418,169,129,663432,145078,518354
c7b59f890011ce7b9b12dbba708b991f,59,44,70601,17976,52625,49,50,47229,18845,28384
5c22dc828659f9635079c2333456f794,89,73,109359,37616,71743,89,74,171931,39818,132113
bc6bf5356a55727da36e47963f2f4a51,84,60,139248,53429,85819,165,112,328783,34364,294419
cee6df06607e1fd8f5cea58d8bf1c7b0,36,28,42333,8779,33554,39,28,29070,11979,17091
e8fbcf66ad4d0d8b0aa1d3f63f11581f,169,133,640830,100405,540425,140,111,404633,103398,301235
46e2e77cc691cf3bdd0a4622a0592fd1,59,42,45752,15825,29927,45,34,38123,11762,26361
e4c98846ab4612f530f667013acd187d,38,31,33335,12476,20859,30,23,24862,8286,16576
7a398a0283eb9018c84103ce1f480809,106,82,373764,117124,256640,199,154,656123,110968,545155
2d12134c34f181ac13f51f79218ca7e3,74,64,111735,46370,65365,65,54,148199,35117,113082
86ef762a4dd63de298f10c3d16a0743f,183,133,448443,86615,361828,124,91,304537,71160,233377
31d74b02ef6fd9d66c91624577a0180d,57,46,66923,25243,41680,57,33,57064,22061,35003
e904b1e2b3f72a3daa497d3ff41cdf2b,130,102,339760,65360,274400,121,80,317804,64752,253052
68f14d5857117f4fabdfeac01dcd042f,35,23,34090,8425,25665,25,23,21381,10583,10798
b1831b2b6db34830b8560bc3879b9ead,112,97,251972,55970,196002,126,107,352046,62800,289246
8593c6cae53438d91d2dc3ad5e539ccf,158,151,546364,79354,467010,127,107,399418,78297,321121
44962ece73b6f4667842d702f1ce8975,44,32,32405,10924,21481,49,42,37522,15530,21992
a5f6050aee29d84934b5480b1aee0fe4,94,78,189976,60833,129143,101,75,224110,62521,161589
db1f5c8a1243c140a5359738c21af870,74,61,91297,26970,64327,70,64,97569,22611,74958
58321752ac2af463268f1ecf30d23148,30,24,16363,4992,11371,28,24,9596,6929,2667
41e05d578bffd991ae85a5283d2bf265,126,111,484393,76279,408114,138,121,586582,145254,441328
c3b8917123ea0ae54198223794b5e5b1,52,42,75578,21152,54426,58,45,67886,21319,46567
d1f4cd35423ff5d4fe3840a34b4ef225,94,74,169846,32600,137246,86,82,145712,52029,93683
05e63faea82701bd79dfcf149e0c68a5,19,19,8166,2747,5419,17,13,9503,2709,6794
9c1f594f5df9babf0c5e15542a10fbfc,181,125,595687,152861,442826,175,115,591769,146143,445626
7a47dee84fd89b8ce29cdec50bebc1d1,108,91,225920,89031,136889,117,94,255879,67837,188042
c0352fb46f5854246eb952d63eb0a013,187,154,891377,129301,762076,233,174,1005761,146087,859674
95f357aeb1dc54f30360e0475fb0c963,30,23,18648,6713,11935,32,24,20048,7750,12298
05f51ef2120f3ffb02d2d8936fffc087,107,92,224468,61166,163302,102,72,275879,62286,213593
4cc7114c5f911f2cfae85dcfc4eb0021,133,91,268985,64799,204186,117,83,282248,77378,204870
70e9733119f5c183e792e6c517035782,80,66,111742,38472,73270,78,59,114754,29929,84825
0ca3d87438690ab9c9c5d02ae9e7b76b,171,132,465500,85430,380070,139,112,356070,83523,272547
219c9074a09c03eb1d0bf2b200764376,84,69,121551,38580,82971,81,71,153492,32800,120692
df8ef5af6d5d2546170c07bc41d40840,88,62,191592,39972,151620,97,77,167872,41627,126245
caf991b25970a365ef2a68a935dcc12c,143,109,443855,112400,331455,147,129,504716,121325,383391
c10b45e9af9ec90590a95c05838637cf,172,147,674100,112058,562042,189,139,583660,110325,473335
0af683ccd33870cae5f170da5a93f84d,144,117,499377,88022,411355,172,122,607258,66836,540422
82df82a3cc142895bfc8c47d4cacb4e5,83,63,151868,35616,116252,68,60,115384,38227,77157
5f97d90e98f571043df589f770b085dc,27,20,9814,3014,6800,25,25,7646,4941,2705
473307a38cacdb5b9b759134367dd761,83,63,186091,60571,125520,121,91,248131,75602,172529
fde7979388f636783254c396629e11e5,70,51,114190,41322,72868,95,82,155478,47056,108422
03bfc3895b7f58f921102001c539feb3,110,77,131031,33876,97155,74,55,95231,30735,64496
943c51f4c066bd133d9385fbe0ab925a,35,24,25705,5737,19968,39,30,30007,8481,21526
d2baf2c57a23ee2f34b75a78ef4e37c0,111,90,145775,38594,107181,92,69,119355,33394,85961
f5ac861dc59eedb3c9a2d8cfeda7fba3,58,48,59906,26376,33530,69,60,70766,21142,49624
0287aeb377e206198515457045996dd5,72,67,169223,46296,122927,136,121,275905,54548,221357
1ecde214d317906025337ea147ba902b,49,46,72022,27173,44849,48,35,62544,17447,45097
5ecefc5011ec2f159ff9b773f9a28af8,140,120,370164,79218,290946,129,98,269439,71741,197698
a8c3664060530304f98f1313f4c191e9,109,78,231754,60315,171439,164,127,386217,49596,336621
b51a6c2b91e2062d153980908948fc44,73,66,194603,41204,153399,131,95,247071,53556,193515
dc761b52811e815e0b9ffdf7f2b4c1bd,67,42,92375,27141,65234,76,60,141177,33365,107812
fe994d07f35e7d72de7208d2b444d53f,94,81,217912,73658,144254,142,121,320617,57067,263550
daeba0e7af074d714ac587b388298658,181,144,606809,111598,495211,168,130,703608,103613,599995
3371b27bbc0febd218bcbbda43c1b15e,23,15,6416,2228,4188,24,14,5602,2446,3156
8040fe2430f52215ada516f156abd1d9,177,128,553394,67321,486073,163,112,340446,72385,268061
b288b45b7aff875237a258bce74cfa3f,214,133,1023806,165177,858629,137,116,609066,173646,435420
ceec514a8526b8c4123dc45f6343c5d0,121,88,302980,74389,228591,153,116,348226,48144,300082
fe8f3cce532dc9ddbd7b819fd95ae584,28,26,13612,5759,7853,29,22,12074,3894,8180
29be093edd25d48414a4fde86dc26572,3,2,774,900,-126,3,2,904,474,430
448bae7eb191026549ffffaa86f88f58,24,18,12325,5737,6588,27,21,13838,4834,9004
68e3608521bb9a7a746e0a570687669f,143,113,442591,98919,343672,178,153,755135,176179,578956
2ebd448323b1b19e34ed5fcf83e53e3e,114,94,224310,47260,177050,88,59,181274,45317,135957
996bf95d3d08593ded6cd9508799397a,89,66,149969,52432,97537,82,45,140723,26781,113942
62c25335b38a76988ccd0db24d03063a,29,21,11916,4563,7353,27,19,9109,4012,5097
e512aa754b7d741dc60599c65ee6395a,141,94,333386,88689,244697,171,104,347933,69917,278016
b3db3baae918a46cee6a1052bb40356c,128,79,318631,61717,256914,126,93,314550,66759,247791
0a3a0b26efcc5869098e8498a983c17c,131,107,360837,73331,287506,121,92,332878,88544,244334
7381f61a06fa0338af33564b71e10864,86,73,139782,39720,100062,117,81,252373,30603,221770
12b5f27ef38ad9cc7a95049ac2c78613,130,118,277028,78097,198931,140,108,341855,64554,277301
5f84238a75c81b6d27cc0aae89a6cf53,139,97,267080,55076,212004,98,74,199084,57618,141466
51fe562165f6457c2b34a904835ded1e,160,105,563256,167924,395332,190,129,785287,183207,602080
11ebf347f91fc5a9f5c5424137f884e3,73,52,94439,37684,56755,66,48,69672,32400,37272
de7f0300d075628974f48287e841bb5e,203,120,867689,149554,718135,195,114,967321,146477,820844
e21dd5d232c69aacdeb7551b6f7dffa1,96,74,211487,41421,170066,103,93,221423,58420,163003
de5408f5fa7578c09765e1c485551203,93,77,250000,47622,202378,148,115,281168,63936,217232
413bd96d2b57de2a704ea46fbfe27779,137,97,647864,102655,545209,195,146,786260,146483,639777
407888db3735b3362c4653302384254b,1,1,118,41,77,1,1,41,118,-77
16bbccd13eb4a741291a4b94348940c7,129,93,282051,52687,229364,96,83,187390,72987,114403
689b7f071cea687f7217f8f3292a25b6,27,21,16247,7634,8613,29,22,21068,5295,15773
f61b8d75c9c3487a191e1b512dd30ddc,40,38,49007,15947,33060,35,22,31191,9251,21940
f1793bf890baf54720080c13eff6508f,60,51,80743,21708,59035,73,50,72057,19292,52765
da54e1b362e31eef184561506a15fef5,66,44,79066,15362,63704,60,46,70788,21221,49567
b1c302b7e09f05adba7f605332f20d2d,105,70,262248,73611,188637,100,79,255096,89823,165273
83f5100711da5e09cd5a390d7b168cf5,121,90,438894,122696,316198,231,168,747607,134326,613281
b7953372228ed6713c37e8fd4c9e1e04,140,92,285395,46368,239027,151,93,282095,49264,232831
46c43592cc926d9e20069ea865b15d84,101,82,223518,95015,128503,180,136,476153,74173,401980
39cc7e6e5579c9c7f5dac0485bfb786e,182,145,722860,307580,415280,216,139,890425,178193,712232
f94a12d7362d2c42d96fd1be2e522f53,126,89,589667,124663,465004,202,164,966987,126658,840329
92077c30549c5b5047653d83dee20030,163,125,360532,87980,272552,124,91,316082,69313,246769
7e9de418d26259d0b7d57ba47b99d947,205,129,556938,64032,492906,170,129,484244,79334,404910
1bc2e86fa3029b10d267cc94f5d25c03,172,134,664455,190697,473758,171,123,646330,190867,455463
0a5e808d714b03bfaada2f0d3aaaa335,18,12,3465,1513,1952,21,15,5952,1806,4146
de43c694fd909303b08e9a77ca6c45b7,117,75,283259,90949,192310,150,124,509003,94655,414348
c4c6eda1d63c905e30d608cad3e2492a,132,115,330990,52722,278268,158,121,386964,63495,323469
3179e700fa17949183354d6dfe3084fe,41,30,39581,21045,18536,54,40,91475,15014,76461
d915845c17fcbce1313d31678a3e6079,63,44,56358,16332,40026,66,55,67538,22333,45205
3c4ca2bb3d5048c6d085fc8668a0cc23,16,15,3713,1414,2299,18,13,3475,1724,1751
2b07d5bcd938e82a9b2932c98afea5fa,65,52,73377,18749,54628,78,57,96262,18022,78240
6d5ed8e9679572bcd8e51c779da4c181,178,129,559369,138887,420482,175,112,602310,178019,424291
4bddd8870bd21d0ca1d423eef914096b,30,23,18868,7031,11837,40,35,27470,8132,19338
95b1e9e9b2026b1d60f972bd292e9574,127,111,305601,98804,206797,123,89,297142,86071,211071
8bb679b0691cc8a307d77ab00c456451,151,100,268480,43447,225033,113,96,203189,61933,141256
dd045a82ddf25d6b37c996ff6a7e4e8a,36,24,34340,11370,22970,29,22,28396,9516,18880
898c51053e819f735646394650bde71b,49,38,38668,12961,25707,51,44,42937,13954,28983
be325cb1ae57603c7a979a7fefad8959,54,50,71941,21988,49953,54,36,46282,20434,25848
aeca28bfd6625f5dd7582869919f7ece,38,41,35642,14425,21217,39,28,30222,13488,16734
de2a4d6d55df2692aac3e498ab471ade,138,110,381785,91983,289802,133,113,473850,92619,381231
f079fbad973e3ec6fd507f6d77a0291b,90,73,121357,34822,86535,88,81,155080,36819,118261
a39b311a0897e38a8be95a8b85c7282b,98,84,199430,58867,140563,93,78,180548,63239,117309
82731d5b7a64e9b24e668364908d3a0b,81,54,107248,22634,84614,75,56,96835,25488,71347
d01ecebac8be0102e66c3815a8820a5e,66,45,73382,20009,53373,64,34,112555,16033,96522
72eee36738becc68ba41426bb8cd0721,168,135,573259,130354,442905,148,112,574759,129124,445635
3ba660edd6fa8f234961715d7f2604db,106,83,318156,111763,206393,158,120,720546,94256,626290
ed43797c7dea3f3c04d5ef7c42a42f0c,175,122,589081,121257,467824,155,109,438774,107288,331486
6c0f91b6c333820c6fa0541f4bebe5d9,33,23,16501,3219,13282,22,20,8853,6586,2267
b7af3236bbcd32975fda35b2ccad18ac,37,26,39372,9716,29656,43,30,45429,13663,31766
2da04c25e22e85c03c409bd0bdaff601,40,37,35613,10614,24999,39,27,25925,10694,15231
2811f26681aa61b9b0c1b9a84c101aa8,137,94,253416,43929,209487,83,72,130873,51879,78994
3e8acfccf58a4b893eab2b9aa7f6aeaa,148,111,322790,97100,225690,180,111,347248,77498,269750
57fa414967e267704e67b372f17c0130,115,70,144683,22042,122641,59,55,106852,27674,79178
6a7f3c801a7b460291d6232cec836a20,72,54,146415,41090,105325,67,54,104718,39683,65035
7d9d96ebd19bb79030a1148d1c174db3,76,69,102971,42060,60911,61,54,94828,41030,53798
4aa38804805a2c90cea2115dd4966573,82,63,152514,39796,112718,77,51,103319,21769,81550
f1c3575266029bf82fd11ee878a2df8b,47,37,37293,10824,26469,37,29,19148,10108,9040
883d4f5b031a5485a4da97947ed5095f,85,67,186391,36504,149887,120,94,194651,47109,147542
ceed4521c0d07eada8ff788638e7fac7,43,27,49977,7780,42197,29,21,20201,11102,9099
4e0b2d8a095c16af25a9b58fce007e02,63,35,89739,14931,74808,84,76,96754,30009,66745
ee0f09c5a7e54af632c841ebdb563722,49,34,66012,17554,48458,50,34,82446,20259,62187
5ae92c85f7869987eeb8f82329aa8387,121,84,370524,115864,254660,133,111,287002,128335,158667
120cc73cae9d051b688afaaf73cc1885,54,47,84566,23044,61522,73,45,67164,15792,51372
fd6ff841aa9679ec84019e71f2926867,77,58,79553,32511,47042,69,60,132225,29964,102261
1a8ea48945e2b7130614fdb8578976c5,67,59,131728,34426,97302,65,48,138200,22047,116153
bfeba0e29464bd3922b07557f706270a,104,74,234021,85819,148202,175,137,422408,81990,340418
0def225e64de08990371620b710111fc,34,24,27224,11051,16173,28,21,24816,9047,15769
49218282adefb1419e0e685f55c2c481,106,69,299775,70486,229289,149,131,381278,85245,296033
157faaee3ae16ed0fbef6796c8f18264,157,113,288667,68958,219709,86,69,178584,53572,125012
00612295d26660f91bb9565467c080b3,116,87,263592,46774,216818,79,64,118822,55800,63022
18f5b4e53166a044a82ec01bd97a8d3f,44,38,35625,21801,13824,47,44,46376,16279,30097
d4084e6a3e7b8e95472ade97933dc54b,30,28,21184,9151,12033,38,28,26188,8671,17517
c7f83785fc0a4c6441a203e337929be0,76,66,102375,22761,79614,63,44,52354,19799,32555
83a2d9035094260aada14ad3173e980d,58,41,50606,14112,36494,48,42,62738,12172,50566
96da102536e836d07d13c0d2bcd0bea6,30,21,19894,6847,13047,28,30,19757,8513,11244
1249768312a9cc9267041b8ea451f87c,75,62,134475,34292,100183,77,48,111250,28779,82471
3ffaf0801532ff408da7ccca0a86d7bd,2,7,301,479,-178,6,2,469,301,168
282dc2d7a2fb8ae7a37bf9cae4c071e1,27,17,12216,4366,7850,26,22,10330,4716,5614
da1a981ede6b75f8318ec5bf9ae88d4d,134,110,550834,115174,435660,110,91,400048,151513,248535
84ee70003fc06dc55610202bbd1f7c15,59,46,52847,17584,35263,85,48,85261,15258,70003
6d0171bffac5ffa0b9f19b4469da29ba,158,115,445573,83837,361736,191,144,545705,127417,418288
8e37a04315dd715acbda2651b85267c1,47,39,39769,14460,25309,26,26,26432,13264,13168
2a478f98a0a9c55995b593feafc9d3c1,104,93,198450,52575,145875,120,89,288956,46477,242479
558ccb7b36ebcd2676a21d94c98c03ed,49,41,37512,12643,24869,44,38,28811,13765,15046
8048c08f249ca62ac3c576da9a3071d4,168,125,602290,101013,501277,148,105,623175,138817,484358
3c96d20024c6a5a795da260e15c92274,93,58,191394,126381,65013,178,89,306877,90659,216218
bb9c93db72627d7bd3167c143627c4b5,80,69,106686,38029,68657,98,77,158499,35043,123456
561d5a14cf74a10fc8dd61e2b9952973,179,121,770621,145205,625416,171,115,627471,145618,481853
d74f1a1361ca87b79fe5600d63076677,78,57,79049,38621,40428,83,67,126314,31024,95290
e843d0acc542a3793d524cb1537749c1,93,71,161602,42959,118643,110,86,196307,52110,144197
e968e7af6aec2ce0f0a95e17586ec593,74,68,150885,54422,96463,78,66,151860,54173,97687
ba409670acf34dd0f1bfd9a03fe67cc7,86,68,150693,43582,107111,104,89,179728,42872,136856
81ce063d3f0618125becff0e8e459ec9,16,10,2258,2031,227,15,7,3280,657,2623
40bde44f3a1ae322dbe0679befec46d5,176,129,657574,119141,538433,197,120,614087,103646,510441
16da1a45bd1ab7776fa2aafbbae3eac0,25,17,12213,1170,11043,17,17,5633,2659,2974
1d2067ad42f0b862a8e8deb66f304423,41,30,39258,13105,26153,43,35,32399,12618,19781
4ec3c4d304531afa48f21f35e908a874,148,118,434435,108698,325737,203,157,578898,104607,474291
6619f63d1d70bf12b18d900cd69d1c4e,106,79,217060,63705,153355,109,88,261923,46485,215438
31e8232401fbd13bf0992e9bdd27335d,99,73,170308,29128,141180,111,101,158453,47153,111300
1ba1aa14299a511fe7392ed7cb902404,78,69,139818,40668,99150,96,75,213656,47615,166041
def1bc70d2e72777a7613c20ced75b71,66,60,85633,30434,55199,73,53,110770,36087,74683
15aa18ed1b855e86c0fd959207aa9e19,74,55,147269,33124,114145,50,43,86336,46494,39842
8f93ed810a6863833b77f50e78528033,83,70,135692,42270,93422,98,79,133636,39458,94178
f0a4c0ee09588b69eaea47d73c8c0733,88,58,130288,30809,99479,81,63,120062,39439,80623
2c3f49c9f9040c6459c2403b09c5a174,154,101,457128,90960,366168,168,113,517211,77820,439391
12d18c7f4e1ca7f96790ca96809ea772,107,79,189591,44398,145193,129,112,252821,47755,205066
d4b48686796cae0d60d53b8c9afab44a,149,110,477030,146406,330624,145,120,571977,147113,424864
d64509d463a011f5c12d946ddcb42f19,141,110,579289,147499,431790,208,151,760119,137363,622756
0760e4ca82ccd36772ea281278ea6a6d,103,92,165145,79835,85310,97,69,194514,53829,140685
8573bfee212c02523b2da3a6340847df,83,71,147941,34080,113861,66,52,90573,30846,59727
db6e806775c203f2c8b8d5db9d75b608,112,86,239304,47009,192295,110,86,255231,53932,201299
04f5b93ee1be907aee53a495448dd1b4,246,155,2105942,251969,1853973,273,185,1647376,391638,1255738
28798886359e78850a58b241fa3735e6,33,30,34192,7950,26242,38,39,38771,13614,25157
0dd9326e4021141d65ec2817588308c8,30,26,12872,6921,5951,21,19,9207,6898,2309
3ba0cf78616397a8e7bc5a4fe718da40,40,31,40996,10639,30357,40,35,46196,16482,29714
6b673a342a6dd787fdee909fa0e400c4,67,54,115262,34899,80363,90,64,145698,36276,109422
7ea9773592013072ad989d7e0056f6a8,28,23,14675,6169,8506,16,22,11852,6069,5783
6bc2eafd7cddb18c2542ac8a9d6a9301,132,124,250072,53104,196968,131,100,285637,50910,234727
b9869849693296c6e1b3394c1044a2cc,102,89,210472,40823,169649,99,61,139601,40411,99190
6b30d67909c60c25771460dc2aa9f4c8,92,56,199385,39211,160174,97,90,176192,47989,128203
050df0e5e3d99bf70328484e08519c59,19,14,6071,2379,3692,18,13,6065,1810,4255
26fb747fc10f19943ef944bc092c6af6,92,79,179518,52903,126615,91,75,171056,48989,122067
eb46d1fb9da20d014950c0988a407646,115,103,275342,44648,230694,101,76,187015,52518,134497
b31d3d425f267524e780005988273305,98,83,251679,68571,183108,113,89,263773,62630,201143
3fde3eb9285537d49b4deeb8dfe265c4,136,123,349173,71751,277422,141,110,307827,74829,232998
0c50c8925c4e331bee31788a8936874d,73,41,75780,26282,49498,96,72,173713,34017,139696
9ac7b9dd6fea1c63c3e3973cdefad390,128,98,315167,75239,239928,124,84,350092,72610,277482
02b3ffc39859cd33a4d1e40668bcbba1,141,114,346583,54411,292172,158,126,397650,40890,356760
a43ff462e92dbf6bfe8cdd2fdb5c2335,122,98,272073,64129,207944,109,84,274564,65503,209061
716676607bc1171a2306c03a5417130b,125,72,241306,56050,185256,128,100,295624,54287,241337
08f38aca9cb238f7697d172547672004,61,45,81372,17376,63996,84,60,70563,19259,51304
8079e2cd444280e44202f3263d2697b7,57,44,76227,18845,57382,51,40,57320,24082,33238
ae26aa90f3cf7e6d5e1ad81c70d8ac1f,16,13,2771,1095,1676,14,12,2586,737,1849
bc4ce843a381ea145cfcb8c7135a84f6,30,25,23242,14145,9097,33,30,27134,9961,17173
dff6c0454113fc45a054f4cd92c458f1,113,94,231338,51254,180084,102,87,171620,73670,97950
818ab1038c1d6d35d21e80eabe6dbfba,123,89,264756,59884,204872,125,105,256444,57354,199090
3c5e8ab6a3bfb6b7ac4e8341633485bb,66,50,80374,31454,48920,73,54,92618,34270,58348
7e3f8abb8828a0950483ea3ea5eda001,153,102,702322,93193,609129,200,140,779840,110282,669558
905db6ebd05487682d28badac6d23bdf,12,7,1389,656,733,12,12,1024,742,282
969c8c1e66ba91bc3956cfeb2b3db8b8,23,17,20312,7251,13061,27,20,28343,4819,23524
abf205b26b91372fe72ef40288571bf0,27,19,12041,3694,8347,21,21,10523,4075,6448
9ad78490374e272fccaaf296fee23677,75,57,104408,31251,73157,64,49,81472,37632,43840
960d77ad9fb0439bad85e1b270c52427,176,120,614063,132787,481276,189,135,877163,106716,770447
25ddd7ba8b459e907f8ebb89c21b47ad,68,50,101182,20001,81181,71,51,113128,21453,91675
499ea4809b5e64a9098b9611bb030b7e,152,126,472172,114517,357655,180,120,497297,101591,395706
b6c51024df36d33e01ff12ecc03cfadb,73,56,152794,57754,95040,108,97,246857,98066,148791
55e8c14ba0c5d38ce6a74c7d74044ac9,150,108,462108,74077,388031,173,133,533275,57425,475850
bf447b63d20f9579f7df183ddef27914,21,17,8226,2386,5840,23,18,5463,2481,2982
d55bd30d98dcd81bf8d7e2243cf0bc47,147,98,271440,57612,213828,150,119,278676,57738,220938
e99b103f4fadd82353aa35574a211a82,37,28,23416,8470,14946,37,36,18694,9957,8737
69ffb4ed337960190a44ffc5214613f3,118,94,233126,77450,155676,94,79,245855,72664,173191
739fc9fb685275de1626283839d02f12,247,157,1036710,103340,933370,176,139,624069,112743,511326
c6bb22794f13ae30b6a9dac5c913f9e8,28,19,23679,6480,17199,35,33,25714,8841,16873
2a61f9c520827c2a007dd5fb69ec3a9e,15,18,2416,1794,622,18,11,2756,1648,1108
869d41e75b6f0e1a95b89f6027484c6d,98,70,197050,75061,121989,112,95,219799,55744,164055
842975a9bb1ddd2e103c02a1baa2ac75,67,53,86488,22226,64262,80,62,133999,27962,106037
34a0976bf85aa6d2a215529ac7a4e41d,81,66,207448,45135,162313,90,79,205134,57832,147302
4d76328262250c7dc0dc4d5373fde440,133,87,577606,141701,435905,140,104,625420,210249,415171
8d85c51fffbce965203ccdbc3df8d3bb,12,8,1662,1167,495,8,12,1712,1519,193
fc7ec5b1cb7958ba865cdb7541620651,89,68,108700,28674,80026,79,44,98329,26140,72189
737204cf793b72a2036b5eeb39c00d7a,137,125,568127,112479,455648,159,126,513145,123384,389761
b86a4219507a31f0543d2e95e1aa59c0,38,32,32103,18622,13481,48,36,39621,17381,22240
1a9fdce135b284e5d0f3dc662b2bf261,56,46,61148,25388,35760,60,43,71867,16461,55406
c98e48fb0f549eff701a186887aa64e5,113,87,259961,43452,216509,108,85,179121,54175,124946
c64680b01ee04f9f55374a856bb042f8,48,35,64063,22709,41354,60,51,67082,33363,33719
77a718e1cd8bcba2c1896df7fa674062,33,22,31707,14339,17368,40,30,54956,14818,40138
18846c3bb8a7023e55d40fda70456a4e,25,22,9828,5331,4497,21,16,11604,4074,7530
4b536a58b3df713fa2ea7361055930cf,46,40,22122,10790,11332,50,39,35669,10610,25059
f2711f3a8a0e48f904c4362295b8a88e,159,94,322348,91829,230519,100,75,304816,94069,210747
2d47b05fafde25085726d998347ede45,187,160,704109,67721,636388,147,115,360262,81561,278701
62d11406ee634308e6d64e0d9d19a968,25,23,12991,8164,4827,28,21,15836,5010,10826
c94891d182d5b017eed545e073b9df46,118,95,268504,38819,229685,100,72,112274,37271,75003
e5e900b927734f0f4ba0070c13351bc3,70,52,100813,32444,68369,53,43,84488,24972,59516
b24ed86ee142dfeee85f1530937ef37b,126,91,288378,80291,208087,102,84,210920,93592,117328
9817109afc20541e102f0643cd834e54,64,49,79458,23891,55567,76,59,84200,25352,58848
db8ded3530dc7501e70134dec22fc8f6,34,25,26748,6996,19752,27,24,34940,9131,25809
e440f59bf9f2caa8cb82ef81ff303ad5,42,26,30534,7899,22635,42,40,34611,16935,17676
d2e65f63cfbfa966f819f0cb98ed2453,106,91,195900,59207,136693,103,95,276163,58552,217611
56e3e53dd93bf41adec9b6d13fd9cbbb,21,13,5290,1956,3334,15,17,5442,2523,2919
8c20114220f133c435a385dee923b620,162,122,751733,161781,589952,240,169,850657,148816,701841
033481e12571fca6112779a71af2d5ba,36,32,62598,11538,51060,44,29,38716,16066,22650
506fd451647cd1972b7067b60f9003bd,123,101,267489,71768,195721,145,108,290247,72452,217795
55770f07a084bc2cfc8a521e1ee4bae5,125,76,335600,64649,270951,194,138,527392,68200,459192
5da8938198812861a984d08911b03f90,147,127,353027,94522,258505,173,129,391227,85083,306144
4ac3023b6bccce10f793dfe6c8ee1a39,123,98,305831,68428,237403,165,115,427509,80864,346645
48c06e3ed9fffbbf0f300341512240e4,86,64,161201,66868,94333,156,119,361054,69929,291125
d0adbf3b76bdea552407e64c37dd1814,116,81,230593,39896,190697,77,49,125215,41598,83617
f2df7d9910f73cdcaad36ffcab706887,154,98,431940,69882,362058,165,96,405600,54357,351243
46c9e076b8ed85783c285c4246f2a8e2,16,13,4664,1056,3608,14,8,1915,2017,-102
b413226bce62b446b924edabf3f9186c,107,69,219131,45801,173330,83,62,167601,49018,118583
215563c04f41511585fd198d2d7561ca,88,69,194584,75048,119536,141,95,321312,54916,266396
bfbfe5543277b3a7f22db062e6187bea,269,166,1089570,175111,914459,208,145,846599,161937,684662
9598a6c433180991b12bcab796ff0dbd,103,73,153975,34145,119830,94,70,155204,39325,115879
ee4bd98cb4bbd48a061181c82623af02,63,39,102834,24248,78586,72,61,76907,32412,44495
6e3f0173c1c82d3172cb0b734630f1d9,90,63,152676,48711,103965,79,55,148231,33851,114380
0916fa8673cf2cc9dbaba26a32330916,217,145,1097207,246808,850399,230,148,897091,196970,700121
8731f6833be190f2dc3ee7d273b93150,164,127,733791,119267,614524,160,135,565014,93327,471687
c32ff4a8adc1b37311b75ab426436338,37,29,15562,6875,8687,39,23,18691,5136,13555
516cb6cd25b6b78f4b5fbcbfe27bce3b,146,121,378575,94831,283744,183,108,439237,62507,376730
65423dc3299e1ef394adc1df4e1bca77,157,105,379549,76224,303325,155,137,342766,94106,248660
2a06a67754f5d4cf60a6e765670ccbe4,98,61,239961,23587,216374,88,69,118780,50348,68432
7f81f970e87fc9c322fcf09fc7e6dd14,52,31,38135,14171,23964,46,35,37319,18289,19030
8f2d11065b8e98b97a01217f97880ca7,86,77,194813,41947,152866,98,70,174952,36560,138392
1e5a6aa39b99c97d537adcb93e9d97d1,137,110,602907,138248,464659,168,136,669086,117718,551368
2ee1c9cff980467fad5786c083a4a1ac,50,36,47975,12014,35961,39,36,36621,12247,24374
48db6cc7ba80b5c76c5f5f1a8a1fcb41,136,79,201730,68227,133503,147,103,255361,51974,203387
0cdc8be68a541d6ed6e5f5f84d6f357a,116,76,282891,71740,211151,105,84,231417,66225,165192
2447453c02a3df619cb9c39e344bdf58,25,22,6463,4033,2430,26,20,7925,4313,3612
422dd35273edf9332c21af6ccfdb1c4c,198,115,904333,213627,690706,192,166,1216433,269737,946696
61fd4cef01c40e2275b63be645a26d1e,60,49,76379,21295,55084,52,35,53791,20075,33716
2c7da63bbd2b95ea70f26d049441808a,26,21,10593,5021,5572,24,21,13341,4088,9253
05dd60aac70d52bf7cc1ec24703b925a,152,114,615148,149004,466144,195,157,916185,129700,786485
10a09afcc4c0be2ac8840307a278203f,130,78,280710,70473,210237,169,116,372759,57669,315090
a423cd54a1e7d9c8de1dd85c46debf13,28,21,17608,9881,7727,36,26,25844,7863,17981
98fe1a61c2c241312aabce5dd470913d,69,52,83874,19816,64058,68,58,84639,26774,57865
c3da09166c569e22f30a931b5f92755f,28,25,10366,7592,2774,35,19,24437,4040,20397
2e4b2460050250f527ada0dd388f3d9c,101,92,228689,35521,193168,68,56,146609,45394,101215
ed3bbd2f0f38dfe67b3714d19103eac4,155,115,607270,97522,509748,163,136,518924,134143,384781
19999fa320a48efc8b80569d3bb3a988,21,16,7728,2134,5594,21,18,5594,3422,2172
32dcc817362cc74a5ee63c47f61f2b36,61,43,139082,44077,95005,81,61,181406,57233,124173
a6e2aaf781e1097fdc7e19be59026c87,115,93,191046,44592,146454,91,71,159529,35729,123800
1289b7eb46149eeafe01738230951705,18,19,4511,2633,1878,23,18,7774,2808,4966
869cdf191bd40415aa79b45ec2918480,69,46,74805,17839,56966,78,51,90009,17325,72684
e28bb03bf53e353ca9a97c0d2f4677bf,58,40,69174,15364,53810,62,49,88885,18875,70010
832c12fa6685e7b4f72518535b9067b3,46,40,61000,22653,38347,49,37,60826,14471,46355
1b27458c145b78cd9744d55d9fa5cc22,98,89,190550,38574,151976,100,84,170458,40510,129948
704ad0805fc32849e4865c5217ee8c52,44,37,62239,25294,36945,38,29,55456,19832,35624
046f452fed55d0f25af9a62ee85ce906,196,133,950976,174110,776866,254,202,1262032,181769,1080263
dedaec362eb1d13d3c776870189e8b66,126,87,251191,80915,170276,172,122,393634,82333,311301
916a4dee911be85b8ab05880c35afb5f,67,43,59872,16278,43594,50,43,66775,25265,41510
6e99ad5647132871dc711c1ff8a9cdb7,210,148,1084188,290860,793328,195,148,1029703,193337,836366
96301e2f7725f2dd0ae9fbc3a612fd24,35,39,39340,19902,19438,37,28,38582,17398,21184
17a3d3900c34746a44a7e8ad0b823620,130,108,447581,107851,339730,195,146,634811,106730,528081
c840f72bd6db6ef15d539759870d7023,174,130,805819,160860,644959,197,137,588032,174581,413451
8166eab9d2ae427f06f53d144a7acb4a,52,36,47513,12627,34886,55,41,37723,17867,19856
621fec2076ddbce055ece668bbca2ee8,117,105,237968,48317,189651,122,94,245549,56236,189313
951fe428d3c17ac14f8bbe7e10e9eed9,128,85,273478,48499,224979,124,97,251799,66365,185434
d214140d5d06aa1281263c87528e3039,17,12,3680,2708,972,17,11,6204,1512,4692
faa83a3508ccdd98e905cf4a564f7ce2,206,136,933111,141712,791399,240,162,1166614,181989,984625
4b6b87d0ba09bbbd3d183363ef7efc89,132,85,275412,46236,229176,122,103,282720,65418,217302
a7840994fcde167465d08f512abb40db,138,102,294571,49733,244838,115,90,200757,52266,148491
2df1f63ca96a023a9506e8e860cb2730,28,23,5748,3699,2049,21,18,4389,3046,1343
e4956cd94568f25f66927c1813283ccb,124,93,358553,86150,272403,155,108,447936,81052,366884
a6c21da2781870bb01adf219899c7136,123,107,299585,80678,218907,141,100,343008,66991,276017
ca42b8beaff70101cb79c7e1d960d40d,146,116,399093,104150,294943,178,117,391697,58601,333096
1f874260cfd342a1596b1c971971d715,19,14,5120,1553,3567,18,16,5259,3011,2248
3324702e1b445ae3eac3a5c2bcd4510d,108,101,271174,67265,203909,89,80,184124,50605,133519
23720b5dc2e4e505f164cc39bc0d12a2,112,100,259198,75418,183780,121,94,221904,71471,150433
f0421d0c945f6e39c413a5b6754d49a9,164,114,464948,79958,384990,173,118,643954,69959,573995
3eb1b80348dec85754c63ce6d2047ea5,46,36,53743,18970,34773,41,36,49880,15830,34050
4a1d580d029ba8113112c9242761dda6,87,73,182322,86125,96197,107,78,292353,50398,241955
24dd97a0c5e20e1b5c232a9fa551d6d6,40,39,28564,11065,17499,52,37,30778,14118,16660
86f2f705a718af979f59153fb7ab453d,120,91,273518,62992,210526,107,88,218167,70877,147290
226dd9e2630d5273959906e4d039daf4,150,109,618928,132801,486127,228,160,847490,162183,685307
d449185387941de4cf830844cb594f46,34,32,25042,6697,18345,27,22,13808,5142,8666
f3e74c3e320dbea253be6c70fe696c25,165,121,314573,79681,234892,131,111,330183,71608,258575
dbc5c2372ac9df75d9b34e2a05e2fc18,148,111,652759,172318,480441,183,135,876730,146760,729970
6a21def9e6d9366ffeb0c1217c2e48e2,63,41,58318,16647,41671,44,43,45800,18051,27749
9274c5531ec41adc9ff20597873ba565,131,87,239349,71697,167652,155,113,293431,75495,217936
65ed9675b56773649e6e79566245ccf2,95,79,162007,56899,105108,78,62,190512,37553,152959
4540666c61cde6fc0e45f84ab65e0d6d,57,46,73662,24347,49315,49,46,70906,22177,48729
37bbd352514784d7b10e4c973eb717b0,100,79,202739,44333,158406,110,77,188345,39902,148443
67c36b65e07513be72af45270c4214e7,34,25,21330,4661,16669,27,23,12054,5480,6574
642eaabb4902974772c765db69ee1865,29,25,17901,5285,12616,24,21,11551,5999,5552
0ac23a960a79e568bbc64568b147eed2,104,91,213798,73008,140790,120,91,236969,60372,176597
9533b6e9251e16f1a19b11ab90af6a35,75,65,117869,34381,83488,94,72,165963,36292,129671
b407ee3b064a7853ebfddea9d9ee93a6,134,93,346537,60064,286473,143,116,351362,62062,289300
0bde9db3bf1e6f8508b7404a4f004daa,90,76,161790,56798,104992,111,83,233050,48815,184235
e0395c3d619ef9c736d778833c4100b9,24,20,17201,8285,8916,29,25,15581,7774,7807
04612b903deedc3785943aeb88e926f7,204,134,744102,154242,589860,225,164,784460,201449,583011
629986ef93bc178cc33a11aac34a7142,146,114,362861,80797,282064,173,106,398623,84601,314022
0d75adc84cc3f9d9f1c574e43920abd1,75,51,91030,27663,63367,70,54,108406,26914,81492
7f1a6328b309d3c02f6f459e9df0be02,103,88,178683,32215,146468,96,78,127670,34408,93262
e8b40b2f7fdb24f94b632c0a1141dc23,31,22,25492,12288,13204,34,30,31786,14782,17004
fe494ff5ccaf03fbbbe0c2ce6695ca87,137,89,327199,58659,268540,127,110,325271,72618,252653
4fe86559ce40b4c7815eb4acf8e9a294,49,31,37702,20389,17313,57,51,77697,19746,57951
96133491b85e8fb916871b09524cbd68,64,41,147972,35917,112055,112,79,217484,38132,179352
2d3898d87322d12f89327a87961faaa7,26,20,9328,6537,2791,26,19,9771,6157,3614
fb206357a30ba0ae45ff9ae6adce5edf,33,25,16400,5855,10545,25,21,9289,3529,5760
370e7b5dc798046aeeccfad7da236dfa,163,122,625061,114039,511022,126,84,392373,106670,285703
122d40fa65056bef06ad1e8a1b2a6b7d,85,63,134012,31505,102507,82,57,133604,28476,105128
82de8d47815c75d228aa213a9cdcf12a,102,67,235839,67007,168832,156,88,306177,62765,243412
12978d7c3a965ae112911912dd343354,27,25,17543,7881,9662,27,22,11391,4985,6406
9219787c2b385ee29d01b3a163253639,99,82,113930,27115,86815,94,72,135871,27223,108648
711dec32479707a0320ed819e9180d30,69,44,49839,15186,34653,56,48,50181,26172,24009
80c154dc47a58cf65bab37c08c21b9f0,70,46,50080,27221,22859,61,41,92851,19130,73721
b3c30b48b3838c6b04619fad36fa4a21,0,0,0,0,0,0,0,0,0,0
eeed3b998ed3ab391e2e7463fb4138e8,21,19,5756,3722,2034,20,17,5183,3810,1373
93d03385ae26ac40ef5756a6570591fe,54,44,81029,41346,39683,56,44,99245,30538,68707
fe9ddef2ec1780a9d419dcdcf5ac1ae4,48,38,39625,12630,26995,43,37,23434,14771,8663
f0f4558b0969ad54b9b6acc9749db8a1,106,83,254700,64895,189805,165,133,455001,76854,378147
6a30ec9126c3104cdb22a4be6492a941,113,104,236334,32145,204189,121,98,177933,30119,147814
fd3f21f7c6555c37dd0853bf88924087,85,66,140803,31866,108937,65,51,95574,29958,65616
ff213d49414a5bf9a9d0959f24a8407d,36,28,19568,6409,13159,33,29,18380,9530,8850
9e6efe013c5f927dedc03d89e548d04b,58,44,74198,19140,55058,61,46,50287,16779,33508
a347b86e00ca4a8708f037512366830b,41,22,44774,10766,34008,44,44,41431,16346,25085
bc7e8065126a3bf44d12c09b978ebe92,169,130,746496,130916,615580,182,138,697446,126993,570453
190fa278395cbdc6e00f3e207224cabc,32,24,20515,7752,12763,26,25,14388,6728,7660
576b7c863647f71d4e202e39cce980f8,93,74,117528,34718,82810,77,68,111952,30078,81874
9593a3f11248f479a2db40176e47ce72,23,27,19026,10496,8530,38,25,38014,7289,30725
c9ed8212200488d39354d6044d39b08b,41,32,36891,10780,26111,40,27,37149,15299,21850
c4b18aec9182274102a23e6db472e6f0,34,26,21051,10992,10059,39,34,26627,9899,16728
9dc6f0c1471fcd8516bd57c56f1f19be,30,22,14180,7355,6825,33,29,21071,6941,14130
2272d0cd890e90e08a3cda6791181bef,161,127,564055,101102,462953,182,139,553982,109946,444036
754a150d436b7baa691f9b5aa25d71b5,104,93,207090,49178,157912,94,81,192730,53831,138899
a8dcb7a0730ab027fe1da292d63c8524,138,101,364076,79525,284551,150,115,487665,65657,422008
41552c7aa5d337a338e2e3053769bc16,193,132,436852,88875,347977,158,138,617699,143498,474201
1234c5c5d9d1ad2321534447dee4a842,30,25,26752,7946,18806,37,33,33752,10542,23210
2201116d6965215951b5665ef1c7e56d,135,99,222089,39752,182337,95,81,190329,49224,141105
511244ac5533a959b531537e6da5651e,146,118,474176,51097,423079,121,75,269216,68681,200535
00d4cee5c371ada231364dcf08bc6b79,159,118,454454,80990,373464,148,103,405321,70203,335118
cd23d8a412d2dd79092a8d788096f1ce,83,64,158060,31891,126169,76,68,156132,32458,123674
b56ea18db1408fc68263757232c1facb,86,59,131559,32694,98865,95,64,154506,25411,129095
77d2b4857033c53e3ad241f67aa619da,37,31,21477,7424,14053,32,26,18221,8518,9703
b741ea0afccc04c3f068f4cd72ffe10e,183,141,936970,218977,717993,212,155,831029,216610,614419
607987430f3b77c0ae42ceb0526328d6,42,33,30383,12448,17935,41,31,28011,10043,17968
9f526bbb18679fbe3a7099fb3d2fc0a4,53,49,79938,31066,48872,53,36,101750,27267,74483
19424f57e8c948cbb59c949ee700bd80,98,79,194953,53657,141296,87,70,219394,37306,182088
4945649be973b40ba6b5f95269e1a7a5,97,66,120898,30144,90754,83,53,98857,35649,63208
dd71dbe568d412ab5aa5e50e71d7df92,178,113,507928,127570,380358,191,121,532237,91462,440775
5ca236b9b890a0e1596bd03d7b566ff5,53,33,51645,13022,38623,49,32,30329,18981,11348
f83096327430e2eec104b933abfc7fad,62,47,68455,26801,41654,62,46,86827,24318,62509
14ff9e74a038cad2c41393ee8a55df40,70,58,108951,49962,58989,62,53,86450,36296,50154
51b930d4c6f065392b227ce96df538c2,204,156,614027,116616,497411,167,96,463958,99334,364624
e93d0a2330bf157545f1e992f6282b78,121,89,253356,45873,207483,145,111,336554,39629,296925
6457b15a82f9592bc779cc14c0c96885,47,35,63868,14478,49390,61,55,44735,22686,22049
8daa0c5756547e0a4f7c877ad4ea8d2b,72,57,142297,63336,78961,111,89,243717,53314,190403
9acfb9ac92fb53e63ae6a651123743a8,22,21,12189,5659,6530,21,27,13912,5941,7971
f74a02f4002ca03bc22d8104bf39efc6,132,95,428597,99042,329555,140,119,510285,109548,400737
32f2d3495c36bb1476faed1dc56d1625,124,85,235933,45886,190047,125,98,245276,62018,183258
298e300e93832356c5de5f13219840b8,95,73,203048,36181,166867,80,66,179758,44739,135019
a382bf665debfb590346d4c21fb1bb0c,0,0,0,0,0,0,0,0,0,0
add2313f5c96c0434fa825c09f0bba62,144,116,694413,86382,608031,165,133,509971,100999,408972
fce24ca089aae7d654f40c16d4c24b29,82,57,126863,32554,94309,69,56,100414,45890,54524
8dbc7d2b3b2533b7f7ac5faa3e934d8d,51,36,54235,22566,31669,74,60,68895,19582,49313
f40adc10ca1e14a4cfad38c8e41fafb7,85,64,162877,44160,118717,103,76,161668,45771,115897
1eccb0e3547ba0dc97ac2e8d73c6c1d1,50,25,74479,20466,54013,50,38,94030,21026,73004
3c0cd4e0163c634fae88cea406ec34b1,130,104,309272,60126,249146,73,73,165340,59850,105490
c4382945c4ba6dc270a24b743393918d,147,125,371975,56952,315023,122,108,297319,66229,231090
89f161ddbb5ace719fa20052671f86a1,41,35,23727,12315,11412,43,40,39918,14576,25342
8ecf3ce040ef51ac2d7549ca0dbba861,126,99,296021,94471,201550,134,122,392372,118505,273867
e47e53b627f56d6e827bdfd693b482f3,86,73,145335,26809,118526,138,92,286683,30192,256491
e82632f8140b88b9e3ecff25b56db241,129,106,453918,111062,342856,167,119,407642,129832,277810
64b692bbb60e9142348f0c5743a941f4,1,3,339,1126,-787,4,5,1270,1015,255
13e9bcc406f41da65c4490acde5ebc31,53,50,59928,21153,38775,72,54,79029,17651,61378
9ee3a6f5719738449ae3d0514d8a8d37,106,90,264833,52496,212337,97,78,192622,71217,121405
106fdcfac0c2ded724eb2d3274bb483e,26,22,11721,3818,7903,26,21,13463,5296,8167
dae79c3b3e490de5e8760955e0104c8c,127,104,278594,42778,235816,127,102,271018,58462,212556
43f48f14254ca6c46d515c872c0f4c60,40,31,43610,15460,28150,42,32,40496,13405,27091
fd0f070411e0ef7ea846ce08f3c9fdd9,151,98,344053,47122,296931,112,86,223601,63121,160480
c4e75c9e1944ab0b55c8e40c76a33d26,160,115,446878,57527,389351,168,138,412150,79176,332974
4fe850734418e35a3e22f688e766eb0c,25,17,11551,4388,7163,21,19,12822,5835,6987
3864395ce2c44be42746325e57426104,55,42,94564,16295,78269,63,54,90953,23312,67641
610753fd39ee6989d6187985054bb597,2,0,156,0,156,1,2,550,156,394
d2ec38da57da417786b4df940f62e9e1,56,48,110011,24438,85573,54,50,72381,22790,49591
d8a11d1efcbd27bec865a8d24542eeea,104,78,203596,44296,159300,104,84,193133,49436,143697
af1dee0fa4a7f77aab21744e23a8dd28,116,80,326031,72832,253199,121,97,285429,68637,216792
aa4d7f4c6cbd6dc67792066aba54bd92,127,101,339936,68459,271477,134,117,479532,57489,422043
9435433fbaec389d93d84e1f88b3a35e,154,114,499993,116825,383168,194,165,728059,143221,584838
46c416d1682afda990aeb86a11bc8be5,48,36,58220,16005,42215,54,44,72644,24998,47646
c1d8511c58ece0d1309187c53f149f4b,23,18,5386,2846,2540,23,17,4258,2938,1320
3f468c829c1b13323b8d9ef96bf0d014,17,17,4011,2648,1363,23,16,4561,2363,2198
df6274f2025eb81985fded21359d5711,63,56,61735,21375,40360,60,49,49907,21968,27939
ad819bf5a5140f0d7e93fc7c9bc1bb06,60,50,142768,52772,89996,82,61,171247,35641,135606
9345fe5d653e202a213758647d478927,134,96,291664,81655,210009,120,99,284296,71186,213110
d3edb565de9292d4b1b38f4373a0e063,40,28,31689,12902,18787,36,35,46391,13937,32454
f92b354597d5f849756ae87309f1baf7,113,86,284110,54912,229198,100,86,208897,88452,120445
5d217744a9e9f7738d8d6a58bad7f655,68,47,74537,30640,43897,52,44,73801,26753,47048
f4052bf84de5dc918b2cc3ad0e6410a7,23,17,5730,2598,3132,19,12,5224,1940,3284
d18ff1fee68b2d63312d090f130c9f5c,183,138,779938,131311,648627,181,142,620859,209915,410944
d464de7959de7b1038bc053a63aa64d7,131,84,276681,51787,224894,67,58,100485,77383,23102
fb6af18eb19002b0a6868a59a3baa282,111,83,304929,90911,214018,156,124,447875,89022,358853
e20807bc7936a260f7cf21fc32ae3b70,53,47,65271,36415,28856,89,53,114930,27894,87036
2356cec27419f5de07d9396a5e0d0063,98,79,224524,55469,169055,125,82,196720,53531,143189
dc4e250a2a030be5b9744707e5b3d77f,37,25,38698,16939,21759,39,28,55946,20740,35206
45b0f7512eb1681fea81a25ce7d67a39,134,107,364995,54486,310509,135,113,314360,72516,241844
8f1186ceda4d77b4092d3e2dde21b2ba,90,71,120930,43862,77068,93,70,129783,41786,87997
35dcc70f4a2f7049cbd63d2029cdb47a,131,109,446025,99107,346918,151,123,471826,169720,302106
527ac40766ad2d51a6718925ce9b1a4d,141,104,279301,72085,207216,144,122,321065,89782,231283
37cddab879519695164491a8a179f3eb,56,47,86703,28353,58350,57,46,73149,28305,44844
087df5988adb1cb2d0b545e1eaede412,151,97,294969,87822,207147,151,114,363434,82404,281030
a9661166bde584261f9079b7c45b2121,59,37,56991,20223,36768,74,49,81102,31730,49372
622ddd4e43019615a95d9fa7ad03d0a5,181,110,420208,85472,334736,129,111,300739,86433,214306
e668b7a65e2475c7a4209ab3651b9e2f,151,114,314236,53255,260981,110,83,246108,74374,171734
ca1178e5bbd3b495d674ef0478b2b8ca,51,42,76252,22523,53729,53,44,84298,20073,64225
83a134804ed4488b6b336b422532690e,44,30,36543,12809,23734,50,35,46836,14654,32182
7eb8850085ed1d7ad7a04c7c28b48514,83,73,198021,58888,139133,58,47,91992,52149,39843
f09501e0e25eba329017668fed9794d3,58,35,56547,13022,43525,53,41,52368,17229,35139
200a726b3a91cbb59d36930973bee0b9,57,47,75657,30686,44971,52,40,69553,27294,42259
e5ead2adc1dc16760ca37577fc62649a,75,56,131611,40425,91186,84,69,167895,31227,136668
a6d27d1eff5c472ef19716f9b4876e48,43,36,47272,19776,27496,40,35,52958,21852,31106
d51de2454e95e7d37f3b18280bda0152,48,36,61633,11487,50146,30,32,30160,11747,18413
7caafa033b19e97aaacd4660e4f649d3,32,29,16403,5768,10635,26,18,11267,4128,7139
c52400c06c7e8d0e0fe13ec54e31ece0,100,83,267843,86315,181528,150,109,364630,69593,295037
7301208a60d7fc5345d23c92eefe7e82,47,41,56982,24900,32082,69,60,89188,19716,69472
2e273d9154a25949bd3ecf455dfb5515,33,33,36784,15108,21676,40,36,30032,15060,14972
f13e6b425a7846217aa646dc94b5d286,30,23,14782,4237,10545,23,22,10891,3922,6969
640958bed77fa3c591f499c8de4cf52e,55,40,63547,24590,38957,48,39,77165,18760,58405
580948831e8d51f486cf2e6ee9803434,147,83,333616,79068,254548,143,100,299219,86817,212402
86198e676d1c9ccfe3d65011c0d62053,93,93,188166,50639,137527,98,77,221956,46382,175574
e57b88842858a58f4ad29e831f3028f2,191,149,546771,189827,356944,192,140,788731,96704,692027
ec45bbaf1c4d141cafc41bf8870acd3b,108,96,177193,51651,125542,70,50,109745,26340,83405
7f810524ba244d97664ecb94c99f0d41,103,92,193976,67845,126131,94,78,165718,42301,123417
4386126db3cfaf1417c444837aa7bd46,76,57,129883,28797,101086,78,72,105991,26318,79673
0ae0f75bdbe6df52741d2b3bb8516e01,120,90,357490,66532,290958,139,112,363674,60543,303131
2f2f9b1a4d26b1e3e3ba5c6356479861,107,75,203618,57127,146491,88,56,153969,47331,106638
fd9aa2d624869cb7bdb363070d7cc99b,89,79,165189,46151,119038,112,99,199391,38708,160683
c74a9c9195e50653be59936be0ba9aed,168,119,380175,105975,274200,114,88,321772,111894,209878
6db2ed0916219a661cedd181a4eb8548,20,19,7215,4378,2837,22,18,7074,3128,3946
2bf6ae6b92c29411980c56550fe6b714,166,125,351757,92333,259424,133,99,368909,93200,275709
d4e6ee7bc5195e99ac01d53c4823bf75,74,50,85908,31513,54395,79,58,141421,31481,109940
f247fbdeacbd7d1b31cad4a29c82de9d,147,93,365316,117791,247525,114,87,313689,120032,193657
11015644a7aa610a8b5a9848cc2b6995,169,132,842242,100738,741504,159,124,527577,119812,407765
f66cd1a4e7906f8af453dacd0ffa5976,148,124,374865,64729,310136,100,75,150639,54564,96075
d55717aabd3855bcfad2b32a724a1292,20,18,4158,4519,-361,23,20,9002,2868,6134
2d095ed2585409e4776833b1c4a5ca3f,128,105,260954,58281,202673,112,92,202327,60803,141524
49d3cd11cbcb68e1e8e210af16add1f1,133,89,305136,69309,235827,96,78,219283,85052,134231
3e942062b103c027315b926c63c74f3b,48,38,33315,18854,14461,33,31,36357,14174,22183
5a7b3a43116ef508f9a57fe2508e3db4,69,57,122531,40046,82485,79,61,137305,40756,96549
8c948e76fe4690b1aafb262d6f590cb0,65,51,64253,14733,49520,60,48,53316,25282,28034
abd7524e49633463349922c379f78cf9,62,50,88664,40784,47880,85,63,153355,36152,117203
8413a6f1f9ec7d8728cfd7db38b47f80,32,21,16829,4614,12215,33,31,15500,7194,8306
8a9be33637321658a9005ee050b5ec5b,85,53,101288,29931,71357,57,52,99701,37452,62249
e1471ed2afd51fb432bed6edc0100f54,166,119,753036,126022,627014,159,108,497974,120624,377350
cc419db39d140000ab078f7060064916,32,18,24411,6964,17447,38,35,35253,11382,23871
00b85496c3cb99533b9c2340b171655b,177,112,360753,76195,284558,129,83,259058,78059,180999
cbe301d4af058c2afdd4b6b9a5b18771,113,86,179972,47261,132711,91,64,147032,35189,111843
4fa5a9fceebcedee1d424e269ff9019f,29,22,22371,7607,14764,35,28,26043,10087,15956
df508f1b17583a01748275a2370116e4,41,28,38088,14627,23461,45,36,37566,14048,23518
daf2724ecc1652d639a2c5639a598eec,158,131,474737,78876,395861,125,110,390739,96121,294618
f5f9b90bb60768749e3103de7e37bd0a,130,106,345932,71746,274186,127,104,225659,98574,127085
9da8b425d892e8e89f6d2fc735b446c2,109,84,182841,41865,140976,87,72,129452,44284,85168
7451d509e47936083299b170af704da5,126,95,361669,60027,301642,145,118,372735,74041,298694
56dc066fe42e134ac72c8753a93e7d4e,22,16,7771,3013,4758,19,18,8725,5122,3603
02a3e67eac761ec1dcb7772d2d514a4c,63,45,77997,28688,49309,72,42,91725,19247,72478
a5a526cb8738add322b01d4f952c0506,49,36,44489,10785,33704,36,27,39456,8668,30788
e71376d706f5ed4cdf7b482f6db99cc1,53,40,68379,15345,53034,69,61,77878,26853,51025
c694830dfd3f80012dc418db6fb1939d,149,129,437778,112602,325176,91,68,274222,89237,184985
35123431e5041e802fab4f28a30acf96,45,31,47007,13618,33389,52,41,70063,17059,53004
a77f052db1f282deb3e18be06493ae6f,90,77,134590,54825,79765,102,85,164241,40404,123837
11a544fbb8b9c1b3a959b3c7d73b49d4,108,74,286109,56003,230106,69,54,142487,59075,83412
85bb841ac09e9942f598c69612345e32,117,93,264340,110493,153847,173,127,441012,76939,364073
db31698ace44b6c55e21315d50258a0f,133,112,406504,100200,306304,168,130,472955,111809,361146
b554aca7223cf03191d47f5ca67a8f7d,54,52,64293,27302,36991,98,66,96575,21902,74673
f26f1e5da7ff94fcb623d56fd8ffe863,25,23,13805,6512,7293,28,22,10508,7942,2566
40438a257eadbaf4a553ab22bbc6a614,42,37,54117,21732,32385,64,40,81458,19349,62109
c9a02edca93221361d7a4a43db70bd7e,35,38,39737,19526,20211,43,32,51007,16770,34237
93900a823f4ab6762789370c574c59e6,37,32,39499,10794,28705,41,27,33096,12583,20513
733b4b55bae7b5af5f90b51c87a07a5c,122,87,279662,62671,216991,123,96,316615,57355,259260
1497e0bd519c67f3b1d547027657562a,105,82,251447,48524,202923,93,72,148679,35026,113653
d34b1ad517609ad6ec0983ae63f2fea7,83,64,93667,16591,77076,68,56,87253,20090,67163
0ade32565fb81f54857a15d1063b7731,41,36,31452,11273,20179,37,32,31770,11957,19813
872936352530317b4809f8c4c5b7cc24,88,74,209298,49463,159835,106,86,201978,52392,149586
d77355065831f3a6d6f7af8a7faf8724,32,28,29110,18256,10854,54,38,51560,13826,37734
83f79b0d91595d4c88fb7d24a109d1b9,32,29,16626,8057,8569,24,20,12529,5814,6715
af552678a13e029deaf85cae288de9cb,55,40,54173,19719,34454,59,49,63111,24775,38336
1b81ab28699b32021993cea1ce8cc868,26,22,11424,7416,4008,27,26,17994,7659,10335
fdb04a86a5ec45e7d4b2db4e09b6c70e,74,57,114780,34108,80672,84,66,133804,36556,97248
5cc415b2a1e9b2ab504f3ef7482fbd30,151,108,321431,69511,251920,161,135,555782,81379,474403
24554673cd034b3293aa828d8a55fc15,54,47,54807,21455,33352,42,37,53012,20162,32850
aba797a314357b431c0155dfbdd9e952,102,77,175551,53336,122215,88,65,132643,51868,80775
f7fff94290c71dd5297261347c030e8a,49,38,34759,12129,22630,39,30,27937,8653,19284
b710cbab04353ed353d2ea930336b425,58,43,63789,25051,38738,61,51,83785,27053,56732
2ae0172cd6d053bde325d34f888c904a,62,40,51543,22658,28885,63,48,49412,21278,28134
16d77415a0ee42bb973792bd0901f1c2,1,0,15,0,15,0,1,0,15,-15
f052a5b708a2dfb5579dd364781f05f0,84,57,84865,20934,63931,44,39,20522,24327,-3805
4bb8cb6e27f788f900e6bf2f226e615d,124,82,262289,69224,193065,120,82,317242,49848,267394
340e5f50997ba17286b1a22de0a1a1f5,53,39,35735,12939,22796,59,46,50306,15470,34836
d2be5011118b46cc659b0218ac1496e5,47,36,67762,18491,49271,43,33,47197,18910,28287
c464dc393eed3c3be0185ae7b531f550,40,33,63875,13993,49882,47,35,36453,21002,15451
dfc93dd1a38cb1891d1fa3d28bd87f8b,64,46,64396,14889,49507,55,40,52816,19297,33519
edd24f12f5a6425adcf529a57ddd93a8,64,53,78407,23647,54760,88,56,137008,20801,116207
1891a86c5b2b52123520ed838ca143c4,133,114,365197,70717,294480,113,93,259055,65381,193674
2f5b3348fdaa0c33c711b6d73f740601,107,84,175456,41825,133631,135,113,244580,48843,195737
d61649728ad59c9c80f44b484e4da611,38,27,33325,9366,23959,55,49,40446,12780,27666
3620195c50e6f1f1a7b1ceb297f65782,27,22,9979,5415,4564,30,22,13901,4352,9549
79eb614831d512dfac95b70579e2f341,124,86,387108,96553,290555,188,132,568142,94200,473942
cd057b46b6e34658b531f94330861a91,108,64,207257,28027,179230,101,75,160875,34635,126240
8089288ed2f87d7b50f3b9b14ef6e27d,25,17,15316,2826,12490,19,20,9522,5915,3607
70cdcb690fc6678520ed2b9e725631c1,107,90,221837,43788,178049,129,110,253334,56657,196677
cab6cd1327637df4741ac54776a171b5,164,128,422360,99898,322462,168,143,527606,94009,433597
f9f32b01899bbcef045aeca1f25a1baa,0,0,0,0,0,1,0,47,0,47
b742a392e0729ec832dd2c96cf38a2ef,88,72,188554,61341,127213,130,83,300320,44387,255933
658613cedff7f72b421e02b121b54965,42,29,52670,13481,39189,41,31,43391,18410,24981
f8a5b172260132d62756a65f068ef6b3,119,68,297741,76134,221607,145,112,466965,78847,388118
88c217d919950eb522f5aa95ffcfeaef,18,11,7039,1425,5614,23,14,14215,1988,12227
d707681fcabdef33fce87440a9166d92,89,63,177493,39629,137864,59,51,138947,42713,96234
f2df0b77955e734033c6ab2e06006616,100,74,172800,69777,103023,119,104,266640,70306,196334
0341abe85bff033284cbc05f0a7db81c,63,54,75195,17060,58135,45,27,59301,14759,44542
a260d96cb7142b70d423c3838b9656ee,117,79,253536,67397,186139,144,100,408406,84576,323830
228d858658e0073ea5e6818b3f0fee0b,35,26,22477,9387,13090,32,25,20622,10027,10595
7de4dfc1e13b0b4d850702158eac74e5,36,23,32234,8897,23337,35,25,27047,10270,16777
60872a3e1fe77059a618d506a2cc79c1,68,60,105934,28914,77020,85,63,127541,28361,99180
36ace6ad906714d09015109568134db8,164,106,384712,65756,318956,180,152,650819,89949,560870
7a6867b46fff722e59c19fa29ad262e0,107,81,188139,56999,131140,126,99,263337,43091,220246
25b6f8cac2830509c4b8b34ae3503b6f,44,33,80964,25768,55196,45,33,63635,24944,38691
ef6643559bc0e7b86b60a29b564c00f1,104,80,299922,138663,161259,138,101,448688,108272,340416
2c736a6432bb54d59e2b595a242af54d,73,60,199328,40112,159216,97,79,207213,56007,151206
6af4de0a62f2eafb4d4cc8ca0a4c2a25,27,23,18347,7750,10597,32,27,28776,8716,20060
060f1ea8c2716f22a7bb1f0574d395e0,99,81,171186,39891,131295,88,76,114450,40618,73832
f3065109a4440b23f71aa94008dc64b4,55,43,100395,40055,60340,89,66,157631,42889,114742
9758b35f9acc89ef950992840ac0439a,127,94,308880,53627,255253,128,97,253480,54246,199234
3543629d01893050017d64bc7c62c387,62,42,82885,21377,61508,59,45,66952,24495,42457
d099949675615a226d07fb99a54f5071,81,58,110872,29041,81831,92,73,129176,32181,96995
926992158eb874e81f6d7bb74652e825,173,139,475210,73970,401240,161,120,413284,79100,334184
90018bbd5a909ea44515d5da55d6c87c,106,80,195929,57829,138100,113,63,203353,30673,172680
8c07a09457b34f5649936a516ff26838,47,31,45447,11534,33913,42,36,36036,12519,23517
94164606f6bf4eb59965ad1b153f7e2d,162,120,406320,77938,328382,121,89,304595,92515,212080
8d57f055806feb0aab1430c56ae08ff8,10,3,1315,779,536,12,9,2017,394,1623
a8bc9768a987878debe82fb4588acc08,27,20,16220,6301,9919,30,22,16566,7473,9093
ee3b605a8fbb32ce471202181595d4ec,108,77,223030,37145,185885,106,87,222803,33768,189035
e2b48e58a8e939efcd8bf9f44e6bb01d,119,106,258000,99041,158959,108,84,259682,58046,201636
054822a4bfb4a185a5abe2d2c9740ef8,19,17,4435,2685,1750,19,14,4112,2228,1884
aa9085cd55492560d4a6c349c337e75c,25,20,14303,6618,7685,26,21,10874,7513,3361
49b190bbb5ae8f77458c6378055f108e,106,85,467124,85560,381564,155,113,337658,85430,252228
68040810de5aa50573b93fddf6b8aa28,142,128,469510,87326,382184,124,99,385356,102729,282627
acae9311f31a4a57ac2d7164c6afb52b,171,135,750865,134167,616698,238,172,798296,157475,640821
f97ae9211b891b75e302f221b22013e6,41,35,45858,12780,33078,51,37,40986,13070,27916
d81055eff2b8dfdf8859fdd3743126df,72,57,111491,27123,84368,89,78,99940,31613,68327
c53f4283aa77aa9a5506e396e777968d,72,49,78451,21620,56831,58,40,81289,17447,63842
fdfd27284f06f1d7fbed2a8ec10ce896,96,79,159810,25142,134668,72,57,104100,37098,67002
2341bcc578ec1c41c217e0f4d9f34a2f,114,71,190751,40127,150624,155,107,285563,44087,241476
d6aaa932757e6bc9d8111d93611c4f88,154,124,462284,100626,361658,150,119,490438,96839,393599
eca034fb0e154a5ef84a92edaf6f5867,149,90,195856,59177,136679,88,74,170660,51361,119299
2989f746b782f9cc6cbf4b8ade762862,68,52,88738,25921,62817,57,44,58410,30186,28224
467e50a20e6374642684c1e72dd4d3fa,103,74,243784,28309,215475,94,67,201392,32779,168613
b93b86f9b09c55371c0e900c5b6ecb47,121,76,309119,113317,195802,123,88,349082,86814,262268
3d922e5b5e9e9f5d91dfe0aba246e517,157,129,326586,87989,238597,129,86,286959,74372,212587
578184d5c6cda1051d3588487ebaeb8d,111,86,213337,42740,170597,92,75,164423,59438,104985
5bb8a7dafbf318b6eb0ee3847721d6cf,32,31,27059,10776,16283,38,24,32957,7048,25909
c04e5b04fdcf9ff29b14487a30e00929,106,81,255058,79795,175263,166,124,467758,57740,410018
7541cadfc6c619ef1370c8fe1dc08ae5,163,116,380173,52705,327468,143,106,253462,50855,202607
ba5822e8a8a625ec83626be53ad7bcfe,42,34,35916,16755,19161,40,32,44852,12985,31867
d41e4972dfe3cbab56a6480d2e072b64,84,58,128299,25563,102736,87,53,91854,30120,61734
48f42bbd0f936843ef0f19c5b2fac6c6,135,113,323380,58443,264937,142,114,314307,60658,253649
8eb300378ea2f297622dfc8eea083c79,121,88,318933,55356,263577,134,101,381517,67881,313636
ab64cfac0ecb281f5770560dc81bc92e,261,161,1501864,215564,1286300,213,130,834231,165399,668832
16cfdc6f26cd7c5b172189fe97891e80,28,19,15631,6686,8945,37,24,18303,5287,13016
93724e8722c08d3dd74e10f895e44469,32,26,28836,8326,20510,34,23,17337,9811,7526
1a05668f169145d76ada0aed947ca3c7,106,91,238911,51006,187905,128,95,285162,68787,216375
219947e63e085420e0ccf7bbc287ce4c,51,39,75178,31293,43885,56,55,92183,34524,57659
95000746a2ca3c080a9fe2c1943da7d1,1,1,108,179,-71,1,1,179,108,71
32b0efd6ef5b61e84662088d1e59245d,82,58,124111,27002,97109,61,44,69203,30683,38520
34554509854a616d67a1810f000f2fb3,72,61,106780,33530,73250,84,53,94061,27311,66750
f8ef7ceb86128f7b63cd676c36caf5b0,42,34,43014,13374,29640,52,34,38661,12977,25684
5481b411067e499adda786bfaa3bc55c,132,85,184024,34342,149682,100,55,167701,27645,140056
258d886d487834e96b10595878b06106,25,19,8010,3308,4702,22,13,9463,2988,6475
b094f15dbecf48a1a0047ad248a0e6bc,152,98,284349,74239,210110,129,84,269740,62627,207113
3e42a3499c739152eaedebbe3abbf3fd,155,102,338086,77615,260471,179,110,412382,62979,349403
7f42a0d274b0839ebbc7a22c39127f83,67,44,66046,14375,51671,53,43,60240,16383,43857
50005828979f8ac67e8aa20ebdda69e0,123,87,225281,25697,199584,83,64,120273,30323,89950
c6b339b1089ed64f655b369e068f60d0,75,53,110584,46828,63756,97,64,168303,39817,128486
70956363b8575602888851bcaf10725b,226,153,1295466,138915,1156551,205,152,769968,160434,609534
843181bad36cbb4e85e4a40d3b6e65fe,159,104,744642,156440,588202,245,170,934034,157733,776301
fd91d128fcf0c6346e1a73a4595c1071,111,78,256561,63507,193054,119,100,345551,74971,270580
486c662532a26bfa8a53752f63f22631,195,129,531270,144836,386434,160,128,610794,124058,486736
8778bb97ac4415d857e586a6ca681adb,192,146,619869,165321,454548,179,144,616903,117260,499643
37b534900f46508c9eee041e1f8f7248,187,151,662354,114177,548177,145,113,548469,96667,451802
d6becc86064033acfd307a68e49d53aa,57,45,65030,22482,42548,63,44,81456,21716,59740
21145b3399791fc38f7c57380a4aa1e5,75,62,132114,43660,88454,73,61,165997,43038,122959
5351b39504bd35ec16c16f1288798ab9,146,104,467540,79748,387792,107,80,397149,92306,304843
f1d40f6834e3ac2c46aff92a3cc8f4d0,102,88,352711,123823,228888,139,88,335876,68239,267637
257d263bd1d0168de55df2055b4c361e,101,79,235848,36916,198932,103,84,218640,47998,170642
797bfaf1a3ff926aed9bcc6ff8068e8d,26,20,17657,5102,12555,26,19,11274,6095,5179
711cd912cfc6fa87d0408795fa10ceec,117,81,186773,31562,155211,76,52,95011,38195,56816
c825b60844a07e56bf3ffa2c0c5e8384,59,42,58393,23260,35133,55,43,75627,23691,51936
0df741baaa985c48a337d7ebcd50245e,38,32,33368,10542,22826,33,22,23695,9144,14551
466c0a02708bfc9e584d085c0a3bb505,136,89,366077,91354,274723,125,93,387383,99429,287954
d1d3c78bca0c6eefa883cbd8ef9ab1b7,96,71,178135,41614,136521,96,82,152082,51806,100276
a7fcd4c52b401dadf8a67b80a6686aa1,155,107,654329,87999,566330,146,112,540221,167147,373074
5005f4139b225d957bc3ffaee3306ca2,173,121,367977,77908,290069,130,88,320681,71650,249031
102616aa62c01aabb4a906038d4e524a,119,98,255331,43916,211415,62,61,115177,47940,67237
9d991261199dc0a6bc3e8e0d8e5aebc7,9,8,1471,378,1093,8,3,947,156,791
d1b6dd18ff55039f987a823b1f87382a,49,42,52610,17381,35229,57,45,57861,20586,37275
2542fe2bad8605ba21638ed2d90c6a51,86,75,185384,45414,139970,76,73,133927,56669,77258
72fb9774eca72a1e0cb8800a48494b3f,139,111,383471,88260,295211,179,127,541285,76388,464897
cd5e5f95e9132ffabbf717bad9f0bbed,148,110,534273,141795,392478,194,157,559352,172350,387002
b43acc20d17a0ac239ece1a63f2371fc,25,19,10097,4185,5912,29,21,13121,4266,8855
79090dfbf829e74eda323b10b85b943a,77,68,192876,67975,124901,102,83,228731,60212,168519
d39687beeb6f6ac46d4eea715b8c749f,62,55,89523,32810,56713,53,44,82163,30946,51217
c2b0e21afcd03fd935aa660806c08f33,46,38,47930,15772,32158,42,29,32990,15046,17944
70b29fc0db71bd49adf3cad794deed61,45,32,37329,10501,26828,34,32,29407,15818,13589
8d154c608012be92ea56ce5d5a2b0157,43,36,50584,15002,35582,36,27,30981,15579,15402
c355a67fe2a408a43f9a38c27d7c19a7,206,162,1067128,283255,783873,216,157,1049391,184279,865112
1c3d84c673f8b4ec53c7ccb2077243d7,155,100,503931,100343,403588,173,141,460073,110409,349664
4464642d8bc9efdc6be4640f39e3a0fc,75,63,89725,21449,68276,69,52,74284,20882,53402
9536262c48f8bb7af0fa379e07a31253,190,136,904670,259035,645635,228,166,975963,264422,711541
dcad0d62f4c5ce015d1babefc8f62609,130,112,301859,76472,225387,137,99,323547,82040,241507
b92be3b841204095c9ceaa1723ecad4d,85,67,135668,55571,80097,106,88,260061,61964,198097
1fffebc6c1e0ba59ff9c2661d4603c4d,38,28,21180,6375,14805,35,28,21628,8004,13624
99316b77221a4fb0168f024ba4a67d03,172,133,815856,133371,682485,262,141,581156,145374,435782
8467c17a87d82a2954d1f4dad0b27b60,69,65,84406,30717,53689,90,72,131710,32374,99336
2cb5e2a0600b01e9cc69da76a6cbdc74,97,62,125740,32203,93537,87,71,127781,34331,93450
7dc37db837c134b3355d9128cdecfb23,70,62,121655,41488,80167,75,63,137371,30525,106846
41c243f2842f96b504533bda43b2f6be,15,11,4971,973,3998,17,12,3190,2485,705
a6bf79084614566781b8169d005a32c4,93,62,144225,33749,110476,83,43,135063,21221,113842
97c804597924110a52767eed1cf1b88f,66,50,81069,16943,64126,66,54,102078,29394,72684
ae5fe5562b4f0a45bd11c68f11330b2b,29,26,15246,9667,5579,38,28,26177,9549,16628
45d1b7dc9a53514d27c2fdf030335572,153,116,532349,114231,418118,206,138,602908,110225,492683
ccd6584be2cc8828186b2d2f77494692,6,3,761,641,120,6,6,1063,520,543
cc039d6a57757e0e25c092aa626c13b2,169,144,455460,72252,383208,140,104,426841,63095,363746
b791e4155fe7bfcdcbe2f05378de6d5b,60,48,119964,28098,91866,55,49,69960,24041,45919
86e3044222473baaf4c87a91bc8271d5,169,134,416396,74493,341903,146,116,420139,77672,342467
13963fee4fa71870a9fba41430301fbb,62,47,72763,22764,49999,67,52,100276,23533,76743
23c3fd6acde1b266872873dc4377c13a,64,56,91344,24956,66388,65,53,98527,24712,73815
b971c0b366d503b642c7828e7e586849,176,133,503238,127857,375381,146,125,338731,113553,225178
c17e41093d8d2d2aeb019bc240d520c8,150,114,352369,66548,285821,152,119,409826,52984,356842
2ad3cc568c9fb5941d050850c00e18a6,107,66,309329,79602,229727,162,133,566587,106850,459737
baea1105efe53894bcce83ad7669e672,183,153,507820,98712,409108,125,117,467747,129443,338304
605e1cf3ac2f401f9c3c2733b6c672e3,57,47,86298,34593,51705,55,40,99833,25558,74275
e3d9d5ac78ea394d768723c7d272125f,40,33,27184,7610,19574,35,30,28338,6386,21952
a112b58bcc7d75fcfc8c9db5a61d5cc5,61,52,96616,37038,59578,81,62,113066,35958,77108
c10d2d918e9cae448849d57cce40b47e,94,76,153970,48417,105553,114,99,258127,52662,205465
d439f972ec7a658de11f14906de244aa,65,56,103022,28343,74679,74,52,84973,25874,59099
2b50ec09ea08a282f5f2592a7ccbbdf2,104,77,190064,44800,145264,98,67,149068,35834,113234
9d5b05c6aa12c371cacd50dcea060c13,163,130,498371,93748,404623,145,113,433132,88288,344844
2dd6c4f16236462e8aaeb591a8a80ee6,20,15,5479,2453,3026,28,23,10937,2828,8109
c4d201d67715a96b469909ce45658e95,155,126,421063,99480,321583,158,123,445366,89083,356283
1b94d66eb5a2be19afda9690f78d0b96,51,34,59002,24667,34335,60,55,99509,26765,72744
dc19f722d1e2d3c4a947fc1a440a114a,163,117,711480,102591,608889,184,138,636107,119827,516280
72081784d3547d303324dfee6fa61a42,66,48,72224,15314,56910,80,59,56242,20546,35696
0620380f1b7b3bc90488bab664cd1527,85,77,132853,46227,86626,82,69,148279,31674,116605
0218af45c10734696c20052881f33c4d,5,4,581,447,134,7,4,1735,529,1206
b9513ff8a9630d86b852b43f401d8da7,110,82,188923,42471,146452,84,57,100185,43257,56928
6b690b0802a0a5021f99b0b23dad5837,75,60,147184,27167,120017,65,67,107814,41039,66775
640d709095e55f80906443923bd84f4f,49,40,37092,11640,25452,38,28,37461,8703,28758
7f5df31d118a45b40a47a8ea37adf143,63,46,112163,19574,92589,56,41,61835,29013,32822
4d94fab055d26c50b27ab5da8121e126,46,35,58120,14417,43703,41,30,46008,17075,28933
13fb0449f8505721e4dbbb00de92c6dc,102,82,274910,62902,212008,180,148,484567,79640,404927
65e09d7f7e60261f10222e2b6b835cfd,13,11,1887,1351,536,13,13,2563,1608,955
71b86e636d1cf82bf372f2988d543006,228,154,851515,131934,719581,149,106,838453,137401,701052
f838e6ab1aff0ac02dc69f58b09e617c,8,4,1211,196,1015,7,5,766,545,221
462fba89916cee6d95fca9604330fec8,86,76,132964,23852,109112,63,56,65225,26658,38567
cc2a0de53117751a230f956b580555a1,99,77,157998,49901,108097,106,70,168490,39724,128766
e96abdb0459048a22cd6029739b19ab1,95,71,170402,56501,113901,113,96,224084,58262,165822
32d192030dfadb526a2f08ed092726c6,45,34,36202,15824,20378,45,41,42360,15179,27181
a3053c51cc7277f1a82eaefdfae080ee,115,93,240866,44104,196762,107,80,187571,58415,129156
f273c355ff6975baf5a18a84ad22402a,61,44,111080,30171,80909,122,124,287630,46712,240918
8888e105548d2dce0e8d63ff8262fc61,153,101,509978,91524,418454,164,126,505331,97497,407834
3ed11a7f9e6d78b58899febc64a8b2f1,33,27,28674,10326,18348,30,22,28195,10210,17985
2c13dc4a4ef18dfb53da5151fce64b50,141,104,373181,116182,256999,190,93,522877,104334,418543
546629cd1b2428ab2c314a09ac53cb2a,96,64,173951,35904,138047,99,82,160358,51933,108425
f84315e0a821ac8ee27c185eb64d61c5,76,62,141505,29551,111954,58,48,45548,36019,9529
bacab526f7db77a5b29db96acc18654f,53,36,57142,18231,38911,67,39,88450,17262,71188
6a609c776a2bb70aa542db6a92f8c4db,152,124,363927,89419,274508,128,110,372831,87004,285827
ce09923a39f5f5c424bd7064927edf16,73,61,123531,29959,93572,84,74,127637,32976,94661
d55d6d88094411a6f77e65750fe55302,140,117,425061,58114,366947,86,64,205620,62946,142674
3775521ab49975aaf7e19877ea79438e,55,54,67711,27793,39918,77,54,75425,18851,56574
7b9f01915ac075804a2caea66926b6c0,117,98,396198,110371,285827,152,130,500593,113654,386939
166d301039117f3245ae39bb040137f3,140,91,272302,74003,198299,131,85,326524,65204,261320
4396c38493a0b9e93809093dc8165016,147,141,470556,85503,385053,123,86,369699,61942,307757
7e1eb7c06da477acfc6922772037ce79,127,105,308453,59891,248562,126,103,249068,52551,196517
aedae7b8f9e25a0455a1cd6363665964,163,107,352475,104857,247618,126,93,330973,86200,244773
856c99ede73feaf8f3a655ff5a437bc1,39,27,41671,10005,31666,38,29,22925,14216,8709
bf8a8c236a73090798dc630f14b2163f,94,79,182312,59822,122490,70,67,122172,52298,69874
80831f8e8042f353efddef2a0e72ddf6,64,52,98683,26742,71941,64,49,67573,29717,37856
63475259b68659f82a4f442f92595779,0,0,0,0,0,0,0,0,0,0
86efefb6716ca99c51190fa13fd1b3e3,76,53,102779,32394,70385,78,63,102427,28484,73943
af24a4a8ce283023343d332a3aafc0d0,106,87,284337,78944,205393,116,90,324291,64923,259368
1cee1a05a4d498d333385f5708151969,191,103,457735,64207,393528,187,132,706120,106315,599805
a5b5c8fb5571916e501b4eff764ddd62,70,57,135208,31108,104100,54,47,52668,37692,14976
c188690a498c6128aa5b65e4f277f81e,65,58,89637,22081,67556,70,55,92398,23788,68610
5d5d9f330cd55cd77b075eea0cfda22a,54,43,60398,42780,17618,68,48,132468,36294,96174
3eb75e402db036f58fc5103372c7e7e9,160,107,359697,91274,268423,142,117,368832,79811,289021
ecf209719f347f8749b4fce825640005,38,34,26161,12498,13663,36,28,34872,11675,23197
b0606d708df58e2c183c0298b6fa8a83,99,87,208177,33603,174574,83,73,143859,50741,93118
40a2c45b481bfb91369374ad9e78ec30,37,29,38071,13692,24379,35,24,29918,12094,17824
09719045bc0132851db3dc50f985eae3,192,164,741268,92269,648999,123,107,472815,117826,354989
6c972b23e80135bcf7594b08e1924bdd,7,5,729,194,535,7,7,350,461,-111
0833c5a9d7e573bee25bfc783e403529,138,105,349156,62609,286547,62,44,182385,65315,117070
9c291c309bc217d6a3c34e19e2f1eea4,151,118,539874,126120,413754,180,116,604877,123431,481446
31eef8ce2018d578e58de2b4ba569a05,147,112,508791,81357,427434,162,117,451101,70519,380582
5a991c3f38552b88c595e54268039aae,25,19,15330,6266,9064,24,19,11346,6359,4987
f1be466f7132f6f4cbbeab6911598ad5,124,90,237030,78990,158040,121,88,258449,77790,180659
45295f30811fb9e9574e12765c9f8626,106,78,215616,71908,143708,118,94,197122,59377,137745
e179b03419e1d68dd22239c30f117453,128,88,379612,84600,295012,147,116,488225,126711,361514
5d8b0f9766cda255d09ac7d14b759e65,78,52,109313,33565,75748,80,61,88775,37073,51702
f3cbf3190eb1786059c130f20e76c660,8,6,920,1761,-841,5,7,1645,804,841
487e8f285960f58398f9b8b7891ea72a,53,35,55665,9560,46105,47,29,48213,14662,33551
c0de3b149c293d1fba971eeb375de06b,143,113,399166,59656,339510,126,98,280650,88823,191827
f21a1ccbc74558097f2b3c3a508ffab5,35,28,47470,12821,34649,43,40,37389,13445,23944
becf86ee3b0d7590afde270288bc6612,164,122,411811,86006,325805,108,77,266162,107662,158500
eb8f471e8496c16a9bcbfdc42b27f150,93,84,182647,52573,130074,137,82,199135,40834,158301
5badd0a9bd3231a069b2424db592462f,119,74,470268,76210,394058,204,162,476691,129879,346812
e129b812a6f07e8365efb79400fcc64c,94,87,152602,70492,82110,125,96,233201,40206,192995
4678489708192ad3eb0a394c1e831b9b,251,154,858883,151697,707186,233,156,1075869,147615,928254
0b7f9cd257d6bb4ba9067a5381c33199,41,34,34465,10207,24258,32,25,22224,9395,12829
b347389a6787f5ecc8e0f70777d6db0a,104,85,176689,54686,122003,132,101,234548,42848,191700
3514f56630027b99e64927283b18e5a1,22,16,6270,3900,2370,22,22,5185,3212,1973
b30a1a05129aa0e8dc65bdf5151e61f6,189,127,579250,153974,425276,150,115,450532,109206,341326
c426c605512cefa190a7a05ac83d1478,39,29,31118,10692,20426,29,33,25758,14138,11620
0064bfd12fd3d2dd8a28088925f3629f,55,42,74869,21389,53480,60,51,66107,26224,39883
7785dd283559a4f2dc77237c4499ddc8,89,85,165098,48583,116515,102,86,199531,45953,153578
3f9abc2c5c71ea781d9569e007595355,177,133,639038,140111,498927,164,141,724923,121045,603878
b5ad75733939e0105655247f1557cb00,175,114,390712,77175,313537,149,125,436799,88231,348568
5d4c708021d405fef703893440af0f49,8,5,1023,656,367,13,6,2261,465,1796
459b00ab681b155878fec76b96253627,127,108,247050,43653,203397,109,94,258054,34998,223056
812b3e83d92a772f3e2b667bfe2dfb97,158,131,515611,90242,425369,129,108,404528,100368,304160
48b4bafc1b22887bddbd8dd58182c9c8,19,17,5404,2833,2571,19,14,6157,1940,4217
e36ecf49ed13ce43652b027c08bedfd9,134,104,315908,67543,248365,174,134,452962,73730,379232
43a9057fbe61920c2122be98a169dfd0,26,20,10566,4277,6289,30,22,16373,5574,10799
42d6040688fa3046d0b30be5f494c5e9,197,128,621676,88718,532958,133,109,304959,141338,163621
8fa770846fc6137100e6d2602b1825ad,76,56,141904,29652,112252,76,63,118837,30263,88574
a0a570efe947fea2e170dbc050596340,106,78,169436,30686,138750,84,71,148513,35378,113135
aafa300f4f64a128bb5038e9f7d9baac,145,117,462972,85211,377761,113,94,321379,86961,234418
735ad82d0a07ab27baa8ec3eff022b4e,34,29,24476,9424,15052,29,24,24980,9297,15683
ba34fed809f5bec20104739add28da35,46,32,50866,15155,35711,51,41,67238,14857,52381
83d7af1aa4a1da3372ba88e1b44bb307,151,117,466316,107080,359236,162,124,372190,130294,241896
35486a36111c1e873c08c83ca3354f43,37,30,35821,13985,21836,61,45,56604,16489,40115
e9ada37b73a293f56a24567d5335a502,114,89,201446,29764,171682,120,91,177946,37325,140621
b6b517da362791b24976771c263fd537,161,129,725096,200744,524352,192,136,727173,153713,573460
2f7894100deaed9d22d6c2529c36cdd4,193,139,631685,149488,482197,148,106,731611,127263,604348
15c1ae97b93b97691c07ce29ac4f7918,118,112,314135,83120,231015,130,120,368822,67701,301121
b68d75bf8f95699114e9a6fcae9d47e2,224,175,1335027,231170,1103857,230,156,1854943,215659,1639284
158ae0eb28a0200a72e1547871542d09,100,81,311479,82021,229458,121,109,360725,90897,269828
085e4f2aa7f80cb23df0d1c52f53123f,83,58,85378,22442,62936,71,56,71725,31161,40564
941a902be2dbc7789631ace259612b06,172,122,326989,60692,266297,115,100,224188,61610,162578
ef6ee2f027f2e17e7a5c4859b316b57a,160,129,556588,104244,452344,164,133,797440,82480,714960
669bab9f4e8cf3549abe15afc59cb3a1,34,28,17814,9995,7819,35,25,25401,6801,18600
5add32f9fb145c64fabb9e9d38fe054f,80,68,115261,28287,86974,65,53,93132,23050,70082
0b01c09e1357488434e786fe1292066f,27,27,14264,5651,8613,31,20,12948,5677,7271
fb2e66a9a9cd4454002fa35021294a36,45,40,70613,41836,28777,68,41,106062,25370,80692
a24c71964d9968695f87e54e982d1fa7,57,40,62816,21964,40852,55,59,61947,23948,37999
e35c1f88e6784e65e43de3fa3927d084,102,81,115954,24255,91699,77,68,86814,34854,51960
57ebfc4ded58dd8b9945b973d6a12252,87,73,214859,48831,166028,117,94,212641,61910,150731
bae35d3a0aab32558038f9b9e03ed36f,150,103,354723,82979,271744,139,100,300219,70466,229753
7b6ce7946cd68eeb05a8d6760ee3af37,25,21,11039,5788,5251,32,23,13710,4893,8817
1fa653483579497e523d3e98e84cb7f2,128,91,208651,42300,166351,121,72,173225,38218,135007
34cfb3e65ff324663097840808587c8b,62,56,106373,29273,77100,48,38,65856,24914,40942
a4f376df5c1cac65c51d6388cda6f6d5,40,28,45435,13025,32410,49,33,63891,19816,44075
a8147485124089bb12ee8c735a25d32a,232,150,1199809,193098,1006711,238,184,1497723,260872,1236851
78799e4ea7c37f690da2d9c82577c9aa,31,27,31613,10239,21374,35,24,31394,13259,18135
87c20a888d2a531de2ea8abb7e0c7a6b,114,86,176406,31231,145175,99,79,152720,35987,116733
7ec6f15a43830ed31af3c804115fe649,57,42,54400,25031,29369,62,39,89602,17212,72390
63fe4580dec8a1e7aa7b6609f3161e52,172,120,437492,89700,347792,154,101,426500,69939,356561
40f8379ade7a5d5a210f246080988d05,164,121,455939,86339,369600,184,150,579084,80629,498455
53365780f3871b1ddbcba88e3cd5e29e,206,127,708118,149138,558980,237,121,810503,128788,681715
66c086254f38df8e0e62b8b4a1345924,135,89,230641,47027,183614,82,63,110246,38499,71747
e0df4648de33dd3d6d7be5b1470d3d2e,122,105,309399,70320,239079,137,104,312527,84516,228011
62319fc668a2ac0dd04cdc5def17f0af,107,100,363810,100659,263151,163,127,504995,98081,406914
e59aec35bc3076a839f95bd77cf04d64,45,31,20769,8683,12086,33,31,27413,10870,16543
794b6184abacda673db067b52e56831c,116,91,208569,36514,172055,88,72,141584,40855,100729
9c13498ad142ce289b97c693f36ef3f2,95,70,135188,38972,96216,58,48,96719,30873,65846
f058d610fa5c8a2ed2d74d6281392c85,35,25,32733,11886,20847,33,22,34739,10315,24424
a7d44f37215a04c2b7fff2ac77e8f4aa,130,101,361048,97561,263487,116,94,269116,112342,156774
45ace3f768c7bfaf0db532b52b95365f,49,37,99455,27197,72258,58,42,93362,29128,64234
463c24752c44ec9e9f861d3e63137ab6,145,120,259424,74195,185229,116,97,216400,41976,174424
e7a47a3ebb6aea0ce0d2571e541bce44,43,33,47768,13670,34098,38,32,38025,20138,17887
f320a690b5efa787ef7a4df546a73526,168,134,674720,133914,540806,203,154,1099909,90900,1009009
2849387546710efc90b520c9839ef32f,138,105,384860,78918,305942,149,126,491543,70804,420739
150b8c720b9141c23880d6e09fd588df,97,77,202970,48463,154507,92,62,146789,36057,110732
d969a610a43d54a35b7656205b64824f,95,73,173683,54387,119296,91,69,168996,62828,106168
037d58a5353c9b0a0f5856ffd54243b9,153,121,498188,76660,421528,170,129,460317,73036,387281
09e96452f9da823c688d5faf159b1c3b,141,119,379796,82272,297524,158,114,392374,62115,330259
f19d151c69481699a04190fc938fd20a,67,52,82048,21397,60651,50,39,57602,20304,37298
5864d5b7243aaef8a7e2b33e91d5d036,84,57,135824,37458,98366,89,65,134436,34442,99994
60dcbeb6241d973a9b6b4714df556ea5,0,0,0,0,0,0,0,0,0,0
e23c739908e3b5b8c8eadb286e344a5f,102,76,174901,56538,118363,151,108,250987,47790,203197
98db43590eb7662175c6cdeba4c4be72,48,36,27594,19137,8457,52,39,56494,12579,43915
ef9c4df32ba8677a5615026daf18ed81,185,99,517242,57551,459691,186,135,490504,75316,415188
3c732e933b4ae0c5d0e3e76b9aa1104e,154,121,433932,56223,377709,182,138,429082,71111,357971
c75d42db95a484b96029bfe8f838ce28,48,41,34958,18352,16606,53,43,65642,20973,44669
8af2d14c323f12e05b263c5287d5d5f1,73,65,199492,63983,135509,108,89,214873,60235,154638
69a706350c49acf1faab2eeecab21e05,60,50,54404,16491,37913,49,40,53112,22505,30607
e3c95790ce9127048055f55c73a453d7,46,32,44567,16294,28273,50,39,53575,15596,37979
8a0b8f3f76f5d20c3af4346c0ed1fd0b,210,165,658179,145267,512912,165,111,672882,110975,561907
a0ebc54bd89a0ca39a36bf6e9c38a83e,61,53,107241,29785,77456,62,50,108164,32335,75829
6913cdef658202ab4b78ec691954930f,100,63,117108,37749,79359,67,58,118672,39072,79600
b83e83a122bfae5f5b17586fd062e2fb,34,26,21344,11060,10284,37,31,25882,10251,15631
b25ac016ff77e61812ae361ee8a05912,107,83,284042,63209,220833,136,106,278298,69833,208465
d6f9742e96fa5889f57bb4e2a41a1677,30,22,7133,5972,1161,27,23,14244,3632,10612
03e626cf84962d8f2f1c07b6635cc975,107,87,166786,42288,124498,151,116,240798,28693,212105
193890a0d23312ba6492527e8a1b594e,73,55,99133,27817,71316,72,60,82357,32663,49694
3736705f39cd5152e04e03caf1f53255,13,10,2008,873,1135,13,10,1933,864,1069
f1420d6e157ba6df7c81fcd72e7d7fde,158,118,454238,107761,346477,136,103,438525,89208,349317
8cc64cfc972c5b937daf1d8a9aeb0dba,40,29,38840,15483,23357,38,30,37157,13772,23385
ffa2310f6ed7361cd38ee8d9ae2932cf,139,123,371173,78699,292474,170,122,382611,88179,294432
a40d972408454870be597cc60c1bed30,29,20,20760,6772,13988,28,24,21613,4236,17377
35502dbc734125aa9a7070b453b271ed,87,67,154578,45863,108715,87,66,141513,30997,110516
859e938ac0d175c9862a995a776b6e71,46,35,69450,30892,38558,50,31,90450,22910,67540
4c38cec4d4791b03461115d462450155,19,17,5391,2706,2685,15,12,3979,2680,1299
14d0884f95f82f36c39e0cb21b346b6f,125,66,261049,44849,216200,143,128,432946,69771,363175
cb5f0ce7890ab52046fd4a20a9fc01e6,96,80,236910,86368,150542,134,109,359480,93874,265606
75d3ac41ff2d87c9497f55e6562ad7fa,56,44,84581,15459,69122,53,44,73143,22611,50532
ea049d36053082dca8c4dbaa304bf6a5,54,37,65212,15383,49829,77,45,87276,19518,67758
81bf9275ca543970540a2967c9b5d17e,43,32,34000,12855,21145,57,40,88822,10370,78452
d0c6c9e48d532d159d3444c276ffdc77,92,73,180251,67060,113191,109,90,234394,63215,171179
f14f4972325388adf01297daed9be5c1,91,81,165222,61213,104009,92,65,187015,54634,132381
a1c85c741468d70d0853c37b702b13b6,38,33,24945,13180,11765,41,28,27072,8119,18953
8c7835e99772756e76333211e48e7753,12,10,1950,692,1258,16,11,2140,1184,956
6da06316a66d1a38a70183ad6e9fde11,68,44,93804,31069,62735,79,70,137697,34811,102886
c0a9a2de26bdb92453970c36a94ef935,26,24,12136,5859,6277,25,20,11160,5915,5245
25e773bf9bf1f094ddbf263f04dbda80,159,101,374420,57248,317172,146,102,348906,70232,278674
df0f495121b709c4f36cc0fd62978092,128,76,225913,59337,166576,146,114,320689,63114,257575
93537f04284b404f659e642b1ad4d4f4,134,107,239393,83426,155967,122,101,296624,59991,236633
b4687d7f9a2b849b17d66dbec909629c,137,109,303822,62246,241576,145,126,415171,74056,341115
d7d63c4cc12cd1734beef4c31bb5ab3e,156,85,537217,92529,444688,167,104,428723,99770,328953
f6a6e99e1ee60307c9bf9112c4be0f71,87,56,131502,31458,100044,95,71,182327,25230,157097
3258d966d629ee2fabdea1c51faa3c69,130,92,299281,56459,242822,113,74,190100,58249,131851
d030c08e9b45b27b9e89dade4a72ec0a,61,40,95167,46301,48866,74,65,182638,42957,139681
7d162eee7c41f4c263464b6061804664,96,72,154740,25504,129236,99,89,153448,30415,123033
35c5a234e1a7858ca70e57b12eed520f,149,106,432057,116437,315620,175,140,557952,116094,441858
bf219547c3d98a3e3c6e3da34acfcfa0,162,110,536095,143397,392698,187,138,671407,88614,582793
8d2cab726a1f64b4843d73c7a98da5a8,28,27,9295,3861,5434,27,20,11342,4094,7248
13ad66bc1420f9198ef7ff41925a842a,95,76,122242,43585,78657,101,90,145099,55987,89112
171c55dd3d85afbc03d41cc716760849,95,72,210207,39412,170795,126,100,241354,38063,203291
661f1cab1ff650cb53df5f2304289a15,39,34,26617,11342,15275,36,29,26051,10842,15209
b2cd661dbc5a871bf738971559efa72d,162,112,351670,73519,278151,148,118,386895,60090,326805
df55e8f8527ee33dfddf4e56def6a7c0,149,115,397364,118954,278410,174,136,448016,119186,328830
ade8151b682351ed461bb5b0a7fb236e,138,107,330384,68095,262289,111,89,259535,72135,187400
f24da582cdc91b1c6324dee35b377eb6,125,110,402693,69911,332782,141,103,300994,59071,241923
5daddab46ef26c8b19625c30c52e19d4,56,47,85786,24602,61184,56,46,87239,22796,64443
7e632c7e3b30763cf08fe990eb77b175,159,127,413659,89357,324302,147,115,343764,77616,266148
0c358c436f9c5d4b52bf9e66187500af,61,45,93954,36264,57690,72,59,103406,32831,70575
a4d5caba7b69484a8719b36e7c2c656b,127,94,514641,100606,414035,166,126,565638,148464,417174
013e3deca14168958386050d70366af8,19,14,6717,1860,4857,19,13,5226,1392,3834
dd19fb25002be9b220d85c294523e227,42,40,43465,14133,29332,50,45,47952,14754,33198
8cb8de9bec063a827a976bfba0247a11,146,117,370791,76070,294721,154,109,436460,76334,360126
307039ba7eb4eaaa373b6447dabf368b,86,67,125223,37497,87726,71,56,84230,44624,39606
12430caf533fac8e191d4487393afd81,177,118,456972,79130,377842,120,89,327918,82964,244954
a969a3130c1009cfe86cf4c6df14dfa2,103,54,173762,39833,133929,123,97,185271,49741,135530
883a4006b79bb0afb7cb6cb4ead2e3f6,87,59,132884,36707,96177,141,102,234837,40896,193941
9ff9f2711780721e2deb1669c4b84330,138,102,319920,82058,237862,167,129,468301,56246,412055
8d83a639588d0048cec24624402735ac,37,31,29805,14071,15734,42,34,27158,14486,12672
69ec67648bb0ec1cad357a005e02f951,173,109,487739,80923,406816,159,116,436785,91640,345145
b70ba608df6766f42f35f0b4c973e57c,25,19,10981,3773,7208,34,19,12203,2958,9245
cefa36ad3a90efce237a03c47e8abb0f,100,75,212811,47958,164853,91,66,156541,46634,109907
176188eb468d5ec4573c007f67fd5946,159,122,440586,73710,366876,126,90,290833,92466,198367
04ffe116bfd4d3baa664baa96beb8ee1,62,46,57631,20907,36724,81,51,75654,21338,54316
c135cb84bc2e60bd0a8d1f53bda10f6e,130,103,302123,76100,226023,154,123,528807,76082,452725
540a098ded268d7e7ddeb84b8c6cc255,53,40,68133,10697,57436,44,33,32809,18697,14112
0658efd6e2bda8fcc8d51d39a2f453a2,128,97,261927,54078,207849,119,95,270485,49650,220835
9d6213030792616c3ad2a3cdc6976aea,53,57,62482,31170,31312,76,59,98387,25597,72790
7a5dd84438988c4760b2f7213af874aa,220,136,795534,176763,618771,217,162,789322,188430,600892
2e4832c409969dc57c8b32f072b3e8ae,184,120,687207,109152,578055,131,103,494973,112897,382076
cd9db61857ddedde4a8bef3a7d5d92ad,179,139,643586,228093,415493,170,141,732366,140065,592301
c26253f0d60d9d2b85e4b1d7e320bf2b,198,121,487645,74208,413437,147,117,449733,67335,382398
808a9bcad91856aa773f43ec723482c7,76,58,136707,27981,108726,77,59,87465,27680,59785
e07d2c3e0f18770e24598e1b8b4e7a10,2,1,261,57,204,1,2,57,261,-204
ed97f5336dacb90352693a08bde415b1,112,87,376185,103065,273120,121,107,329238,94217,235021
8adc8ec43d310e8134aa869156d72574,154,110,562505,135500,427005,183,143,653691,137798,515893
32a09824cead8e80eddb6fbcca51488d,120,89,310731,43458,267273,131,107,300578,67520,233058
01545a547da55c0114f183b87b771172,146,96,551368,121968,429400,201,160,822584,128562,694022
dab16b96e51289eac49034652d4988ee,8,3,929,132,797,7,5,987,316,671
6b5087143eb7fc876ee2ef699b068ade,52,29,56300,15334,40966,58,47,49153,24178,24975
46b0dcf0b5d47cc57459ab6e08a22688,110,65,245729,92649,153080,152,104,321678,103549,218129
488c763bf13168fcffed7348731c177e,19,15,4945,2935,2010,19,16,4757,2853,1904
e7291a651febfe06f47ac8dbbf36614d,50,41,30967,12903,18064,44,28,43119,8641,34478
fd4e7489115111a375a9e33a61be51c4,155,111,404853,84236,320617,151,110,493749,125796,367953
5da88d2bdd9c672e5f37c3ebe43d3103,149,115,316091,71223,244868,153,97,376796,76920,299876
0cdea3663b5107b3f3b7d46b7ebd531a,145,105,298995,48161,250834,127,108,243665,67614,176051
151f8a948487fbd5c37551440c714b6d,96,74,170530,38204,132326,97,74,183641,46115,137526
ca5dc942fbc1549f2cb3954f3149dcbc,73,60,107511,27257,80254,74,56,102083,27853,74230
80dc0f46a37bb2ab4ece351fe8336a14,50,43,71903,25258,46645,83,72,126308,39985,86323
867867db869eb42c327ae58e1f94d92c,91,74,193308,39149,154159,83,63,153521,39992,113529
730223a139257dbd147c27c2e5f80364,143,110,353522,70850,282672,117,87,245449,54427,191022
448a6d68b9c4b094bdd43bff88d006b3,256,169,1180003,266540,913463,204,153,1302317,213117,1089200
ad49ea87b13a70b07bb59db912d4b016,41,29,46711,18660,28051,42,32,58008,16641,41367
946cebc736b2b9358232d06835fcd4ad,83,60,90284,22867,67417,60,44,52687,18019,34668
1cb9fe57f19fe605c7e6e712e77f53e4,76,62,133760,32694,101066,80,55,123474,28358,95116
09dc86078d461eb33f3d3d7ff980ba9a,191,137,488616,98545,390071,147,116,465013,103757,361256
eaa58c70b51f664698056bdb710d3928,50,32,44299,10942,33357,47,40,53241,15084,38157
db0f7df35b4ca1d43f5d0658def411e2,15,16,5170,2804,2366,22,19,6872,4518,2354
e01775d061c21aa10e9453a561f6fcf4,162,112,264292,53821,210471,90,68,197686,41773,155913
2ae2f87d27d537f8d27348bedd8c94fd,81,63,123521,51059,72462,92,47,130068,42022,88046
d7ce3ced8a43b6e2e9762b488cb4e7fe,140,104,449807,81587,368220,184,143,457821,86080,371741
ba615d9c2b26c0ea12699725ad49db17,154,110,403585,69721,333864,161,135,442334,75218,367116
c7d71e74af56cb9fe165c26bc5352029,140,107,501919,89702,412217,140,114,630142,114465,515677
2d971ea795cec1b49266e93d5fc60cde,156,110,605581,105017,500564,152,115,385756,127181,258575
26edf49aef5b4d14c0726efc1456e152,186,113,436856,68310,368546,115,94,407925,89458,318467
2b0a56e3faef7f9f17c4a6a3d3cd189e,80,64,73386,21757,51629,59,61,80219,16527,63692
5e4ba8e5d741e36afffa44a53609c8fc,17,19,4742,2841,1901,18,16,2698,2412,286
2ce65b6b4a692a5360e6289798affc4a,75,63,99354,45420,53934,101,72,207989,28753,179236
5963109a1e9bf01a4ab180dfc9fdda96,48,39,45402,16889,28513,38,36,48534,20572,27962
d024c8c8c4ef27f2df622785e34f8c0b,172,130,584979,142409,442570,218,159,767478,117625,649853
d1861174c48ce9c0b5c3d60190bf5a7a,40,35,32074,9311,22763,31,21,22328,7212,15116
38f47fb3ff6819ff4c402cb637780d27,130,103,289729,73299,216430,109,92,232691,77700,154991
a1b45b63896058253e9841693d57948d,54,44,81581,18954,62627,49,43,51299,25766,25533
283ced99b316f3d1d8b4b803187796af,48,43,41817,19498,22319,41,28,39162,13658,25504
3f0a82b9e95672837d6c94013a0b8bd7,40,27,41140,13643,27497,49,34,62866,11958,50908
fc3eb03a4c6dc5e6d94fde72641e5c2a,23,17,7979,2500,5479,25,19,8733,2404,6329
1573f402884a5475b9fc8b2a23fba6e7,122,100,321453,54519,266934,71,58,158236,54504,103732
c83af3d30070efcfcd4d36fa4bbff942,169,123,431875,75015,356860,154,83,351701,64623,287078
6479cad501c73adfbe6b199a4590a8d5,84,63,160392,42608,117784,101,88,173521,47708,125813
594ce3c1021072a1d91bafb2cb5f2cf9,15,8,2996,604,2392,13,10,2716,814,1902
c7ae385b70a871af7568f3b9b712cc77,43,35,30693,9048,21645,38,25,23281,8297,14984
5011c6220807a771e2fac9812d5958a7,136,103,454575,107231,347344,160,123,596194,118478,477716
a2aa9a1d830f7c1994ed5422e17e799e,126,92,264815,50220,214595,135,104,256497,40898,215599
9731440a1b0acc4ec15c56905e187bf0,140,112,767183,230756,536427,210,160,1000699,196050,804649
d8302be173fa6ba6fc73917f05acd5c4,118,86,402406,76497,325909,152,98,384005,82283,301722
440fd9e0cc6fb73ca18fafbcdc201048,53,54,48408,18582,29826,60,43,49577,15820,33757
48ab89c7d5d1f9f8e73887b73f34012b,39,22,28064,6390,21674,37,29,40874,8855,32019
c915a2e1ec1be6e2e9b340bb6dd55901,169,132,532395,139928,392467,129,95,380747,115679,265068
1eed98cfc3ac3ba853504f363cf31a0e,202,125,856886,157933,698953,250,172,936565,138389,798176
accdf5fd3926b5f8ccae128615a58d80,18,13,3472,1521,1951,18,13,3454,1394,2060
ff364ab79818dd89574c22e46b24cfad,105,89,185676,58197,127479,79,57,112683,51507,61176
c17dd675f24eccab61dac644b6d43718,47,30,31665,11044,20621,45,32,36461,9022,27439
2b77de170f16f418cab362c72e253fda,104,83,173098,37146,135952,98,83,237865,45664,192201
8b78e4e8a30ff7e46ec5288ae1113a8d,22,17,4374,2183,2191,18,15,6734,1584,5150
088f8e660ed8530797b57433bf9504e9,144,112,386214,80050,306164,177,138,534329,72514,461815
e10091c5b7e7b7136eeb6b6e481ba04d,174,143,469283,76012,393271,144,128,389011,110610,278401
b3e9d30946139d9084d424c59f34054d,106,86,214750,39390,175360,130,99,260649,45346,215303
afe8902d66dfeea52c9878c8286b8372,50,49,67787,18065,49722,40,31,36376,21782,14594
b104dbf8acdec508fbf13f93a2a24208,115,103,282487,65274,217213,94,70,182445,67145,115300
299a47e5c0230d4300a9b63d47436c9c,163,114,548472,80785,467687,146,117,405855,124168,281687
134cba1c55e019e2346ccfb723da6697,149,95,265926,55959,209967,101,70,240058,69204,170854
7c9b3921aad8106dc501d55d33aae9a4,123,93,342853,76316,266537,140,115,410258,62269,347989
70a5398ec2b639402ba273508ece2e92,38,32,23463,11220,12243,42,32,31648,12433,19215
a3aa66b9e1768c690739eb56d94114f8,37,26,25897,11304,14593,43,26,34579,8171,26408
676eeb6d2c179114d3f132c1d4f8f5a2,104,65,209267,41098,168169,109,86,234329,48539,185790
db3f311804f3bdc6d9af3ed8811b19dc,42,35,26154,14183,11971,46,34,47568,13529,34039
86c1cad7434b248efb4465765d879792,137,101,370638,93123,277515,116,82,271083,100053,171030
335d30b3a29b18aa91d47880688d1b2f,82,61,130063,34247,95816,99,76,153287,29837,123450
9a2b77490dacc2d6312eba2c1936588c,91,71,226045,90163,135882,200,138,419446,73689,345757
15d78302bdd56e3d72c290cc08e7eacb,105,85,225840,76304,149536,145,119,336680,68991,267689
976db05ffd4da7bc6973649093efd723,125,86,383558,49529,334029,122,97,276351,57901,218450
cd901ecfac74a04545394cca45c01426,49,35,40374,9985,30389,54,44,55203,15262,39941
070f94864aabcb74fd21c547c144828d,168,110,294082,105348,188734,99,80,174305,65962,108343
6a346973a2b4524aac0b00bfcf7d25d8,33,25,22628,10535,12093,33,30,24253,6801,17452
a660a4ac8ddee53d4385fe6fc1c7bfbc,49,39,34752,9756,24996,34,29,28679,8747,19932
1b94f98c44bdb05d0e1250cb07408a7c,55,45,73207,35248,37959,62,47,98734,27617,71117
7a56cfa72872aed618037a481af9d418,104,85,150199,41629,108570,80,63,110180,53714,56466
7a73dbeba3e93df9c8b7f773d5ddd347,41,33,36028,11910,24118,45,40,38399,11952,26447
00a4a3df3c8a56b5d6cb888360e77bf7,55,57,78780,38912,39868,60,39,78042,30980,47062
13fb04fb21a40cc5ac50d1d19f07e147,108,94,194138,53626,140512,107,90,176701,48271,128430
d86f8099d7c95306d5213dd568739b4a,70,61,104151,34390,69761,88,70,117327,33912,83415
c3a7077a2b0083b8cb5948e086298bef,11,9,1917,1143,774,9,9,1237,1062,175
75c8df12d17911f868c1cb3bae503b11,122,74,237318,65676,171642,132,69,237729,97773,139956
68ff1a050fce47d5507cb42be3e6706c,189,136,524152,73663,450489,128,98,350498,82793,267705
f7d920acb551fba615add893c46f9964,4,5,625,656,-31,6,4,752,341,411
02a43c6ee56d2fd89d0255133452690a,110,87,256277,77562,178715,98,65,236577,63114,173463
966128a64074b1d306e9062a42e0da96,41,29,26786,9774,17012,32,27,24736,10350,14386
6f88eed286c1508172f2781a0e7f2119,142,121,471861,151799,320062,150,113,536213,108188,428025
21baad3c2c3be94cee369e1634cb0eda,105,85,205532,41973,163559,97,95,175363,55335,120028
efbbacfcf4950f39aceb8a492fb89244,30,25,16935,6559,10376,29,22,12056,6665,5391
e498fff98ed3ccb364a884611a90fc18,52,48,63777,21469,42308,60,41,67780,21056,46724
b4080f9712e7b0c050df8ff2a6d34eb3,89,69,235063,45493,189570,73,52,134182,52002,82180
a9b5c1e2fd08319d794bdb46dff56f85,117,90,325715,90628,235087,140,102,414607,65447,349160
f6f7b9e0cbe23d675e7e4ecdc05610d3,91,71,126516,28925,97591,52,48,74628,33413,41215
b2a650bcb17976c4b8900d004fb70f08,176,133,550071,108359,441712,192,132,546488,121507,424981
b5b7db400dc294ac7a3bcfaafc6e3fe1,88,76,125958,62126,63832,110,54,152593,43039,109554
ebd053704fe6ccf05af20f3136d8f1dd,31,27,28597,9775,18822,28,24,20377,7603,12774
50e1d546a99bfe773124a1d8637ba2dc,52,52,51281,21994,29287,56,39,48469,23645,24824
b959662aaba68419f3a6294519e1ee01,125,82,249549,63427,186122,127,114,269086,77066,192020
3ffd709cc5fa4dd26d96fc7ea0c63c09,150,114,405547,107512,298035,155,106,350599,99983,250616
817b7b886b484186b1e2d8c649b7942b,106,75,347912,80687,267225,180,135,556892,79454,477438
90e1fe30d67a392bf65d5bd3dc9064c4,114,91,226596,47343,179253,104,87,206239,48201,158038
0c84cf2fee9cb2102a069c0565b85df2,80,67,135712,27642,108070,80,65,98560,31855,66705
b759acf0945c66e94caee6f1eb3e9ebc,108,89,255398,63323,192075,114,74,274131,61771,212360
539c45f94234710f7e62567b16c3615c,111,84,225857,56803,169054,103,79,231261,59665,171596
ce5f629352cb05baaa0e8320e64d8bc1,117,78,194334,58350,135984,84,63,149032,61131,87901
f78d5766a3d3faac7c2a8756c0e0f21f,182,110,418018,70039,347979,146,115,368015,65087,302928
e5a16318acd1537adc7b4f3479b16679,95,66,133905,32683,101222,95,53,102460,35906,66554
be19888dfe9b6b3bcfa5838cb024a492,148,114,340848,90840,250008,108,71,294410,52658,241752
3d02853ab34c53ee97b87908dff56cd0,135,108,444770,122806,321964,147,102,347135,93270,253865
14e30fc6683743f5c00d37fd37906e10,97,73,217051,80253,136798,169,137,424284,87457,336827
8c5726d5619f2dbf5725f7c6e9005f65,13,16,6094,2508,3586,20,12,7015,3316,3699
4d82551ff2b8f1f2e5c48e4315d7df47,23,18,7103,4482,2621,24,19,8076,3316,4760
70787af6943b35f0b61bbba611e6ba31,36,32,30842,9534,21308,36,25,28574,10368,18206
678a3317cba87c61f39bb00d7a479287,58,42,73942,17134,56808,108,59,124122,19640,104482
8775a6eacd5541da57a093807f4eaecb,23,18,12364,3863,8501,33,23,17911,5238,12673
ad1232d6214cf2c6c03c2d8863a1af4a,89,61,120204,27173,93031,64,43,72823,27060,45763
4f48204a4d02955fd8677c9a7ebfa642,157,128,408609,83598,325011,174,121,427811,51104,376707
a4fd218db0d8311a1d5e19f98317b0d8,165,149,570951,157161,413790,143,122,533751,138515,395236
ab6fad527c4bfb8566e424bffbf3db40,149,108,360933,60095,300838,133,108,380563,63678,316885
4cdfc440dae1f6803b6826f59113dac1,166,111,404935,80342,324593,172,109,583624,96023,487601
dd687ee90ba465fbe45af9ec1e857fae,48,43,64212,31715,32497,63,52,102803,22187,80616
0222fc771ae30078af593c1356e3c422,60,51,84045,41331,42714,89,69,145327,36078,109249
93f079ea0854e823b710171f0b75069f,67,46,87707,37475,50232,76,56,120271,30134,90137
d5c489d187296340cfa256dbddbaae93,62,53,81175,28493,52682,86,71,121837,18894,102943
e22af9f8a68867bae5fd93a078c0cd41,91,61,123131,32561,90570,55,49,76872,28146,48726
028cf32bf42b7df51db8415410372ed9,62,50,90540,29676,60864,78,52,121224,23403,97821
efa975a2af16c19ee6c4370fab903ef6,183,137,522954,123433,399521,158,126,472902,119138,353764
606ee7eec0c4537468bd6534d183078b,39,27,26507,7842,18665,56,50,51613,10760,40853
5cb13d69eae109d06e041638d5906317,42,35,41148,14842,26306,44,30,27109,12389,14720
f938da4925890d6e3ce6a61a77f6cb42,21,19,10184,2861,7323,24,17,9400,4179,5221
054974aa90fc6afe64c66c720b512968,111,64,433492,68179,365313,61,50,172902,79981,92921
3b1d86591993287c3be32c1f5039fdc9,84,63,153045,37557,115488,69,56,123812,41317,82495
2fa271a1c2b00f69453ece32512b72c2,57,48,74415,20367,54048,54,39,59795,20572,39223
91dafe682fea45aeb1db65eb6a298ac3,154,101,440787,82401,358386,134,99,342653,96230,246423
19c2bed86a3e067727792ac1fad36ff6,64,51,97670,33419,64251,70,59,118877,32238,86639
7471f4b1d5428e37356381f8502731cb,31,24,19916,5348,14568,26,35,14182,4582,9600
1662bc6dc199d69716fa33b48777884d,71,58,85165,30971,54194,93,56,124295,28353,95942
00c1be45c6a299fbdbfdc273021c5777,104,89,208069,55743,152326,88,88,132641,50096,82545
ffe2837eb66be6fcf1949adc06c90776,71,56,102207,30201,72006,104,92,186568,47310,139258
7f875cc7cfdd96a6186fea5eeeff2f8b,70,56,159377,37893,121484,73,53,128625,38252,90373
520dd8c99f34f9d78847ffe7679375b7,58,51,102085,17024,85061,62,48,68925,32651,36274
0f551912fff03ccd4b72c16ddca5ddca,130,98,339170,38419,300751,158,116,385169,38234,346935
8b881cc8905408801e8c8c8fa7dace40,152,132,400222,124628,275594,157,111,324191,112482,211709
aee7fbaaee9f5631049a1c90d51fdc88,71,49,111696,25468,86228,115,86,207047,39266,167781
62c1b710f8c9a6093eff4a498649611f,112,89,245070,46964,198106,107,92,220645,51176,169469
4da8b0cec625107326fa70b0be1ebd22,76,57,84787,21269,63518,80,67,94735,20898,73837
58a362ed2a5fc72871df8df6da434fdf,52,46,74242,39339,34903,58,44,87200,32997,54203
c8bd9bfcf5f3db77d50ef963f8cde4dc,43,30,33931,9936,23995,48,41,53782,14292,39490
662402ff35de632d145c00eb7ef8df62,87,68,124080,35873,88207,134,102,205376,34284,171092
3bc6fb174b217f8c042970e1457622aa,75,53,115212,28489,86723,82,68,136089,35216,100873
1c199eec87b910ce7f4c446e5a51a35f,111,75,231565,94820,136745,121,91,233763,83340,150423
42ea1df13ab4440a19512e85cc522fb5,159,135,719498,120786,598712,142,115,477936,133717,344219
c254bbc6704ef057e3ed88cae0f5bcbf,24,21,17297,5367,11930,32,25,12059,7302,4757
2f016546104f54018255509b587c3dad,64,52,86998,22060,64938,54,44,78414,21520,56894
17eea153f534a09605e8085f96dcea9f,3,4,454,307,147,4,4,305,466,-161
589c4528c9aa5c38ab790a2d91ef95a7,29,20,13674,6875,6799,23,16,14840,6254,8586
611112f1efa18547f8f9c7db2fd78c5f,113,78,250082,57178,192904,122,95,272499,51225,221274
be7bb1bfcac73b97c253bbeb51523008,138,124,382797,58324,324473,75,70,146984,70862,76122
e9d901043debaebf39f3ac7da5ed5829,166,102,339484,52088,287396,100,73,213494,64528,148966
601f660bf37f4a9987ef7236008abd0d,96,57,100778,20669,80109,82,62,100721,24328,76393
cffede029990dd6a5afaafb9ed41cc65,28,22,11950,6078,5872,29,26,13169,5425,7744
955290b8e655df97a3542b86e3354df9,104,81,291590,62581,229009,119,106,274944,56652,218292
4ae84f56b5ff4ac6eeeea45a7a382526,20,14,6324,2947,3377,23,17,6532,3313,3219
8ac6b9980419b6db09bc6d57ff38bc30,48,40,73865,22754,51111,43,37,71746,24711,47035
5181cda1680e71602d61a4abaa23b0b4,39,38,31015,12488,18527,43,29,29645,8018,21627
9dd0b23ff5c21972b321206fba59f7ce,36,27,28130,8889,19241,34,31,34081,12277,21804
2ffb2b2fcc401a15a562001d27b54eb1,75,55,96049,34521,61528,56,46,59183,35246,23937
d56117d8a1ce84625087818097254f3c,53,46,92037,28257,63780,78,66,106630,31663,74967
6ae7e76175315c2d06056192543d2694,159,132,641843,137809,504034,156,122,633478,136040,497438
545b76acbd0b4506ad32c6657311d309,68,50,122491,47253,75238,52,36,105347,29398,75949
066112c2e2cf5a4924eda7e3f3f847d9,72,72,91775,26286,65489,65,49,95010,25686,69324
045011bada4cef77f6af4eecc4f3b97d,65,48,117669,22708,94961,98,87,114108,32505,81603
aea1afa1fb6bc97b5c48e10c7d5f61a7,192,139,1007406,242848,764558,221,154,871184,183815,687369
e653b6026bf3d0b8c80de31a771ce4da,19,13,5195,1873,3322,22,18,6425,2993,3432
e2138d588c889cc3daa34a89b56430f1,25,15,9024,1987,7037,20,15,7955,2030,5925
de13316eafe0e97121af9858e0257d53,43,30,46485,13219,33266,37,33,35422,18500,16922
862f22259fe77492770263dac4e72fc7,25,19,16798,7279,9519,33,24,20909,7300,13609
9d04469ae5e9530e24a452b37e8e3ae6,68,60,125028,31234,93794,63,47,83843,21210,62633
2e790d66c320dcae293b44016e136cb4,37,29,24914,9450,15464,37,33,30688,7978,22710
f7bbeec4408040942df5b7827bead278,54,50,76065,27872,48193,54,42,74655,21378,53277
4623577bd952fcfd6481cb702fd128f0,161,119,494511,83939,410572,204,158,572506,96805,475701
83caa4009fdd6aa88fae241155714c03,150,125,440655,78754,361901,117,94,263861,76540,187321
11ff334f3fdaa65fd7435d4660d68384,42,34,42454,10822,31632,57,41,41246,12220,29026
6c3b26b5c0993a6f090ebd7f49dae343,116,99,177072,64387,112685,135,118,334963,66522,268441
e3ad8fc4f31aad7dfe5d7a626a44f1d5,31,26,18141,6510,11631,32,19,16808,6517,10291
59b4f3bdc5e3735a5daa28533f9508c6,136,95,611350,90440,520910,200,171,760859,133493,627366
14591090792b48c617a27bac08268c23,25,23,16147,10837,5310,38,21,30229,4868,25361
a7f9898816920c099130a4ef9951a691,98,51,156642,50742,105900,98,68,204459,52455,152004
884894250c50f622c5165fb48e33699b,104,86,242682,57751,184931,86,69,229485,52496,176989
641cc73f9289688d7b5cdcccbb58566c,139,107,363494,73497,289997,108,95,272941,68806,204135
6615cf36cfefcafc96f83fe52678a32b,29,25,17180,8366,8814,33,30,23026,9729,13297
d1a644de8fdea04a2e0d11079a26a116,79,66,129671,27228,102443,85,61,119793,22651,97142
c2dac6d66c5cb146d6c3c96c9e842428,68,60,100729,23992,76737,62,60,82346,21736,60610
716668041f63debade071effa82fef94,140,120,317725,74761,242964,153,120,559172,70186,488986
f2ad255e85e920845bcc0ba4282d91dc,73,54,153627,54615,99012,108,84,232551,52019,180532
dcf8f45ac549f08f55af33704d0fc1e6,56,39,61805,19517,42288,52,40,59520,20408,39112
728da1b22b81cb2d68b72042efc9d517,151,112,490462,87553,402909,156,113,401224,66856,334368
e76ded2c83d1c52ce98cc229785e2fbf,29,15,6831,2800,4031,23,25,8661,3251,5410
b7507c1e384ca57b1b9390a1b1686fa0,30,24,11215,6070,5145,31,23,15403,5047,10356
e46f7788e37d54ad0efa2987e95c1bbb,90,48,106750,22447,84303,65,43,76950,30653,46297
bf30fc6cc7c015e88d2b8fa63a8f95a4,60,57,98716,23172,75544,50,37,83319,20817,62502
0cb145bbd323aec3251b65a336fdbd91,36,24,30298,8210,22088,46,35,54261,13486,40775
9a66073e667e707326ac1f6869508ce8,35,28,26335,11267,15068,45,36,45545,10328,35217
22ca396ca3d296ac8bf86230bf48f8b1,46,34,59571,19085,40486,61,43,74810,19603,55207
2190f2ba50ab55b27972a9c529a5adfa,0,0,0,0,0,0,0,0,0,0
f3ddcaa2260fe65231e314ad5858599b,153,109,355520,83369,272151,113,95,305338,86177,219161
136d459608ecf0fe3b71c2a3967281c5,126,103,408830,82801,326029,147,121,495310,93980,401330
bf6e87308ba1ad39230dee6de0c1b576,109,91,251162,73053,178109,130,106,372750,75491,297259
d95ece96c5acf62f8a7ea5c7c5cc42c6,158,142,533730,119078,414652,187,148,624986,89433,535553
a972a4224ddff340d37e7f3aeb46ed57,30,27,23298,8081,15217,37,26,24959,9275,15684
76f42daeeb8e31b3a11ced684d3a98ef,80,60,162962,45766,117196,111,83,215073,49185,165888
0bb27a9f9544d9a57cc9e5d97d973bd7,119,101,261096,62018,199078,126,104,280222,66832,213390
b5999811e96c8056434d0c040bc3e2dd,124,99,260936,59101,201835,110,90,231109,50962,180147
fcf6e48511ffc7db965a71ba9906f71d,30,29,47940,12946,34994,38,25,33136,14399,18737
d41fe5bba194e402c72b148bbe62ca61,121,105,279302,60024,219278,98,63,186332,50066,136266
c46313d109b03e2b7909e498b6d0da79,56,53,60030,23021,37009,79,51,65827,19130,46697
5575f563eae9ecc0692c2e8104402628,13,17,2944,3858,-914,20,12,6241,1378,4863
f7074572e62fdc46068aa6bbbfc54186,81,77,131043,43827,87216,82,59,146418,31812,114606
92a54d39b97fbd6a2cb5aa0fa0d31140,34,31,44873,19455,25418,49,36,59469,21996,37473
fe2eecc192a8c96123ebe0b59ee679a2,34,25,19507,8676,10831,29,21,16819,7766,9053
4f623b528a29a14201e61f28e861a48b,84,43,105646,29462,76184,107,77,152379,37634,114745
0d1f2e8eab23562fb68579540abaa231,112,82,236184,48616,187568,96,76,162501,80658,81843
da1da677ab358798d9c60e438d3ebcaa,142,117,304214,77508,226706,109,78,179850,74862,104988
47d9d930ea9dfd29583d1d87071ef416,18,16,3737,2063,1674,20,19,4898,1755,3143
bd7825ad68c36a97a21995fe06ca5523,75,60,167352,91254,76098,153,132,393061,87468,305593
24fbe881df7e2ddd41b1a51af029b60d,186,125,397660,88567,309093,147,119,367011,113578,253433
94195aba85305b042aec68ced5feda68,47,36,43323,14422,28901,56,39,51294,12953,38341
7879a664c37e2768a5f0802ef357851e,103,71,168419,41618,126801,100,72,198236,41058,157178
61123f987f42d6335d329a53c609d113,66,55,84614,24633,59981,59,42,72071,25103,46968
2c86e0820750c9f7213ad583e55400db,178,116,498344,135198,363146,152,129,438248,128829,309419
e4ca6413be432796b3044e101ef9a05f,81,64,69829,17013,52816,46,50,57804,12520,45284
015072490fa1a04e4825d5e2b723b7cd,66,51,118864,27891,90973,81,66,122266,39195,83071
b86d2b13579e97d3b69727e222190b88,103,81,232558,57063,175495,123,105,263707,79095,184612
807714c7243d2310a35e6ca7194e7061,175,118,666206,130275,535931,171,136,750445,126170,624275
2b90c260afbed3f9e88553263f639762,108,79,236207,56253,179954,107,93,261823,56000,205823
d3d6d31d4c150868520d64fed1dda24c,22,14,4444,2285,2159,19,16,4003,2654,1349
7a7ad471144c673a875089209b6507a2,52,31,64893,13350,51543,41,36,49221,18321,30900
423143979175537528dd0174a429458c,17,9,4356,376,3980,9,14,927,1331,-404
443d84162611d5d15c4a003fad6fa4ef,112,89,224917,70319,154598,172,128,417012,67760,349252
a1ed2d8bc81cf649e2dcddd3378d07f9,69,52,56032,31377,24655,103,69,138168,26627,111541
8b4195e789cf1572db0f348805223e4a,44,37,67387,16661,50726,59,60,89312,19098,70214
9375757864ce0371986fe72ef82d5e90,124,90,352903,73824,279079,124,93,287232,72453,214779
18266d3c6a4b42c31574e2891791edf4,226,148,1028159,218754,809405,151,96,1430761,154536,1276225
147131b91e86786885c898b9b4031a6d,120,106,286347,72753,213594,132,116,410754,61179,349575
fd90328efed454149d2e80eda17d5c6f,142,125,332918,58823,274095,114,109,240861,72519,168342
c6cac769629a87ade6028d86a10a78eb,118,93,228705,62212,166493,126,83,235536,52201,183335
1efdbdf00c31781ff8ae6b1f427e7bbc,117,102,225317,70439,154878,92,81,199770,81226,118544
60b3846ed1104ec07814cabc1c546faa,143,107,470598,126329,344269,136,121,462322,88972,373350
b8045d8201576bd187fa080690d359f6,59,47,110546,49555,60991,86,58,164634,41959,122675
199dae862064ceac3b8de91e3cb64c25,35,33,21042,10319,10723,36,27,27308,8630,18678
9a271da30f20cff6ddc18b9d358b7d7e,93,66,132051,27260,104791,76,49,84103,26566,57537
cb5ae11211ba4c5b8129ab3de028532b,20,17,5674,2814,2860,21,16,7780,3519,4261
33b4d4e4ed44d66ae836680b97194702,22,21,9550,5675,3875,21,23,11120,6629,4491
1da6cbdefd18c53bd2cd4127d06d5b79,29,24,13659,6003,7656,28,23,11870,4610,7260
a1d4b51586875a12ae19f22e935de4be,171,130,818696,95444,723252,194,144,624462,123624,500838
0b04014d1402ffaabd206ae6dffcc4a5,80,65,117658,30414,87244,67,52,128924,34387,94537
82f64e8d8931aabd595d95737674cdc8,106,76,243237,65673,177564,100,87,207613,66230,141383
204c7d279b4ae40504e12a267e18e604,34,31,31633,17495,14138,44,32,45255,13514,31741
eb6ba3f3e1c5248884a026790f0925c6,226,140,888688,177366,711322,192,148,962656,144000,818656
fc72d87318267d2982f5ceb1e9ab95ee,125,106,278326,65024,213302,111,87,248110,55069,193041
26e9e427b5ddaf3cb2b9620e128da14a,72,57,77781,21535,56246,57,43,76443,20371,56072
a2ae17860fc7fdd8a68252f91da4bf0e,122,107,263527,76187,187340,155,115,381372,51562,329810
3789708fe9e34476710773c1d5745fc3,28,22,13012,4499,8513,21,22,12166,4786,7380
fd89913e47bbecd797d2c5c3a6aa707e,127,78,273737,62030,211707,135,104,313654,77711,235943
2e15b2504a402b717162f8761121985c,37,29,17797,7886,9911,35,29,18580,6415,12165
465fc0ea58eafd3c9b24f53cfe237452,61,52,95467,35657,59810,79,72,99060,30411,68649
77b165c494a7bbf3c22f5b8c2af933f5,171,104,418638,73081,345557,106,84,246906,85572,161334
1031d3ab31ffb3ada55ee65c2c454f39,2,0,209,0,209,0,2,0,209,-209
ecf882fe5a243707b1882e8b5f0255bb,107,75,190791,32978,157813,114,96,226977,50678,176299
5d5c8e8f3cc778bc1e3aad17287798ac,46,38,52875,27184,25691,70,56,101275,26008,75267
4a9f41d0f0af69ca5fc70d2d74f81f61,157,105,422968,107893,315075,166,126,527770,112541,415229
c104dcac93cbc41c57392c40c784345f,85,60,158014,36068,121946,104,66,151383,31306,120077
1f9801d2d8a15be4667b9f2dc4163442,48,41,43122,16198,26924,51,38,54504,14416,40088
adc7758d320b0d4f522399c2fa1c769f,69,50,76077,35688,40389,64,52,89651,35939,53712
e8936d45df14843e005ca10ae7ffe380,149,109,463812,105325,358487,170,95,538481,62107,476374
28bde5f44cb4d9ad96215ecb902f4e74,28,21,22667,4494,18173,19,23,14970,4972,9998
ee1975f50acfb0efb3a3316f7cb61929,89,65,133534,32301,101233,54,48,93399,39954,53445
6fe9d46b8f252d23cd308b5c2e92c23e,22,18,9520,4454,5066,27,23,11499,4675,6824
c3ebe7aebd8ebe7278fc9224c9c44b45,41,28,46289,10402,35887,43,23,30653,14672,15981
88db96d3e375266b932a1e248a71ed3c,51,46,77507,28019,49488,66,49,66160,27403,38757
5e39f33e84eed7c646fa3ca6060aed7e,157,135,409971,94439,315532,118,98,345525,69937,275588
a315781835722bf0db80fc701b33e147,60,49,78716,28459,50257,67,59,100340,25666,74674
f7c1822ac3d7e125515f59f6754cbf73,110,81,227846,53561,174285,122,99,287282,72085,215197
11876e1d926184bd975e206592fc98ca,114,96,185435,48190,137245,96,79,195101,48457,146644
cd86d803fcde55d062a74d82cac879b8,152,103,244918,51805,193113,93,56,142714,59290,83424
6ed793681fcc0a0d8298cf7489e1e78b,103,88,256590,47429,209161,145,112,268506,51969,216537
f3d901ef853fbff870310ec2038b24dd,94,67,150003,33347,116656,52,46,90390,30196,60194
cc8d1e3ac68134825f1c5434504b071e,57,31,91988,20712,71276,71,54,115109,26437,88672
94efa0c1a5cfe013c540d886764f330b,98,68,216756,71008,145748,93,81,244509,75147,169362
07423dad67300bf8553ff20b26513263,77,65,140490,55064,85426,97,65,169852,38424,131428
d715eabfdcf165e4ba8b2e444976d076,107,85,223970,73085,150885,101,71,283011,59671,223340
c91533154d2483a2bcdf1b5c50e91e8c,64,40,71203,20304,50899,57,47,85092,19047,66045
983001e2373756d3d085ae861ded5249,139,106,320645,37129,283516,119,91,184299,40151,144148
eacd4ff8d80661dd7e29c237a45103b6,64,42,95972,22179,73793,64,46,112918,28168,84750
2c47c5b7a0985a4891b273a405c52e98,43,32,28338,7110,21228,36,34,19908,8279,11629
d60c82350b800aba2e73a0b5e7b590da,30,24,21710,9146,12564,30,22,19886,8116,11770
13f178d19175d274c1771636e57c92e1,131,84,380564,100083,280481,157,129,477891,90737,387154
253871397b1df82f30a79a3e48f9e46d,55,54,86463,27743,58720,67,49,71076,31264,39812
bf532d3ac6dd7ca896401c986a86d8f2,77,54,68774,28910,39864,61,48,97113,25945,71168
6ee3eb42f07f23f06c5b7adf0c2e2bc6,127,106,319341,68975,250366,131,114,333271,61866,271405
a00a7a4d8152ca141753d948d27ec64b,167,116,419709,120104,299605,156,115,305389,71846,233543
ea518dbdf512ac2d5914378c15ff5145,101,81,218401,69208,149193,142,116,314288,49650,264638
1b254783069f70b47cdca098cddba01a,126,99,268862,69951,198911,98,76,291429,77805,213624
4c7d3859e590df04dce8ad8361d69a2e,24,18,6604,3517,3087,24,25,8845,4418,4427
514f36bdb6d69bca8b6d5674ff566319,22,17,5595,2952,2643,16,11,3658,2746,912
4147cc05e8bb5de28cbd8b91db8cf2ca,32,21,10147,2827,7320,29,26,8903,4977,3926
94a8557dbc227eef14422d25f55b6970,102,74,219015,45495,173520,82,65,140957,48216,92741
608342f0e7fddacf7a554d9d2d8df2bb,46,37,42359,17977,24382,43,37,44422,13461,30961
3d91f6d2e7479bdd3eb23c61f66c057f,4,6,280,882,-602,6,4,1001,217,784
d4682603a1eb3435a6df7858473fb18d,87,73,182357,62992,119365,124,94,267133,42749,224384
558c77687ed19e3b1263f3c4714ee7a5,113,90,271745,93201,178544,114,95,368169,86979,281190
70a6a8990f40774458f13c037e4b1a4d,146,116,358667,84610,274057,124,83,248967,69410,179557
1b73425349f0a846e37fc6e160998ed8,14,12,3850,1798,2052,19,15,3437,1209,2228
42dbcef7a48409ad016f743c289ea34c,149,120,511531,101852,409679,130,111,467924,127191,340733
69eaa9027fa41f87feef6660e4e42f50,95,64,257889,93141,164748,128,106,325183,100325,224858
f66e057605cd83b3f477c536ef937f85,45,32,28930,9096,19834,39,33,21386,10135,11251
57e2c063fffee7eb89a9129f57392463,52,34,58187,16035,42152,63,40,52641,15284,37357
60ad6f5c9e06638319919b4ecd20853c,89,69,108821,20312,88509,81,72,85062,21911,63151
cd9b8255ead24cbc05286c6b92359234,89,55,191062,99152,91910,161,100,489323,99779,389544
8d8069653cee8020693c744c9e40522e,40,31,26935,11635,15300,48,37,37676,13669,24007
0cdc61954a1027c08f0a06bc95906e90,125,120,346741,79017,267724,111,83,269606,48930,220676
6310700b51386e8ef7e931e5850da367,194,142,829679,143860,685819,184,119,1109546,123338,986208
1d54af9af3ebe8c016d27126c586d6f1,113,102,243169,59396,183773,113,98,264818,71837,192981
751d6071bb6ddc0b0768664f597ded7a,53,38,58392,17355,41037,46,39,37718,16483,21235
a840b775c6753e7fe80dbf91fbb2f164,70,45,140099,95163,44936,134,95,311160,89764,221396
e55c9fd62768c4f97cf8ed411d17f25f,141,105,479259,99574,379685,214,125,572723,81738,490985
ac2a038e2d4f1350c0c31658c0d28967,163,119,430018,97212,332806,190,126,559705,70491,489214
f38ebc0a85729081eb5c038fe0e3103e,149,112,354983,91771,263212,146,116,377995,86604,291391
219be999cc26b0f415672337a446d5b8,155,92,327162,68640,258522,121,109,279600,111853,167747
598a928f54abbcbedf0a084ba3ee2862,45,39,62437,17600,44837,54,42,59102,16916,42186
1b45c217c8391263b67336f4f4e432be,29,20,16501,3783,12718,29,15,9854,4831,5023
abefe4acca3276c9f91fdaf98d076463,171,97,401663,61621,340042,104,75,300720,97449,203271
09671f0cfb9ee0a12bdd9c00e5efa09f,27,21,4981,3173,1808,28,25,7256,3151,4105
69956bd7018a17e0f1c641e263d52e4e,168,123,913902,143179,770723,202,166,1072162,174772,897390
e96626cb44f55f024a27ee934b548da2,180,134,637454,123557,513897,173,124,586169,96028,490141
3d0681626d93f07909bb4f8f9e964271,32,22,15607,4391,11216,34,21,13526,5925,7601
e36041c6f536ed0af8b3f9396a960f91,32,25,16104,5964,10140,25,20,13793,8041,5752
a63e2671e17f210cab5c35e2106dca63,69,47,80525,19363,61162,52,50,49540,23171,26369
3b07dfb988ce54bc28bcdd542e908829,139,122,395552,115869,279683,190,139,498189,106407,391782
a23d9e53235a25f617fa6429b8756083,119,92,260334,39011,221323,104,80,174376,46020,128356
ce7737321493e5ff75e4245ca2922a56,179,137,1000750,212349,788401,197,125,907895,196395,711500
5ff42ce9797656f7c7516190da52ae7d,75,53,137273,51059,86214,106,84,156385,33735,122650
5d1480eed3dd0716ff06691a7852c9f9,65,58,89354,40329,49025,98,75,143624,31417,112207
3dfed8dcaa2f55d61ce4ce5b980121be,45,31,58983,18611,40372,32,31,39160,20431,18729
8174be483a20c39c88e45f4c67732f0d,157,131,543999,158055,385944,190,127,660492,124629,535863
ebb578d1df03138ed4971c1610af9371,89,74,174888,46443,128445,77,51,128395,38551,89844
1939b75ab4995e23f8d7f47e438a6763,175,123,566514,72547,493967,151,109,391275,99666,291609
f2f78b2dce8a87cfe9d623650d38415b,65,52,66953,33439,33514,78,57,100866,30342,70524
4ee201b3d1035e1cc61073a5661933be,34,28,32499,7947,24552,30,20,14227,10855,3372
35a382dd9350c86401f142915ec6a94a,88,71,114963,33898,81065,88,59,118247,26431,91816
1dddd145a7fb106ed1d2a278bea25937,205,150,948957,141331,807626,140,83,777996,143011,634985
549ea89125814cb00fe1c2794d4fc0ff,125,99,473000,78308,394692,203,158,698327,85019,613308
6fef695d83f2723de3c47119a92a65c3,104,71,124061,36723,87338,88,78,174108,37787,136321
97132aa069f91776a973346ac4330595,98,79,200345,50288,150057,87,56,204658,39006,165652
98834aa11002e9a9a694d9b0c3f2fb0e,102,76,196155,48791,147364,107,76,222781,47965,174816
e709158d542d5bbe9cae8b0761ab3cc3,50,52,54263,31742,22521,84,68,112438,19482,92956
de65b2c35265dfba9ffc883e012d9e47,32,18,14757,9134,5623,32,24,22438,6122,16316
71fbfe6c575248fb88c9cb4ec8ed0d62,95,87,166861,50610,116251,105,94,228799,52871,175928
77d47a3d3afa25b1e5a2c9c206b75578,107,90,243414,53233,190181,133,107,284298,59461,224837
5ab9206c12866003b50e8b522b77a903,183,106,499547,62192,437355,149,116,383113,64980,318133
ac2d5c13b841d2707d0dc88960f8d9f9,34,26,25435,6756,18679,35,30,21530,9305,12225
30a86920309b1c4bb7855483568972ff,1,1,25,75,-50,3,1,418,25,393
5d29534246a25961ee843af2988ecda1,23,15,10244,4646,5598,19,20,8434,4631,3803
51e2162d45190922db812a8351a5dba8,87,60,213980,38778,175202,130,92,413856,44420,369436
d557d4a9e95605968a196a86bc6edfab,95,73,201711,38831,162880,107,100,194764,61870,132894
eab2a98194b1066abc68aa09b4432514,80,68,139912,75188,64724,126,97,260601,54985,205616
83bb9454c37b4a5fb84eda0fed550e86,89,76,207093,51264,155829,83,59,158832,49680,109152
da43e75dc79fc5ff3668f36497ef9792,119,82,247120,41886,205234,119,108,218008,60345,157663
ef0219d39a583d19b26eb93cdc2ead0b,41,31,27647,11564,16083,38,31,31495,12717,18778
46447d9c90acbdae8b6401f34415ac6e,27,20,20408,6751,13657,30,21,15607,6909,8698
e5244554e8a3182a5eefa987d0693844,92,64,116843,33825,83018,75,54,89475,29541,59934
40b88fd327a80b082a25231ef822796e,61,51,80432,25720,54712,113,86,184269,28730,155539
c17043aa2d392aeb63496f1dcc2704cf,86,65,143217,52022,91195,85,73,165535,50288,115247
e5212bb36a76ffbe9791dbfad4e0bd5e,68,67,113704,36512,77192,99,73,132747,39257,93490
6126337220ab7665767959359a99e157,190,147,965109,219060,746049,170,111,651197,140102,511095
8f47ad51d1526e08693b4619f731e521,66,50,72278,28249,44029,72,52,79279,26077,53202
e36f2db5568adeecce96608fc1fec47e,115,78,272358,66627,205731,143,110,431946,57455,374491
c25cd3b929fc78090ab97d4022393a1d,90,54,176320,57762,118558,110,79,201488,78712,122776
f70a2c4413b3ab5e625db41202de40b4,51,39,84708,25517,59191,44,43,72947,19407,53540
2154c68da2c1ed8e4dbdcaefb622ad39,45,40,59014,21881,37133,41,32,67464,22230,45234
85a0191663a7e034e4dddc313a91b99f,136,103,216566,53328,163238,102,74,210088,36406,173682
3035c1d2befdc9b917db798ab0c3ec53,182,153,569841,79131,490710,144,117,353247,84717,268530
38975238dd958f0ae59f0d7ecd9e3d17,53,39,49206,17486,31720,42,37,48677,15553,33124
887927d907f8e06606601199f7469bce,137,107,355490,51965,303525,141,109,252817,44979,207838
5e9fb151722592ac8a05aee7f0ae9871,124,93,554071,149518,404553,197,138,752696,114465,638231
443d98487718661f9628cc4cbd6e6888,106,88,214300,62100,152200,74,65,157196,53999,103197
92d12dbc05b8c0d1733e6f90525cdf83,40,34,33079,13396,19683,46,36,48413,13675,34738
97c159c6fa4b14b50ffa6f4a9821f3d3,2,1,51,45,6,1,1,45,47,-2
747244821b5aeee9e92ca859312f7c98,54,56,92887,29368,63519,47,43,66568,21398,45170
2441902a5d8730430e17c1e2a36f92cc,181,143,698979,144933,554046,194,141,784030,149074,634956
2b545aad2588c2b7aa0698d828a8c75c,50,34,57662,11594,46068,47,31,42788,18919,23869
a349a975b4ea3f49797e83ee79175d20,165,130,737446,138721,598725,208,137,777742,116118,661624
dbafec0e76b836ea01cfed8832558397,137,86,476629,82281,394348,151,114,416225,96898,319327
c8108f6251c4e66d6e21a3372703849e,63,46,117948,16504,101444,54,39,51254,22563,28691
7840c9427607671b916ee489cced853b,25,18,10252,4729,5523,24,23,8866,6656,2210
70a49bf5326ab7c1a060d4d6bd1feca9,52,33,41466,8716,32750,38,30,30471,13293,17178
f9fdd5e1391e853fec78256f7492514c,54,39,43684,20912,22772,65,47,40098,22977,17121
ab7a9df341dac0e517e7cc4c580d6289,204,161,633943,113421,520522,152,134,521766,113036,408730
1d5c97f095ff5a2cc8f900e47d4ff75c,24,15,8298,2228,6070,20,16,4517,3539,978
f9157b755d8b60975c28aaa154ffc775,66,60,122058,32198,89860,82,65,108307,28899,79408
d2439e0c887b99b2891aaf38e06cf58d,116,79,231940,41521,190419,93,83,141988,38191,103797
09efcd0c0644229e2264fee77db8be18,40,32,32622,10955,21667,50,31,29272,11112,18160
2a1cea95330a250a8ecb7131173ac999,0,0,0,0,0,0,0,0,0,0
2d10973c60dda709ac65970d03bf69b2,167,102,434866,75555,359311,136,116,308522,104006,204516
67a1f68ec203f5a65dc92f4f0acb1f49,94,68,201572,42344,159228,80,64,185999,54623,131376
5e70dbf0c3c0b2a33653fdd4736c58a0,173,114,500454,140838,359616,189,133,582506,74347,508159
34feca3803881d3a11b86d40a9d611ac,59,47,66502,18051,48451,76,57,95153,23613,71540
4d79f88458de4aa3298514df340ba38b,56,45,72739,20152,52587,59,51,70402,21215,49187
33a450f6c112a964aa8d488462cea308,192,143,723937,143364,580573,170,133,707290,144843,562447
4618ebd691c57802ed00e7e2f051af04,86,66,133044,34915,98129,70,53,96814,48719,48095
a57359912bfa7864ba15f3756e5f6ad2,55,38,44195,14404,29791,60,44,51679,14437,37242
e75288eff8e8d0261253c3f65473c57b,42,33,24898,13001,11897,50,36,45446,12864,32582
4c2acc0d7ac87952101b4859e3fea8b3,202,132,820696,164601,656095,198,165,877957,191666,686291
703744b5b9a1e7bec0a5d5ebfc4025f3,102,89,183381,42659,140722,85,75,187455,47685,139770
fb05d5a23b4e2f730210152c8dde03fa,29,29,15882,8211,7671,31,21,15845,5902,9943
6176de9b29ae9d8ef221f6f59858f5fa,101,80,391236,121709,269527,149,124,460848,90733,370115
cdf335630733c3573371ad559f83d293,65,52,76277,28967,47310,57,47,61010,21687,39323
d16511bd45c2cac76e929e1169d21faa,50,53,44721,25584,19137,73,61,83003,23592,59411
867286b021b0d7a138fc7d441805a894,151,129,452653,100907,351746,148,120,493602,97832,395770
1446b85e6bfae42037831a991c4912fc,153,109,418301,104051,314250,141,112,382501,97155,285346
5c401a2f026be9f2d9974f67847cdf15,126,77,323870,85460,238410,184,124,485607,110120,375487
519845883dc08313b0d05a18699f941b,43,33,45257,14292,30965,39,27,35248,12285,22963
3272e64793a17842ea36b54c12fccc33,204,111,586034,67549,518485,167,131,459211,74684,384527
4aedf0bd99bf1197998e1621573d0b8b,125,96,561473,118587,442886,181,118,744502,78397,666105
930c489465760708c8801e48b8768f0c,84,57,113405,22278,91127,85,78,184271,31721,152550
0b396c421bfbc65e30b49b4cfb3363cb,210,148,831464,179833,651631,201,151,785343,144983,640360
8f038677388c81deccab093e64d5a159,188,157,517065,104114,412951,132,112,362861,97701,265160
aa3df0cf414eb81c52cd5aae90c295bc,37,25,24950,6798,18152,41,31,25410,7512,17898
21bf3f172f41f717f54934e1645a01a3,36,29,19769,9028,10741,41,32,24359,7149,17210
92995df30c5cce2f9955b392938533bf,208,175,1164264,216919,947345,218,161,1486929,217503,1269426
ee5a6fa37b4e4d7b36ada0b1b428e5fe,179,128,603939,95980,507959,156,123,605417,136802,468615
e0943081f9251fc187680c80cdaf51c8,184,140,822750,138327,684423,174,119,629059,108610,520449
18959f9c3e1bd7dc56a10e848ecde0c2,50,44,95004,37019,57985,73,60,116755,43207,73548
5bb0c1390182a474d240e0f33989940b,175,125,558696,110580,448116,157,127,528875,111889,416986
c261570a1f5b25413fc105ee8ad22b76,23,19,15298,10578,4720,30,18,31524,6512,25012
619edd9b7d07f8e5a4cb608771112c5f,56,40,115145,38341,76804,86,74,180001,34234,145767
ebc29f57fff4a1c55cf002b246e13ee8,37,27,18817,10690,8127,35,26,25391,8695,16696
11cd5b4c3944eb65f377901e3774935e,23,18,9086,3426,5660,21,20,6737,5095,1642
ff05b098f394969fa9b4d4d46290e98a,118,86,207962,49447,158515,116,99,197509,57866,139643
90be4a7fb686ed444518169e15e36498,15,10,2696,559,2137,12,10,2053,364,1689
93048eb0683f9b0cd9dd91033e642410,46,31,26909,7317,19592,42,35,24829,8303,16526
40fba6a748a2e8ea95053819422f45bf,88,68,277450,60369,217081,116,80,299057,62302,236755
2349dc4bd7c2fd70b5c4290a9c97c848,24,18,12752,4820,7932,26,19,11596,3750,7846
648fe4558c9983846781b080813a9615,119,104,273926,81066,192860,107,79,195866,48167,147699
8c0b8231070c258bd5d24dd5dc81bc54,114,101,297374,54796,242578,126,110,281766,56920,224846
8c795ed855b18e16f2e5ea439d861143,25,13,4827,1201,3626,22,14,5236,2526,2710
19244a9b103c1d12605c61287c82ba74,33,32,24122,8674,15448,33,29,20452,9833,10619
c1fbc2dc43a4d8f5cc76782799917c0c,61,49,121612,32219,89393,63,50,106344,33384,72960
fa64002bbcc6ce6d111d4546fadd1f39,102,79,198553,65522,133031,102,83,224613,56591,168022
ff75256e39493cc1305bc3201a581e45,174,130,468797,93995,374802,207,127,532877,66149,466728
a4ba313faee8a9cb81e03867580634e4,186,146,571612,87239,484373,118,98,372535,74661,297874
116b13e0506fa578f01767857dad9f48,128,100,288963,68774,220189,156,111,325097,63282,261815
d6c3612f28d2f8e750407eb0dd589858,188,143,1055730,262237,793493,220,192,1330802,197547,1133255
95ac3af22764bd3e44baa625f592bd4b,88,66,215807,55352,160455,85,60,130416,56990,73426
27740d8914cd847342cb5a948579d363,194,160,715978,195055,520923,163,128,860032,155873,704159
6b69c27138258f7c24da1e4efc933180,172,118,330319,97516,232803,114,97,273280,96081,177199
d75b9e5b4864a4d14e69debb1cfcdc8b,139,113,271440,58418,213022,92,73,233955,48935,185020
255022fe16f84f028e68757178c27d13,64,49,60432,16536,43896,48,40,43271,13003,30268
95e9f5a5923e6a9421dafa09fa74a952,118,91,347418,72246,275172,155,114,421064,132259,288805
5f25f98cc187b10f015df78f0bbef8d0,142,119,459044,105301,353743,172,103,393453,89683,303770
d702e755566b7a80d3566365ff7999e7,169,129,444802,79217,365585,158,124,537415,72077,465338
478e959ab9f96e8d5615924bbf375fc1,48,35,63470,16783,46687,50,40,52710,21368,31342
af0fc7bbbd9cf647b7595b41694c5589,121,86,212770,57530,155240,81,61,144016,57008,87008
09297eeb42709ea521c2e85c29cd1970,64,56,82937,23964,58973,66,64,69431,23510,45921
5e2420f531df05fd0a90d6923ce6987e,104,92,244281,53212,191069,106,84,187679,64796,122883
7844f2bec523d83dc27907605a15e9ed,130,93,310394,67589,242805,157,126,525426,89079,436347
48aff23cc94fb5e349400f94d4caad35,44,30,41287,17354,23933,50,45,61357,19506,41851
597269e82cdcbb918d4dd1871e4e674c,104,91,300877,62027,238850,87,64,188402,53389,135013
37c287140c0c65ea285c6d3f9eac1e74,27,24,14326,7263,7063,29,25,17430,5851,11579
1b461afc05f55205f36abd855b0a5f69,115,96,260099,50889,209210,121,98,269596,61269,208327
8dc5e1ebc144cdb414c26f64370f17b1,173,136,496309,71089,425220,157,126,520095,84678,435417
7813461148c04582cd651758e7a3575c,62,37,63244,20086,43158,58,55,71247,20429,50818
1761bef005169e57d948ed43afda7561,94,74,212274,52841,159433,82,71,201844,68409,133435
84cb5d70702802a4d40e8f4c74977988,126,90,273885,80244,193641,112,94,250186,58547,191639
582142c94e4c442c6449faca1e978f2e,61,46,130443,56917,73526,88,81,194812,49258,145554
9d4a4a364d71ad58b5256efafe078977,0,1,0,75,-75,1,0,75,0,75
bae2456808a8d87867a79c29d463849d,203,117,676811,203177,473634,208,146,760508,154613,605895
3e3c2c35f57453d3745de6336597d4ef,183,139,408770,59403,349367,149,123,423318,84285,339033
ec68a0d2167313da96ca4f11828c4662,168,128,479697,86148,393549,171,143,480984,84438,396546
458d7bc6efeed6fb4251542cdae409df,76,67,103638,34304,69334,65,54,92553,24431,68122
ce9723c8e1ed6c909f365ae97e052fd8,55,42,113554,40397,73157,71,64,176420,30899,145521
48954a06e8534b7e2b50bc99b4916f37,192,156,1040623,115502,925121,146,106,494918,133166,361752
fae41ec0c1dd17becb3165335d61e9d8,141,116,536483,87330,449153,170,129,506748,79159,427589
988a53c0f6aedf2cd5455dddbf6a113c,96,75,143063,42695,100368,82,61,124613,34040,90573
bcd8ba2668bc6460fc70ffdee2c9a41f,93,63,128252,20559,107693,67,60,77083,23304,53779
405ce33dcdfcccd15295720928b45979,27,23,12911,8795,4116,33,19,20409,7468,12941
97d4b27d4f9abd4b6a7c8dedbdf1d9ff,132,115,403893,113604,290289,172,132,400256,109177,291079
09e78409f4c9093536b80e8c4706acee,128,101,347975,102587,245388,163,141,458482,93376,365106
f156a83cc4c8d9337290bfdf78d338ee,70,54,120910,34564,86346,80,79,133501,33831,99670
1461538f6b2dcd6540aa0af147e0ac25,98,59,158117,32961,125156,81,44,114224,40561,73663
7b4c288c06d81cde6d677027f6e382c8,64,49,95294,34076,61218,87,74,133658,31394,102264
b209c5de5295ac5c485492524fc271a3,134,104,310764,109898,200866,88,63,220826,100322,120504
4e0b17288449365ab0089acae8caa024,63,43,42782,12113,30669,38,32,35298,12124,23174
39f864febe373ff27c593310d3929bac,74,64,155758,49555,106203,78,58,200400,40451,159949
fd863b084efe651554d9ad75c1c35385,20,17,9169,3015,6154,22,17,7598,2814,4784
929a799ad0b848279c7a7218f9c3a211,107,76,167927,37615,130312,94,76,160604,33516,127088
dfb7abef1d2f64a535892ecefabefa2b,82,67,83624,23255,60369,108,74,90531,28924,61607
9700f65fc19520892c4450961ab306a9,85,65,194201,45499,148702,85,72,158132,47637,110495
8195a226cce7204f48e1d1ff73f2380c,53,49,79816,19485,60331,52,46,70485,27635,42850
989337e6e5397cd9bfb6d9883426daf8,17,14,5230,2022,3208,15,17,2947,3025,-78
f51a11de59a69b952217f835ca58a048,121,86,306936,85721,221215,159,128,384281,76365,307916
8bf06cf43dc41a09a8e65a75423fe6aa,32,29,15746,5612,10134,36,28,10330,4634,5696
c25b80b1b87313a12a71528a4f9eb11e,30,26,18365,6510,11855,38,30,26243,8388,17855
473a95b5314f65d4ccd5eab02fd3cd68,76,62,124788,33424,91364,104,81,151429,48370,103059
068d1bc3aee5129a598bca706898776f,164,128,1007818,184077,823741,245,184,1493090,211073,1282017
e33b6bfe2bafba7c34583c79b4f968a7,107,89,246550,72549,174001,106,64,189257,65442,123815
2aca399ed25971d02443236df945b7f1,49,35,35107,14994,20113,43,39,28955,14138,14817
f1bc7c7c030f74645dff59c1d428e3e1,142,81,253724,48350,205374,126,105,273624,50284,223340
6629c9db4d1e497a86eab64ed4bd4f89,77,57,97410,36521,60889,69,56,104632,37535,67097
87d19426b6d234c2fc96cd834212fd59,113,78,244209,36485,207724,110,75,167864,48951,118913
13049b4dc5ff4861fb339ac6c9fa7ca7,151,115,478833,96595,382238,162,129,470505,89929,380576
47a794d452a86c3c6a33448f9b47e83d,200,126,533905,109788,424117,137,118,466986,130018,336968
3d268cfd642daa25a370e8514037951e,178,109,445702,99724,345978,177,128,612376,154615,457761
63673beedb1dff4e1a0e1c8cdb631405,26,22,15027,5683,9344,24,15,13456,2739,10717
fac70672e5b932499702e6b9fe940925,146,119,375047,76630,298417,167,145,441144,97382,343762
2a58bb8aee12931965cfa53bf42b32c2,30,28,25278,7948,17330,26,21,16900,7316,9584
0c606d7dcac3f76dc150a14ef9fe1310,83,72,138785,32212,106573,86,66,160046,36236,123810
9d68b279381b930cc96dcde961af2306,126,106,313137,67155,245982,161,114,336618,73360,263258
1b4901e14aa77a9f8a5bc441cf69c94f,35,33,31715,11706,20009,39,24,28339,7374,20965
6eadce6bae28eb13f6f70f554df09720,27,23,11330,5617,5713,30,25,19173,6020,13153
50ff5aea194b83765b045831e0d43e9b,43,34,43470,18197,25273,40,35,41048,17305,23743
824a630a24f9b82e11d78a59152301d3,158,119,370034,90780,279254,173,124,496966,104499,392467
3bfdbb3a76bd6084931f93c72602bee8,57,49,58651,17456,41195,63,48,48074,24355,23719
4d1f8977fde7a867b9c246cf4ac72524,97,71,145291,47332,97959,94,59,117447,40790,76657
14b5ed418b457633c5a4644dd5f3c6d3,220,151,1091665,203861,887804,249,188,1183363,239815,943548
8d7aab649e88dab17f3b54b1bf8ae045,45,39,47892,19430,28462,63,51,75447,20406,55041
c9e019378a9e34035d75d459a135338f,165,130,615773,125744,490029,141,111,536651,112099,424552
7684c7923929c5bd221df5f0cef972d1,99,83,212329,61535,150794,80,53,202285,55480,146805
1d7fbad027bf1b56a83548530fb94698,46,35,31049,11394,19655,36,30,21532,14680,6852
6aee7f369d31cb15275e2efcc442d2e4,76,54,99952,23197,76755,49,39,59899,21110,38789
e084580ff01982ce167a8a34cecdc191,47,30,29584,12872,16712,60,47,47730,15860,31870
cb87cbb1026a0e16a36190634f625fa4,15,13,2719,1356,1363,15,10,1970,1228,742
f76624b585d7eb65ef08c3d5ac2832e5,132,113,333107,86220,246887,147,103,358028,79244,278784
e00edc07548d68675945d64d12c98e51,56,44,50123,19300,30823,35,38,46456,15242,31214
40ffa0ca38902d09b92e99e2f4aa0640,111,88,255025,40780,214245,114,94,205983,51464,154519
fe6194b84772dccf95f0357d273368ef,179,147,737074,178286,558788,231,156,854947,176563,678384
0b255490fda83e32e7e86ab6125b1f75,136,90,261471,62433,199038,120,96,197230,57623,139607
ef2d13c95c67ca595bc3867c69189dde,118,86,230100,49875,180225,110,88,208395,48977,159418
76e3eab131280a37101cf54f28cabb1d,123,75,511215,152032,359183,179,123,680228,179189,501039
3aa1904e536909f4ee850427c0356ba8,12,16,3109,2085,1024,16,14,3686,1818,1868
6849564f94cdf1d3dff1d4f525776e89,26,26,21039,8175,12864,29,23,14441,7430,7011
dd8499c7c86a255f3d520655a23f6301,14,12,2757,655,2102,14,10,2817,837,1980
3f00eecfad13120fe480b62147cfb4ac,131,89,263690,42415,221275,107,84,165892,54644,111248
eab4879fb845038f844dc5472c081d70,148,107,435326,111619,323707,163,132,413063,98585,314478
1c600d36004a2e8a1f0bc91a5acb3f17,22,14,6390,2483,3907,14,14,6494,1941,4553
df06ce99269deb9f550006e74f444941,114,76,363349,91978,271371,144,68,313008,82864,230144
7a97495080103a959cab33777126b13e,125,95,415346,103722,311624,132,95,384199,113656,270543
c26cb9ad629815031a41e032b12a8eeb,19,16,4734,2711,2023,24,20,8220,3055,5165
4f23c6c610feacb761851734650f872f,37,19,27744,4739,23005,30,32,14112,5866,8246
cb275ccd7c4ea9ad2b051ce43bda5f29,52,31,89786,24013,65773,60,52,82053,29740,52313
dd5829d227ebca05b5329f835c3fa86e,186,128,487538,103948,383590,148,102,464192,96225,367967
12851e02a9b96b0d75168e33fe227976,157,109,392693,65638,327055,152,122,368316,72070,296246
19a814f0da326b4cb61051f8926eb231,114,87,257984,60652,197332,105,79,245298,52570,192728
c2686306311f2375ee2ad068b8920fbc,41,29,50579,10942,39637,40,36,25405,16016,9389
05955342a1aaee579455400140e3d5ae,107,70,164039,90642,73397,125,107,292099,72469,219630
ff950a2d8f532b2ff7cfed24965e1a59,92,60,155992,44105,111887,77,54,138942,42298,96644
145a58744f04b7bd8914babeaa11901d,198,146,1003418,144543,858875,229,152,965316,158388,806928
df8be0565d6f129a0b641bb685c18eed,144,124,487893,95887,392006,144,93,401139,95613,305526
c7d020c615ef24c04f6102729aea41f1,168,108,393280,81615,311665,105,99,263713,101594,162119
eca4806242b3f2017069cf579bac85f5,192,156,733816,210080,523736,174,132,676387,163818,512569
e5ca80fc2c32d87899016092ddc13848,150,104,364765,75433,289332,130,108,365300,80841,284459
89747f9d0528d8eeb438e88b4382f1dd,117,79,216145,67035,149110,168,105,381734,75326,306408
c5c3c34bc6b475d27146c3e159af7f4a,172,131,480613,81418,399195,118,92,309809,84477,225332
29019efb229720e679c9d88c6c5b61a6,108,87,235997,67713,168284,149,93,359832,53243,306589
dbecd2b1ac3df970bdb1034164a2b422,30,29,20727,7439,13288,31,26,14117,9969,4148
6381aa9824077bd92b229fc48c3cb908,62,43,85582,15224,70358,37,33,40432,20070,20362
e6197827bf03f5c32eaa4e74a39f9a94,93,77,183581,67472,116109,124,103,268292,55674,212618
44624579744456a41cedb1963061d336,99,87,195197,53497,141700,113,78,256282,44790,211492
bb3eaea791272ffadb2c9be3536679fb,133,90,292108,62776,229332,145,110,328575,75598,252977
51a58dccaa7d263aa385c8ac3b7148d5,93,86,171187,47607,123580,75,53,190869,31679,159190
13c497fcf5458e0ddc56fbe36658d0ef,62,31,55098,15524,39574,51,43,49645,18197,31448
a3ea403ddf81c6cbe34755f23985c7ec,123,95,300841,62356,238485,162,140,544378,78503,465875
1ef16241b60e49c8266e8d6a105cbc6b,165,125,438551,117089,321462,161,130,486022,113377,372645
bee90aa55a7e8f09ded6a404b593bd02,141,92,298375,68483,229892,169,114,365787,78001,287786
bbfd7e52f35a9109fd778c54241a3505,94,63,142065,18606,123459,97,75,110717,23005,87712
f4f535247bbc0668f2a9836ce78df3b7,100,80,157949,47081,110868,119,95,192697,43858,148839
0904e8fec6b0fa7e296eb783ac30444f,172,113,478932,80606,398326,164,131,520127,88778,431349
c3f194e9b61c5824faae535a9165bb14,92,72,161427,43653,117774,104,75,168393,43357,125036
6a07b07e29d32387cd03e39f34c43650,36,22,22614,4383,18231,35,26,21185,7760,13425
252cc248f3e4eb3212768797138d69bc,143,109,346522,72213,274309,104,73,291702,72299,219403
55a5a0f8a5dbffa9407e845f31418842,63,50,104907,30176,74731,69,60,126434,26894,99540
8fea604727d56514c164df2437616aef,27,25,12104,3938,8166,27,20,10957,5208,5749
041e68e5f50b9c2930b73e202e8b9b72,23,23,13132,6815,6317,24,23,15279,5941,9338
631b2d5fbb31369d3a799b7199c1f2c1,84,62,109817,28454,81363,91,82,135757,36713,99044
6da29f2c9730cac062e1bb32a16e147b,39,39,45983,17253,28730,46,33,49860,15383,34477
33b51a8456f293faedb934457733e744,138,107,529714,153159,376555,126,87,390693,92065,298628
d9ecacf48081c57ca0209facbfb947ef,29,25,17442,6987,10455,33,26,16061,9008,7053
7233f4390aa4b078153110b70014221d,35,28,29671,9588,20083,39,28,27491,11271,16220
a604a1aeb7cff53b7353d7b68ed0a05e,94,65,146825,41828,104997,122,90,234634,49249,185385
de3a5e7376cc28a127941cd505206aba,232,169,831275,129962,701313,220,146,938890,83144,855746
91690f034e150a479a3f4a3a9c7b8151,128,92,226729,43329,183400,132,87,200004,45719,154285
da0e5a6cb1645c946b33199aca33ca34,62,50,80618,32883,47735,78,62,107564,45319,62245
8acb049d731d0bb0f3d3a011077982ee,184,128,600106,127674,472432,125,89,532409,181539,350870
0da445addf987604f72e856e8c01e300,105,86,135039,25194,109845,95,77,101947,18797,83150
ffbc710810d4200f25481c78bc964409,71,48,84955,29303,55652,61,48,79117,37739,41378
18f8d051ea6594886c40092224be0746,4,0,444,0,444,0,6,0,471,-471
2c82587b9ddb970f63caf67c2940686f,36,24,24887,11582,13305,30,25,29662,9989,19673
0f856aa53535c6d4e418f44e256bd357,105,90,184715,60111,124604,106,87,242338,53548,188790
88f25a3bc20c4078e56b68ebe64485fc,68,51,112028,21147,90881,67,54,110812,28717,82095
e7184b8ea810b262e249ad580ee3f018,65,46,61166,15294,45872,50,34,50279,17622,32657
3ca66e9b079f6ecf03bcfdd9a09a32aa,135,95,358080,122288,235792,122,78,306676,99070,207606
8e4847d98aa5cad3cfae6d95579df8a1,29,25,14453,5364,9089,29,19,20115,5716,14399
d6f0a317d3f89a59e487a70dd3d06c92,111,79,188461,43713,144748,90,74,169909,56735,113174
5d15afdeeb242b4bae48286f6c512048,18,17,6049,3088,2961,19,16,7111,3142,3969
aaf3e6a3b6be9e36eeca63b4682ad7f6,112,95,191262,42482,148780,93,68,180562,36913,143649
cefe12c1a6083f20024b0fcae35149a0,106,79,231104,82368,148736,150,108,381666,61867,319799
e11706dabac1807bd30126854f05c22b,154,109,620232,89016,531216,155,120,414524,113918,300606
78cf09434bdb87b847087246453b0843,130,104,294077,66178,227899,155,129,410153,59664,350489
073d4f397f02077a746fabc90a626698,149,95,366730,93062,273668,133,117,421600,118729,302871
cdfbf720b47675b7c292e81a6d865796,118,85,376791,89287,287504,130,90,353932,47817,306115
6e7ca3e516d17c41c95dcef581e88bcb,30,22,16605,5323,11282,30,23,11508,6050,5458
de857f28af20ce3825065032c2b8017f,26,15,8769,5353,3416,22,20,7381,3780,3601
d4127dfc62d560567e9b1db065f8e3b6,78,70,148138,38945,109193,120,92,197411,50549,146862
069e3960acc935c979f8c85574dd2172,123,94,336673,74527,262146,118,97,301726,79878,221848
30bb6817305a72ce661aae5c5937ef6a,102,72,256315,49786,206529,73,57,118192,59906,58286
ae703706027a9f97858aab8176f78de4,69,54,116282,35711,80571,58,47,92493,34237,58256
cda01665d1fd56cedda49bb7626c6088,136,115,393905,73114,320791,117,88,290796,78459,212337
470e6d98d04da95d63c11535023a8594,182,123,476889,95590,381299,140,107,482367,152061,330306
de40d001c815c81d0d43eb242ca5579b,9,8,1398,1011,387,10,7,1260,617,643
22ed15d7fd407819cebf147521d4721a,139,90,389707,88734,300973,159,126,386899,78706,308193
3aeeebbe3713ac6f0b0fd95523084514,122,107,374005,62377,311628,193,167,542408,116177,426231
feb41940672f2a79b438e29d3d37c2b6,99,76,267073,95288,171785,110,98,302554,101631,200923
af7123d1a1efa0b949413ff2c1a5fe01,111,98,159752,37594,122158,100,96,158000,34157,123843
80b8cd9156115c4352626e41d0c3aa64,165,114,338308,49833,288475,121,95,211333,62682,148651
9cf1d14a88a43b57db94834fc10be3ee,70,64,105180,34097,71083,64,47,108744,30967,77777
46f537f0e1479810d83f842542830f20,191,156,947650,162269,785381,200,155,769261,176435,592826
8d1b51c9d11ff9f1a0c5e3cf9e9bf4c2,167,102,520638,96893,423745,184,153,664220,134339,529881
2b3bdafb181f4bcab439b25e0989f81b,40,34,34250,16023,18227,63,39,37182,17570,19612
75d1d491b2902ed3727f83584a1d2ca2,103,79,220900,39260,181640,80,68,153777,53418,100359
6bfbafbccf06740ae17a964edc638931,127,95,340495,87244,253251,152,101,372154,70505,301649
f076b812a56acebbba52c7afafc54eb7,111,83,229411,46531,182880,124,84,205599,54048,151551
6ad6a6fb94c3bc9ea3f07423853b6245,97,74,153011,42480,110531,98,75,199914,43170,156744
f9cee711d62d4ebb45c89b34b523d11c,110,80,204729,44717,160012,104,90,212317,56834,155483
f6af52358c16b3317be798af913158a4,205,160,840545,170192,670353,193,129,840378,155582,684796
964f0614df3ef090d9aac215a5f1b301,14,12,6417,1539,4878,16,12,3150,1530,1620
f0dd945cec279321e4d9fc4d2661551e,5,3,451,304,147,6,5,665,329,336
c36536fbe07d61d6c83bf14d1c8d2134,22,20,13211,6288,6923,23,22,11583,7689,3894
5d8cdaa80065e60935523598a5803cf1,35,23,20693,8471,12222,29,26,18650,9124,9526
c09cc6a8c52868c64fb9789d74e8f704,172,113,470427,93895,376532,213,144,527205,82413,444792
a9543ed34d1ff3cb7f7fc94008eb550d,45,43,64564,20787,43777,43,30,36813,18114,18699
7476e87d688a437a77be3b3733ab521a,178,116,520829,114923,405906,181,111,530602,94258,436344
68855640902772027eac8490eba0754e,97,64,156895,56964,99931,87,67,143182,60960,82222
9bde20b9e57d700de6fc6b72c6780c5e,144,100,270875,84921,185954,138,121,383227,78880,304347
f4786a97d4cf8f79fab5ac4004e372df,170,136,555840,128915,426925,178,150,933869,137795,796074
4556f5c3a6851df77b27418c0cfd10d1,56,39,79958,13860,66098,47,39,39653,20726,18927
0ed14bb54b041d3c752ec417b4b30770,69,56,106593,28620,77973,96,78,147490,41065,106425
c1029f227e2b15a46d91f1a75e84ccbf,143,107,493164,90262,402902,143,113,566637,110306,456331
8b482b7ab51d8c30aae3f0a2d65fcc64,90,77,156929,35936,120993,72,50,137188,15884,121304
cd9984520a1b7710872fcbc6a17a832a,96,68,218603,25323,193280,66,58,109426,36771,72655
4373a9ac031c9146a1d939fa2689d4ef,4,5,292,550,-258,5,3,686,130,556
8f438dbc6148c0fc297cad67e2e640cf,46,28,52916,16541,36375,50,36,40889,18962,21927
9982fa7941ecbd58c17ab397b27aeff5,66,50,96626,40204,56422,79,54,117097,37335,79762
741b400aec75034f9ad34c9a969794c4,64,39,66163,23339,42824,66,57,93360,37722,55638
b157e002a3fa84f6e3fe487103e3a488,24,19,11070,4479,6591,26,21,8220,5522,2698
ec697a0f72d06d559cc2f6e94b49b596,24,13,5005,1644,3361,15,13,2874,1379,1495
343d170fe77cf6969e716a5b97b8a59e,34,25,33790,11097,22693,19,19,15808,6993,8815
0752b6554a5d35f5ed9d8b8a2855c895,14,8,2277,536,1741,10,10,4013,861,3152
8390b0c6079feaef0f20de98d02f26c7,155,91,410578,84461,326117,114,92,284857,89460,195397
b2a91229eb63da86ef93e3f8e8a8a2cb,127,104,485239,107244,377995,187,134,547239,102640,444599
0b36b14fd6af1d166e5da35561d0b07a,114,84,241637,37189,204448,102,78,230437,34926,195511
b8173ce48536042043bba3495ffe7fe1,58,42,65639,17814,47825,57,51,60024,18766,41258
6df71feecbde242ee21dd90c2509a74d,59,38,69105,14936,54169,66,49,60235,25588,34647
65bdcd1ea8f64a985e133b0b6b3e35f3,45,37,53320,13328,39992,49,36,48894,15526,33368
91d7f761930cc78be846f399111c759a,3,3,481,242,239,3,3,242,481,-239
9e30e8cfcedb1d729bfb12aa6890de32,190,145,539079,64644,474435,113,78,380190,75474,304716
634485703d48478eecd473c26127fbb9,53,40,62963,17161,45802,64,47,60042,27293,32749
d88f4346f1e40b862ea115beb06f7e24,164,106,326514,86260,240254,109,93,377105,94205,282900
9037f98851dcdf02ede9692721221fff,29,22,11744,4327,7417,24,22,15253,4475,10778
bb45b47d05c63a59a2c2718d293a6ad8,45,38,62787,24707,38080,60,44,68835,26170,42665
6154ecaa8a445777f97f7df12ecb6c00,118,95,333741,61400,272341,118,98,325742,70340,255402
43652c26ff6d5254b853361e0d527da7,140,94,275263,55697,219566,128,91,262563,52587,209976
5b630375f9dd8596af1fe5ff21437bea,101,66,212717,55749,156968,105,90,207160,61435,145725
72efe5f6dd684e85dea0bb98c5e6603f,23,12,7325,2095,5230,21,16,5077,2784,2293
1f5532803189f2fae83049f347157acb,20,17,4305,3626,679,20,20,5592,3072,2520
7d801e6699e19612cd526fdbf7b31137,39,26,23183,9063,14120,46,26,32920,9485,23435
a09396ebcf0d8f2556ff0e0edceef1ff,71,56,103708,23947,79761,58,42,72263,26482,45781
5ca58127a4183d5ad76735aaffc67198,100,83,238840,74796,164044,97,73,278915,62099,216816
df55bc3456aa9ed5b5db7c5d52e7a91e,48,36,49040,13495,35545,55,46,72085,19642,52443
2aa191ac02e5f08b8cde5db2dcab71d8,53,40,87638,15226,72412,53,54,56820,20807,36013
e4b0c3d109c93854ba1903d7cf28c73a,17,15,4924,2616,2308,15,11,2875,2962,-87
f25a7b36ac2f46f04b75ccd8fffc7348,53,32,48378,15245,33133,37,37,54762,13557,41205
efc29f7532094d74c946d72275afa52b,58,47,73216,16318,56898,70,53,72493,19975,52518
b76d0501f4e44791b8325af116e37b05,173,117,1392280,286887,1105393,235,192,1146723,437579,709144
71887e9a0631eaef37691a5259a17169,195,110,344033,57661,286372,124,81,185375,59745,125630
accae5cc0afadaa97fdde9f2b9537cec,118,83,277519,73791,203728,142,96,346813,66278,280535
74753a0bc910d0558ff72db381ba4d5c,146,104,354578,71813,282765,146,121,440098,74965,365133
50a4559998ce975672a4b9d5cf5f60ae,159,130,579456,123198,456258,213,158,625215,134437,490778
4778fc20ff030670d112a9bd8a5f06ec,36,33,44328,14945,29383,34,33,30962,16326,14636
0588d8790b15789092d8bb8d705c103f,127,80,428806,102073,326733,183,143,718691,132753,585938
44755b0306f45a84073b6a37a2c9ca89,106,87,187857,41040,146817,101,88,217677,35876,181801
dcd097cbd3a89719f4d140ec4a4e0da2,35,28,19862,8003,11859,26,24,21659,6983,14676
7d14b9f11819e403a06d3b58b4ca4726,222,138,688913,169634,519279,227,174,1150953,158987,991966
d6681aa1d181028ac9f8cdf63748f0bd,152,92,344017,73956,270061,112,89,296830,95361,201469
509a7ca17adf51e10a164322ffdcdaec,197,144,594691,153779,440912,175,135,683892,115648,568244
94f0ddae883101b6762ab2ae19ebefee,26,19,9876,3300,6576,24,24,10661,3233,7428
40d75f50dcc6c58298fe7baaba590666,135,102,311316,53198,258118,132,95,258784,60564,198220
420e7431f1caf949a575c1b91c3dbc0c,25,21,14907,5492,9415,22,21,12711,4686,8025
0fcdb374d0e04013cde3a06092baadff,68,50,129015,38436,90579,61,53,105489,34155,71334
92ab1c520994762619eed42cbb82283f,28,23,7328,3281,4047,23,22,9511,4533,4978
61632c2bbcb952d9054a4c6a56e9f211,94,78,204889,40564,164325,86,77,161130,41831,119299
f9b15322dc8b875a29886212ea4260fd,42,33,47447,15308,32139,33,33,31998,17054,14944
e0b6daca48702c188c137cfb7f548190,34,25,19619,8258,11361,28,23,25285,7216,18069
5ad9fad5bd7f6015010a05b6481d22f6,31,29,20873,5780,15093,38,23,14359,6179,8180
c33f2e756af394f31e8a29c11a4f8c9a,186,117,876410,137055,739355,184,136,832906,153899,679007
529190b1467b36cbaab0c02b8803cb04,10,6,1094,546,548,12,6,1456,300,1156
ab0e56965480e710896c6136efb3044a,134,107,348179,73691,274488,153,135,398961,74521,324440
109a07b7255820dddaa0311affe96841,126,101,308229,57948,250281,149,94,304137,61889,242248
eafd33757abc603d5cc9199e21b76c43,125,115,472477,119042,353435,140,105,394467,76291,318176
c23938b51f244cddb723c45286195741,25,25,9263,4973,4290,27,18,17737,5371,12366
05e2da42d7e983d211092a95cbe9d445,21,19,7522,4719,2803,27,20,11971,5230,6741
ae7cd26a815f8022ee439daa7f38be72,194,114,364304,56741,307563,137,114,322912,77959,244953
8fc0bb255d08581ee9ae25ea9587cbca,126,92,304943,42391,262552,150,131,451577,58281,393296
a0ba4ef0965f56d2eba69c2b9ef33353,198,155,692975,98956,594019,147,116,480736,150634,330102
6ed4de7a8740fabab4d0252ae16c5a8e,109,84,262082,60812,201270,87,67,190680,61443,129237
4fdd03707243bf3fb3759594ed42448e,63,48,67202,14706,52496,41,38,23263,13804,9459
ac5530ff40b87b448b9e0acd8b367964,92,84,216905,49722,167183,65,47,132852,30531,102321
ec2f9d444f608356bc1e169acf7b2df9,41,29,34113,14735,19378,35,32,31775,21452,10323
e7151f60b44a8d71889b537411ea6157,20,14,3676,1934,1742,16,13,3534,2263,1271
7b1f2dba9d3d95f65f2cba3b59dfa564,106,94,201242,46954,154288,96,68,151169,42484,108685
28ad1e3b7a0ada6c05bec1da50337cbc,106,83,232354,29899,202455,116,83,218580,30579,188001
2e870f7584ec57d7a6bcc41274e7eca5,38,32,27252,14740,12512,59,45,40655,15793,24862
25cb14d0bcdb3054b7a8dd8eb19e6a2a,83,53,129636,27571,102065,67,58,128194,30578,97616
0248812041678ca3538a4740c0b80779,169,135,624814,122612,502202,144,111,467673,131178,336495
a85dcf79a0a104f75c717cd6cd10fa09,87,59,113966,23820,90146,78,49,95941,24732,71209
81591603875aa0305a9c354c9a5abc2c,105,85,312327,81306,231021,118,97,335239,78835,256404
cc0546f91bca2b7e6b9c48e27d8e4333,48,30,39982,15491,24491,45,35,45884,14867,31017
48c153e747143671e89cfe39f8dd3e25,136,93,474191,95925,378266,122,95,337800,100841,236959
2cd85f9e056589b4e4b2afaf9658538b,158,139,421079,116943,304136,176,135,414371,57343,357028
0a4c38dbb3e646d39778f40d8e0cc85b,143,114,522817,113377,409440,192,153,573290,114746,458544
360a5ab6e22b41143906a2564443be51,116,95,239421,51061,188360,115,93,205587,49448,156139
51760c7e3f745057e762e6755f813736,184,125,387690,63316,324374,94,85,309463,86880,222583
f26ce43cafa430523bac1f2d24e47691,137,109,428192,120931,307261,127,97,425018,100989,324029
84eaab20b7055843e1326c4d3780b225,161,105,517007,95745,421262,170,134,508354,110357,397997
731246a13d4b796711444e1c772f42fe,39,35,42179,16998,25181,42,38,37385,16120,21265
0a797eda7cbfc5bc8f69eab3c2c2aaac,157,94,395663,82852,312811,155,123,446169,75121,371048
9163eb09d6a3bfe306e94e127d86bb11,74,52,98010,23389,74621,97,70,114920,32619,82301
5d244c6b52fed829b4ac6c0f9f96f85f,116,85,187685,42051,145634,118,97,190803,43716,147087
8c63176774f1f2e3eba8464d3f276334,61,49,93391,22499,70892,68,40,79557,26059,53498
6b11e9988cc7e806d0c49d5d6029749e,87,68,157822,49119,108703,105,83,203412,48229,155183
cfe10acfd6a50bde6c2367bee483bbf7,179,125,576815,78174,498641,158,121,484801,73270,411531
e2cbe915372f9bbd2a5ed95cd4d324a4,174,137,510940,57210,453730,104,84,236154,60002,176152
5c916d56351d1e17956d060a2972f70f,46,43,45881,18023,27858,33,28,37581,16933,20648
6f2dfd747c0a21126ec6daaf49caabcc,179,135,525196,99630,425566,143,106,403311,107766,295545
d4871a61581f834766fd5f740cd23263,50,34,34708,10120,24588,37,26,29478,8728,20750
e619b653b16761c581fbe2ac04414d09,73,58,111628,37201,74427,76,64,196375,31867,164508
aadb6f5ada5b2fa5db7291e79420275e,171,108,356975,73766,283209,162,121,515392,90303,425089
8d31c2a25caea698189723af8bc703c7,96,64,211297,55340,155957,96,78,263773,66995,196778
f45331059c257f016e3811f6c366b3dd,85,62,115888,26466,89422,86,58,131604,28509,103095
f88f6cf2aca1ce931bf07d1610b35497,161,141,518043,121959,396084,142,112,479804,94857,384947
a7b2f71ac1ea937885f59d875b21e7cd,93,68,149084,34175,114909,91,68,101847,36042,65805
044db49cc3fa907cbd888069b49e4c95,188,128,935495,151151,784344,192,133,936105,137702,798403
6bc505fad5c0a05dff7d060f20e57542,110,92,255996,58370,197626,124,88,261540,74540,187000
4b3d150cec4be259a0a4d9d7a77bec21,150,114,389579,68245,321334,132,100,285148,82462,202686
cdebb2ed6bf42313b24bf38b13968da5,139,104,464165,76654,387511,136,131,479319,118593,360726
4fe23bcecb5ac6dd96fdc56d66521e65,41,35,32105,16690,15415,39,41,43314,13842,29472
1c8d09219abc68bd14a170078e26623e,73,48,91242,26885,64357,76,52,82690,30508,52182
52dc7997745c90e4f78782f4d97e392d,109,80,349025,73490,275535,128,101,361614,79759,281855
71eeeef19edb5b101335755ddc6cea2a,88,72,210167,77387,132780,106,90,262162,78369,183793
3a7b322583ca9e0bb61e8ffa1dbbe26e,83,60,169214,46380,122834,75,63,126376,49354,77022
a4ca94093e6d7a30ed3ee91288339b8c,40,28,36426,13818,22608,37,37,35522,18496,17026
5070d052a11700627e220f071678e7e1,209,127,519817,66572,453245,133,97,295378,102712,192666
c040446177243707031816231de09c2b,11,10,1256,715,541,8,8,1077,602,475
0b5585831ceeafa8f30eed32a2c156b4,79,64,141094,38284,102810,94,73,141091,32454,108637
261ab7a191c23cb1c92680eb61380d5c,116,70,158235,56808,101427,141,102,309450,48229,261221
b7e8a96ad0b94cc474f13ad93c17b329,75,54,140070,39161,100909,64,49,131044,35494,95550
182fd05aba25969cebbd343c7070e93b,58,45,57051,19087,37964,57,41,61118,19250,41868
392d3d36f983a07e15a16273f1a6a7b4,20,21,11435,7133,4302,29,22,14504,6067,8437
637bf8aefddf885349d88d5c2ed123b4,138,112,308663,76082,232581,146,110,438650,59131,379519
05e17d2cf65ebe2dd81b026fb8f49575,120,91,382283,116705,265578,192,117,367634,78781,288853
560d349b9ff6a6cdc82825312563adab,128,112,279893,71974,207919,116,91,205490,60688,144802
1b8a164681b6e51be40219e4a12c826f,131,106,452764,158215,294549,183,138,671297,110792,560505
2323aaf0d25a4c01e6eed2cf903175ce,118,99,265036,75630,189406,123,92,267765,70535,197230
544a2d9752fbe64913578f27110b107d,106,86,241658,52471,189187,108,83,232687,52379,180308
d8623d33641f8ca6c44d2387164acf31,17,14,5798,1995,3803,19,19,6515,2110,4405
316d5913eb253b28a0ea6f91dc6dd2b6,104,82,357826,60276,297550,136,130,321418,77477,243941
abff79975df302bf3216e14850963e8f,112,87,185450,47515,137935,109,82,177459,48844,128615
383c5bce377ee1fea298d50c9fe0eb26,124,105,273361,53514,219847,111,85,251542,43787,207755
4752b4fc5c0b9ed7de3a302714a9f4a1,152,123,557742,68053,489689,132,94,391070,80513,310557
0ae2c895c70c4b4d7bcc09f9b4d614a6,99,74,222417,40477,181940,131,106,264297,52180,212117
5ff662509c2b67176298e89562caef44,190,118,591883,93861,498022,178,124,431401,130273,301128
f4342d7f853a0e2b10848fef34ac7e35,27,23,7948,5150,2798,27,20,9415,3819,5596
d95b95a9e1be838616c4e3985a1b2213,139,99,290243,49459,240784,131,92,261870,56732,205138
048273680c5ae1cce0804d1ba3c7a891,23,19,6058,3368,2690,23,17,7757,2203,5554
14692401c71261c3505f88123f884adf,58,49,86903,20578,66325,57,47,74124,37496,36628
f0c7e50986859f3ff7dad3569daf9703,152,113,354943,81631,273312,152,126,310572,78838,231734
3d28e227d61506f18030b9e9cf8bbdd4,20,21,10533,7411,3122,23,19,13813,7247,6566
54224a468e72d29ad42d5dc16d9c3430,41,41,28403,9908,18495,36,27,20048,9226,10822
0544638e198a11d9691f97d9bcf9d198,30,17,10871,3081,7790,17,23,6479,4313,2166
80180a16824cc97abc61f1c63bd9d52c,151,128,390842,95374,295468,136,98,342086,87510,254576
46af5b63d8b2914be463bb628471c321,139,117,348305,85279,263026,145,134,411217,84923,326294
38f50709af79d4df72685c4df824f005,209,127,1159255,207227,952028,256,155,971868,200645,771223
85ef179f255a5d5370295e1c5a33d3e0,62,54,85900,27267,58633,53,38,91238,14649,76589
796d90e1a4cf7c16fde8bb72a5aaef27,36,22,30034,6749,23285,35,24,26412,9368,17044
784d0367870272c3540c88e960b10a5b,159,96,312022,55141,256881,86,68,211093,72414,138679
21f5f0ffb72ffd650404bcbe431ba1e0,49,36,57039,21823,35216,49,35,53126,18407,34719
9123315864832b74c8372372dae9ca34,70,58,114459,31359,83100,95,83,110802,28969,81833
4d20ded81ee6f5f5d1390cc83af2bc43,42,42,45469,20795,24674,68,45,62008,17708,44300
cee4f61fb907a465e695da37e82e2f62,132,97,281513,43851,237662,134,107,243489,48046,195443
d3d1dbbd33eb3112b3ebc84d2c8048b0,220,141,1042824,175574,867250,254,163,858038,232097,625941
27cd6abaae2ceaec8016bda8da771850,70,58,152730,30757,121973,61,60,93350,41868,51482
034f667df3f477437905d844c7c46b7c,123,86,191498,53055,138443,130,86,216655,54917,161738
46275ae6adb728d5461c1cb62f694150,174,121,544256,104838,439418,178,107,661576,84032,577544
fe749807ab97237d2a95dbd62e44bd02,93,76,117461,36475,80986,100,67,129279,28494,100785
9ab30224e200dfce313230467dacfbe2,156,94,295268,61676,233592,129,97,276748,51605,225143
92bbd0442b732d67e2ae721a1c5edbd7,217,122,725702,127244,598458,178,142,809480,149807,659673
2b31d5c6bc47126deff711f546cf4c8b,52,40,62056,28177,33879,55,42,98278,23050,75228
ec2c04eeedf3734c49169eb253af7bda,65,53,122094,24922,97172,86,69,173130,31281,141849
a69edbac4a6d601ef34fec7a9d0e5ac2,106,89,221036,80755,140281,128,102,283986,63264,220722
ae9f807c272273ec876e462ed647afd1,79,70,142435,30886,111549,62,56,78663,44192,34471
1a472221964a109e2ab2f93c0194492c,21,9,4110,1210,2900,11,13,1708,2156,-448
02ab51c521826f35d14bb66b5db3ee11,78,65,181913,41566,140347,104,86,233067,54716,178351
b3c702dbc34d99be1e022e4910a46d94,11,11,2927,1700,1227,12,5,3970,1707,2263
24fb4b6ce1941c5bd921a65c23f0d504,57,43,73997,11886,62111,63,45,72898,15025,57873
1319f4e84d80ddb733c0578a9fa360e8,134,91,395714,59527,336187,163,103,525657,51825,473832
958433f51703f1d2c90d82f46ed0f567,25,23,10027,5006,5021,23,22,11270,6264,5006
2357d854141261f5c16db1d798715707,167,109,416864,111907,304957,170,144,595496,101253,494243
9fc36edc69ce0b263b556102b188e72e,88,75,206843,46173,160670,136,104,308424,36229,272195
de3d8d7a7e5af8008a852b692dfb05d0,116,88,216047,49600,166447,94,73,189140,31624,157516
db9f716d875100526f5884624e5f9613,219,146,1378264,193998,1184266,250,158,1111341,147346,963995
91b66df07d68a93d7a57c7e8a2106099,10,10,2637,967,1670,16,10,2451,657,1794
41aeca70872782a8300946fce66b3425,112,74,143881,31107,112774,111,78,107802,34956,72846
29cc4d70b4d2b45cd7c58ed2771e1f9f,142,117,306449,77903,228546,110,80,263290,38255,225035
8b704dd1690646f35a4e12e54b7b5eae,31,26,23251,8132,15119,33,26,22831,10670,12161
4cccf66c7b054d6dc8bff9683b4a4112,51,42,81852,19024,62828,74,50,101800,15125,86675
4e82e74a5f1084be3a5d4965c7492632,87,82,167519,37939,129580,114,100,190121,54410,135711
26e4ffea974b36c02643d117d377f0d0,135,120,360190,65484,294706,122,98,232058,70269,161789
d896088c7ee88f36c1db9e20c2adcd7a,134,104,365034,76397,288637,183,127,488548,77458,411090
8eb3ae92c08dc7318c975525e2b8d5b3,183,136,1190980,185086,1005894,188,131,733011,204758,528253
d38f48672610763b28d3dfa7f839d6cb,42,36,45175,20596,24579,50,41,73000,20231,52769
93e78392aef099ab928e50fafac8cc07,97,73,143628,43977,99651,79,64,100053,50855,49198
4e1792a33cc0bf8ceaa6799311025da7,121,90,221168,45089,176079,117,100,223681,46562,177119
ecd46cf2e3bdc296b5703e6409d073bb,65,57,111632,33273,78359,81,67,115237,39284,75953
01092ef9e7f494f59cc2ebd56cffde73,32,22,19346,7040,12306,32,24,24544,8390,16154
30c5d5d903866fbe933dd081f9918178,166,129,503926,119107,384819,170,141,581974,154163,427811
14b6478dde95b25447c087a76412ea34,35,35,25651,9751,15900,35,29,22688,8090,14598
150feae66144620e9bc330d293cea93a,104,85,196553,46417,150136,92,87,149123,46012,103111
b8cfae6277be6c75c4c4fc254a6ddc3e,159,112,418460,68507,349953,140,98,296339,92241,204098
44ca37b7f7fdf01a82abef2b52fd562a,40,37,37702,14612,23090,52,38,68214,13580,54634
7244ca9b4a5f6aa00c9bf48a0eeafb7c,151,126,479121,90590,388531,138,106,373966,82560,291406
44b51f27a2dc1f9b2da5159153a0791d,132,73,251113,58221,192892,98,76,192643,86887,105756
d7329bd0b507424df8b2cce3256cf054,99,69,129561,31365,98196,74,55,91744,39784,51960
b23f9123456c2682e6ba77bedc802850,85,65,188166,37081,151085,90,65,132424,50087,82337
7e0486a4f21ad010925665a40905756f,138,92,342915,82484,260431,144,94,339217,70505,268712
83a2aececb7811279a29122bb27934a1,26,23,11903,6053,5850,29,21,14224,5316,8908
07b11d0b16c96ffccd8fa217139da7f1,113,88,316312,132117,184195,161,129,451676,137208,314468
86a0f9f71d110596f77e72ed428c10c6,79,67,166791,55100,111691,98,73,200544,57558,142986
be3aeeed133968e8fb4b99841707dbfa,41,36,54162,15257,38905,43,27,43062,15780,27282
0361daa307f1759d4d192c66247be50d,171,108,656229,137755,518474,160,109,511740,128590,383150
44e5adcec411cbe0df4989b6148cf12f,6,3,837,150,687,4,2,264,292,-28
d32c32f13dc72551a55c0220d19f07a7,42,36,58824,21943,36881,39,32,59852,16938,42914
b39311e5b1054c9343c76f8c3553dcee,18,17,7161,3394,3767,20,9,5281,1477,3804
c6c0231fa660099d62bb9978bbea1cf6,153,114,411774,84612,327162,194,151,478368,98647,379721
c6a78ab268bbefc9102469a98c853ec4,109,75,179453,49059,130394,98,73,173285,54596,118689
d697f50cb62ab84b52a1fff6d9a03286,58,48,89355,26892,62463,64,52,97127,28765,68362
5acf9ca79c6a2607b7d985fbd70ab738,99,68,200242,55366,144876,117,82,169692,52471,117221
6d98b19a5381aab0c2837118d0c29faa,89,60,149742,42454,107288,73,67,197189,51804,145385
c4d89b577b0a0e101b0d6d3c5a70b723,88,70,173120,52320,120800,126,111,217135,74003,143132
43d64ac25576ee337df8b3d06d8c9248,72,60,103345,35256,68089,75,53,86649,32681,53968
bd93d4409baf81fe5955a406187f1766,16,12,4560,1493,3067,14,14,2448,2188,260
4139234eba88bab9d1d7df07877e045b,24,18,6205,3366,2839,22,14,6424,2475,3949
798c748119d27a5e7852cfd44eeb7b96,75,46,167336,60390,106946,82,56,212379,49134,163245
f7bef0e58500f45e5298037885923286,37,26,46335,15730,30605,41,28,47113,18548,28565
09622a332942864b2dbe758d818b5fba,139,114,440667,106322,334345,177,127,469044,87646,381398
4a3f4d297d3457d7b13a93c450bae2cc,152,106,282511,46301,236210,117,95,199416,58782,140634
d433eebedde783f75f9e550c8086b609,54,46,50602,16212,34390,54,44,60849,16295,44554
fb4a93ecafbaf9bb17e228b41b777992,111,93,216204,51409,164795,130,101,211118,52094,159024
5f73a690aec5565b95123e5d6305c71e,130,109,317296,78603,238693,153,118,332181,56891,275290
88fb0f431382d1a1fd517fe2f10c3742,76,62,126488,41912,84576,113,103,230347,45848,184499
65c02ccb49ab7cb6abd46a7f394177bd,60,48,61979,17070,44909,70,48,75960,21195,54765
06a526a3a28a06410ab0adf2117dd465,17,9,1569,272,1297,14,12,1312,529,783
019661a9721e39574b847826f26c5c89,125,78,221779,61383,160396,121,87,206806,56115,150691
029d8f7ca6c0234e2d448cac076a4ec2,127,88,316492,51197,265295,92,67,156356,60256,96100
b50b8d75c22b0a1bf3b178a9faea5e36,30,28,21664,6164,15500,28,23,11416,7395,4021
533af27cf5649abfabb4595e8fe49a4e,170,118,445987,95812,350175,189,118,647928,95133,552795
f1d79e06f5ca09615218d4c088eb1329,87,62,124531,44891,79640,92,78,159562,42128,117434
3c0d24f76ad8a93dea3ad6c10ba15498,76,52,132513,30434,102079,56,47,81641,46770,34871
20ed1d9a2a25b080a1180d7453d668f9,110,80,185489,50774,134715,137,85,273547,34686,238861
5d35bcedf61af1916c7f85b4295568ab,43,29,25690,11694,13996,32,28,21809,12184,9625
10db5006abc4795312c240f0b11eaed0,38,33,43889,9838,34051,38,33,30989,13213,17776
7cbb56f9bb382ee29d50dbc180eb0066,65,55,124309,47373,76936,75,59,179110,35687,143423
24ef6f6fb50b78403719042f52d57c60,35,25,25234,6120,19114,37,30,18386,7394,10992
12361d5abc7e4cc35d8d8395fe9cba7a,32,25,15716,3545,12171,25,17,10272,4010,6262
0769665d0758be9c8b64ae144108d4b1,104,62,169456,34564,134892,100,81,159374,46352,113022
770c11bbc3f37e86d99481fb0fb1dba8,194,141,811179,125226,685953,166,130,581913,137931,443982
287eeed7af1a6623665a4a3467af9c25,7,10,768,1396,-628,9,8,1328,722,606
c870f8cd4e5285f07496c7869fe666b9,111,96,258099,72667,185432,109,98,240070,80048,160022
2514394c378edaccb961815fd5000bd9,95,78,190497,54698,135799,101,80,202503,44405,158098
78fe654085296af744fc028fe7ebbacf,115,88,268491,61265,207226,116,77,227080,60337,166743
08654c9446b3215d60de1953babdb3b4,113,88,232428,41355,191073,96,72,246744,52591,194153
d99d2236b6425475736fa0b545595370,35,28,26569,9465,17104,33,26,17720,10628,7092
4c69601f47d92206c0a9e21919dcda7d,128,99,302418,60915,241503,106,79,228322,63397,164925
13f507173a643320caf182c73ce59c4d,94,68,236347,45956,190391,117,83,213600,71763,141837
90b249210f0519e1138c825a2259d167,122,97,190760,37920,152840,100,67,192186,31627,160559
8a5ff257ba84f8bc518e8f1e96ac12d4,45,36,67624,25242,42382,44,34,53411,21116,32295
f082b670984bbf1dbfbdde82e3931b0a,200,120,695341,159790,535551,185,123,759656,140856,618800
ab1339981b69c40b4d4c845b392092c6,181,129,730150,119887,610263,178,128,647514,149865,497649
ddddd10ece496fb4d95517e4aef79769,43,33,30147,12223,17924,43,33,44407,13701,30706
620b354eb99bad4e3d1f48606145f41f,199,162,1009396,164114,845282,231,156,917983,165574,752409
a6eaa56a04f3f069e72f2af0af45b9fd,27,28,23014,9056,13958,29,23,17727,8528,9199
0ba8e8b4c8e8819f120af8b36415c8ba,114,87,140343,52637,87706,86,78,151424,46496,104928
6444c654633a780fe8f67c3ec6741b94,50,41,59486,21172,38314,56,43,47587,19343,28244
dc42b042aac16c59dd5b2c31b2919315,139,106,327434,53390,274044,118,91,276833,48295,228538
b95d1f9ef2e91be6a36686372fec446c,59,45,72477,24428,48049,82,38,84742,19237,65505
9e4d74091aa55ce730c3285ac39b366e,151,92,765161,101197,663964,195,144,713295,105112,608183
0ee2d2e19e97d051e9ea5fc2b5f7cf83,199,152,1029631,143610,886021,250,187,843933,173664,670269
40094790bf36630577bb750ea38e9e5d,36,31,51402,24457,26945,39,29,62655,23640,39015
e56f2abe29c144228cf3c3f73b0a5b04,145,92,374292,98146,276146,128,104,398771,89294,309477
4ea5b3c6ec0b791805383e2774172615,32,21,30053,6263,23790,30,23,20521,11026,9495
930381235149ba08c677ac50c9e999f0,45,31,38160,16694,21466,51,40,56688,13299,43389
a79b0ba75bbd6b4f309fc0c58fe13a68,172,142,466482,102519,363963,107,77,252395,91614,160781
e9f0e7a01bb788ed296c7dc091d5a229,139,106,278118,39716,238402,93,64,140702,47625,93077
e39dc58e2709edf3c0dc43096eada248,40,35,60673,19786,40887,40,33,57740,19375,38365
ce81b13a42ba39606ceb60d625da080d,133,98,244881,47633,197248,103,75,193956,60354,133602
a4e94cdfb9a46ff23cb32fa56f0eb282,23,18,11504,4513,6991,24,21,8525,5487,3038
d002b480b7006c3d4ceb64e4bc56c873,106,92,254084,78215,175869,97,69,209049,65912,143137
1afd54d49202e1a0f51c6452b43b20d8,53,43,82821,34000,48821,56,49,90961,24747,66214
03172b823e56a81e944e97c108058c0a,68,41,88801,16993,71808,53,48,66808,17684,49124
56480ca02058c6abe5a5f6f28c71a58e,38,36,82349,32698,49651,56,38,111661,29631,82030
a43ebafb307e5f86b2daff9288bc7c07,127,90,269038,43729,225309,118,96,216214,53573,162641
3df6385a5ab6434d7d7b92b96a616b16,117,99,445430,112086,333344,165,116,482359,125291,357068
cea5a6cf62e6540623ef2cd13fb05ecd,83,60,170902,80107,90795,126,92,267662,68531,199131
270fe02463ab2d6a6d0d89b7c26885b3,1,0,37,0,37,0,1,0,37,-37
c641ce3d577ce3f1b7bd190461b64182,26,18,11275,5260,6015,23,23,10364,3906,6458
928cba07cdc2b564705ef75d85b5cee3,100,74,241615,57949,183666,129,90,274482,66474,208008
4c6a3f6389dbf7b9ea763e2b4cce5f3b,101,85,181938,58989,122949,115,83,200618,50512,150106
65532a28e6e6d512467ceb4553ef94e3,196,137,691820,127278,564542,200,170,774450,152724,621726
1fb94bd113a4588b418c1f21f3d6c38a,28,28,12264,6466,5798,24,19,18585,4539,14046
6291de558d39d3bf35015acea581ce4e,95,74,133575,30727,102848,82,75,88262,46810,41452
c2ee33568e624c3f0d5e7578281e85e9,43,35,42671,15829,26842,36,36,34683,17849,16834
f8f52dc9c2e693a0fc2125ec249e64c6,148,113,478046,117318,360728,160,138,470123,108522,361601
5febced59cf8db21c06ff530e071c0f6,162,111,660582,153594,506988,185,121,1138678,130871,1007807
f1149ae4307a3bcfb529651939dd3bcb,122,90,244027,87122,156905,157,107,404598,62571,342027
0edf999a1554fe446cce386d32006462,173,128,387325,80205,307120,153,111,342748,57195,285553
bea67c0a9ce804979ae40dd3a58ee76a,48,38,75227,23566,51661,52,46,74994,28758,46236
17ecd70420fb03620cde9c3ee6f667d1,123,94,245160,50275,194885,155,109,302527,44011,258516
fd97d6fa1ecc90134b7870679481de34,119,97,297294,75538,221756,116,101,349240,87271,261969
922da2b39fda31017adbd6ba6d51660a,76,56,119152,30110,89042,87,66,97064,53103,43961
80c688fa973270c88af467fff357789e,160,123,404990,66870,338120,138,111,345126,100901,244225
7521dfa58938b16312b7762303d827ab,145,83,272025,80762,191263,208,152,491756,83881,407875
a6b85c40190b3f1a9c75feb9507c9ef5,104,80,179581,37842,141739,107,92,226979,41269,185710
925ae4b3302eee4558b5b0819cabb146,18,16,3376,1172,2204,15,12,2649,1688,961
26f12e6f639ae02651bb2cfff896e67c,91,67,140841,38303,102538,100,73,127959,35049,92910
2ff92f06902f4bd2c6dd38e5626563db,20,13,4262,688,3574,16,10,4382,828,3554
16e5705dc75cd87a2bc882f5f8c67b07,180,125,828705,179256,649449,217,173,1229093,175161,1053932
1133713ebbd98e4522a5fc6a2a546395,70,65,107058,24620,82438,85,48,105191,24084,81107
c28ff7778309e9920bff296ac36ad3bf,119,78,265148,80669,184479,114,89,269419,62867,206552
b2e517f06044c1f385023708ca9e9871,43,32,44231,10937,33294,31,25,23944,12957,10987
9ac46789dedaf3f589bcefb975f25069,56,48,63873,27289,36584,90,71,88906,25061,63845
57c79c4a7e013a573698460a8167cc11,104,84,278926,67731,211195,142,105,392666,58280,334386
14247e3b97dec28e7fe6b9c54926318b,128,108,404119,84385,319734,154,124,344551,101825,242726
dc2c11ce0894a8a5166eda4ba9211c7b,67,57,104032,32861,71171,75,63,157427,28628,128799
d57d2a86aa14f5b70045020a7ec57b42,59,40,123612,30595,93017,68,50,91936,39787,52149
5ded06bad110491de97e6194b1622c6d,145,95,403772,101203,302569,189,150,579994,115712,464282
41c4dddf4bb0d8077cf5f1da415ec167,190,143,1028120,148997,879123,182,157,738536,140402,598134
233cd3410e09b250bf91b5052af3292f,90,70,135150,35688,99462,73,63,94213,47372,46841
7e0225f11774c7272385846d966c5e36,60,30,59477,9213,50264,51,47,43665,15186,28479
be8a506b8074cbc92cacac80f5869a4d,169,116,546517,177193,369324,184,141,640610,187190,453420
fcd489e2ced344944804b93425f2d62f,19,19,9914,4243,5671,23,19,10790,4647,6143
81b7d1d3c3631a533e19687026c8580a,40,36,41949,16004,25945,46,37,40687,18628,22059
536d1ba30b4fd597d6b3378b96853090,23,24,9731,3857,5874,27,21,10414,3217,7197
cfddfda42ecf134b3507e2fadaaf9ad0,70,46,107758,18470,89288,68,56,73821,24440,49381
350046f4953aeeafaf056bba08ed86bc,128,85,219888,45005,174883,107,78,197344,51737,145607
f9d2936db52c2aa2adedf152551ad239,23,17,13457,5531,7926,18,20,13727,3952,9775
cc7c0e4f2f21e55781d75193a3b4acea,23,23,6374,7487,-1113,21,18,7245,3808,3437
1ec1e9dc721775133a36ac4c2999768b,132,113,658252,127158,531094,166,110,503888,138826,365062
c15145de368cf0ae7f2627fef3860469,149,135,455018,134358,320660,220,142,570603,105522,465081
8be65987e9ae3f077b034d113f5cd741,122,98,291160,56957,234203,117,85,276884,49672,227212
325002ebf25d1b9a99b370a93ca15ea0,61,39,67891,17691,50200,41,37,53286,17173,36113
0b310abb5e8b4d1b93c98e8a0572fdb7,119,108,348308,43459,304849,141,103,287074,68731,218343
1cdb506dfe3f5955c6c08724cc5c6c62,150,107,718700,77324,641376,217,143,643819,119516,524303
27fd867159fed4fb152a6f03f9be8dfe,172,117,545813,65542,480271,180,141,510703,76017,434686
eadd53dc2bc02375172765283f35f8d8,52,42,64087,19636,44451,48,34,44246,17587,26659
926db49c198365d7ab3f64fdb7fed4c6,26,24,14851,7326,7525,30,25,15778,9409,6369
b73af52bccc688b9b510511b9d114afb,131,84,328010,81651,246359,198,167,600246,82666,517580
0b8df2f96bb37c31bb88d072367e3818,48,34,39740,12764,26976,55,38,40981,12831,28150
1447d86cf3a671e3dc5cde169282b710,145,116,469404,79830,389574,109,86,323667,85084,238583
a658022bae97d37eccf210e5e8181805,90,70,179624,39654,139970,95,68,200290,34051,166239
0bbf7aa7961bffa2fb47384b490fc795,152,125,456789,114641,342148,160,139,458069,138947,319122
89a336926438f5fc7551fde1d21c3e89,30,22,20012,7620,12392,29,25,22975,5829,17146
bb0c12f3388247f3f2f0ed5a44b39024,66,52,99347,42904,56443,81,62,158543,27732,130811
a015a3eff5a725e94ea0a9625169d78f,32,34,27390,13142,14248,39,22,31003,11161,19842
5d3c62c1799b5c08a9b1525dfbb73f0f,113,76,231183,60582,170601,123,94,238389,65158,173231
6961d42bae76655a21ebe5d5632df11e,92,64,225707,85984,139723,109,95,278405,89320,189085
c6b8a364502c8a9ec5bd932d258993aa,78,68,198336,83369,114967,116,95,330672,58038,272634
d3de0824d29716071c440b3505cbc6ae,16,10,3991,1531,2460,11,12,2970,1387,1583
0afb5d4776e6be46c030eec0411d7fd5,142,81,249956,48943,201013,125,87,273467,46231,227236
d9f94e29b04055e540425a7c1847bf47,18,18,3753,1548,2205,16,17,4166,2136,2030
53dc345fb014660908d0e6a412deffc0,138,122,429770,86114,343656,113,92,288074,68516,219558
e78ebd786d031d0a5ef3f0b7d2f6bcfd,63,40,56546,19479,37067,51,43,42678,25923,16755
e9d24d796bd0ec51b9b8370192886c62,84,69,247230,74048,173182,147,115,433785,71232,362553
30028c5c3ff313588566a53e125b89d1,62,52,89428,27040,62388,65,45,66563,31423,35140
ef02e178c7ee03e18b10f7d16382cdfa,52,44,71875,20615,51260,59,48,66449,21624,44825
80106a58f7dded1de61eb4b45df66cad,31,26,14608,7220,7388,33,26,19232,6833,12399
c9a11f8c37bf6684ad0e597558b4d591,16,10,1740,906,834,13,14,1777,823,954
0012f5c24c211fb92b7ea4d7ae73d6a5,104,85,196977,52393,144584,131,110,307074,51146,255928
114926fa13bf94dbf884428aa55957eb,174,125,603221,140389,462832,246,160,807110,156831,650279
ecbb16fa7f9279e3e1cb0734ea2caf13,45,33,40022,9420,30602,44,39,37751,11401,26350
4f489ccc0d023985106416958c564e11,158,110,402320,80227,322093,218,135,468169,77430,390739
83cd9b5016865940fe8f6bcb68c76cb4,129,95,236744,86077,150667,124,95,366108,65550,300558
515b409f582416a872cfd545f2e3abe6,46,40,68418,21461,46957,45,40,53633,27935,25698
19eb0731679a7fe9a5c349eb70659556,108,70,149075,28754,120321,87,69,113179,35182,77997
6486be8eba8c0d420ce5d91976a41406,99,82,182582,54337,128245,134,100,258265,49555,208710
7c59c63063ac35412cdc13ced2ac65d2,126,94,300164,66853,233311,114,89,269701,61586,208115
c3565ef1ea3d78de7f468d0130e27331,102,77,282356,72736,209620,137,126,336882,106091,230791
571f98ddbd17ec2e102abc1ca35e3aa4,166,118,440692,103599,337093,190,159,514726,83870,430856
525ec9625ec81bf40e76d35f24859b41,114,97,315102,66825,248277,109,83,297736,58609,239127
34f7429649365a9fcf1cbd659d9a6f64,58,47,69069,28881,40188,64,43,109605,23887,85718
ff73c206c4a7e3271db2f63097576efd,143,116,450995,96500,354495,165,96,539758,118600,421158
b6f16a44933aec8afe640c5a0b94328d,67,48,99583,10783,88800,29,18,35637,7888,27749
eb09a2f56c992db7e5f324d03d3c9929,44,37,42625,16588,26037,48,35,42738,14016,28722
a173863032ca2f63e76e5cc4ba1c330b,107,94,373628,120924,252704,172,135,580017,105255,474762
5968546493ee2934702afb15b86f232a,22,16,7735,2577,5158,17,16,10821,3043,7778
d33e07bef1d4383aab92a6d947f7f9b7,31,23,20564,11607,8957,43,34,37016,8904,28112
69d59bf6ce118f00f6d50b12f02fc5c5,92,77,151249,23020,128229,64,49,100389,31335,69054
5e81d72d0d9bc1ea530dd945084c5bf8,79,59,138479,25752,112727,79,59,95709,36952,58757
48162fba100cabacbba6f4600b7f9be7,115,94,238956,51414,187542,126,105,314854,33424,281430
e82123f8ad4a9591908de9658ac5690f,64,45,57972,17198,40774,46,41,40385,14181,26204
14f862776dfc742e4f92cd5593caf795,186,134,688582,136607,551975,203,162,821806,197245,624561
bb0a3c32c27ef967488234078370d76f,56,42,67990,26181,41809,86,58,111366,23941,87425
99144825b0abf5e820c4b3af7b296300,96,82,191499,37568,153931,75,68,148980,49003,99977
879db6f618fd1b77096feaa7ae447d66,34,24,18927,4593,14334,36,23,23195,4352,18843
6dbde5bca1a452cc66882d4ddfd14265,215,145,599894,85549,514345,161,101,414387,75543,338844
02683839510d303185dfd9965be5440f,88,62,132016,36388,95628,86,68,139655,39759,99896
a4a0b0e61744c8d64141716af331e4a3,39,38,22967,10645,12322,29,28,28725,7417,21308
d26968f4e01bd6d63da1a4da3821d20e,121,72,299831,61302,238529,132,93,285391,61044,224347
79c9a457bf092358228648f352283b6b,19,15,11718,2397,9321,18,15,6438,1989,4449
1eebc7a92976d44937b3c6fef88f0249,135,109,416771,95856,320915,106,80,285393,77374,208019
9a5921e040ad4c6dae7514dd1996a2b8,89,58,135022,33041,101981,89,77,165260,36824,128436
d243dbb063a70cb7245d61a86c0835a3,129,87,257446,50155,207291,130,95,301554,56278,245276
0981641d76ba1673007d17915bd7cecf,37,26,22440,9489,12951,31,28,24533,9681,14852
97ee8cb0700d39dd8ed18c748d3b6109,24,18,10920,3699,7221,24,15,9998,3368,6630
0d2f816e161714e581d7d977703a338e,68,62,95390,25417,69973,95,77,118859,32434,86425
43d41cd575ca3e3b3315ba844c262d75,32,20,20612,8504,12108,41,30,31569,7364,24205
649025e7e3bf44de00162d39d8dd1699,117,81,202368,47780,154588,109,89,187531,53810,133721
c6128dd32ced4ba876d1ed84aea894dd,78,51,135259,33430,101829,80,55,128733,40596,88137
3779e438201ef9be74126554b7f26c33,47,42,41001,11812,29189,32,23,18561,9604,8957
2b77e49ff4599cfd6c84b55f3e287b93,105,91,258224,74369,183855,104,80,238315,81658,156657
ffdd16483c63771799fb5f47e5b72fcd,106,83,181527,52222,129305,101,89,190282,67142,123140
b7e5dc72704eb58ee8a17f157d7a53dd,19,14,7041,2797,4244,21,16,7644,3112,4532
81f67649dd7dfd134d129d75bbbcc755,132,99,388029,110557,277472,99,62,283652,117924,165728
4f90cf0469a1e1a4d83322c4baa58a0d,5,3,679,189,490,5,0,288,0,288
a038e2039e66069691a6e0e11da2c901,86,65,158266,40735,117531,98,83,166841,51504,115337
0f8893afaa389ede6ac0659eae231808,68,51,130912,25347,105565,69,63,91751,40775,50976
37bb9bed4cf0f00230dbc745b7d59d9c,93,76,184474,66638,117836,89,80,203648,71674,131974
5b1c28f44253d5be1e213fa188f46e44,137,96,271207,51614,219593,141,117,395565,50492,345073
dd804fd460253aa90f78ff84c9e8c2ad,92,84,173940,43521,130419,115,93,135677,47494,88183
e74d7b5aeaf9ce2d28ebfed046d0abb1,89,74,217792,70548,147244,76,61,165788,63401,102387
16c51f272c8a74bbcf2959511c5c17ab,21,14,3910,1984,1926,16,17,3286,1820,1466
5afae28b86d13a55a4fc565a32dc2604,103,80,198283,62983,135300,111,66,169369,49590,119779
5f24655df98961869b5e4945aebf8a37,145,114,409093,93649,315444,171,107,351676,132356,219320
02479fe089de3c8ffc8c6afcf3c2254c,47,41,43061,14167,28894,36,40,39451,13303,26148
e2c17eb9321020a286d4546be6c08615,77,47,80278,17125,63153,66,54,82841,23971,58870
5f6f7f6b7ecbee56f8fe83160acf05ae,26,19,11923,3888,8035,25,22,16350,5236,11114
dd4286185e7126a371c214433f1e64ff,60,60,141610,35840,105770,64,42,92403,39109,53294
bd310dac5733c789450af45a19d9cbbe,109,92,185061,36261,148800,102,79,167602,50386,117216
8afd5ddfcea8eb25b739f45446a946df,47,33,52766,12771,39995,57,46,84804,26162,58642
4c69f065071b7a61bf31a8fde959bc49,24,15,9170,3403,5767,18,15,6450,2607,3843
40f92c1259353b8c42e4126bb887abed,144,115,340222,80649,259573,128,96,270171,60921,209250
30692f283c46187fad0a51b74f2a9292,21,10,4880,1202,3678,20,22,4009,2565,1444
26029799508bc3f3f06248fe019bb585,97,79,222460,74625,147835,109,92,275883,68331,207552
21930ff32e5dde74494e1ef9ae3e7f17,33,32,22551,9281,13270,40,35,30081,12143,17938
40b3c127da456d8e6b80afd03a50a4e2,142,102,448026,95995,352031,114,107,366333,129525,236808
ffaf8dfd34cb68b700c4845a4d32a1d8,105,69,170914,31794,139120,93,73,160810,43720,117090
7e6370368a49dd2b90c59e3bdb20dbae,92,66,259920,62698,197222,91,72,168944,68889,100055
c099e38a888fbd61a0c921de2d18c99d,87,66,137687,36688,100999,96,74,193156,44242,148914
3843667aa10305e05b4b45758701aaa3,212,142,1166711,215303,951408,243,158,1171527,165274,1006253
3172bdcebc26060d809375a5ed2817eb,1,2,222,220,2,2,1,220,222,-2
6bbe8ddf7f19176c4e3f3474511d79ab,17,15,5822,3643,2179,25,20,7669,2938,4731
041b806eb977d12572667ee4df85dc3b,163,116,681408,78026,603382,155,135,527164,111644,415520
e254a0a3b34b51c47bfab1fdc40ce271,74,67,138583,31511,107072,76,58,112710,32196,80514
6e5517a071854c9e71987557101c17b8,78,62,118332,42507,75825,89,73,145162,41953,103209
0529478141078109001eaee4a1ca9a55,28,28,20504,5665,14839,31,23,22571,7460,15111
c36fceda96a9ef4975ef29f1c577468c,32,30,16973,9195,7778,33,25,18883,5079,13804
4baf34c5dbf0b0c53f794067d26bf431,59,42,91601,20396,71205,54,38,76552,24865,51687
cce327a95779b75148cdda5178b44647,26,26,16055,7615,8440,26,21,19499,6380,13119
dfe2584e65726d6f1b5793bc2512c085,73,63,127350,32683,94667,79,61,96935,37381,59554
c13e4e7e32a04c78954f3bd9ff4befe2,158,125,359099,88789,270310,158,132,363896,67527,296369
d95d9d76b2ec28130368bfeee0635b35,145,120,305168,53227,251941,119,96,253670,60018,193652
8de2add9996a157f130696936c4e87ad,26,19,15442,5728,9714,25,19,17010,5901,11109
f42dcf0653e91d878681907dad05e7a8,149,123,494556,133208,361348,217,154,707764,112833,594931
c51cbbda5ae535b9efe7f65075854f94,97,85,192803,32366,160437,109,82,138433,41847,96586
0f4414fef3e1de7306ad7db47a90f0f7,31,23,19076,9289,9787,34,22,23690,7657,16033
9828a84a41c32bae9d7258a6290185ca,156,104,472516,93121,379395,158,119,443592,104403,339189
d1141c576ebc67efa1e77ed5d61f5273,91,68,144826,25087,119739,112,82,176425,26215,150210
d17f32b95cf9620d6a66d62f6134e392,77,55,135179,30844,104335,51,45,97180,25462,71718
27b7e29e0b381a4cec1285868de47c76,145,113,452509,87717,364792,166,126,540618,83711,456907
590a15a6d6359a12147f7a82abf317ab,159,122,675654,170634,505020,181,126,626157,84877,541280
c2f5a3fcd4e1ba6e79f510a962aeece5,143,110,649317,104716,544601,156,121,522860,120658,402202
4dea023df6092de2550a0b495cb935c1,85,74,221874,42362,179512,99,83,200377,45548,154829
fc60e1b33e78a4629020d57b1abe9f1a,127,97,309451,78592,230859,140,129,346665,85266,261399
60a7ee76a88370a1c1931227076e6e95,108,91,165058,52393,112665,94,71,203588,40984,162604
19c012555d867fbe0ce15b549274ba30,119,82,202504,29327,173177,150,117,324851,41695,283156
f167a50ab744dd7a0a7d5458f2616768,116,90,229483,36707,192776,94,79,174735,43095,131640
ab62226f73c57614dd8ec5778ff6e251,162,131,431772,71068,360704,174,144,473982,79587,394395
b92eeb3d36271243f8e5b22675a30f98,52,43,63737,25426,38311,47,41,70022,22838,47184
68d36d5ec40f8ebb61c37e546ec78fbb,37,31,40906,12984,27922,36,30,40550,9844,30706
e42653894e523ddb43bbeae53e24f926,22,15,9077,2166,6911,20,19,10845,3594,7251
689a3aa977b72da9f91848fe0f896b08,62,30,51478,15731,35747,64,59,84392,15236,69156
99c7642079c3f9379e4f9ab4f35469eb,152,132,356680,67986,288694,133,99,253595,55680,197915
5e76b4f155b72f9933f626c57eaf09bb,33,27,48012,16080,31932,39,27,33226,16080,17146
36ba8f65141e3ca73b5a3290816ed10b,139,103,345233,91091,254142,167,129,385609,133233,252376
8d0e92cb12b52d5dbb7c3faebbbad3d1,23,18,7408,2479,4929,24,18,10576,3806,6770
0a7defac4f0b32ad0def19e59c8f3a3b,123,83,219119,36124,182995,98,54,157739,40535,117204
e7a087eb2ed8b276893fb0d524c0c8ed,40,37,43048,12723,30325,43,36,34289,16775,17514
ec21abab4fba201ecb2202910ea1851d,144,105,226770,43650,183120,153,111,332206,43812,288394
4e91933b5b33b5e81facfa66fc2b0299,99,78,199558,55926,143632,112,78,246423,31361,215062
75e624912402ea631924b46cfa529eb0,33,24,13669,7745,5924,26,22,16696,8447,8249
5892b887fa278fb4af93ebe0f3f628ab,65,53,69788,16242,53546,90,61,98101,22246,75855
aec9246effaffc31562cf391324c4909,54,49,59931,16166,43765,51,37,42874,17684,25190
4622499b1454a993353fd67ec9f8643b,25,16,8164,3057,5107,20,18,9266,3027,6239
da0612437cf9cf70ffda4078c2d59322,100,84,187558,53007,134551,74,58,99929,49760,50169
402c9e51367c5f0a330dc1e6a1034dac,127,105,264425,64812,199613,116,83,217423,45313,172110
83dcac4e39166b8200757af08d4ec8d9,64,53,86483,27594,58889,52,48,61580,38566,23014
094c7386e049204b8b8d8dfc757bbd5b,152,94,319806,76152,243654,139,89,335750,89932,245818
e94a074abda269ea610a1d6f411db7a5,87,71,173869,39265,134604,84,70,179098,48457,130641
50b4ead125644707318cd00e448330e0,101,78,197303,83793,113510,102,85,194118,51939,142179
75f9945ca4bbfab01c5b5a700096a0e8,137,95,408060,140514,267546,151,104,456451,187235,269216
9c3b235c020a15985e9eeeac6663521b,83,62,138565,48552,90013,100,60,234873,30484,204389
73d2807879b569fa8b0d4ffb7cbdf6b0,65,47,78261,15047,63214,55,53,62447,31084,31363
9a7d44f6c527f22c399d99a74b969d2b,85,69,185274,56374,128900,107,78,212353,45321,167032
0b1e26b8fbe38ad2dcdaff53d9b93ac7,160,141,384348,85334,299014,122,79,258120,55443,202677
2594a0c4c4268076a03b7acff77cfe5d,81,71,209894,68301,141593,181,110,317814,76649,241165
e4dfc966abc2635260f3522df033c979,132,109,352051,147405,204646,101,76,243814,79290,164524
f74f9fa870ce851c7954dbf85051777a,130,100,307474,54188,253286,133,95,297828,48366,249462
1b3d5997302629cd15b539665a10f1cd,43,40,30248,15585,14663,42,37,47699,13140,34559
632d2c6be9e1a8c723f21a67e1111bc0,62,41,73549,19997,53552,46,43,54362,22228,32134
0547f10f369a489085efbf78f5eb4c42,40,30,31914,10108,21806,34,28,29880,14308,15572
f1946267508418d6005bfb77785bdf9b,175,121,446652,151751,294901,140,108,399420,100593,298827
92ef6c6b50d14b498eed88995284aee8,0,0,0,0,0,1,0,100,0,100
03c4aff3548166c8f9e17c3f99b88d9a,120,88,330895,60678,270217,106,75,215863,64525,151338
7b6fe2bfad6a2bfbac68c7616491e09c,50,38,59026,21267,37759,74,54,77564,25251,52313
4ee2d4e551a3e38d6262bd0d1e3354d1,73,50,116137,57596,58541,134,121,249581,65932,183649
153eddca39e85a76e54e79ba20265dca,130,82,296778,84792,211986,134,105,437952,77409,360543
db38438007a8e3f64456b7d25dbffda9,55,43,54782,17721,37061,44,39,62184,13181,49003
3b86d45e2005b2604d1eeb2475965d25,42,31,35310,9458,25852,26,28,21059,8264,12795
4a7ae18147631bb2f79bddce3840eec0,80,64,138733,41631,97102,82,63,120037,39603,80434
f3affa910ae5a35fa2e15a28ad67c1fa,130,111,334900,68562,266338,155,122,399403,87995,311408
9a0669a09c3b1eb4522d7435e2b93a23,71,45,119036,39588,79448,79,50,128836,34342,94494
98ceba1c630263de43979ad9e50c29a1,220,151,785878,139179,646699,193,150,740583,122564,618019
2b28c9a6dacbfd8224d2fcc36f636e6c,131,93,288408,50122,238286,93,74,198449,62917,135532
357498b8d6043be91fbf05b8cde3d89f,48,35,61515,21027,40488,66,48,87097,22727,64370
a09c7496a6c35708a1023f41bb235dd2,201,130,783254,236997,546257,175,119,986391,245671,740720
77451e7ced424611a723f24ff59e0a46,129,106,315158,65466,249692,108,82,286857,46590,240267
683dc7a11947804690c373ba414c33f0,99,82,205260,42269,162991,85,62,124498,47487,77011
f61a5010155f52505ad885bd89558f09,34,28,26141,16479,9662,35,26,32312,12217,20095
dfb419f46aa20641e76cea202d2181de,155,108,463589,87227,376362,156,94,382975,84051,298924
03621870b175b086b076899631419e15,51,40,48303,15128,33175,65,49,49067,18289,30778
3b31210fc21f731d879476bea9823e08,6,7,654,901,-247,6,5,889,642,247
0c6e15ad7b98724b5c5aeb763f4fc5cf,30,23,18910,5388,13522,23,20,18091,6163,11928
0e725833bb3865768ed0a8d8d49d6510,120,90,221935,67606,154329,128,91,295475,52037,243438
125f4e6ccd1599f5114a30fc373c2479,142,114,321803,58291,263512,134,101,360383,55520,304863
eef45e34c6e171df15202982c84eb006,94,75,118766,27754,91012,71,54,74347,18959,55388
9808801527c88c775c83299f288b096d,103,79,241550,79098,162452,130,88,287329,56364,230965
ca8f453e5ba08fd779c7211c026b0dc3,39,31,58748,16180,42568,48,35,79019,13519,65500
0c50a3521fdf9ff514462b0f255ccbbf,143,109,303854,52902,250952,160,141,385678,88674,297004
de7b747842d2aff1ed81029d0477df54,100,89,221777,55715,166062,124,107,254102,48122,205980
e9390b9fa4cbc3bddf59ec4428956ad0,72,57,150704,30888,119816,87,62,161664,25601,136063
a31be9086846e60f952b5ac92108d711,45,37,47207,16457,30750,43,36,43765,14798,28967
b3cdf3b71435803e1cf2f350239d584e,111,112,428719,112104,316615,135,96,410235,124378,285857
ec79590852d7d2a4be0be93708db9495,49,32,64008,17645,46363,49,35,68447,24339,44108
a8a327270fad1e75a485ca0ecd7a360d,46,36,33574,10401,23173,51,43,44861,12745,32116
00d0c2c4c9fd95034d171628d14ea592,148,119,413601,58366,355235,141,113,418268,63932,354336
1cebdb4a1e40c952fdbcc07225b942b0,27,25,7361,4263,3098,26,21,7224,4568,2656
421e72e39daaa8ba940ab4d42b0a8b83,29,23,10081,6100,3981,23,21,8036,5306,2730
cd2da8c5c7f53456da794934f90497fa,122,96,320824,40441,280383,95,81,205581,62404,143177
c0c58f687ae8dfd44bbb12364360a1df,128,90,334669,63665,271004,171,124,389511,69022,320489
4977cfdb15f38c89f206c3d61d5b5385,69,57,97342,22017,75325,78,65,114749,28498,86251
035a0c1d5567cc9c4c60c5242132c747,191,138,673657,190616,483041,267,167,1018186,165816,852370
9a142643f8873a8db08bb0c270830b00,50,42,50936,17887,33049,44,31,57880,16014,41866
cf66d79853c9d7bd05916906b9ff9ec2,83,77,192056,35979,156077,105,83,149215,44781,104434
7d7eab92de4bf784ceaf5e3e09780abc,7,5,712,880,-168,5,6,880,544,336
37f017253d76aeba9e1829dbbd2b935b,130,100,269075,88772,180303,128,98,260414,67436,192978
dd6ce54fee91cbd375be7cf0155f99ac,92,78,156080,41938,114142,107,87,191124,47769,143355
514e8bfb631152de1ebdf01eab85e76d,142,104,348748,80807,267941,164,126,381033,63863,317170
501629e630def910507d91402359e3dd,156,101,520833,118337,402496,162,115,581799,116471,465328
cc2559542815580033ad715ff157e9ac,155,130,419386,82833,336553,133,97,371178,81198,289980
15a10efa4661256e0d729c068403e15a,35,27,36405,14614,21791,31,31,36319,13054,23265
c7dffe7a820f12dd5dde4f71db1b1070,44,34,33927,16876,17051,48,44,54760,19664,35096
3a68e2804e96cf51c8ad98f3674a4205,150,101,310863,63986,246877,136,98,328365,65172,263193
41e90fabca92131638c2b81f013c5b8f,120,89,387274,72849,314425,166,134,399499,81226,318273
0f905ceb56992b2f7963b6a206dc03bd,90,77,189126,57469,131657,117,90,340344,45531,294813
76a3687727c4e043167eaf72a1920f53,151,128,425039,81987,343052,149,113,459424,72843,386581
6891b460e6f63383faf2bdb80d694b79,94,69,157147,39620,117527,103,89,175497,54657,120840
2173a5b7e1e03c22fc33e0fc5e5c2d42,65,42,70166,22227,47939,54,51,94129,27472,66657
3639c1cd50407f0a35bcb7424ffa953a,75,68,146198,39723,106475,79,60,94474,35639,58835
d5bea6cf11d5b1b760a721ae66a3502c,106,83,255435,38095,217340,89,64,133988,37581,96407
4972208fd5dcf9a88af89b77fe9a6bf0,110,91,237997,57739,180258,155,117,329979,64169,265810
eb1a4a959172912796d881fa6dcbe2a6,205,125,464779,106409,358370,137,126,437099,98353,338746
a8d805457622246cdde2bfcf5d0454bc,120,88,282728,49775,232953,141,115,295851,48171,247680
eedc66b04b173d0956ec8321743523fd,30,21,20775,5076,15699,23,21,13707,6229,7478
ba6f0b49f7184a2de7870210ebd5a73c,44,38,59280,27359,31921,54,33,83341,20631,62710
e39226cd36876b1313750beb2ceca93a,41,39,60717,30025,30692,61,39,117257,32054,85203
eebeb9c9b5f2fb42abb2bf4ee476cd9a,77,59,165042,70367,94675,107,66,220146,56339,163807
298ce82fa65b94b0e25d7ab2f6a293c8,71,49,48318,22803,25515,50,38,47373,16393,30980
0c3c4fdd2ca642823998a2f545c72df0,136,121,452034,103329,348705,168,132,514313,102511,411802
40d64af25f56a2560217014896a4bba2,32,25,15770,6698,9072,27,25,12162,5941,6221
a4f0cf6251876f55db5ea7c443ed79e6,131,104,249915,45330,204585,86,68,177977,33731,144246
20533923edd08a8f9090b0ef785edaf8,11,6,1751,1035,716,7,9,1889,1208,681
465d5ab9a44940f6ec4775d9d5bc4bf4,144,100,355165,107227,247938,141,113,406691,113423,293268
565e254d4ef90b23bbddf41cf5786f20,33,30,28544,13489,15055,44,33,39668,10342,29326
d73570f3126546c83ab8ece2536f6d83,181,118,514797,74546,440251,190,142,651748,118468,533280
b485e79a9c032147bbddb6b4707cb70b,25,21,10453,5137,5316,24,21,15899,5647,10252
888e64f692682f1dfacb228e4ff27955,117,90,226091,36780,189311,115,73,211884,41932,169952
33af4d976ee89fe39f95ed9e0571b1b4,101,66,255459,75876,179583,128,106,392088,108395,283693
254173b18ca105b3d0e27e1da98eb8c2,133,107,257053,61254,195799,122,87,287682,67338,220344
8596700c8741fb00c5d2d47493285e41,110,83,610795,136458,474337,185,137,696877,129575,567302
7c04554d10c78f4c3b4fa362da87eaa0,44,27,32393,10462,21931,38,25,33252,8039,25213
47b67c78e5c5c8d9773af6ec0040a564,41,26,30591,8110,22481,44,36,42327,14161,28166
4275b1b3e97a9b36a1e26d33f6afa086,61,43,79449,21332,58117,80,68,119445,30854,88591
38d6a9bb7b8d941c2fe5d4ad070f3ecb,71,59,138891,39253,99638,80,55,103638,32406,71232
a55316e4f88cc858a85e270a78ffb092,102,86,135732,33553,102179,83,71,100759,39281,61478
e56beab91c255a12b80ac8be4533d651,76,70,102496,32645,69851,77,55,114261,26619,87642
2ea4b663328b1509654eb5ed83c16e60,115,75,238880,54975,183905,103,85,218504,50797,167707
07a4b63e8e73b58e580f73d3efc563c0,35,25,28745,8605,20140,24,24,15522,9917,5605
3262c2741dd4983dc979518e0056ae4a,41,33,37430,13093,24337,52,28,39548,12806,26742
69190f7c5b02cd317e882d1af6d127df,2,6,144,673,-529,7,3,788,337,451
f5366659a31f35d6ebe11f7dcd1c5ced,83,61,150419,33063,117356,58,56,75354,45902,29452
67bf0ceb1d9a6d0db927d7410702a916,153,114,537802,74871,462931,142,115,365103,69193,295910
4b6d4201f440470464748aa4af91ba44,159,120,463928,70181,393747,173,120,430575,86971,343604
f88c12da88ab8f88b57b1b8e459a81aa,60,51,93145,31955,61190,68,57,87146,26156,60990
5f6fb78437c4f0bf40d4a808b8f945ab,54,43,48251,14978,33273,61,57,46237,19294,26943
4f9823970dc5cfba33f591e05bc7b1fb,148,102,328367,58902,269465,133,103,354319,61822,292497
e2320462f4eb2d90b9ea0c4bc8d8dd16,126,94,311219,81420,229799,89,81,241709,97998,143711
b5cc4669c9411d724d1b09bae91b3dca,79,52,115850,22707,93143,50,41,63709,27073,36636
b795f7aa066fef0f0af8ca5ad2365fd1,96,72,206534,38328,168206,128,107,274378,61329,213049
b243b85d91a20ec067b970667e1002f4,14,11,2056,711,1345,11,11,1197,912,285
a6bf159f3b5dd810eb0a5a885af2b5df,99,80,208889,61300,147589,123,104,281042,43280,237762
1eee3982697ecf9c3e1a728d2a671511,157,117,572033,103823,468210,196,127,633961,122966,510995
7ae04caa8201f0f1a59e3be133cbbb55,112,86,180223,61773,118450,113,86,268858,39068,229790
12752a41e9212746d4b174abbe73244c,84,59,156207,34347,121860,92,69,159348,36429,122919
01967a10f8c5cff7d493b4e1d634b96b,95,77,175710,61828,113882,82,60,172784,50009,122775
cac6688065a8af148c345bbe166aa355,107,86,183268,50673,132595,146,95,226793,36364,190429
31dadbabb029b6dd6d036e81376e2c46,89,72,200715,52295,148420,111,91,231418,44241,187177
2a941977f7f0d1c987563c7357563727,34,24,26217,10390,15827,25,22,20343,6756,13587
203f67f421fd731320f2a11352505fd7,61,45,73537,30095,43442,66,54,81854,26741,55113
18f8e09361deebc21f6164cc87af0739,27,25,12203,5642,6561,28,17,9621,3725,5896
fdeec31d8c7c0f944879b47d3da60440,60,52,99255,31626,67629,59,50,50884,43508,7376
30e1cc24e1ede61c295f256073575d31,126,90,304285,81562,222723,94,77,207920,73696,134224
5ce4a2b908aea5346ed2b3faf39e2ee4,34,27,13995,10231,3764,32,28,25471,8325,17146
453de23b20c94d4486d7728bea953480,49,32,40567,8981,31586,43,32,37831,13569,24262
e4f7c0dc8b70ace1997ba2cc30abe7fd,33,22,24247,5951,18296,37,23,24886,6495,18391
610942fa30ca8ea8f119411d3e66cfde,79,69,224121,53490,170631,131,86,259923,54921,205002
cf6229bb228b8591ac210f24c365dcc1,32,21,18412,8800,9612,32,29,28405,8458,19947
d349a06b35451176102f1900adc4fb4f,50,43,47788,17065,30723,54,37,50748,17086,33662
17709f671a84e56874324ea3d78c4920,39,31,33086,8599,24487,40,28,27441,12366,15075
242daa9c7ba7f90fc7bb7f469014603e,29,22,9175,3618,5557,28,25,12031,5472,6559
47fd0268751f8c05c1210ade921a5c3f,105,88,216020,49459,166561,95,77,135355,43542,91813
a20f6cba34a47b8236783ec15a3a0dd9,123,86,233415,51270,182145,132,105,194228,62524,131704
d97b2dc026075e3ea671c967083db1d9,184,133,837160,217614,619546,226,159,959788,182138,777650
0c03647d0560764bfdd49c0e05655f28,43,29,53431,8786,44645,48,46,47397,19323,28074
4a6bf15c2b0ae54b84f3b1253562700a,45,32,53405,13356,40049,37,24,33440,15019,18421
185791223892c4d3faad49da72865742,47,35,47398,12023,35375,48,39,60862,16540,44322
0396d75d72a910456c7eed38ede2bc9a,28,24,19576,7973,11603,31,22,17595,7186,10409
953a82abdae00d3d8d2703c7d4a332b4,69,57,80847,25766,55081,61,42,62862,22033,40829
b23f02db6c74abfaec287dd0ee4bce08,251,152,960242,145485,814757,195,130,866439,183259,683180
941982952050eb77d47fbd7fbb2775d1,203,112,679731,168305,511426,200,119,963421,131735,831686
32d888094a431547092adf1a62c043c9,37,30,24348,12160,12188,44,40,43720,11387,32333
7f2751997473097ba59feaf11e142fcb,118,75,254802,47053,207749,151,107,345530,47291,298239
667e5961692b87d4d790376570a11d58,29,26,26184,12339,13845,43,27,40267,8806,31461
e54feb9e1f4e64b4c8572110aa4450c6,198,140,961568,183977,777591,202,172,1140420,219940,920480
63576e01c506648fff5f9f8e9ddb6e39,112,77,190539,26589,163950,93,67,110505,48028,62477
3c86fb5378aacc3c87aac23c7b56c319,135,101,332810,66333,266477,112,75,214586,57430,157156
fec735cdf5a8270ec02a1d6bb4ff5c23,123,73,335589,111358,224231,196,132,618444,108209,510235
3bc447d02c08fdcdb76d529b9c685a5b,48,31,34151,5321,28830,29,27,14671,7186,7485
8761ef6d0b276e572c8b88351bde722b,148,116,573561,132313,441248,175,130,603488,136064,467424
dfe3449338605106c8f5ccdef6424744,55,45,68582,18216,50366,57,43,52927,18318,34609
f603bf61a2a93f10a19d4ab38f69b5e0,38,24,32858,8099,24759,24,21,17552,7796,9756
e07b03c663b10f2288d7bd54174170ce,139,92,339915,73293,266622,139,107,328349,77537,250812
ce4d4dc8ba9370acc96a07b1efadffcf,47,28,33442,9536,23906,53,48,31700,12184,19516
8eafd2e24a544e41b86493183cbe7379,52,42,45334,12890,32444,41,25,40371,9880,30491
2ef86edc4bd569b03ea570ce99a83ac2,62,55,77831,18563,59268,62,41,75249,12305,62944
41d9780db39718b9b7d237badc7e08a0,147,111,306418,63577,242841,122,86,262704,68329,194375
fdc175e351ec2359c5aa6f0de77c94a4,152,125,627688,143089,484599,172,111,755804,112727,643077
2f4a63fb8764e31c464180ca8d682551,25,19,6849,5170,1679,27,17,10959,2670,8289
5b1ff888d3b0ee7c20aa6e5385971c5a,123,95,332512,96370,236142,113,93,411129,101728,309401
aa5f51b92dfcb719deb6be21bd3cd59b,57,40,58229,25739,32490,51,43,59028,19829,39199
5029814e96e9bbab985d81fe11e9cd9e,174,116,403434,54577,348857,142,106,345566,81145,264421
2ea44c7568da47476d0e4e3bb4fa1a13,167,103,388900,74154,314746,150,105,334799,95456,239343
cf798ab1de5cf3b5b8beb0cc52b7465e,40,28,37762,14166,23596,44,37,51242,15277,35965
5d028846514aadf81a7e99ec9b7253be,93,50,477575,71467,406108,190,134,516374,76609,439765
e64a5e796bbdcfd2756154826e4d6a63,153,93,373777,64937,308840,159,106,339530,78279,261251
181aab29cce4859640e86ddf7c04cc7b,75,57,139729,26121,113608,67,54,110811,29290,81521
e6eab89d1e2d8b8b8440110d4f985dae,39,36,59312,17686,41626,49,30,68971,22212,46759
5d37abcd80e7ec9cbe1de57ca09550fa,150,108,350035,58083,291952,176,148,425736,71166,354570
c298c45cafb00a81783a8e24112d5b26,125,106,230745,46607,184138,122,95,277145,51363,225782
d6a601a179756d7bcb56878aa747e891,103,82,221502,50125,171377,95,74,159491,53969,105522
a9b41c6871a8e6adc76389e974a18ec0,135,88,261662,79161,182501,147,101,249789,67649,182140
6116d4b93768ae1ecfe930ae61adb3cc,5,5,846,1049,-203,5,5,1049,846,203
304a0acaa2675b4c0d6f7fa01c69129d,47,43,53793,20237,33556,50,49,53914,24377,29537
dc1aa4ee80bb2d12079e4398c4d0540b,132,68,211922,25124,186798,92,60,118948,33772,85176
4891a62e826dc0ece403d78f04c0eaa8,17,10,2810,1260,1550,14,11,2999,1329,1670
6a1737aa296b7ec1dd882a9cd1dddd0b,3,4,383,782,-399,4,3,782,383,399
f013524c85717fc72bb671b9587495fa,80,58,124077,36369,87708,86,67,177642,27491,150151
e41fa0be19bbf30f78277ecb1e4de93a,64,55,70103,23503,46600,46,56,43434,21927,21507
faf87196e8c2d74f1d751ac3d9ab0ddf,141,126,375363,86505,288858,159,125,452290,61948,390342
43839e354969c959798d7e2a7744be7d,152,113,440640,128244,312396,201,135,538851,157347,381504
add3a1707f15c32ad7c637afbe147e5c,25,20,12656,4994,7662,23,19,11615,4968,6647
a8ef2665ef916c9a358591e936827c90,42,33,45973,16236,29737,42,30,40830,15169,25661
9d5eea6d1d10123f6d5c243f3aab4890,48,32,38225,7986,30239,46,35,37847,6566,31281
b8cbbe9c44d8c05d0e99881686641f68,171,141,712306,199491,512815,200,142,765910,143259,622651
43c8e4ad85bf1cfbb7f10fb65f872784,122,108,290519,58627,231892,113,89,259337,60379,198958
288a7a7636c9652804a90d10d15e9308,62,52,103029,39439,63590,57,49,101456,26474,74982
a91f059dce10cfe669a1a118bce064ae,185,123,694067,124241,569826,190,139,563722,150415,413307
8880f3c492f3faa5120b7428c61d20c8,89,68,203213,68961,134252,108,87,245000,68001,176999
9bb658f9c916e6f4b58ff6bf95acc0de,27,23,17760,8221,9539,31,23,20498,7560,12938
8b7d351c4166818f7ef09379a0603e80,2,1,699,121,578,1,2,121,699,-578
5345c5be5fc945b24c3456a1fe5c51d9,97,72,160206,62992,97214,98,95,207589,63917,143672
035fcd28603dded740ea04802effff2c,16,8,3382,1195,2187,15,14,4092,2165,1927
c181091b5d1196de76875c43cdcf00ca,154,108,328024,58215,269809,132,107,301685,76921,224764
17e7c15af01ea5ba5d9c26de9abf554a,163,85,378906,109392,269514,180,142,423645,150430,273215
7dc097921b0e609de7016b2218e43f9b,30,24,18027,4137,13890,33,24,12723,4530,8193
cfa4bff052821aec585182c6976e31ae,19,18,5987,2969,3018,21,15,5276,2682,2594
c603a01f55a928ea76543a85f05adee7,146,104,452050,92491,359559,188,153,659671,129928,529743
c0500c86d49a0387b7fd3b0d12c865af,88,70,169617,31454,138163,83,66,136993,43934,93059
ecbaa6d249574a760785f471bb1e7ab2,78,57,105221,39239,65982,99,88,184108,48075,136033
b9079ade33d1110e8537f38017e342fb,29,24,13240,4977,8263,29,20,15433,4116,11317
18e3348a8790509fd4eb8e2e566c9d92,49,31,57405,10838,46567,46,35,38724,11856,26868
dfd5a327f1816758d07b8b30761706eb,33,32,31689,14211,17478,33,29,29933,14728,15205
9367caf7ca04ff37f0013d8c8b42e804,22,20,15439,4353,11086,23,20,9615,5176,4439
6c1e2bbe1508ba5da82aa66edbcf2fe8,45,41,79558,36004,43554,59,53,143832,35511,108321
d226eea211af00430b93d6679c776067,27,17,13058,2982,10076,19,19,8934,5473,3461
ab82c7f4888c165471ab61c886e2fe13,79,66,138385,37889,100496,76,56,129545,28323,101222
ff294d00e6f10b8a6934783922e40810,140,119,444411,115019,329392,201,107,595911,135617,460294
ba308d31d14254580ce5fb51d084f0c0,77,58,151104,29997,121107,89,63,103824,35289,68535
59be0c13085d1fa6e3cbde94d4fbff5f,71,54,120820,27395,93425,65,49,85061,27313,57748
b8d832de88ee1b33fd736f13303af9c6,151,117,333333,88920,244413,158,128,544360,77643,466717
4383e8b643425d333345a994f35c80d8,24,22,8723,5942,2781,22,21,11207,4118,7089
674d286e0b70b3dd0dfa425b5d42bbd1,23,20,11700,4282,7418,25,20,11273,5715,5558
29645c21336b96c7a3e3c8ae34fee6f1,69,45,95332,33638,61694,87,64,127111,42728,84383
b6dfcec34243d5c0ec796e48d97ec5d1,63,42,81911,17729,64182,58,50,60138,20518,39620
89ee7fb320939ac6e72f6100152e3e3e,190,129,735377,163147,572230,191,156,895631,157088,738543
2041a6d9923dcadfd7eada65a378ce71,197,131,497738,103474,394264,152,100,448453,104007,344446
83a3e12bef06c2286792bc2f8ae83d94,18,15,3473,1925,1548,21,17,5454,1259,4195
8c8ca74c56f45339e9620afaec5afc58,0,0,0,0,0,0,0,0,0,0
d87f4bfbd8a5c8cf6cc1d5415da922a0,155,126,466710,75171,391539,168,128,595429,101367,494062
db99735364f15dde93c098636dbcddaf,78,64,96578,27331,69247,71,63,69037,29813,39224
f121df49c39270587bef0735b0e9d943,135,102,354420,128226,226194,169,123,586508,92939,493569
e18d48fe2bb397b1fa5133f3282c5946,66,46,62304,17780,44524,46,39,44581,18209,26372
16c14a9d23d992e9184d8b6bea521dec,128,114,318413,67433,250980,129,99,291488,72910,218578
c9c510697e0189ae2d8e34e20c02b32f,41,30,40398,16500,23898,34,30,49739,14147,35592
5584c0c662214cae4a29703fb09658ad,35,20,20879,4263,16616,29,24,15553,5053,10500
04d08754d89295e88eef60777b0105d5,107,84,243741,49635,194106,120,94,309751,55482,254269
b34011015568eea2ebd366f65cd1b5a8,71,54,96790,32816,63974,54,39,75598,24398,51200
d8a0359332afd98cedadf7af945697ef,43,38,47010,17909,29101,48,30,44129,15243,28886
c903c83d00d3b6d70ebe689a8b9b59ea,60,50,75247,27153,48094,79,65,106277,27622,78655
7fb24ac6da9c76f5a80d4cdd19c123ae,123,95,231188,38902,192286,135,98,193296,43903,149393
7dcd59cfbee93f99ceccfa56315199f0,107,88,251489,59587,191902,114,93,250537,63193,187344
b7b10d12c14acf79681a3cb8cb0b791b,179,134,712265,74884,637381,154,135,562806,101666,461140
68620b5ba77fdd4742fde831827cc098,131,97,259617,90690,168927,150,121,465896,70829,395067
fdf55354538755b993ffa9154372f059,124,102,419787,119562,300225,185,141,669239,117614,551625
f25cd3944fe928f504380ab35b94822d,76,66,151473,53744,97729,82,73,160393,43119,117274
fa86ba7bb32dad0d4ccd4d87004414fe,42,30,54134,14240,39894,53,34,45814,19783,26031
73b3183cff29d57261bcbb537c74296f,66,45,67871,12582,55289,71,52,76690,19544,57146
6e34fc792ad162ac60be1de829166dbd,72,64,155917,68019,87898,95,82,252189,66345,185844
69ea1a1155d304fe21c146e6b836ad98,50,43,37861,10693,27168,51,26,48229,8028,40201
cb855162d76562cf080a76527dc4fa05,62,49,92230,33162,59068,64,61,112695,25028,87667
a96a0edec9874b48afda4294e1d7cca2,27,18,14473,4496,9977,26,18,11534,6982,4552
6ee83edab26e0a5e394a061708af0c50,142,99,422037,135891,286146,181,136,609950,110113,499837
e5714a16daae5dd42db994303ec9f0e0,71,56,75227,27859,47368,83,58,89333,29843,59490
20f6a8587c70e6219cb93b41b8fdd018,121,91,645589,127343,518246,163,124,679399,127107,552292
aee889e52e0b286eb2b9c16ed00c2c8f,61,40,52668,17390,35278,60,50,68603,12825,55778
6fc30f47e324a357d084e8e937a7a9b6,54,41,59257,19642,39615,48,34,44893,18361,26532
46f936c5e5ee979d6168c8595b8c03de,94,76,137022,62227,74795,115,81,210751,32467,178284
fe6b567489b23b45a3a780f0b24592bd,121,87,332399,93786,238613,90,76,267129,84095,183034
6fdbf5f8b1ca73c12904130d9bd55dc5,37,28,40001,9449,30552,41,37,32158,16035,16123
000f6a90d850a43393649af550572f48,143,119,350282,52082,298200,107,81,172483,58520,113963
6e1f0ad7a7b42af961d13691ba09045c,61,50,95446,27811,67635,82,60,104498,32997,71501
73e977d6ea4813c836b4eb4e97b241d6,40,24,36303,10992,25311,47,35,38992,12858,26134
3d3ad2f509c82b9c719d081ffded1147,32,27,14659,6772,7887,32,27,15957,9518,6439
e097485242b7be721ec934eed4fe3d65,1,0,32,0,32,0,1,0,32,-32
507dcac02fbc41a46232d867eb865abc,183,141,740617,159189,581428,181,109,921656,99264,822392
b1eb2666d4258c4d7a85db57cd4fb122,139,113,460336,78853,381483,162,113,423123,78256,344867
c02a00bf015a5a21fa9fb97e6dc792cd,2,1,135,59,76,1,2,59,135,-76
3732aeeadf4737beaf837b141e0976be,172,134,633352,121555,511797,178,131,617545,105063,512482
4378d8f185a0c6d0f4fedc0a5711cefd,135,86,269818,74810,195008,122,89,269469,71236,198233
9507af7fc420cbd77cc24bf1131b5571,18,14,3538,2961,577,20,16,5547,2381,3166
34afcc3850b5e8b5165f0d7bf41907ce,140,120,349476,50456,299020,125,95,215651,58799,156852
6575716c90cf44d6899d64b41aa7e846,143,105,446565,75039,371526,135,106,508131,64268,443863
7438a35f2119669b22b0a938e49b747e,65,52,83220,28511,54709,71,58,86143,24518,61625
f68bc0a51ae16b0793dc4f60fee4c9f9,154,114,528634,102511,426123,188,145,522589,137393,385196
ddaa4239d703b74a150b0d4ffe46ccb9,72,52,91903,34596,57307,91,64,176006,37631,138375
db7034f6472346631a8c355c1546c653,58,36,80994,9103,71891,45,31,43053,9397,33656
7ce4122f2be4168eca97a0710bb18a81,44,32,35034,10880,24154,40,33,26162,11010,15152
0c576550b18ec65c0a8984f591083bab,80,62,115947,21433,94514,49,39,80385,20324,60061
befe162c7fbc5549e8dfc69776bffb9d,44,35,49457,9736,39721,46,37,37140,10588,26552
1aba5c1d56d38254fc06a31e3829afd7,116,88,291571,82501,209070,99,77,225524,76816,148708
db7b53c1e865bf4839a2f9304218c60c,91,51,162816,32963,129853,126,107,260870,54648,206222
461da10cdb1e11ac665fc30cd45726a6,23,20,16530,6079,10451,29,23,12745,5583,7162
b3c5101feec9ea0513950c8cd1a91f6d,53,37,113758,37360,76398,53,49,127539,36181,91358
f55745a7a6c9975db7586d6276b0721c,87,76,120998,33860,87138,73,58,87569,33179,54390
e9c1b49e6c64d8cdfbe042f1042ab766,128,80,265286,59570,205716,140,97,298246,62797,235449
9dce058c6f488766f0b5c37e3b8b0a9f,81,68,169346,40968,128378,153,103,353643,33037,320606
fb2deb09446407c7ae86a5f7571ef723,25,20,15965,8644,7321,31,22,22635,7092,15543
ca5cf34b7fab12a6971599cb414d3126,45,40,60637,17323,43314,45,37,35885,14299,21586
d0ddd1ad87219d7532dbf5289c96aa91,21,16,4645,1468,3177,16,19,3409,2512,897
349690e8af9da1c8591e4a208ad3bb27,89,50,143146,34844,108302,98,67,157340,40958,116382
95e08535b8bf81747879a84aedab1750,144,107,381690,89529,292161,158,117,405419,77827,327592
9bf78763dd4531402b91fdfb55354ae5,81,56,145614,38208,107406,71,51,93559,38729,54830
39b492856fa03ea468a1cb7b84bf79a1,64,45,67831,19249,48582,56,44,98190,21244,76946
7f4cf995bfeba2d93f1e255293259edd,36,29,25537,11430,14107,32,27,24785,12612,12173
218e6bed3879903e4b18ae726d57a21d,86,72,114631,42033,72598,114,102,235550,28657,206893
384b7c317bf3cc4720b654ad9dc59572,150,112,391963,84078,307885,158,119,404596,101882,302714
6f4d7d55a8bbd3fcea6eff2589ef35cf,55,42,65695,26204,39491,45,35,69894,18985,50909
1c9586f91feeb319d310fd3af5be3430,33,31,23261,16267,6994,35,27,36040,11935,24105
7495b33feca0a923afbdf2cc9d3484b4,25,25,18425,5945,12480,25,15,11540,4804,6736
9e4cdc0b0981c5658d7836abf4327643,65,32,61874,11341,50533,46,40,38421,18491,19930
a4aa94bc52c5b2f971a97dfdee05bb45,135,96,383457,134668,248789,108,86,459945,156262,303683
e15fddf1cf653d15bb28646f5ee8e93a,28,23,14979,7753,7226,36,29,18187,8160,10027
f8ce4401db1273b7f0389eeb72595f4a,102,78,221637,69040,152597,154,117,445405,88988,356417
a4b6617a05aaa5b7bcf6dc13d195f8c7,40,35,53285,14300,38985,31,27,32075,16166,15909
bb4879ef0814207ac4f4fd562e4185c1,67,58,100454,42131,58323,90,73,157376,31894,125482
f41fa74bb78cf04c8fa2b6f309399a62,103,88,224202,85737,138465,129,88,273457,69886,203571
a9c32c18eadc0f57cd99501f8184f731,52,45,73856,21993,51863,62,49,74726,21235,53491
b469fc3f90df8844ab56a1ec503bc3d5,76,59,176600,42821,133779,77,60,150168,39357,110811
29620f33ff4dc2cd4423359da445303f,32,24,31092,7901,23191,26,20,21850,7678,14172
32e0ab249d009c298810ff57eb098b3b,36,29,27997,12052,15945,36,21,38507,7079,31428
7aabe6e5677df51eab45bf961c5d9a53,72,55,107983,27460,80523,74,64,131697,30359,101338
172175eb86af3865a48d1f3b03fd9854,83,60,140637,32407,108230,78,64,100435,27763,72672
fd3dab92af8f26b6a392e8fdb866566b,77,62,116316,29654,86662,66,49,80627,26343,54284
c99a09061adec271b99fafd8380ff70b,122,98,219969,59697,160272,98,80,165694,53110,112584
21f8c44923d47bd254e3b828eb109215,154,127,378712,169880,208832,163,115,523992,136796,387196
e881acf222dd6fda1b2258a21146a0eb,86,64,143685,34050,109635,55,42,80507,41250,39257
13f2ea84de49a5549f050dbcfbacc686,42,27,36965,19024,17941,41,30,53123,11428,41695
b31a2a6e359b88fbf0b6f608a77926ec,143,119,362850,80246,282604,159,106,360567,61476,299091
a97bb32ed534aa54289d8cbd8f99a786,47,40,43834,13337,30497,43,28,48667,12080,36587
e5cc763c2b06179e68e3502e1c0ed323,189,120,638872,106176,532696,173,101,695632,123909,571723
264654d693f4074c2ba889e365076b3a,18,13,6432,3006,3426,19,15,7539,3833,3706
e4bc0f0a866256891ddaccd6594e8e85,207,159,791620,134100,657520,188,140,579934,163224,416710
05140a615f7cc41d4fed3814d40d7996,201,134,488422,111423,376999,162,126,473143,102809,370334
b373e50bae936eac54ab23c19445afb2,160,102,442019,105497,336522,165,140,555019,79517,475502
d7ed045a357b5ab0250a528e5905ff87,131,114,347968,72423,275545,104,88,263460,52165,211295
67ffb3791c2fe58f641b39ee8efaa5cc,129,99,340637,76466,264171,134,100,349779,66641,283138
0603cfc089b9a768ba338ba048cd1c25,28,19,7199,3310,3889,19,22,4980,4311,669
be736cc2a963839da27c8dc00af096e8,44,35,36960,17408,19552,56,45,53550,18934,34616
858ed0e1b4f063b3adcf2f91d58a0c66,85,69,251428,68660,182768,93,80,319029,67095,251934
3d7493aa5ba6395555255b0db76b9fbf,20,12,4396,1304,3092,18,16,3530,2260,1270
8f93efd90d61e5931f072e4cded98af7,176,106,480453,51478,428975,157,133,380279,92302,287977
00fcdb096fb3e9f287ad4fbd33f023cf,72,57,83194,33985,49209,72,55,102959,23784,79175
cfdf1b1964c901cbbfc852ff83bbc818,32,24,12205,4952,7253,36,30,9854,7680,2174
38ea4d39080fe3a3a62ffecbcd765942,74,59,201383,42856,158527,58,45,133802,51369,82433
be6d2c0b2693ea38237ec1ee2deee6b5,174,141,444285,61496,382789,146,115,360422,72122,288300
123ad421858526f72470911c44f37ad8,50,37,49594,11629,37965,33,37,36128,15486,20642
965787658543fd530fcd22ad51412f55,107,91,240543,98448,142095,131,80,340239,63657,276582
ea5bf290fba6f33aad3e01c68b76a5a9,24,20,14164,4651,9513,19,17,13425,4109,9316
336805e3520403db8ea63e95fa714dee,207,164,776981,131139,645842,210,128,687179,114056,573123
a4f2792b6dc717f7a74b33f5f2c39123,4,5,545,347,198,9,2,970,268,702
6eb0592192072822f5c2c6b335874256,68,47,127082,29241,97841,59,47,73152,34587,38565
4def7c302819149dee34cb07f3f9d4f5,69,54,81367,23691,57676,65,47,106625,20403,86222
8c6ad841a69ca65afe4517f0ea0fec4a,54,41,46184,9272,36912,29,25,20858,7844,13014
2215c94088b949b6f5fd3f36d480b0f1,138,88,304197,95568,208629,126,103,290310,80177,210133
e39cdff651144e12259a3b6e14643ba4,100,75,243525,37347,206178,94,62,185011,33922,151089
40c3af79da77d6ed4422c25d274cc0a8,55,49,72382,22986,49396,67,68,74908,31695,43213
c3ae92951d8c6cfbf2823c2ed205a6c1,159,123,395995,80571,315424,108,92,284712,68908,215804
d7fa5f691999ef09c9c9c77a4b930a59,31,27,15060,7209,7851,30,23,22193,7849,14344
b78d323d24c545cd8af3299fc1420805,62,48,118089,20825,97264,74,59,108141,22600,85541
c8f4b2b986d54fccd59bbc8a93d755c5,115,69,216456,57814,158642,163,119,342156,63495,278661
82284f2fd786b4aa16b72dbde302e8e4,108,76,276608,57233,219375,122,98,258635,67482,191153
a3c53dff1afb73f21e0854bd0768192d,65,42,84543,26170,58373,61,57,76498,28787,47711
bddd5227772e71f41ec091e70a8692dd,128,113,448901,165783,283118,170,127,513143,133885,379258
a177f24ae946ee470ebe988aacba103d,118,93,217405,36159,181246,108,84,193075,60774,132301
2a4e6e17cdc5409277053d845160020b,94,65,187052,83315,103737,162,96,337832,85021,252811
b25ff9a68fc8df8087db63a485e2c0af,56,39,41535,15210,26325,34,31,23775,12264,11511
2b57970a5906993bd18fa50515695a40,27,19,12433,3552,8881,25,22,9682,4151,5531
1d1c75783ce01f72dac61fc292f5d998,187,111,433986,120231,313755,158,118,414360,130484,283876
90ad8dab90820d2a9a845743ab452a26,16,8,2364,715,1649,11,9,1641,1172,469
c28f28646ac233130b71f66ae9a27154,67,51,110829,34999,75830,91,77,165964,35173,130791
66747d916280d54be4c1f31d41cd272a,37,27,30960,12606,18354,40,35,32419,13209,19210
a2d5dee45e63b976469aae161c92a8f8,3,5,245,264,-19,5,5,892,224,668
bc99df20f7954ab84de14470c148d9f2,100,84,286877,75249,211628,201,170,473814,89086,384728
1ab2b442f80eddda89cac56e64959d96,205,118,371481,44889,326592,145,107,334552,61315,273237
b2450e73a8dca5876a4e8a4ca1a4a01f,129,85,346574,54770,291804,156,115,426596,74698,351898
992705ef13f85e454d00907b640849e4,34,24,40408,9958,30450,29,27,27217,11817,15400
c08cd94569325d5e421f43c01fd4e903,120,77,295251,91318,203933,153,131,363680,124840,238840
9bb2ae0323de69fcd5b9dff9b27340a5,50,37,42548,17768,24780,73,63,89333,16409,72924
e902f3e9b3dde5e666582d2144d74d70,133,88,298973,43224,255749,163,131,418215,64555,353660
105ae89ab6c12b0c70f03cbaf892562b,56,38,71310,18050,53260,43,38,44793,22640,22153
da44f0e1c30e4b7a7e66822c3941b92b,55,46,89499,43029,46470,55,49,104286,29767,74519
9b51c45ca9114fa9eaa82a4406bc4fea,64,57,79053,20239,58814,43,33,52742,10992,41750
a09e40c94f8b93096e3e034780393848,176,129,772016,161779,610237,227,186,1028514,204947,823567
dee75bcd2cde46633ee6106e3c740c9b,67,57,98456,24197,74259,96,61,84150,31546,52604
aa842383fd7fabe7440b14867c228ff5,46,33,47457,15087,32370,38,30,39455,12969,26486
0c7ef4d4f490c8a00b61e7b152f63feb,187,142,532946,104436,428510,127,100,428982,75521,353461
c2fd398c282a885b5b38b2de6ca47225,88,74,178662,60585,118077,96,81,234445,55548,178897
562498d6d7f1bec24781b9035bdd4c8a,43,36,32365,14587,17778,43,35,43540,15337,28203
adefd7c51c3b0cdb81dc5b38d136c691,68,54,101064,26241,74823,62,49,74039,18975,55064
e021daba4f385798cdd78f1163da77c9,28,27,16024,6127,9897,29,27,11041,6875,4166
5fdbdddee58ac27d042b73f7a3588662,125,86,241740,70267,171473,161,118,334893,73299,261594
8484cf8de40d8bded2e42bf8b5c3682a,124,98,243857,68781,175076,157,117,323721,71423,252298
8570362d7e059422bfb4175156309884,160,114,622408,151298,471110,170,119,533025,172771,360254
0ccd03944c3960a52e9fb396d259ab6d,113,72,136962,32163,104799,113,80,146064,44370,101694
a3197e683d4523047b4cffc2555791bb,116,96,256622,49679,206943,124,106,283217,64274,218943
78484b3f01e626de9c8ce341452cb163,58,36,73033,20809,52224,47,34,62166,19977,42189
bf114acb236b1575a9a29c1edbd20af8,49,37,83824,30508,53316,56,49,108176,24361,83815
dcf786e83089a0cc7ecb539809b7736e,76,58,101546,41943,59603,67,50,104901,29698,75203
c7f470aad8ffce625cba3d00ab9ae7c4,104,79,270155,58650,211505,141,120,341149,61346,279803
931ddbb42f03b65f4cf8486da4bb28f6,48,48,53398,15297,38101,43,25,27296,12967,14329
06d56e35a5106d9855497be354a9c993,156,94,373416,74410,299006,240,147,527041,107392,419649
5917f4737df8085ae634d890d33ad9ad,159,123,576888,154276,422612,166,121,567974,176002,391972
8acfb35bbfab97724eb557455b337cf8,157,70,252516,40445,212071,98,75,192589,61678,130911
df945a3e12e3fe79dcaf6d3ecc06681a,124,95,250093,46673,203420,110,92,273986,56155,217831
ed41efa51483ed2006c236ea2532b1fe,32,28,18090,5900,12190,36,27,22869,5731,17138
a6e5984051584d45440871bf9548abb7,20,17,7027,4155,2872,18,16,5694,3356,2338
37e146d47ed2e356f312b23b8a8be06e,99,91,236888,101809,135079,134,96,377310,88350,288960
72ccf8874f6e335171c4b9cf0210c70d,81,65,165428,45191,120237,104,91,199725,37504,162221
162bdb4bb1b3389572279be37411780e,110,86,193389,62248,131141,122,91,291685,65721,225964
3b2b810f8ec508d71d4ed990c2bdf867,51,47,74144,27423,46721,44,30,68130,20885,47245
679b5e1cf1c5c6a0444979b04d3a3894,137,91,457156,93255,363901,168,117,412325,87429,324896
fabd7bdae1e0aa266c50d6c42b3b1c43,132,118,336868,64591,272277,135,113,321903,67061,254842
6ec030ddce8307a217268ab3ff563fd9,27,21,15500,6069,9431,21,20,13066,6992,6074
0ba40cf5c41b801da12b8ab13793de77,89,64,167992,42572,125420,86,66,129172,45063,84109
02295eb730adebd5040b04d96fe1ed83,68,60,74976,23786,51190,60,43,75376,20786,54590
1add41a850ee27fd7f77fc7e01e36e34,91,73,182663,60220,122443,109,89,230975,65750,165225
b3642021541da42d6da7b89bf82cbb11,13,11,1885,1791,94,12,10,1981,1413,568
0386b455fffe171d6927b7dd355de938,122,89,196863,37495,159368,102,79,213042,34150,178892
ad8bce0b563d99df646140b30d485721,60,47,74099,19614,54485,48,36,44768,21233,23535
adad5e0ab510b8c086d050ee59b192bb,35,24,19344,13506,5838,37,28,40363,9148,31215
7f855c0818b9a51707c49d0475a15043,88,61,218394,31568,186826,92,78,162289,47892,114397
b4c0cf09a866b335b0bd48b85dd84b68,91,73,172614,69734,102880,119,86,252416,81651,170765
62ff390885be98391f3a6e02294b4820,80,61,157506,51950,105556,80,64,147994,41570,106424
7a94f3c98e01b70955250eb8dcb35be2,45,39,72749,19185,53564,62,48,59731,22965,36766
94b013e4daefe13587687afdef481cd4,45,31,48559,18277,30282,56,40,63392,22849,40543
723ea44635040a815740123b6010ff34,130,99,401337,102288,299049,151,129,440000,109150,330850
c6238f361ba8e10cb2648f4f6d290fd3,31,25,17941,5762,12179,37,31,23339,6304,17035
18cf444b8b36ca8bb389e67a62c09913,84,67,175634,58357,117277,124,88,227833,72558,155275
57d9b2f540784963e55c8fffc4f7644f,13,6,2092,243,1849,7,6,489,551,-62
7de236f55eb2e1437c4373e0c24e19af,103,57,186570,34032,152538,109,101,235948,42604,193344
6efcbda2217b6324cd3e68428005baa1,52,44,58524,22544,35980,67,50,59926,20507,39419
a8f6c66c2a0d9bae5d65c25430fce345,176,110,586105,106030,480075,179,130,566305,154062,412243
2cbc9650c0a96fd498a2a8ea758439b4,47,35,36984,16835,20149,39,30,31724,10975,20749
1ead2f67f1cace76019ba80982aaaa14,54,37,44739,12522,32217,59,50,46568,13837,32731
e77521cb04447464a71af3965054a0a0,121,89,273007,58797,214210,123,109,281081,50581,230500
133d1bc11560f30b0a7c8596fae1fbe3,25,18,7845,1866,5979,22,16,11730,1508,10222
45fd8714e026ac1942393621269c0e1e,111,74,171909,36181,135728,83,65,132035,42205,89830
dcf083c5a56f71552edb93011196e996,166,140,386305,65795,320510,144,113,369177,61477,307700
7984763d0699b076329c531879094cde,20,21,21250,8548,12702,33,29,28959,7240,21719
1d857564886be3430d8480e5f3c4f4c9,45,38,69550,20124,49426,62,53,68038,20794,47244
55d347925f19e0366f7a62ddf0914c6e,88,66,245701,78062,167639,100,70,221682,99081,122601
70a84341738a749e596b42ee4e2c679c,38,32,50581,18126,32455,40,35,69585,20653,48932
d2932957357348c986cb59d2c4caf608,29,28,21038,8919,12119,32,19,27457,5814,21643
e81962d6c9fcec5895bf40a8e3e73125,97,70,178863,67121,111742,145,109,332783,63466,269317
4cdbc8a3db8a81fca0afacfea9bd9fbb,112,99,296063,68992,227071,137,109,362112,56436,305676
4fcfb3c61076e333ce2045a13b7cae02,144,108,325642,62571,263071,156,131,340492,66417,274075
c56baa92e92b06cf4ec0c72f680a34f6,72,48,98293,21822,76471,87,71,97062,25808,71254
226a228b037b84a0fbddcb7cd4511563,166,138,559467,114122,445345,118,86,376811,113239,263572
f73fc88ab322ca4c1dee7b04eab6db3f,187,152,685172,120104,565068,173,117,607946,82632,525314
ca2230be235cb4dc95866cea9112a976,203,147,642822,139722,503100,170,123,540532,107504,433028
f2bb59d8be383f9fcdebffcfb9841ea0,65,57,67789,41799,25990,77,64,131443,29782,101661
667c52cdcf86824de879481e2ecf11c2,22,19,8803,4383,4420,20,23,7161,4778,2383
7ffc7cdf8460a91afc7b333059f494e7,37,29,37422,11649,25773,26,22,18005,8022,9983
dba0e7a28e7af143fe6ffdec5f3b6040,73,55,114291,29948,84343,62,52,64280,31258,33022
d5f4eaaeee5266b33b16de54bebebb67,37,26,26687,8192,18495,43,41,39997,11526,28471
d0664c9a67320adbee97ad7fc33043c1,145,107,421826,72890,348936,139,112,350272,82939,267333
0fcb1d8b9ec61b438c9fd1540e12f93a,27,22,7678,3818,3860,19,16,4599,4102,497
9e251350b9916cb502bda40ddb561045,75,56,115049,52152,62897,106,63,149475,44301,105174
a04a5385cc80981aed50d497a035008f,81,58,112318,29518,82800,66,58,97509,36004,61505
6e24ac63ba64b99ce45d2b3b1c2fe715,85,60,129323,29310,100013,65,49,84881,25777,59104
20787e75e649381d66acf5609597e327,74,57,107860,24698,83162,60,51,75553,27915,47638
8682f9c3d6f493620654bead62a70269,38,21,22510,6634,15876,26,28,18942,8771,10171
f095b39a23154c7bf3afdc884a6f554b,59,57,108088,30861,77227,75,61,116437,33366,83071
633fda5f597c9452b73b32a6a965a85d,167,126,380185,55262,324923,149,120,412013,73813,338200
c1c61a98c246f30fa3100ae630ca913e,185,127,595742,108000,487742,217,130,840260,74143,766117
f409ba0224f751a42036788cc3d2548a,108,80,212486,36902,175584,127,100,238140,37281,200859
0efe392c109dfc03473e179e59161e54,26,18,7828,4845,2983,25,22,9267,3445,5822
ae4c1720c0b92e1dd0faaa789d0740dc,95,85,238182,85959,152223,147,107,398276,71324,326952
e9b9f4903993d31049e71a9d0e2796ce,125,92,254513,51615,202898,145,92,235811,49110,186701
0b6636ccca2b632a7ac146a317d6eb26,67,50,89748,38005,51743,90,73,180107,39816,140291
c6c69c1f558bd1451b05d7ae84ae8e30,5,8,350,788,-438,9,8,1007,242,765
857623b1fce5bc900feebe3458c9a29e,50,35,57254,18307,38947,73,58,88919,14672,74247
c4bdb59880a2ae374b28dda5fcf0d65f,101,84,244129,78997,165132,119,100,320137,68036,252101
1e7fee87c2436df625c413f905ae1c01,3,2,488,662,-174,3,4,709,434,275
7b9025fd1560675b5789724caf94e45b,86,67,213377,43123,170254,127,94,178370,59837,118533
0134ba680679cf68f6fe9b49d0c4d7f3,19,12,8583,1840,6743,20,16,5536,3530,2006
60e413bd2554ff0dfac2aec0f3d842f1,59,51,96585,26453,70132,47,42,61299,25309,35990
d88acea9ccece1b89a09d82ceb756653,105,76,226548,45433,181115,114,96,189854,56939,132915
d0af5c306db8ef06086069a9f9f59758,139,109,286886,54370,232516,177,118,408477,51846,356631
e9fa949aacd965fe422089678e818ffc,49,34,54156,12785,41371,43,40,36961,16496,20465
9d06995c75d2c3b21680ee2db8da942d,81,70,125126,32481,92645,85,66,124788,26244,98544
850352d19dd657d9dedc1101bd00c05d,53,40,63847,14230,49617,53,45,55842,19747,36095
1be48f9ba74bc1515a3ebad8b109c39d,43,40,39204,15578,23626,47,34,39679,11739,27940
336304738dd0718b51f7fabc74b696c3,28,22,19008,5911,13097,28,22,13443,8159,5284
4b45ac301dad98018041aa734294456f,115,92,377457,87347,290110,126,89,349516,77824,271692
0c1d99827e8a4c8626b168569b07e221,61,47,59262,18503,40759,55,38,75227,13615,61612
08db6f03efecc35b29b12401be5b2d80,30,19,10165,5159,5006,24,19,9914,5650,4264
30dbe3a944596666d04ebc303ae62df5,95,63,134419,30024,104395,65,55,76435,33600,42835
10a012e527782bec07ec3702ff6d5984,25,24,17374,7427,9947,26,18,11572,6902,4670
909c9549f4e7e16b4815ad8af833884f,63,44,85996,24980,61016,59,39,46646,23651,22995
9672774cbd057b763a159d2422ae98cc,0,0,0,0,0,0,0,0,0,0
9820c415a840677dd13c5805bee21237,101,81,437194,130613,306581,182,123,604096,98171,505925
ee0af9bfd4319db66aff90e3ff2650e4,44,31,35978,15696,20282,46,32,49572,13897,35675
bd6de77bea09b9f830abae6283657c9e,153,103,427985,86698,341287,144,111,373358,122085,251273
975d0c64bc41dc634c14f27ec2d5b4eb,40,26,50063,10238,39825,48,35,33566,12638,20928
55d81de3838e44fe499e594b7e162ce2,27,22,18125,5604,12521,24,20,16415,4674,11741
604a21f18b90f1b096c37161b1317134,148,126,475971,117295,358676,206,157,578696,108137,470559
fb3951656664732483ee1427b548a66b,154,117,409492,69189,340303,136,114,364483,74611,289872
b62deb4365cf7deab8a732e2567577d4,78,63,113483,36851,76632,119,89,150488,41413,109075
406d5d425157cd43529c2a37691d58e8,23,21,14619,4085,10534,31,24,20759,7859,12900
c95603e2c3790acf04bb9b678f0222eb,211,135,751232,138281,612951,170,106,806169,125395,680774
be4c7dd4173478d381be90dcc407ccb0,61,49,85413,19740,65673,62,52,81526,28996,52530
ab235a6ba01946c7b856accffbac69f2,112,84,222698,82440,140258,151,111,309480,45223,264257
cc02eb4014f27a3fa3dba59c047514fc,152,99,417694,74062,343632,149,119,477775,98781,378994
80235902a1b50b5d6e8ca43dafe3b8c5,126,107,402827,84576,318251,144,105,320521,70100,250421
825e5712976b82614545f2f74fe265a0,25,19,20128,4410,15718,37,27,24090,5144,18946
dec9e6260f61f4dcd1876be2bf5e5fc4,25,23,16698,3282,13416,23,20,13979,4411,9568
018a737fdb6c6f4853cd1381ce977c1c,36,24,22667,4186,18481,29,20,19065,8227,10838
ddadea4c81aea5fa017971a93071f40a,115,84,267885,91897,175988,139,120,317279,87245,230034
ad9ce1c02c848654ade1c954deafe55f,88,61,106265,16695,89570,68,61,58720,23093,35627
2ebf3cbcc32c8bca887382b9f1fe6cd1,100,84,228227,53374,174853,95,91,258854,60940,197914
c47c26f33c800be4e974e6148a2dab84,37,32,29452,16047,13405,41,24,34670,9330,25340
4de03c05a47af6c3ce8933c8fa65bd2c,43,32,27911,9400,18511,46,37,31031,8910,22121
62210b81afe88cbf9a489ef276bab9c8,23,21,9866,3555,6311,24,20,7682,5306,2376
bccc7b91e0c781898cc33afae565ba6c,147,132,870103,171857,698246,175,141,1079830,183730,896100
dfeb06ebda4a939ec5c59abfb8b28810,127,93,187591,39089,148502,101,92,182455,44564,137891
7094359949f7048dfae7b2c786ba8363,97,81,353501,124813,228688,100,73,340584,93100,247484
56480ae0807ac2c664d5807ff561921c,101,86,233960,68835,165125,142,110,308631,78156,230475
42a8cc327be7fe347cb88619ef83f89f,141,107,342484,86273,256211,127,95,314409,86386,228023
5c956be7c9107277de42ffd725a16b71,124,101,403364,85034,318330,180,139,490290,92624,397666
ae8f5ad18be3201dd4bf23b2dc0b65d5,173,147,791889,157507,634382,189,155,883683,156408,727275
be7ec1c04f1e917ff7351fa0710c513a,111,66,239234,48299,190935,107,87,235507,62761,172746
ff1fce8600cc767607a7de5f90c53216,121,91,316759,106329,210430,191,118,485774,78377,407397
c85ae9fb92a1ba143d1d72f7e6f60e99,42,29,36866,15303,21563,32,23,24436,15124,9312
6b6ca85b3a3e29c8b8c1db16eb5a4024,72,49,108957,27391,81566,83,69,129898,32284,97614
1b513a04b802aa4fc7449810ae0d3fbe,85,68,161088,26738,134350,93,72,121291,31995,89296
3edc865e0218fa6c3e14747808d4f5cb,89,63,105910,27651,78259,75,62,108457,32588,75869
881c9cc7177b133c82e7e507809d9b58,114,94,313404,80324,233080,143,121,364366,98628,265738
92e5d174c74a978c06d7aa25ecccf503,23,20,6042,3269,2773,23,17,5876,2492,3384
45b4e24e1d26684c47a4d02ea76f0110,97,78,132545,34655,97890,82,64,115762,27398,88364
733a8fde04e4d7afc22be961c590ad0a,93,78,221659,60672,160987,134,99,293135,53224,239911
caa19a9232b82aaff6a06764cff888d5,182,142,856796,171449,685347,191,146,863848,129889,733959
2b226e064c81e550d2618c7b10d2f8b9,66,56,72660,28752,43908,52,46,71904,27267,44637
2b78edb52c6b8e38c812fdb75de1e105,58,53,99396,35608,63788,62,41,97712,22661,75051
c7b0399be3f57702ad12edd7b7d8819d,41,33,30310,11219,19091,40,28,35521,10786,24735
5f12cdfa825db91f74e23769ec5bc935,72,62,158984,57621,101363,162,137,386329,58812,327517
ec817c3f315be7acf543b7c8613f07bf,147,128,532181,117826,414355,150,93,638154,91901,546253
54c18e80d99de60bccf1e01820011771,180,137,848958,164304,684654,179,139,863789,161062,702727
125c1ec3a8d8956b9bc2814e86ed5ef6,117,99,289855,76831,213024,135,106,364132,69905,294227
6b9672357b15c3abdc7d573f154861b2,100,75,203391,36800,166591,134,105,190531,58795,131736
6669a84dbff33dacc1cf91c7f5313517,139,91,287947,62887,225060,110,97,176095,62921,113174
2299bfc2a5885a450d7c7c190dbf4529,168,121,436277,73853,362424,160,128,482091,77540,404551
32cf4ee7ac121e186d5d9d0249bd673e,133,109,398002,111932,286070,191,140,528104,108652,419452
d09ee16f393ac646935febf2c43ad692,42,32,33140,11517,21623,41,37,34708,10847,23861
96912dc17894f350cf10ad3755c53923,116,91,238986,48961,190025,101,77,178442,43599,134843
42b81b28604feac9fdc3f72b9450b4da,138,106,286400,42572,243828,107,90,206349,46782,159567
ecd04ee1d5a881147a7a2817f003c343,18,13,3949,1314,2635,18,13,2790,1828,962
6df1c646a8f2654dd77b07a89a183402,31,24,34083,16043,18040,42,30,60092,13207,46885
9d26e89cbd32faf859ee5700f7253d02,84,66,158607,49767,108840,93,81,212670,67848,144822
5ba0d2db86383c2298079122dde091e4,77,65,124174,29083,95091,76,68,113456,26386,87070
0c604963f515c9469bbd644be8e8adbc,5,6,601,686,-85,7,5,701,612,89
3bc497f37708c51c8c62fb476e6f63a0,6,6,788,306,482,4,6,301,686,-385
9f9d247a31a99fd78326a431667c136e,30,23,16092,7391,8701,29,24,22001,6689,15312
648097ab4830b3aaca9d5f84cc467db8,84,72,140468,50684,89784,87,71,180357,35020,145337
af2c83fe2426522f9e744713b6a61e61,136,114,384191,74797,309394,125,101,318733,73709,245024
72216be11cf5e9f4458cad1ae389b039,158,123,630859,126151,504708,188,166,669520,146834,522686
3ea9df1ef55edc529334a64004a65a65,29,24,21583,6762,14821,34,25,14320,5545,8775
a71446478fdd8a0a015900338ed9601a,79,55,238234,83224,155010,78,70,194635,63720,130915
b219a52cc7ace346cc74b2db89b81697,134,92,364344,68524,295820,174,130,508904,92887,416017
9219bc3d157d69063ee1bce4d6658204,160,106,569558,86443,483115,184,139,494378,103064,391314
d7d215c774acdc73ae3fa37f4d10712a,69,49,91210,26603,64607,65,58,82623,32498,50125
4fcd8f2da1cf1b5111716fe9174efb26,104,79,264133,110014,154119,126,96,300641,92104,208537
a83a437d8caa9c7e29ca3d59427ab93a,100,90,200375,54513,145862,118,100,210362,49467,160895
dac73fe3507bd705270badd871410f6c,26,24,16744,11570,5174,44,37,38458,11054,27404
0c5f9420ca69ad119de941c17f6f588a,85,63,252092,44798,207294,98,80,255383,72809,182574
5025076e190a4c60f6fdbe8a35de303e,94,58,127279,30085,97194,99,75,156374,37063,119311
d7cb04970cd0414feca2fb6b57b53a66,147,84,258476,35887,222589,107,83,133537,50958,82579
f16cb62814c23ca06efbfc5aa12e2631,61,44,91752,20180,71572,66,57,81569,27465,54104
842ceabe49615484074e64d66a535d80,68,57,128823,36216,92607,72,44,119542,40228,79314
f9fcfc542faef7993db4df0f67ea3a0a,101,87,185651,41854,143797,115,91,207182,34547,172635
adbe6945d1d7b6599e9ad90131e30f27,174,149,595247,129675,465572,157,116,494328,114694,379634
924b2c4b6225f422d587822dc49db6f7,49,39,56577,22574,34003,42,27,38981,18376,20605
bbc8bc04c438270c4b99680516b29ed0,81,60,117174,39790,77384,88,77,132438,34294,98144
69821bbc4ff105b6b57b1c08297cb28d,23,15,11301,4376,6925,24,19,12911,4587,8324
b16e7e9a2cda27d497e8218462539517,26,21,7702,3322,4380,25,20,7017,3820,3197
c2af1d9ca65f5d496704285b169aa3fd,130,95,193849,59818,134031,148,92,219904,46217,173687
56cb497102c48f7270ee2165946172dc,86,58,181490,44501,136989,98,78,197949,36962,160987
df8a6259ece68355306c8d6928ca52b7,41,36,37704,21367,16337,49,37,53418,21119,32299
ce776993a19c3854a81e12408b7bce1f,83,73,139512,46843,92669,83,75,174656,36941,137715
f51a4901b35156a67fad447c9352fb07,119,84,258671,50121,208550,108,85,181332,48980,132352
520919d8fb4fa8cfb46c5bf31b5528da,52,42,74280,22457,51823,38,35,40505,24577,15928
7aff8cc62fb5fe0aef14059ed780172e,19,13,3243,976,2267,14,15,2135,2359,-224
b4406c5a9b0212b6863b05e1aefa72d6,134,101,365377,74984,290393,123,103,330824,77796,253028
39c92478f19ca63c4240ed1a77d4f58a,35,25,17322,8848,8474,36,27,17755,7033,10722
cb97f71f44c3c84441cc4866672c958d,152,127,499987,118755,381232,174,120,446833,93659,353174
4b953b17be1511e6a07ac3bc07d20cc9,115,85,237903,62077,175826,110,77,264114,47034,217080
b67d1573cd2968f6ba59d59f4262b7d3,16,16,3074,2022,1052,22,12,3393,2071,1322
74962114cde6434722b71653b06a89db,212,130,637056,144146,492910,232,143,678833,163338,515495
3b4e64912d1df1c22d7353ccd2546a66,164,130,597451,105742,491709,151,103,457150,77852,379298
151aed92c32cd15d7dbb9a668c0d8ed8,154,94,273925,39621,234304,151,112,321190,56592,264598
f57ed432d13d340fd962021d7bc9d2e6,92,80,209000,70616,138384,103,85,248213,59407,188806
e76ece580d2aefd6a842fb1f24ab0ab6,167,132,383177,49203,333974,104,87,172809,45002,127807
a66fef70d674d176c9628f9c98fd35b8,19,21,4713,3429,1284,20,17,3900,3795,105
06df8a4952514314bacb0d0fbf58589d,67,44,71048,26161,44887,75,38,76451,24213,52238
6586fa55eabb8bc802379a21807f9745,162,116,327695,65039,262656,119,106,311417,75287,236130
7f3ae5073436e388a1f6fa89dd515717,124,78,195640,26660,168980,106,82,169583,33160,136423
ec89449dcf909d6937572f2f3cfe3a8e,41,28,51548,16056,35492,43,27,40973,15754,25219
314c8c745b4dabaea143400fe716c07e,167,114,640667,129326,511341,187,132,602555,104733,497822
da3d9e11bd424d6ed1144a1a14dbb6e6,177,148,893013,195924,697089,186,139,730985,184218,546767
c6968376c364ef55149764f401cdd71f,56,45,78675,19760,58915,61,49,71029,24050,46979
29dea28339170a4a137374d2574f7adb,133,109,386455,94988,291467,188,119,486856,82074,404782
8d136cf254d4c313ccc979fed7e4f318,235,157,1106653,184894,921759,200,160,1354075,232176,1121899
dbccf850ffc729243d96261a8dddf4c4,26,21,8257,6463,1794,26,23,16629,5256,11373
3993ea59e1a37445129e326b470919d6,74,47,130700,36896,93804,98,74,119927,34894,85033
76f94adbab130429f0bf11d359b17dba,22,19,9425,5284,4141,25,17,10725,4981,5744
a576ec95adfc48b1b842b223cf8904c7,93,73,241819,76029,165790,154,102,448409,65882,382527
cfeb7eae096ce7e6ef2e5318f9d94961,44,31,35327,11850,23477,43,32,39327,9399,29928
b98720fca1369b520ca68733ea5d3ab5,132,88,299780,66875,232905,147,99,358281,52057,306224
00707781427f8ef95549b33a63bc41ca,79,47,93466,27033,66433,84,62,111163,31487,79676
66e3f3266fe8a20e232c03e2b8ad5044,43,31,57149,13418,43731,62,40,60175,15905,44270
7f9f76dad91406c435dfd945a5e69c5b,99,68,174827,43509,131318,119,78,225504,42107,183397
477c3ef2f8b040dbcdf409ba5e431499,16,10,2572,842,1730,15,13,3100,1024,2076
6d1e51dd5afcc051e01724fccd1578ce,107,75,236628,66690,169938,155,111,428000,62611,365389
91135d159785b9caebf88abad1bc41a5,163,133,622589,88512,534077,140,86,386893,142376,244517
9b8ed7898b459d3407acdcebd980af75,111,80,249741,41539,208202,76,63,142569,50737,91832
8e819c0297a72ffff520d9def51ad7ff,127,96,307388,105020,202368,85,69,233449,89722,143727
b8b444bf9e68bacfa6375adf3a54ed72,65,60,108216,49475,58741,106,91,236101,50516,185585
00e8ccdea5a35e7f7813cd35dc741de7,44,33,40495,20235,20260,60,45,89053,20344,68709
694676a7af17e88f6c0a9a64b82d7932,126,109,295576,55208,240368,112,78,200096,57930,142166
872569d405de03b8930112b6d8ae4725,60,44,120686,27371,93315,69,49,133015,28919,104096
36414384f108a3031f39e197e4f4b135,3,3,451,665,-214,4,2,713,407,306
bdd482e915ff2f9c369e82dc46be86bf,94,67,159334,53274,106060,87,73,193896,54546,139350
abe7a705126b5f3731bf0cc14024b892,44,39,37643,15152,22491,42,34,42349,12556,29793
b37a6f3553b97561e7c8858c2d50daf1,63,38,60282,23042,37240,77,70,143187,21435,121752
89f861e98a5eb91e2250c6733ad3d732,77,67,120034,27365,92669,52,50,64246,26627,37619
d6a94a18462d2033d6446124780d7e42,42,33,61314,13140,48174,40,29,34091,17635,16456
3ba43b3569d7932dd44544af43d99b74,155,97,594115,139266,454849,175,115,931083,137068,794015
bf5507ca217950e2d47ea8a23fa31481,97,74,171352,29370,141982,101,78,123423,39843,83580
4b5033dbfc173082c4ba64ece5304b8c,139,108,351589,82516,269073,135,106,272138,79037,193101
b0a2b99b66ca5ce07ac61f35921ecad3,99,90,144595,44515,100080,109,83,217146,40837,176309
11abeaf3ae52f8819ae7933d90966398,42,28,40351,12650,27701,50,40,32591,15453,17138
60edac7f437c0edf89486b2fa6ac5e88,78,53,137907,54777,83130,107,89,231982,64638,167344
ed29f8b9c939aaf8a2a9b119eac9b3e2,164,129,523120,130529,392591,169,128,482933,90972,391961
c1ab7be252aba1821cf3e49746d8c03e,144,102,447260,86333,360927,174,152,499822,105545,394277
20596574d09e7e47cc2ddf2b1729e25c,113,79,190680,29593,161087,81,72,145745,32342,113403
9f5654e564649c7b5e31997baf9100a1,156,113,707611,161037,546574,235,151,671360,156355,515005
2d00318b625dbd3f6c19329ca6a7f61f,38,23,26117,6150,19967,26,21,15208,6956,8252
f2e4278dbacb47c95613ab6d397a4950,79,54,102269,25688,76581,78,58,101832,31261,70571
5328286e0c0eadaa814b8f006c4cceac,204,144,1095542,254108,841434,193,164,1100873,267384,833489
30e6b35c5b99679d3633afaab26dfaf7,120,84,254839,49526,205313,108,87,241363,53419,187944
8ee2b743195624fa5b17269ab4988124,25,19,15773,5545,10228,29,21,17849,5931,11918
64df07ff1b35fd86d0374c990d3c3823,96,70,146545,25685,120860,95,64,122876,30888,91988
33363d15cf7cedbe92ab9de52005fe01,35,31,33603,8957,24646,39,36,34014,11143,22871
039b982a9f1a9309db93630b81d74e0c,40,29,38963,14534,24429,42,40,53491,16742,36749
9598e8642aa7e71fa970e8ca55f6e8f8,54,45,50523,26501,24022,56,46,74027,22801,51226
08ac97a664fb43faf072584d828c4d5f,25,27,24495,8566,15929,29,24,15657,7823,7834
bb02ddde943dee50de7a9feadf3bb2d4,37,33,60071,15809,44262,48,39,64855,15466,49389
1bd0e2e823170d12a4047c99d8d9be18,69,54,83991,24841,59150,77,60,133005,30623,102382
0dc3771144d219f00886c3a65c603347,111,90,209448,45971,163477,97,72,182655,34078,148577
4ba3c42817ca0072872c58fdb6e3037d,153,101,332286,59450,272836,195,169,542227,70207,472020
8cbb36117a183c8e92e7b4496942d498,130,94,258003,74545,183458,178,109,371358,56116,315242
6f104491988d3fdde504e252b30c7172,45,37,31683,15238,16445,49,38,42927,18220,24707
0dcc83af1caf1bce1d3702f0f2ca5209,73,57,147455,73746,73709,114,74,235328,63103,172225
f59d1b5f764add349cc09456a5571859,75,42,79516,20643,58873,70,57,71650,35696,35954
1f173cc51af28eb18847a417ce8917c1,172,124,548217,206078,342139,114,85,451598,145000,306598
62ef48385a73fb8c24032c9c93749f57,139,103,335470,104740,230730,169,134,418275,110481,307794
1f08416be650d3f66a2edefd77140fea,184,133,493561,78788,414773,179,126,493511,125852,367659
b4da9450b3e120ff85c3cba217054f8f,132,107,277787,64868,212919,118,102,240653,54447,186206
4b502c99e6c525e475c7037b05d8ad3e,169,123,664485,141303,523182,111,83,561453,103771,457682
99b0e93ac4d192b40bbf0c3c40db1b0e,40,34,36199,11372,24827,43,40,39511,15595,23916
784252a678823ec4eadb2e0a1ba8787b,40,34,34631,14166,20465,51,35,41523,15471,26052
5e5d229b1867c64ec39d18f055efc474,154,100,419613,86218,333395,114,93,266333,104169,162164
84d59f5f0e440efc444bfba63aca11fa,25,18,13958,6421,7537,25,19,14205,6030,8175
cdc4a7a20b9193733713abc89b9dcea5,158,107,493456,99027,394429,162,128,460847,113507,347340
d4853eae170dad200c522fab198dbc19,90,74,208770,53013,155757,134,107,408054,57568,350486
6a207504ad5fc525207a81d1516d281c,224,140,738156,143640,594516,172,127,863617,162323,701294
620c3bcbea2a20564124b1dcc3a44676,83,70,162507,38465,124042,69,44,152901,29521,123380
092bdf0e25f111ada74e5749addedca5,53,34,45255,13837,31418,56,39,55187,14096,41091
61db5df785e150d6500c77f19a831ef3,132,61,181510,54661,126849,168,82,324649,61149,263500
c07fae0ff5e8bc335a4591e27e9d89a7,127,94,306873,91686,215187,132,89,354807,74047,280760
1266b60e5a7f48a6204b763232ea21da,73,53,125030,24941,100089,74,48,113152,30306,82846
f3bf0ff5b2e0ad587031a12ed845c245,157,111,317237,53452,263785,122,81,232616,57368,175248
00ba0b60238aab9e50593beef509d48f,63,51,91009,24697,66312,55,46,68735,30803,37932
5d9a59390c257ebd0a4ae0623aaa45bf,163,123,329933,70550,259383,184,114,389946,61755,328191
22efae2993990ec70f1ad58bd0bb131b,152,112,309357,75374,233983,187,136,501624,75376,426248
e2355ffc261a5ac1549613f98927d2f3,22,21,14997,7116,7881,25,20,15941,5957,9984
cc4825eb4618d4421ac65a4bc81abb51,171,133,605312,106619,498693,138,116,379759,98282,281477
fff6df5c319b6c7b591be47a9fda299d,12,9,3067,605,2462,17,8,4918,1314,3604
34191ce28d6d758e3304d8503a258d43,81,59,119831,28474,91357,87,79,139988,53690,86298
b6ed7dccffa9c11907d751a82e65b1de,48,32,38462,10765,27697,46,43,37909,11807,26102
67d7bfd9c12ab7adf7d8181f5bc7968b,149,107,353441,74902,278539,162,106,394639,78683,315956
5b34af43b9b79e0b99cd34a8b777e0c4,133,86,235528,39526,196002,97,88,136306,60185,76121
7e0bc8d9f3ad0c4569e46bb3bf64e2a1,102,83,243179,45087,198092,75,58,154277,56501,97776
8adf97f411ca98f17c848c6e239b4911,76,66,159690,33676,126014,97,82,135573,28907,106666
228ccbe249349073027953ab468ea98e,5,9,694,1264,-570,8,4,1477,465,1012
5f3f4c1b1111a233228d889e2522c8e4,78,56,98433,22261,76172,63,54,90698,28662,62036
9b45ae98e16683778a30c5f933507cf9,34,30,40003,12168,27835,61,47,60975,11088,49887
cb78b5faa60f0890f1070aec9b12b50b,52,32,41074,10481,30593,45,35,28236,17810,10426
5798f8a6c52b194e646eca0b3067d2a9,27,20,13565,6488,7077,26,21,9939,6595,3344
decec93b067649113e28fbac8435ef3e,178,119,815639,144459,671180,205,150,775889,140671,635218
4c5826e4fbb0541657214786deb87950,57,51,59510,22978,36532,55,38,49692,17156,32536
b930fbfe62d4cb2cef0856272adf0771,93,75,144161,37035,107126,74,51,95537,36228,59309
f77f775ffcfa86b2e90f355bb682db47,22,17,6166,2694,3472,23,14,6981,2988,3993
77fe99f07ec9116d18872d4e6da0cb76,2,0,100,0,100,0,2,0,100,-100
3c4def7fdfe740cd05471c8eb80a89f7,113,95,192268,59051,133217,90,76,190618,51848,138770
8c5631ec87cf3b77c125a1fd960b7c51,30,25,10198,6197,4001,26,22,13326,5218,8108
7315a5d751a05be8a00b6a91d1c4c303,43,40,45358,15951,29407,48,28,45619,12352,33267
357f40f415ea79586a9d189232a4beb5,19,14,6199,4284,1915,22,27,8144,5763,2381
4ba49c774beffd39d171cef04716062f,91,72,119455,35149,84306,78,55,94495,27756,66739
c5cd7db0b5b90c321cae66df8c5a2ceb,27,21,10535,5190,5345,22,25,10023,5517,4506
e1709e1f4e50fa209251125fa0ac7f8a,60,59,94824,26308,68516,53,47,78418,25608,52810
9df04f0786f3dfd43f11002dc4cbd6d7,154,110,417217,73866,343351,144,97,388332,67410,320922
6a734109aa8e8393d6b613b1a296cad5,92,81,157472,35271,122201,83,71,117932,30321,87611
ab53c7b394b19761bee05c2b28e5bfeb,78,65,116932,44255,72677,80,59,108433,31200,77233
69a0a4b03b9baa66198fe4b3523e892a,125,83,276980,53119,223861,107,74,167541,52022,115519
f6581acf1d7ef147057fd1071d43678d,101,72,201286,47675,153611,119,94,188519,47622,140897
4d37f4b4bdab72d664e181eb48b72976,40,28,41156,8318,32838,33,34,27243,13869,13374
63fd03a7485c1d2797aa03efdcb494e4,89,68,186401,56896,129505,74,63,229847,59977,169870
809c4a6d22d51d48f11ae05a99071226,50,38,43959,14301,29658,55,43,53201,15598,37603
9c8743a839ded2856f98e8f4bd89076f,214,158,864116,169558,694558,159,134,751104,188515,562589
5af20763691773d743954c019ba93bc0,144,122,381695,57407,324288,157,127,358090,55076,303014
e90eec75255cd6f9aea4c56cd25a10d9,127,103,317496,65065,252431,138,110,294050,58049,236001
178f21e6a83e7b107dcb41fa27794e48,168,118,448914,67653,381261,145,116,469550,96524,373026
45d008f209505337a3ee28bb9f14472d,174,136,422695,67266,355429,148,112,393730,78343,315387
c71139797dcfdb5a3a30b40b92121973,93,66,178448,64156,114292,145,109,239285,69106,170179
ff3d4c3348e1986907743721aa8e5238,11,10,2223,2261,-38,16,12,2692,1721,971
8834b31fa949c9ab2be6b848a3aa2e22,153,119,487880,95584,392296,162,136,508232,111694,396538
4ef7cf91b6865035b07701841ed49411,37,29,24229,10716,13513,33,26,30480,8012,22468
34c5cea5318a9cc09694a8d86405ed5b,89,68,155509,32244,123265,71,53,116933,39793,77140
c5e18aa835046340411d411721911b71,65,52,68855,26213,42642,53,35,48525,20631,27894
50bbbe4b9ac6ceb9ea51112372a6951c,142,114,357130,69236,287894,116,79,297879,85041,212838
95e784df391dbe822992ff340b05fda2,48,40,50265,23796,26469,52,51,60516,23010,37506
d90457052776ed00761c5f2f750ea1db,56,36,67192,17682,49510,53,48,64233,24475,39758
49bb1baa109a539882a70f55447ece02,55,38,51076,15795,35281,52,49,34634,15711,18923
d00bf85ac248e4dfa2355f678dec7a7c,95,81,156139,35845,120294,68,56,82087,29827,52260
431e8a53d00ebae11928008ec1a57ad3,1,2,437,523,-86,2,0,523,0,523
44c320b2d69cce77a6c13ee3a6ee967d,186,136,657640,135234,522406,200,145,740650,121727,618923
d9eaef3885967f5f8edaf1848c99cd7b,52,35,63390,16068,47322,56,37,73485,14263,59222
a6e157b1c65724799366e1e76a19219e,171,100,595595,106702,488893,178,121,667933,112226,555707
0e8e161e19119ca0454c9a86662482f4,43,37,28156,10869,17287,37,30,20862,11539,9323
d65aab824f19f8419c5392ae48ade148,133,92,313091,53401,259690,127,106,414195,57881,356314
ed2774c162b1b3f008f54c7be0bf0c0c,134,91,255833,48512,207321,119,84,199236,47329,151907
cfdf4d4ba45192da20a64a6bc495fdf0,38,37,25049,12330,12719,40,47,31803,9951,21852
bb5ed11f822fe7ae35d0c4758950c772,177,132,690567,106636,583931,164,126,516122,91578,424544
af0c6e5a1696ccdcc4b8e4b51e44a8c4,61,41,65680,19899,45781,69,64,71259,23404,47855
ec539d6e70a04cffe3e7c6cdb4a7b01b,55,40,65706,29466,36240,71,49,70734,34425,36309
a1adb974d3c82db604cd9b0c81b718c2,66,47,94841,23526,71315,51,37,81361,16141,65220
d718e360a3d679a47a464f7c718046db,121,81,281625,83756,197869,136,93,321524,88864,232660
8a95315dda60e3a4437d210861e05aaf,64,50,104677,27020,77657,77,59,114694,31274,83420
10768be05b7836d40a29b1bdedc01634,133,84,365459,121551,243908,165,126,552280,88284,463996
295a57cb94c6664dbe901b4bb6acdec0,70,52,77686,30271,47415,77,66,75908,33811,42097
686b7b2b0738df5bb64ab468fa8b86ad,174,126,1039216,289733,749483,172,120,1426815,235747,1191068
abd4feb102462c719a29586d860fb1b7,48,36,68444,27922,40522,58,47,96100,29604,66496
777b1b4b7a8f876a8f6ed21254d10558,125,101,282824,40085,242739,134,75,327173,49020,278153
16caf925a456ee07fbb6360816a81c01,53,33,40764,15075,25689,46,43,38874,12718,26156
cc29d7c82ced78bf403664d3ca8fff59,162,110,392997,107414,285583,162,118,468318,87741,380577
9b861ff117417482904ff90e9a2e8e4e,66,41,46201,14285,31916,73,46,69819,15060,54759
1a06a9c292ac5e24f450fbc280b373ae,119,77,261142,85182,175960,131,103,289183,99298,189885
47e25d11d3f12f636e84db5a708e0c3b,141,82,409194,64610,344584,134,75,329080,77239,251841
84c2c1079f2c08b39a2447024289ba22,92,68,194856,38491,156365,92,76,160291,37467,122824
eec95c24f74c4b8259e2fca8b06ca452,40,35,34947,11385,23562,32,29,21260,13275,7985
8f46ad29a9cfaf544e294aba7350b6ec,29,33,15005,5167,9838,30,23,11819,4876,6943
72877da249dce2a6f9f2edf618ecea2a,143,113,406929,84345,322584,133,99,404890,74232,330658
f1dfdc14b07c21c8e2884d156647df56,31,21,18483,7340,11143,27,22,15521,6896,8625
6ffa8384e90981f1d097aa286c3e8846,194,146,718619,90785,627834,137,104,558496,115859,442637
d16f2dd7bfd426d181882822c8a1e754,75,56,135216,33883,101333,79,69,135880,38642,97238
ceb98544ed2981bcb512a81a3cafdb94,133,104,408695,92646,316049,176,116,524576,65772,458804
5591b0f48b935727bba515ef606d56db,13,6,2445,296,2149,8,4,1426,182,1244
62078296cc26fb97ef7e6d347451ef80,26,23,13704,6078,7626,29,22,17425,6507,10918
30dcdc1b22210c5c24f47af318d1d5a9,23,21,16291,7522,8769,23,20,11913,8172,3741
27e976aefaa30404c7dcf75be5722831,183,123,408027,54390,353637,138,98,340253,52289,287964
e0a14756353289053cc7590cb8c1f7d0,23,19,13501,5218,8283,29,20,16474,5171,11303
507044ec7702e0962869157ef3e961ee,36,26,30608,9572,21036,33,25,23888,10488,13400
24fec8cb7d1692d0cf7f46c21502e683,38,27,23391,7718,15673,31,23,17380,7510,9870
14da77b33587720a0ad297c6d58474ef,161,105,515737,88928,426809,139,92,324237,62701,261536
130b874f25ce1ba8caab069e1bcadbaf,110,93,198310,49443,148867,127,98,243322,46255,197067
926b66177f1ca5cb540b7433f1d13115,57,46,83376,33684,49692,71,59,142753,28738,114015
e389d7959cb52c70c3b39f8a0003b3e0,104,93,179403,49228,130175,98,84,181212,50294,130918
2701c9b9b38f50c89dae0bc1ff62408f,99,76,160071,49570,110501,96,74,180078,40710,139368
8bdd707e86464ee248623a77d49eb030,64,48,104932,33557,71375,80,58,120346,28701,91645
2a880ba6b1c81536fc6f345f4ead24cf,139,104,365448,79850,285598,140,104,355855,81009,274846
f5a90b9807f03346b2a83cb490bc49ac,190,126,475253,93187,382066,138,105,352178,121921,230257
b9fa429dcd4787ab1adca07bf9c507f6,86,67,212639,50788,161851,112,90,221445,68978,152467
4cf7027a8ba18284f0a51e9b3ec08e4d,48,33,46433,12075,34358,40,32,33730,14822,18908
b1506c73de1a0bdb466cef853ec0bd1c,30,26,16044,6401,9643,34,22,14831,5240,9591
dfbde195326cf12dfe6509f41519003b,102,72,179448,36818,142630,99,71,189690,35546,154144
62ccb575abd3eb803e77fac2064be655,86,74,210960,80482,130478,116,82,243413,73877,169536
3e0acba7dc9f757452de0319936d13b0,134,90,314702,57517,257185,172,115,366040,60849,305191
c81625e6107c15b10070bf6c6693eb1e,162,111,451714,71529,380185,184,135,447967,104037,343930
1a53b39a948601c564bcfa1ed74dadd8,1,2,245,136,109,2,1,136,245,-109
25f6ddcdc0382a60cceb650b68ca744d,230,157,667936,130876,537060,251,171,898156,171339,726817
97490c7bdac8398f071929f1ca5ebae7,88,76,125119,47977,77142,114,84,170627,44094,126533
aedfc19b8c977d168f74e7f87598189d,113,96,315724,77868,237856,96,82,222168,60870,161298
2d672db4fb3da934190ad5b9942de282,40,36,26000,10293,15707,35,29,26368,9099,17269
b9393c23ed3c3302e8784ed4d1b24049,154,131,435099,117099,318000,172,131,622109,136184,485925
e5f8f1b431cbd276f4cfbe81a9710785,72,52,130567,22540,108027,64,57,65195,27665,37530
f39572cee303135f0baaaed9852277bb,34,32,43608,15724,27884,49,30,39065,15532,23533
ffadfbd9f7b448c51eeb70be769ba0ee,135,88,295682,66518,229164,115,76,259115,58059,201056
1d09da19f9421e4cfdbc192235fa8758,24,16,8255,3165,5090,22,22,5913,4129,1784
df509ab6f3868b450b735a6f0e9713d6,78,56,79066,19033,60033,90,77,97848,23536,74312
dd96d1e2b2460321e55d126c06fb50ce,27,27,9947,6520,3427,27,24,12885,5200,7685
0c752a09fb6a5af682a88715498c3e6c,162,126,583539,138991,444548,191,145,831122,122405,708717
9feb01559b41b294f880bdff2579c1f5,33,28,21299,4996,16303,37,22,26741,5313,21428
61c2ffe53cf8bf0e5bbd70201c0dce87,152,109,497528,146358,351170,168,112,435663,107477,328186
74b4b4038b81d6b86e3583b9ea4637a3,10,5,1772,841,931,7,9,940,1369,-429
3feb5f0503ed13be4d088d8a54e04e69,66,55,92551,24967,67584,58,57,81431,30649,50782
4f9cf1b4155a4f080e4818a6bcce61fc,106,83,259003,49213,209790,121,95,202514,61724,140790
a9134e5d09f1308756dc9413288071b7,202,140,685961,108763,577198,176,146,676587,115949,560638
6a9de922ff3ce96e4bccc9313d74f265,103,81,235803,66374,169429,113,84,249531,50967,198564
0b8d71f5d24114129cb7196ba762098b,59,42,54322,20621,33701,41,36,39484,17446,22038
ac357f465beedde02020f708c59527ab,34,29,18094,11710,6384,39,31,27898,6513,21385
9595632e3be70b60fc2ca8375c7c5bf6,184,137,709741,171540,538201,207,157,741293,213652,527641
9b746f490f168752ef8eefc5114ebdf0,176,124,613947,99264,514683,167,104,470131,118015,352116
3941ea4fbec502fedb702d9c34e11c25,53,42,99601,34077,65524,73,62,125787,37199,88588
f915813b5289bdb2e722859af33a0ca8,49,39,48145,12094,36051,71,59,68591,16581,52010
565f17d02a21748f568a4a8596ef4ecb,172,136,488953,57615,431338,143,107,323201,70877,252324
00a4bf84f59b6b03e0c741c456529c19,63,53,74516,20413,54103,58,47,68136,17273,50863
89c02d12cad455bd30c5de87bce38f88,125,97,246175,38204,207971,98,84,202828,43105,159723
d2b932aaf863d9c95365a1f87d428dff,43,37,49848,11857,37991,33,27,22957,9764,13193
7870b1a132aed389184d83bfabf92a11,45,27,50980,11235,39745,55,38,69386,10480,58906
30fe835a90ef3b5e1355b406b46018bc,82,67,137532,41272,96260,85,59,144158,44416,99742
11223c25ffbf1dc2e1175c9d97a51039,194,142,1037406,152124,885282,239,159,830852,142603,688249
6847af7e7b0d82d3682ceeb361d7d525,37,23,15251,6413,8838,30,25,13977,6029,7948
d01764c14ea77a1d792223efb29e6b06,41,31,64514,17428,47086,49,33,54488,14035,40453
fb4d769202c0059f19c13abab141abf8,203,141,549458,119641,429817,193,170,644614,112621,531993
eee7dff560387d49a4768004d6c8fce3,146,118,552400,115186,437214,137,115,519705,138644,381061
a9fc0e61de81e1896c50c68a9c4b35fc,93,69,136049,50449,85600,109,103,287049,38866,248183
9939fe41cbd8e04e350955e0e43346a5,55,43,88560,35231,53329,56,49,94259,38384,55875
df0000bb0d3084cadeb25b7717181702,134,116,655580,138662,516918,128,93,439365,144883,294482
bea92b6698efcac8ab8e880b123edb19,81,66,130595,27890,102705,114,67,135720,26764,108956
c6d921ab632350880b88d9fd6f7acec8,158,97,287629,52877,234752,131,92,177048,62465,114583
4558b463b77ae652f10b4561d78c6c62,75,54,110208,27594,82614,89,68,130746,23453,107293
c394d89414c20108c3bc5e8f0312aedf,18,21,3642,3766,-124,21,13,5697,1677,4020
379657f3363404eafc679c2d41c89011,123,98,348877,90004,258873,155,112,371515,78475,293040
ee71761d8816737708c63f42d0a29e98,155,110,422057,150782,271275,152,107,449178,105697,343481
9f360bf6c7e6c736453d0928bb31713b,65,58,75531,30397,45134,59,51,84818,20274,64544
47b6f5f194cc9912ff42233162c902e4,13,7,3390,1054,2336,12,7,2454,1332,1122
9b67b8630bc1f0cff9b668363d65b3ed,12,9,5608,1766,3842,18,14,4581,1856,2725
4f54207892d51b0ec54c7dc5812747b6,42,34,30080,10905,19175,29,27,21802,11515,10287
b807d0c1d58a5d8f9d09f42d1fefefe9,119,89,315650,77984,237666,144,115,511348,94349,416999
997090d5b19089eaefa82a53f179e61b,128,90,287972,49237,238735,159,137,361135,46704,314431
4973c00625e4a4732c1aea635d50e223,42,31,48329,16985,31344,36,28,39529,18201,21328
5eb52915d5d3c8226c1ea4d6d1161ba5,94,75,167671,30284,137387,65,63,74028,30045,43983
f9093d0195cea0e358a82fb0716ee21c,139,109,570189,99843,470346,171,131,606950,149798,457152
69c18ecd595c682c6c69fb13580fa343,26,24,10435,5090,5345,27,25,10372,5049,5323
bd17971d66004bc56e6f432eff526d65,94,83,167088,55623,111465,112,88,222527,34023,188504
08f09bedcda2dd443aed4f04fded9b23,78,60,118713,39481,79232,81,55,159058,31988,127070
fc09ab015283a2dbb2f24d4b7c578d24,56,51,71416,23062,48354,49,39,63074,21647,41427
c82968ac9413bb9ac1ddb2365d68bb71,111,100,280917,50528,230389,110,85,249512,45402,204110
6c6427042f462bcdcad4ab00275389b7,26,22,11786,4503,7283,26,23,11181,5533,5648
31d7390fb6376b87d16ea18bc8c36b4a,130,95,275062,64687,210375,113,102,268406,71171,197235
43279518e04929a98fc1b05defcf18b3,42,27,54300,15595,38705,52,38,59683,19716,39967
35c9cb576fd43d2465576d385a0bccca,138,111,462661,85141,377520,128,104,402165,88092,314073
2bf9c51058d9368f0f92c8767803ed1b,60,40,89904,27885,62019,61,52,98931,29085,69846
073b6f1209fa498759c60de50e302746,9,5,1606,894,712,7,7,1118,768,350
166a5ce6b9bc7ca434a052b8eb71bb11,163,106,377446,62534,314912,129,99,366521,66310,300211
487de83b34bcbe6cd7c9efa987675d06,88,60,151388,33805,117583,90,86,209733,51570,158163
eded223caef5a87f1efe27f45f18cdd5,198,120,714236,93119,621117,163,106,473890,102313,371577
faab01d316326a5651d7058736c758be,40,23,46259,11785,34474,33,28,35637,15501,20136
3e2b18cdee41e889f9359aad37538c6e,58,48,82863,21756,61107,71,67,102375,35282,67093
e91e8c5a36d161383e3cd600b975f6b2,125,109,341911,54082,287829,77,59,175929,49437,126492
855b9122c3fcb484aa7dafbbc5f8462b,53,43,63269,18647,44622,65,46,86603,18862,67741
f70d7369e969b636ab9576f2677dcb42,8,6,821,1171,-350,8,6,1389,678,711
036b235abd5210a67776ae66604c2d8c,121,91,346058,100937,245121,127,104,371676,103520,268156
e873564615791b980e0835b30ffe751f,52,40,57743,16002,41741,41,39,44882,19131,25751
babf2965554cb554d7544f63e1d70d28,45,36,39039,10986,28053,47,36,34922,10351,24571
1304301cc96bf22c97eb570bfb99050d,70,60,115582,36719,78863,50,42,65221,31295,33926
4c2193e453af8301979816ab33a51f68,188,139,730194,144120,586074,151,104,551868,99972,451896
66d43f2cb59a035d2294bdddfdc9bc1b,134,114,365337,120888,244449,101,73,323926,94095,229831
784001a0479c2111611aee344787ea73,57,57,53380,20317,33063,50,42,55440,21870,33570
13c68cc2c881b2f7a3343686da5439fa,12,9,2966,1675,1291,19,14,4242,1834,2408
8e1f9ff55b6871faf34fbb7cfc14ad43,103,88,190711,51793,138918,93,73,143660,47745,95915
76a32946e08ef540caf65ebd8539ec06,42,29,53481,14299,39182,42,34,28697,17333,11364
63cd87a7f8a70c1a9aa82f971e6bc49b,63,59,74029,25814,48215,109,83,141909,21202,120707
485d7e49a5e53a1a1f70a898817f63e3,142,90,248628,50026,198602,117,94,210255,65778,144477
37c0bf136ab285463d26aee839f2967f,73,68,140611,40771,99840,61,41,124384,27762,96622
248e3aaad13ec8521331942ed2a45f98,134,88,424933,92854,332079,179,131,576517,83047,493470
68397d03e9d89139edfc350ae9633065,145,120,519160,76199,442961,173,127,513996,74627,439369
09e911db230fe1726b96bf99becf7a9d,22,24,12455,7126,5329,27,17,13668,4928,8740
bed1730fd7c3b0b9c8b518bb881cf141,158,96,410671,106009,304662,161,107,444994,88531,356463
25bffd8e42583d44dc48029992516f57,113,91,252623,56638,195985,141,110,325881,62643,263238
9b8c0d184280fc0a818ae4880e668b71,113,86,272388,67733,204655,130,88,311754,81502,230252
619c8a62e906649a49a92aceff97ed49,100,81,162068,37431,124637,78,62,124987,34616,90371
ef27e8faf254011280b1e1a8aae578ef,175,120,445099,107784,337315,208,124,548654,93199,455455
1d2e4c8be7b445e16464a740e3ccfe4c,54,45,89745,31555,58190,68,41,114915,27205,87710
c633718afe9133f39f8bc4f209aad757,53,47,90989,25113,65876,57,45,85777,19460,66317
03e5ffbefce01742ea06940ed41b942d,102,88,228084,69563,158521,104,84,237220,45742,191478
94e94ef5680c606aeb4d87aa9932205c,63,38,90156,15541,74615,66,47,81735,12847,68888
c508f72a3dac0d60d8ea15bf37dbbd44,87,61,120660,41278,79382,70,50,96744,37494,59250
10e6d8f3c1e6cad915935b886b4676f2,41,28,27945,13888,14057,44,29,36841,15366,21475
b2d4f9dd8eeac83e3a37ec8bca927052,20,18,6658,3410,3248,20,21,5778,3271,2507
272e4f602cecc4cdede5c6259698355b,151,109,356017,64094,291923,141,104,317426,51123,266303
dbdc35266985950996d22c53dd0f65a8,139,116,278137,104215,173922,142,118,398904,102960,295944
e820be39db98294a9d5a7f631a2d1c2c,88,67,156641,55473,101168,107,89,211607,59484,152123
3ea278ce8738d8cea2e5fda17b0bb891,221,160,990572,136517,854055,218,160,1006353,157019,849334
5ed9b4604f16acdbfda75c28226a6b4b,100,79,242105,53400,188705,120,103,274795,86920,187875
00184d97d4748d901c668ee873296d4d,206,161,937511,173831,763680,170,139,849783,182460,667323
4c0fccfeae5dc2cf9d13edd73fb1c990,32,26,14173,6558,7615,31,20,15768,7565,8203
29fda660768f2af397ad858d51ee46c7,85,60,155352,40187,115165,97,57,135956,33213,102743
855c69fd3d61655ccf35d70752e1573d,166,145,443896,80062,363834,123,94,285930,78351,207579
fb202d81b9c56cbc32905a62b47e55e3,72,50,82853,33674,49179,93,79,158207,35318,122889
bb30c841e0532e88b1ed0fe962a16eb6,95,85,174410,36822,137588,86,63,110861,40693,70168
e934bc9a05c9898a85c82d3507afd4e6,25,21,8852,6548,2304,26,21,10783,5861,4922
5a202278d4cc1df0f5527bb6160fe084,99,73,204892,56762,148130,100,81,177545,38368,139177
91a0c667b58c72e08d85bfb9911aede2,63,45,79061,20075,58986,77,67,83761,20431,63330
961e518cac585d96b3720eabf8ef4ccc,45,39,27489,11887,15602,37,38,30350,11325,19025
703b54316fc05c8ec0658d2438ed5644,118,108,224364,56965,167399,103,87,161877,34703,127174
80676fca708c0b8a12de4f0e2fabb39d,119,87,229647,39047,190600,106,81,195867,31873,163994
3ba67c3d31b1154eb908817549576990,2,1,107,35,72,2,1,180,88,92
47677a5c8eb0874d1260c91b9cbdd9b3,89,66,164987,38240,126747,112,93,201307,34188,167119
16694b57b4d93b88c7f2d2cf01bd8fe9,77,59,111576,26045,85531,86,74,102945,36530,66415
eadc7090c07c49622bab1510d83aeb65,175,145,544617,108717,435900,164,125,647248,115808,531440
34f764d6deb20455f0f68c19a6f8fbcc,102,81,153386,56822,96564,120,90,194582,38604,155978
469b273dccde79cbfbe9cbe1c7b9dccc,45,30,52015,13970,38045,40,37,50219,17362,32857
71c82823cd7443b34fb54f3792d4a7a7,60,53,60149,26794,33355,58,48,74222,22242,51980
a888e9ee751a0f1902ab188436a5140c,132,106,506405,150673,355732,205,130,429488,121793,307695
e897ea1e07cee1161e10f343508a180a,179,131,701276,129669,571607,160,112,495552,112973,382579
894d9db6733c3ac30cde3a9d69bec6fc,78,68,183108,55193,127915,124,98,297776,51239,246537
9d4569cc63c175a22c8906561b79b0df,103,79,231281,101346,129935,132,90,306524,78182,228342
3674fc83265006b5e5572cef1f14ff1e,111,77,156952,36067,120885,77,62,91911,27944,63967
ca6cdd6d4c366a482b387c8ede076fe8,149,105,316603,80964,235639,189,141,455012,79679,375333
610eb42d704819409dc45ccd7e1a7e0b,23,18,6918,2979,3939,23,18,8726,2788,5938
aaadb19dd5c13021402e0dbe85b70e22,35,24,21565,7671,13894,34,24,22421,7769,14652
539ac478f36fccce6479412a30363e56,144,88,328675,47842,280833,158,116,355049,67249,287800
5e89bfc5a603d4346e15c05211ad2607,31,23,24932,6830,18102,22,20,12255,10857,1398
fdf3f3f7143e72d2525d8c5ac6ad05aa,161,127,746139,118841,627298,196,152,758420,122947,635473
f539d04e949f549b3f6f4c39bb1360d1,68,44,145259,51023,94236,91,59,169696,52733,116963
f485d17397bb51092643e38cf75a5637,201,131,958205,139895,818310,251,201,1096614,204117,892497
8a88ebbaead3eb8348e9f331de497b79,62,48,67578,19932,47646,70,52,87179,20845,66334
3c0b9749442a44a760657f1d42c2c80b,135,97,292091,81672,210419,98,77,304357,88575,215782
bd05c229570ef2864184ed4ff2fae8e4,139,110,440896,97120,343776,132,109,414224,71224,343000
eb857081a02213da48774872a4f91f19,3,6,353,254,99,7,7,432,390,42
9d6c084acae01621f52ec26276a3505c,186,133,1087268,169829,917439,162,126,770295,169223,601072
6a30fa3a322edaf279046d0ab02a1a7f,148,101,350847,84086,266761,153,107,295123,108455,186668
229eba8a4a035f8d352fa587fdf8fcbb,58,49,51027,21808,29219,53,36,68539,15582,52957
6c43b14f5882277efe064a8791e053cc,53,47,68661,26613,42048,41,39,55231,22644,32587
96a732f66af27504dfde3213674b4ec0,168,136,493074,115772,377302,87,72,251116,103221,147895
be8c15ca534c17367372f1e90d0d1a18,90,71,386882,71401,315481,109,63,256863,75683,181180
f8146540e3988d5596dea5c76e80b6c6,182,148,999195,291791,707404,177,122,1088224,157849,930375
19e031a98d0bdd3aa5d9a40383d39edf,47,39,40996,16608,24388,54,47,78787,11340,67447
179022cafdfc40f2f3c0196c3c6740cb,122,101,281078,46570,234508,108,83,154965,48696,106269
b84ae33f4d451734d9075c6eed8e9e30,35,25,24263,11321,12942,42,31,29976,11264,18712
bf55f1e27147f3ac124fcbca5dbca122,73,60,76598,19773,56825,43,41,56216,13253,42963
199f9dcac9c37734eca07a40a95364c5,35,29,20621,7168,13453,33,22,14454,6821,7633
d3c2837cebb2b835c68ece51a51729b7,69,54,105227,25834,79393,63,56,72754,37245,35509
b8630c1c73be08fbe6629cd545b90003,102,87,236903,57075,179828,101,86,185962,64040,121922
9230a3c914b074426fc0c6a09f13be92,212,130,1599156,192605,1406551,228,181,1317459,196207,1121252
ad715746ca5080d39f28fbd29ae9618e,130,84,222042,43014,179028,121,82,164757,49761,114996
ab209da28d7a2d309b2642cfd166b697,132,88,330304,67979,262325,155,123,332853,95278,237575
dc43a1fa30c71ce48b1da14ff5a7bab4,123,90,263433,45185,218248,76,67,124826,56736,68090
6b1d1526282a37be15a78c7e7c40fd26,51,30,51512,13957,37555,46,26,49858,14515,35343
7d2a3d71cb1ae91b0f2370007f946aee,45,32,36707,15194,21513,40,29,45328,9509,35819
70ec37b596fa17dd58d631d927565837,64,53,69939,26569,43370,68,58,94968,23646,71322
3f2420b55816f69b9d69fb055f09d8f5,106,69,156926,29572,127354,112,85,165064,28541,136523
c83d6c38468b7bda85e4285aafb170a4,62,48,69949,23547,46402,76,58,94564,27154,67410
b4f610ebd01eeb592c1ce2685e6794d2,49,38,57231,14652,42579,57,37,55658,14837,40821
0d195ef344f99cbba162b22780814a56,96,83,249977,46398,203579,84,65,200497,50097,150400
9db679d066550e264eb5741969999cf8,113,83,339394,72140,267254,102,83,324454,60564,263890
76df10aa3ca2b84c142c0e2f0e86502e,2,3,624,716,-92,3,2,716,624,92
f317d87167d3fad0c226f017aef749a2,136,102,357863,79767,278096,145,112,355150,90359,264791
afcfba96cdccc5b0a9a23230c0a337fb,59,43,75482,26070,49412,57,47,81650,26526,55124
c0a914bf58e4c7d7aa7d806666ada0b0,39,30,22675,10459,12216,39,30,24727,8246,16481
affe8b6dbd5c5f03cd706f0bf8fb3855,196,140,593820,124127,469693,177,150,727920,82150,645770
3a8e9c8dc3edda02080b2cff60fd8b55,65,55,146725,43420,103305,74,63,118667,45725,72942
698fe3dda8242b2f07e15bea817ed497,39,34,28988,11723,17265,53,31,34401,8263,26138
3ea9fe1330f589fd736f68feb85fa910,64,61,95386,52280,43106,103,83,185733,39462,146271
8e14c71830a68067f595f38dee6babfd,138,100,385137,117984,267153,132,79,421611,125619,295992
3af9b99fc58d8a3138f1bfbf9f72a287,97,83,169138,36187,132951,102,82,171223,34163,137060
65fb7e3af0445437221884b65a3dda6b,173,125,678005,148155,529850,185,167,708175,184349,523826
149425200c023ba254ebb360c8ca43c4,69,50,107118,28200,78918,69,46,96635,26146,70489
3e1394aaed9c5f69593189017b619a1d,47,36,58944,10356,48588,33,23,27913,12601,15312
06fea046d936f04d7a57b2b82d21a6ab,76,70,139366,37500,101866,86,71,197557,47202,150355
0a73ef9d4d7606b48f57318b2f6b5e59,151,125,347756,82918,264838,129,107,304748,73085,231663
6508a08ad504956d4e564955cbd9699e,161,127,454221,80236,373985,157,139,535740,105428,430312
ae3493cd0b9b779c931d618f8cc3c412,166,96,480857,68528,412329,133,98,371806,93825,277981
4f95e7835d79f2546759be3083c76a5e,55,43,80558,22595,57963,57,52,87663,29977,57686
682def5541e8e1188c054343ea0953d3,26,20,14124,3732,10392,26,19,8541,4349,4192
1803aafa0350e5313c63e0f3c2d8bf28,42,34,35040,17640,17400,51,51,68777,20681,48096
9cf50ce41d58490c95ae61041a725b2a,152,105,570888,99895,470993,183,132,623679,87567,536112
be92d8c940acb066b6fb3d605f6127ec,175,110,419381,63702,355679,139,109,402490,54410,348080
f7ce9c1c4f0f96a381b558c7f31971a3,24,23,13873,6153,7720,22,22,8497,5852,2645
0e8b09733f73c048002e0045c5c09eaa,206,156,775814,199386,576428,214,150,977823,169215,808608
73561315328cecb9662a30b22df665bb,39,30,37399,11118,26281,33,22,32763,10379,22384
590df5abf9483b43ff8bad4d561700d2,35,27,24197,11871,12326,44,34,22857,14493,8364
14aaa934dad0af7c6ab2625b2bc95a13,42,30,59358,22120,37238,50,43,61666,23517,38149
99ae62563c478c59cb562294f2594cfc,111,87,211885,54184,157701,105,88,201984,56836,145148
60e393b6d8da90669dfcc247c700a6b2,140,95,221652,29442,192210,82,63,112701,30651,82050
0e2ac6260bdb5aac0b7baadb0783e5c9,82,64,123742,36214,87528,82,76,119484,26212,93272
b150e4c20b4ed59891c52abad38446ca,144,92,329397,71626,257771,83,63,158831,83980,74851
d962a9667d32aaeb20ddfbcf8bb078e7,53,34,71896,13608,58288,60,53,59465,18746,40719
0a49886d368e35aa8f8f0834d3627edc,18,21,5174,3467,1707,25,15,6709,2306,4403
42416637a4d5e99287f8d3a014ad96fc,51,31,73368,14277,59091,63,50,106567,18631,87936
c3a17ed18bd0cd7689f91f30ea5a5e84,107,95,191484,35529,155955,103,75,141600,48826,92774
3eb77dda2e7c10760d4ff5bbfd4f098f,10,8,1496,1016,480,11,8,3366,386,2980
f4deb1a061e06775752594a1a47e29a7,181,101,500539,84088,416451,148,88,388794,72816,315978
1d1fa06d33c3401d6e3208a3e66a20ea,85,45,124208,29012,95196,87,62,122775,41329,81446
6c9ae96e801e78fe89224a8ce9137a77,107,75,348275,57582,290693,123,104,277193,88564,188629
3313fa297b75a40a38e6074b753e0ac2,52,45,53208,15306,37902,52,38,65659,14095,51564
069a7131c08ab66d9f8990448155a076,183,121,390127,55188,334939,157,121,370122,52088,318034
cdbf50c94a82d425670af491a142d207,83,74,131856,28328,103528,73,62,135091,24252,110839
408bd7c2079c6f1ca73a4ce19d48f3ca,195,143,743992,78970,665022,183,128,591762,87557,504205
7cdd1cfcca9b4c968369c67971c08f7d,153,128,359961,77918,282043,146,81,311063,62404,248659
6a93eee21a3450c15744b96610673c56,18,17,4231,2712,1519,22,14,6448,2351,4097
e684f5e064ae62716185ae0332b1ebcb,159,111,521185,115336,405849,141,116,435920,96265,339655
8b8c27f46a92911993f21e1148e1048a,120,88,245071,70900,174171,152,124,360144,81545,278599
c87bc6869639f9f18e7e9fc9b7235002,51,31,30018,8700,21318,48,34,47812,8765,39047
3df96ce80c757e1e49a58e6fe800b876,107,81,194591,53507,141084,97,88,212674,55242,157432
a6cfc06fb7e267c1a43fd07c9d2a74f3,103,87,157704,41529,116175,120,98,172110,65757,106353
27b9e44c69c23703c7d4121030522781,158,121,764504,183896,580608,168,134,698563,203559,495004
ace57e07b03e5aa11c5cd4ae83c8f31c,157,116,599276,92212,507064,181,137,652674,247811,404863
707982d7f38f3945a3f06cda4d528f79,73,71,92124,40286,51838,76,57,124176,24375,99801
31b4b5e2f8d823911d97151e414647f6,32,23,24605,6082,18523,25,23,11564,8408,3156
e69be69affca57eedcb63833a3a1f8a3,74,68,106026,43172,62854,102,81,155699,33779,121920
f03addafeaea5b379975e79cb0cbbb64,36,22,17757,5728,12029,30,27,14393,5291,9102
02c35789d8474452fe07fcbe61e128cc,25,19,6961,4464,2497,16,19,5973,4412,1561
3018282b55c1a2742bf7a9b6927939be,45,39,43773,14255,29518,42,32,35454,15653,19801
e73efcded921f4267765fad20eacf1a5,47,39,46997,14896,32101,40,38,44036,14773,29263
67b9e08cfcd5c117fdb9dfdc994b4620,65,40,154780,30724,124056,91,62,135493,53151,82342
e42f7fc19faf6acdd2c19d20c3bec5da,133,87,227063,58432,168631,115,105,253305,66822,186483
09edad7d84c614a55c553b0e2ddbc57c,172,122,496896,123542,373354,187,120,697317,124850,572467
4c1372e23b8f74727eca6bb14883eb9e,71,44,126429,37088,89341,82,67,146572,38792,107780
73bd8a5859681e20c1f89910b3dcc2e9,114,99,269794,58529,211265,139,118,274558,62175,212383
94613a2c595f30b074e2253b204bc1b3,123,95,397050,97148,299902,134,107,337911,84384,253527
00e163a7f515c783325582b020232a7d,8,7,1720,1317,403,5,8,659,1720,-1061
666ead29feab4a1c028af45687a4ab49,126,81,450855,73681,377174,155,130,435675,106618,329057
aa9830cc07995c4083254d081bcf4715,101,83,197211,59771,137440,109,82,213503,61668,151835
e50ae020b745bbc1c19db30cba1f97d0,144,96,317613,41268,276345,149,112,301864,53034,248830
e6a5a8c89d95b633fb68b55593998067,0,0,0,0,0,0,0,0,0,0
bd3676275d112876c0db078124734d30,47,34,44233,14181,30052,37,33,48989,10163,38826
cb9205f3f5d87293afa6058bd041f053,98,67,176509,36952,139557,92,79,158430,49493,108937
482e585d8dd025d04880ed399f033b2d,180,141,638877,149051,489826,180,110,536413,127443,408970
d7466e45678b7d8d8cc73dcc5ce72e17,151,120,348522,65323,283199,119,92,368326,58985,309341
c657acf34346e41e65536241a090b4e7,89,60,202141,66845,135296,121,110,306531,65010,241521
363ef3c9443b5e6c8a18ba3c7b929dd3,218,157,606211,146310,459901,174,127,685549,147744,537805
001485875d89a24c2eff87d16ec3678c,157,129,511040,106664,404376,174,134,583474,82613,500861
29ffe788ac6c93ef1cdd492d52c04287,177,114,446814,86026,360788,158,120,506910,102063,404847
32e3b02b8c52d3c2d1c0702532d210bc,96,63,157951,25277,132674,76,67,101043,37293,63750
2246508768855293c1d1e13b2b96c76b,99,66,148439,26188,122251,62,47,89628,37686,51942
169be520cf526082dcfc1fd34cb953e0,122,82,268583,104855,163728,96,73,274889,68915,205974
c6594f66c780b00fcaaa72d0b2aa4e7b,57,35,100840,19356,81484,79,70,122639,22575,100064
5b8662123c4596795a7fc13ce3e48ae3,98,62,141646,30762,110884,81,58,100750,35965,64785
48209f50b17673ed574e5b58dfbd8ba9,76,58,69908,28502,41406,84,58,67312,21071,46241
b9bac54ab0394e1a859524734d61df1c,186,141,859803,196572,663231,189,141,740980,235107,505873
bb397f861359a1caf2487fdf25371e85,75,71,151516,42732,108784,58,48,105305,32631,72674
74306e86524088d82d4a2c2c8c9c38eb,137,93,291603,41802,249801,110,94,191389,61939,129450
19c98abd01050602d08af92244cf68d1,92,72,120402,27877,92525,70,50,89504,28305,61199
8e467b81d10357ac1617d29fb73d7769,26,18,14436,5573,8863,26,19,15774,6266,9508
03d249a7380de51375bac41ecaadbbd7,57,40,61820,22077,39743,54,41,63424,24569,38855
16a2b834f8d2e966770fc11c1b2a32c0,175,139,611551,153670,457881,117,98,466710,153725,312985
4733a8d61aaf9d37a8f5951ca63352ff,146,112,377308,44507,332801,151,115,310934,62849,248085
1fe277b0c4446ac7a36d0f0aeeecb433,45,32,65507,19185,46322,48,38,50901,24074,26827
3839f4d3fb465b13fa63e73feabb329e,165,129,478681,52651,426030,99,75,239593,77874,161719
5b1fef110da064f04b9efbc81f7cefd0,28,22,16242,5327,10915,28,17,15480,5191,10289
1b0170f98cf78176c43410e2d7952275,20,12,7205,1874,5331,22,15,6670,1678,4992
996164a5621df4656d560e2beeb91220,137,96,300789,57971,242818,106,80,260501,60178,200323
f53a3be96ebac149aa68e8d2a16a78f0,186,100,592425,54781,537644,142,101,409613,97478,312135
2f30875f8428cc81c0b360e8652d1020,143,127,337887,69925,267962,133,102,285144,55574,229570
a9d6db546ba035aeb254ac36e236d467,136,90,308174,43912,264262,119,77,231333,56379,174954
20676ddabef56ad32922004800c6e690,92,69,148124,32810,115314,107,78,169557,33351,136206
1c62faa5b2d8f20422ef37219f982a2c,80,54,134720,24082,110638,70,58,114255,25586,88669
acbf5a414015aa6581b385fca8932fd1,91,77,150889,54924,95965,95,82,218093,39381,178712
45ecaeb90455de3da7955d2d4b9d6da3,72,69,176355,51428,124927,105,73,138679,57631,81048
6ae5eb990886e8d596630355c98b9143,15,13,7096,3547,3549,19,14,8623,3705,4918
23eeac1243c316c74e47dbe6f73ba29a,90,47,135041,24625,110416,106,87,189800,40836,148964
9baddcc3e83459a1cefae678c60c0a63,56,59,63475,39665,23810,70,53,112822,27365,85457
e001d220e1a2dd2495b5c71ac328a3f2,98,82,168478,39053,129425,96,84,150533,45003,105530
8e7bd5f7f250512d7009b35bd859c5a7,140,116,460944,157376,303568,178,124,731579,121572,610007
2795373522a741372f43919c7d348dc3,138,85,568795,133454,435341,219,167,664534,140103,524431
fc16cfee379314bfbf5c36e18f3f4343,184,142,680391,147561,532830,231,153,806459,134675,671784
7e798638044b680c5fbbaca6f87c61a6,149,116,370284,77183,293101,142,103,281358,83116,198242
bc1d8abb320d2cda808d937644ae3ef3,215,144,601054,154723,446331,199,132,765119,121199,643920
e3713ae6f494640f2dfe20098a2a868d,71,62,106042,46392,59650,64,50,120788,27276,93512
8f07a1f90e3826805b6519bf4a61eb19,122,103,236889,54749,182140,96,70,223273,47324,175949
e03418b955772d4d538e9a16fc929aac,60,51,59162,24333,34829,62,44,74855,25653,49202
dc4112c5869e30ea68a7ea522a3c7ca5,45,31,47931,15213,32718,48,28,59150,12768,46382
01d35c673f7cf84c3cfc4acfef240def,151,122,384916,78088,306828,152,101,282664,82962,199702
c2ce63bf776d11340d10a4a3cf3bb7ac,85,68,147361,41152,106209,127,109,263089,49647,213442
e53363c4f6d7aacfa7d9f0058dc8b983,163,136,695774,158456,537318,171,145,640197,189038,451159
ca5d988907f14155f0cf830e622326e7,171,128,459307,92736,366571,141,109,310708,87370,223338
5b4396e5861e9b2aaed9a358e000f0ab,70,59,103125,39769,63356,89,70,103236,28869,74367
b10d99bb0a19d7f1c71465d83bbc2d1e,51,41,47862,19823,28039,58,42,83733,17111,66622
062be796b22b0d205eb35b7ee4bbb5a4,177,129,471306,111040,360266,280,162,636845,101972,534873
09b90c12ab14cfa52c95c987b0bf560e,111,80,259721,99021,160700,171,121,412704,94155,318549
b168302d6ecb8c110c950a1632998f5a,132,92,332092,49733,282359,134,113,332773,53658,279115
2981a9b01c4b3ca8c418889923089331,25,26,21329,9023,12306,23,19,18120,5981,12139
fdd064800dddc2a610f1a3c2a72dd487,35,31,15949,9135,6814,33,29,17165,7705,9460
e84bc557c99e3e1f3d3da68b896ff72e,26,20,8196,3796,4400,26,19,8540,3824,4716
4318f00729433a7ffb8f7e4a9629a5ea,163,105,436392,83207,353185,139,91,364575,100929,263646
3a60d28e1e76fb3c6fabb700b2d12a5d,80,69,157265,40862,116403,60,61,80662,47429,33233
ab44e493e639be14c0c6de4336c3b020,122,87,232603,49394,183209,109,81,232588,54479,178109
6e72345046451de5bf5d41534116ec24,29,20,16127,7194,8933,28,24,14778,8850,5928
cb378ca304ccb982742648d4b0342baf,47,31,23983,10980,13003,42,34,29436,7181,22255
11fa87f437b0609ecd971ff41eb5c173,29,19,14010,3474,10536,23,25,7740,5081,2659
dfe24a3d9bd1aac4a123aaed40ffb0b5,79,66,116768,35716,81052,106,79,161313,29138,132175
c357461781348b199433b72175b52bac,94,81,214430,60003,154427,107,76,211754,51688,160066
7a1bd067b3411f3f552f8e268ced1049,179,114,341535,63295,278240,109,85,226599,66348,160251
39a676bd4fd4753baeeccf5d18dee1ce,200,161,711955,127080,584875,183,145,993595,90436,903159
587a5f3e572767714b8f677a4ab409aa,103,70,197163,53543,143620,102,90,207702,52081,155621
6853fac462a2affa1b8deed5a374209d,175,114,507601,67679,439922,127,87,359144,78310,280834
b64f76d7ee3bc07ae85f92bd8260dbdc,26,22,11245,4004,7241,33,27,10830,6795,4035
f860ec277b0950876a94bc7eaa0c9e69,72,45,107403,18342,89061,73,48,74619,16489,58130
d9e1b3e5882c728fd975330889db992c,1,1,188,93,95,1,1,93,188,-95
e82fe49452f3db83aab4fe33e71b05cc,66,47,95709,19689,76020,60,45,72454,20678,51776
535114c8cbea55b3bdf45e36c3802363,117,95,275960,94223,181737,132,93,250972,53948,197024
98c9c4a1060112c80abd6a9fdbf37591,53,44,89880,26589,63291,71,67,102382,26510,75872
d88ee96ae6c83791f35a2c11ed468d4d,125,85,286374,88698,197676,206,161,558785,103525,455260
886cb16d3d40efcf83e6a52b3e6b8606,139,86,282616,68929,213687,151,102,361660,67413,294247
a6016782a5aaa74449c861342c21a8e8,177,129,395055,92122,302933,119,97,248811,76764,172047
762354544be5f996277219cf1bc8b3a9,40,29,28935,7186,21749,38,28,16443,13152,3291
846becee884b6c4eb7a24b9d8cf7775a,25,17,16949,4032,12917,21,16,9668,3999,5669
25d0cb1e48f1b53a8f444785217729c9,45,36,54522,17023,37499,38,24,45584,13909,31675
8fe51cffcf7bdd755e1e8e95c13276cb,33,23,24870,11548,13322,33,27,33447,10491,22956
d8fc74147055e89fee603fcd480bf669,33,32,39154,9895,29259,55,33,30539,8777,21762
60fc31267641f475db3a49dd81325d80,132,97,268397,45411,222986,138,112,252879,55841,197038
77511b19867abe6e17f0e564d9cfea39,80,80,181170,88383,92787,124,113,356163,91667,264496
20d027f7724f7d07cf4b45f69faf4441,54,38,42246,12775,29471,44,32,39405,13355,26050
7ef4d6d61e5ee5ffbaf086b55255b932,114,87,228230,54468,173762,119,87,204222,62152,142070
68c851b21a8f7b5abe6ffb4d6d5576a1,34,25,24966,13620,11346,35,34,33712,11976,21736
9a07ea7f5c542325bfe4681aa057607d,86,60,116049,33092,82957,93,58,96107,36442,59665
415759a66f40b11fd362af1c7239a5d2,157,105,514014,78966,435048,197,151,446206,116622,329584
fb1208b4c86f70a1551e14beea73d0b1,133,105,284028,60289,223739,102,66,198446,62827,135619
00b9844e956f01c351bedd88ed53e217,39,27,22681,10823,11858,39,45,27174,12764,14410
ae4ba80ce577dc0c0b941eb72dda5570,58,39,54811,21919,32892,49,45,52661,19439,33222
bb134ab000e7bbd24a80c50cde8c13ce,154,128,537874,134839,403035,188,149,611716,125288,486428
0517b4527de4cffce2a4af762d949d9e,154,119,370320,75304,295016,144,105,367120,76625,290495
676bceec33f988a9042461a0d419bd2c,108,93,286315,71830,214485,129,79,272331,47728,224603
74ff408c714bf7b7b39311345afdde72,22,20,8994,5348,3646,35,19,20547,5062,15485
9ee129296ee8c8607f2341de9d60a4f5,187,144,769034,175926,593108,171,123,662282,142007,520275
79ff6d83a204ae85d83de520168f653a,153,88,335985,54403,281582,110,87,263510,76262,187248
2eb0d5ff2a1b114364b4ee1f58b99070,69,57,91547,23168,68379,75,62,79933,21460,58473
75add27da79276c67aa9426e49d51690,43,35,27760,8308,19452,25,20,25055,8580,16475
066d58babcbfb6ac09a4437be6a4955f,112,91,286651,76685,209966,146,118,474005,56799,417206
60ef3ed64f091615d8cf5f5a5baad460,156,126,375972,88038,287934,138,104,371497,81590,289907
e1c1c5b316ad4489e68f4ddf6fc5c52f,114,84,274855,66870,207985,121,99,265542,77698,187844
b7506f1dbcdb693bbaa12116eca21691,147,113,575611,84094,491517,222,174,1128191,94379,1033812
20217441576f187e26fe2d1ed3119ac0,137,111,471845,149856,321989,203,163,757864,157845,600019
2bcd517a8c0a94746f0a10f59a11eb3e,183,131,649409,87178,562231,155,120,621510,95616,525894
2d70e974ca1e15c4a28cbbbd6a42fe5f,9,6,1429,485,944,11,9,1367,400,967
fe1358ca283b5fd58054e3241a3cdd24,23,15,6244,3643,2601,19,19,5636,3391,2245
beb5181969423d0c8d559f22a7e64430,35,29,21224,5863,15361,54,39,44919,9897,35022
536afd80cb5ecdd7653b305e6eb7f310,138,118,370694,133925,236769,147,99,377210,72420,304790
75067aaccc3050af1742c58e2f3c5660,122,98,311263,85882,225381,120,97,288554,81345,207209
5c5a996087df0405b25aeb41de2cf266,20,13,4331,1444,2887,17,13,4699,1859,2840
c9fb06e89079c4272e3eeacd66013441,198,132,761459,162839,598620,181,154,655666,185318,470348
cd20b79a329cfdd98388dd7dcae9fe3b,86,53,154478,36770,117708,115,77,265969,28934,237035
43a484099279ac4c861579b4ee1eb2bf,30,21,11742,5463,6279,25,22,11703,6465,5238
a66067c18e8356a64d6e86de2c2432dd,171,83,336151,110881,225270,137,94,290048,101684,188364
f707af63450fb77267d9ee9d9a1d05a5,45,40,53816,20464,33352,40,32,57206,15325,41881
2be52f84292873ec9cc169ab4ed75aa6,78,63,154609,37949,116660,77,60,156445,41775,114670
a3187bfaf56d0391bc5f7a87f63dbefd,166,101,285039,58294,226745,140,104,306290,63007,243283
4685e260d28ba7cbbef3a74e4da83704,71,63,111432,46432,65000,120,79,237824,36486,201338
bffddd5715d302453d978875ece4d4f5,95,64,212361,37257,175104,118,95,226739,51631,175108
935881b466ca2653d7e547b15da3c06b,91,70,150751,32437,118314,76,68,89882,36653,53229
2e6eb4d4c2979f5d91cfd195ebfabaf2,75,58,136398,28448,107950,71,49,126411,33579,92832
60c65f56cb894e45f7778adb2ed6127d,27,20,16436,6863,9573,28,27,16956,9797,7159
9d323b40147499c44e08c2bf43b526b5,21,24,14635,6566,8069,25,22,14024,6766,7258
7812dac4ca258eff792fe0b60e1b8a66,126,98,263531,76479,187052,137,100,266721,61705,205016
c8b59ed4e8438f6dcc65ecacf3047b05,47,35,57517,15217,42300,49,36,45868,18474,27394
e9087fb457796598c321d315580e93af,57,47,82196,19295,62901,53,35,68107,16081,52026
1a57967e87024bb010b0de9f760243fc,100,81,196213,54297,141916,113,74,192910,33834,159076
5bae0e119d06953b0323942585cbe218,44,34,44033,13588,30445,36,29,31361,13855,17506
075587e3ad5699ade9f3da43d6d14bf7,36,26,16769,10657,6112,32,33,20579,9079,11500
2d95d3833264cdaa4fefc7052ab2f1ae,203,134,1162462,161490,1000972,173,129,848424,196614,651810
87e65fbc5f99a48ae70c100c7e469b51,70,63,115921,47869,68052,84,71,135301,46564,88737
3acb7082c7b291becdc807b6a0d31ee1,34,20,16951,8181,8770,30,22,24214,9427,14787
e37c3933b833a5d7b58a5feb67422040,108,78,179793,65210,114583,123,83,245712,82007,163705
bad89bb40c48b1ad1c52319799d45c15,96,73,207822,36681,171141,85,66,141590,39660,101930
ee8959b51c28f39b6d56e83d9a0807f6,61,52,68975,17011,51964,52,40,81509,19618,61891
040d63cdec44571daa1b475222c25032,38,24,43305,13980,29325,29,25,46914,8646,38268
739d4e6b566e2074b09c3ac05451414a,194,136,806632,88491,718141,143,97,518427,101618,416809
9bf04d36a6084b8d6e4118fe96e7e630,67,52,85928,34816,51112,68,56,107596,36337,71259
23e32db1bc3cb6e4f4c69132b36f76ec,136,98,451700,93772,357928,156,138,481164,146760,334404
cda45cbfa96d91e4cdca6e55f5ab8fa8,129,89,299208,109053,190155,185,117,471996,105333,366663
c629b6db15f3d604ba16b7065cefd7a4,102,71,124808,30332,94476,52,46,62288,28098,34190
ea76c03145974178232229cbe5e09410,69,54,75900,25404,50496,103,81,127235,29650,97585
3a774e1e968195d9dc11a872f9c7ffad,34,23,22649,4332,18317,31,24,18363,7423,10940
7e34c0bac7d11ee62239c7895c77d437,23,15,4559,2994,1565,20,19,5584,2097,3487
ae93b2d5be9804cfa7c5e9a3d03367cc,101,79,268397,52066,216331,116,95,283880,71374,212506
f51a7573d09103c3da63ecfab0a6bf23,2,3,387,271,116,3,2,271,387,-116
bf36705879a8a6e5878a85a72b8fcf23,150,88,278030,70929,207101,144,96,333416,64333,269083
b3eec342ec6492c6e6fd6402776e77f2,18,14,4275,1383,2892,20,15,4483,2299,2184
54ca6d11fbf77dee8eddbab44c6510ef,205,144,1200954,197402,1003552,191,132,953913,281878,672035
242ed68564a5ad6c025d715553f3ab63,156,121,555665,137830,417835,150,122,552929,116282,436647
7d5e0e32fe9310614e615b35ab4836cb,93,78,267543,107989,159554,148,113,448030,106915,341115
32f5a282b299628936d283a1b5e68b0f,57,55,98734,21036,77698,51,40,52306,23796,28510
5304ea1a006d12a53a9a309845982dbb,69,59,102733,31726,71007,89,78,123728,28543,95185
dcba1a389fa630f33405b704ba50b192,183,134,479776,141706,338070,174,134,570762,123980,446782
6f59097ac01e7ad7c48a421d0ce06fbd,59,57,72668,31060,41608,71,48,70789,25286,45503
11ee4d6500a3bac6f2dc2572e1d41171,145,99,324051,110829,213222,147,84,354234,88067,266167
9434f7e43d9d518767552472a93c5a64,70,41,62725,19896,42829,54,48,52814,29370,23444
b2c54efcc892dc977f4f83f45aaedb50,102,85,231380,51229,180151,146,113,228283,64792,163491
f5c435dcd5b77bf40a29172eeebdbc3a,92,69,240662,102777,137885,135,104,369163,72969,296194
101544b5d2ad56f508a034437e91f9c1,144,100,398434,101974,296460,176,144,717974,118455,599519
43ac117b346348c38b5c02152d7b86d6,178,119,607105,183281,423824,198,143,722399,175278,547121
83fd72c1839d9cd5ea21e97f33a1e9cb,25,16,6812,6118,694,25,23,15114,4400,10714
568f877ae90fc6efb6b4babe7794322f,187,129,673463,106217,567246,206,163,835728,117502,718226
1968f74b79344b49488070f92c48ce2c,58,48,61518,27500,34018,53,52,83039,25534,57505
d477fafcea7e147324031ee12c8281ce,43,29,23837,6608,17229,33,24,14367,7718,6649
6dd2c7488378ea8ea13804383a046ed5,147,108,285226,40794,244432,82,70,149240,54363,94877
c5d660618c7e6e90b291cba7b567daf7,25,24,11605,5447,6158,36,20,12693,5059,7634
82282b10f73e64db0d48f56820b90f18,88,57,143908,28827,115081,92,76,119615,55061,64554
9caa302c07f28d9aa18d8e9d81d5c2c3,86,77,122411,49727,72684,105,78,180426,36550,143876
3b0cb6890b3eeaac681f524dbfe22365,85,61,112313,23859,88454,80,60,122313,25484,96829
5d7b364c11729f2a875dd9ac361ce04b,117,93,221489,65755,155734,119,94,187326,66235,121091
983c1e46d7ab6af24750def95b8b0e84,47,30,61811,15472,46339,56,45,53476,17251,36225
fffd0c0cf7381099fa76beb168f59f75,100,70,132806,24058,108748,71,63,107637,35553,72084
ac7b56cf0cb7ecb269966d8423a29f27,80,55,118505,19839,98666,53,43,73331,14354,58977
347caf6fae30293374c1a3059527125d,148,114,466248,93153,373095,139,110,416047,104032,312015
4a9c35a778e01644010da2bc04a43739,180,149,840627,148683,691944,175,135,629045,136490,492555
8287c7629364597945bdca5f8757a9e7,154,120,509006,151757,357249,142,124,468872,168693,300179
286fa8a171bee2570d45f8611f920f22,241,165,1179826,189004,990822,227,161,1500477,166731,1333746
222a2b83ac9e3901fb4c28e49b499073,143,101,310146,59033,251113,126,97,293795,63109,230686
1f12582da4de21ef1542e4f9267a4b86,44,35,33619,15586,18033,59,43,43735,16259,27476
fadcd5be5e980449a94a6b523c37a310,71,59,85011,23878,61133,57,49,82087,23333,58754
c54ee34ce3e82a23d882dfa4b8c7907c,46,37,49186,16109,33077,36,31,41018,14899,26119
a1c870c03709ad015ee323b90102369c,91,62,164728,54889,109839,87,63,201363,57050,144313
8f2e7b327624e302f1cfd3931fdd0053,91,71,143747,38726,105021,88,77,126661,39352,87309
069fd814bea94f187234209442ed1745,3,4,298,298,0,5,5,557,326,231
b7b4098bf32da7989f44c4f3e0aa5b92,171,131,569586,138815,430771,227,177,791553,97466,694087
dbee93b54a7482bef2b5cef7d4f4d291,117,97,301009,62704,238305,159,112,416005,67131,348874
9f4d699e229629c6e33cb503cc6aa248,65,47,101545,32026,69519,81,56,123297,33912,89385
ef23cad0e08edf14f229efba8a5ef14a,76,56,108959,26582,82377,85,67,109387,36291,73096
f01435b33661feacd22ae733a18a9559,69,61,75023,31920,43103,79,60,115309,27767,87542
08349cecd68b72b1467018ea0d4446ee,29,22,23737,5665,18072,36,27,24921,8869,16052
1565f664eb09a216edf0308c4241851d,76,65,132268,35917,96351,98,79,166377,27882,138495
16eefea6293a67ef2ec06c1af4fa4da6,123,105,233102,50374,182728,150,115,322423,63900,258523
8950c87655a31b18b2fad434d1412a53,228,125,972066,122994,849072,226,150,894938,126367,768571
eaeff97eea2d054b0b0b42744c2cd73a,103,88,271165,76470,194695,111,102,259762,93499,166263
e119cde0da6edc78af04c683cb7abc95,43,28,25550,10361,15189,44,33,29327,8461,20866
90a547a5c0f855a45029cd5fe3522b9c,197,152,862187,94090,768097,169,135,726520,89262,637258
226bba6c93fadef64bf76a60ab6431ab,96,80,182353,44069,138284,109,101,239734,52327,187407
24becfc348f1381ab51b2c8c53980e02,156,119,450981,92590,358391,183,159,570824,87439,483385
ff50a269ed2f67bd1be319317f1b5b50,26,18,8604,5359,3245,23,18,10825,6145,4680
228d4e58abd63104a0621802f3f48b89,23,17,11576,2172,9404,32,23,12516,4049,8467
d474615963a212923cfbfab57cf3b575,34,31,21893,8535,13358,35,28,28924,8774,20150
d18e741230fe6b3a87fdeed8df28651a,110,77,137464,32276,105188,97,80,191426,43022,148404
1ed22181b5fbf1db7bedc7ecf30cf041,45,34,66839,28363,38476,58,53,90580,30587,59993
c1a87ffed103c59c287a133089c4d77a,108,82,255172,80534,174638,156,105,327569,67447,260122
b1a2f98f18091e166187264f17abfc5c,67,42,70637,22474,48163,73,50,97969,25424,72545
07913e1ed52142b74c2791deca474bd5,28,19,12409,4515,7894,25,20,12588,6267,6321
93c91c88bbef4e828d6db375e5ad7856,138,124,333494,79492,254002,121,81,272306,72544,199762
0d1e19e71c1393ef0ac6f48437e198ae,123,86,254031,41474,212557,116,87,252960,44882,208078
3391510e7d9790088f99da38b4a6df0a,15,17,5361,2375,2986,26,16,5208,2205,3003
e6b5b4056b7ac938c2757e9b818bb279,97,86,197819,61057,136762,137,117,260376,68059,192317
ae1a8423106ced8dec980daaffe102d6,131,86,219927,59379,160548,110,87,214939,58962,155977
289885f65602f3ec598768e9733d28dc,16,14,2342,1434,908,16,10,2472,753,1719
5cef3405744b1e86d7e7304e2fdd7f03,101,67,178555,21143,157412,80,53,139713,31230,108483
789c4888e2ccaaef57b1b375f430d8e0,68,50,85343,29209,56134,84,75,127863,37101,90762
4c218ff5fab85626dbacecaf2adf1ce7,65,44,132092,25626,106466,68,62,106331,35891,70440
00faed3b8889ee0959d5b3264a244c89,76,58,94053,46211,47842,67,51,122014,39328,82686
2aabe5ae5c5c5a9f4918bb2aa4b16d7c,39,33,34177,15747,18430,45,39,24721,13220,11501
3ae6b0622cc0bfccb15adef764766bc3,107,82,242819,68596,174223,135,91,235274,69393,165881
7e09beb03559541c19ea1c51d6067ef0,140,86,226804,32570,194234,81,74,179631,35400,144231
b17d58b030253a0ad20fce4a5172ad0e,36,21,51424,8960,42464,40,35,70231,19632,50599
111dfafe19c7a9a7c2f0e8b98388fc0a,110,87,237763,47400,190363,98,82,195442,48839,146603
f2e29a1dd9cef7b9265c7768149db973,112,96,228131,39741,188390,121,96,188455,47640,140815
ea37ef85a2cd27b6abc46d17d0bf1252,139,105,252545,58836,193709,143,107,248176,49914,198262
b122716e03db9c7c2c4fe98c82509c50,67,44,100447,21421,79026,58,52,76967,26762,50205
9b23c2a2f1d9c996e3ca4e728a042074,120,79,443646,132770,310876,183,142,747065,122888,624177
44917b64055f3d4610bdec27dde2b6a5,160,134,380830,97832,282998,111,94,302154,105075,197079
65987581f5be92a2609c97fe50fdce74,54,43,62595,22531,40064,54,46,68754,21232,47522
e0a94166f7ed48a62d446d61b4a26997,124,95,259681,63389,196292,104,89,206886,77340,129546
7cb7220004ac1840736427b31b5cea2b,44,34,41554,17695,23859,56,41,57393,19045,38348
2682ce165d30e33802a9f983779cc307,28,26,15552,7369,8183,30,31,18566,6976,11590
8e27a644668326363e7ef4d32a8e1ff6,77,60,112830,27065,85765,59,44,78753,25521,53232
ab735b885109faefe1b6e7d8673a4058,117,97,254504,41731,212773,110,91,215597,28658,186939
5bf4e3b6d1a569d3ba2bc18b1dbefa79,82,54,111744,26012,85732,71,63,78249,22908,55341
839ff13b3ab292aed9e0e8797159a429,72,52,93902,28427,65475,91,74,112969,28227,84742
55cab50f0f2c80e124f3b8257849b71e,39,30,38851,10336,28515,57,48,58785,12987,45798
f483ad9a8d117bed2b7a371791c39a2c,60,47,90070,24050,66020,72,64,95529,26341,69188
9b3acaa94012bdac6150917add0504b2,175,134,401571,72315,329256,87,71,241602,82595,159007
04ff18acc95a817997d2b4b0e87e6c32,138,110,457658,73164,384494,157,134,469833,75035,394798
cebab2a2bde79d6574178603af81b94b,146,75,282985,49968,233017,153,122,342208,74763,267445
16564cb79d2bdbf7f62ef58f8325a8ab,37,26,29553,10795,18758,34,32,23722,13710,10012
a091e7c44e884f48660b587edcfb0ea2,141,98,229051,42677,186374,103,76,173272,40415,132857
f52443d5bb0cd3b515504933a6d1dd27,76,67,113740,32042,81698,73,51,111384,33302,78082
44a6e5b2f80079bbcc5e41009b527da1,165,125,584078,107125,476953,168,145,606466,106337,500129
97c276896286751d415c2d683232ccf0,74,59,104145,44599,59546,79,69,126044,39879,86165
6af83b940add56ff9f605ae869a3f570,44,35,78628,20860,57768,53,39,78364,22542,55822
c0f8af8d7f837f69df947f6f9fae9b6e,28,22,12844,3249,9595,24,21,10175,4108,6067
7c7605d548b991a527356dc0042c466f,56,32,78222,18720,59502,55,51,84331,23422,60909
f2390dd2757b242533a5435d9ef9901a,99,72,145303,31354,113949,84,69,125212,36438,88774
07a0d3902c8d3b1dd2f507e82decbe40,39,23,37526,6913,30613,44,31,26577,9723,16854
ed9428784224e51414e30cf69c10500f,147,112,478532,91259,387273,151,124,452361,94880,357481
0320209f813645d1c922794e47fd2cec,35,29,23491,13453,10038,35,24,28683,11759,16924
1df610eda0b6d228506c59ce854dba25,45,33,47152,19012,28140,46,40,64789,18319,46470
54f85de646de986c92c2bb1d3797c843,130,103,436334,117615,318719,156,120,564586,113768,450818
9552e9393b1a1c844017b9934793777c,104,83,192615,49608,143007,122,89,151988,42148,109840
9d2622bf82ceffda8c702799bda6b9ef,105,82,199676,39023,160653,116,97,208031,41823,166208
0b4e1710f4ffe5130f4cbf5e8f751487,150,126,756279,145577,610702,132,107,676401,167797,508604
f60261a11fc8dc26090199ae63c876a6,101,68,142275,26795,115480,91,87,184692,39880,144812
de84be6d4ae9c5c1f27da449535acca0,23,23,20841,4617,16224,25,22,16414,7597,8817
a5dadaf9fa7c9456479dbee7353ba788,104,83,247769,43053,204716,83,64,150480,44971,105509
a914a486ec950cc2d1efb9e51780e66b,55,38,36241,13223,23018,39,38,25812,14214,11598
9b15ab3ad10cf61747a2a731d3621364,6,5,1602,956,646,10,8,1326,1181,145
9fb93a9f7a1a89766e0c2a47e2fc1cc3,123,99,303087,61012,242075,104,75,276263,55653,220610
b02c39e450b22040ea9415385b352243,133,96,323868,78152,245716,135,107,409328,76543,332785
32d0a9b3e28f74b8d15f01c9df6fc1fb,124,87,272540,69005,203535,136,77,276509,71631,204878
f366db9b7ad06439e7472509e8acc8ca,89,70,177667,44829,132838,110,93,182081,45942,136139
b773bc9f40194b1cd00e4920e8645d0c,27,22,27410,12352,15058,27,21,29121,10886,18235
1504abf3a6e21cf8fd05e04755379ed7,146,98,384196,96591,287605,128,88,324342,106361,217981
aa92ea84bf14c4389f9cc6a189a908d8,84,53,83828,26237,57591,47,42,64095,18773,45322
6b08d0a9a9fbb88b975808baf9efb89a,3,2,380,125,255,2,2,125,80,45
7db39e75fc0cfe0b256c28cddcd89f1d,79,70,150056,41377,108679,101,79,120162,46525,73637
f51027708fa4a627c5ca54f5c874c55a,69,55,65157,23839,41318,59,42,59493,23071,36422
f8ea645f6b33c2f6b039ef2ae91a4b3c,80,61,117800,28355,89445,74,70,132391,35787,96604
fac5f598e3028e82f195c7ee6a235b7e,127,88,279360,67458,211902,116,86,260862,64030,196832
a9462ad509ae8304fecfb94db7c76a84,170,119,462495,111932,350563,147,117,441943,104714,337229
1feb00706f74d8195608dd2966635284,26,20,15713,4326,11387,25,23,17156,6340,10816
325e3377fe271392534637e59fb990e0,42,31,48573,14594,33979,34,24,34436,14269,20167
1ee7e628d2429c7affc4c7b5d5d75e92,205,164,858359,176530,681829,161,128,729669,170652,559017
8d0a0871903e5633a01ee1273942908a,46,31,46692,12362,34330,32,27,37692,7141,30551
4b2027ba3c825aa6989bf545b392f4d9,88,76,168771,41655,127116,84,68,149951,43470,106481
ade88986194005be126c9607738598ef,63,56,106979,34545,72434,65,48,95798,40235,55563
69728355e33764579fe469be6a74d860,131,111,386785,79054,307731,124,89,294794,87195,207599
21abe22cbdc12084e749b0cc146413bf,42,37,44916,19008,25908,52,36,64302,13388,50914
4e6705f928545b9f12d07133498f5760,48,37,63400,15104,48296,50,29,40880,15261,25619
5a1a47c07072fed4566ba884d5b3d930,124,100,308593,72775,235818,125,94,298910,46039,252871
b9f1ba26f5bd1d79f910f83f56a61f34,82,69,140824,40789,100035,99,70,172148,26871,145277
27db9837a5264246c57120bf953f5dff,27,18,7461,3808,3653,23,22,8081,3904,4177
20e9e65167146cabf938d48a49a90d95,84,81,159461,38206,121255,106,89,151513,38459,113054
7e2beb4415dfdaf905f64fe1633aa8cf,104,81,176253,32037,144216,82,69,99844,31373,68471
952f1c44f428bd2f2728f72620ffb6b8,33,21,34759,8529,26230,35,32,29626,11292,18334
eab759188c509248a6b84c2fb9b850cb,68,58,79001,21513,57488,69,49,77935,21150,56785
ebeecb063a25323369011fa41635c94d,44,37,38613,21682,16931,56,34,68244,15287,52957
554323c1db4f3654e9ff415142d33f21,86,66,177088,62863,114225,107,70,160142,60135,100007
9362cbd840b7a2b68cfe6ab4976cc420,207,121,746655,156393,590262,180,128,791533,229472,562061
36ff7a80dbed05bb985c043f67e40ff7,120,87,210603,56840,153763,107,73,186543,59558,126985
a54d1945312f2479f0bf9931320f59f0,84,82,126071,40517,85554,77,62,105115,28187,76928
71200b7a17f89e246e68b5d87e9c0c78,134,114,321580,60848,260732,100,82,234479,43894,190585
29af1a306009d77e19e696c063b2dc69,103,81,199900,43661,156239,114,87,246014,40527,205487
d62dc19397408405caa4514cceee2645,106,75,192391,27404,164987,76,70,91330,37280,54050
2e36ea1d04eafe6090eac893706fcfa4,34,24,25161,9220,15941,30,26,24636,8461,16175
f92416193f3dd30545785900f1c91510,112,100,376516,98785,277731,157,131,390129,106483,283646
8a8b2d2e601a94049569c4606035fba9,161,122,377735,56223,321512,120,92,228153,84554,143599
1bee822e06e8e9da825bbd72cb35e4fb,104,64,169116,59826,109290,88,72,120042,59783,60259
8f84e3b7f7b87466678003a46750be17,152,123,440754,83401,357353,149,114,364025,78833,285192
6542ff27a91dfb65ab01e0cf5a19f9f4,45,35,34718,15791,18927,51,48,47489,14069,33420
16ccbf4a9170e5f5ecf2ac54621ee208,186,129,666334,148098,518236,185,130,900390,123895,776495
4678e2ad601b51b7261480a598fbd5cc,34,27,20509,5963,14546,36,28,20206,8422,11784
b2b223a4063d46d65e616aa4eca0b83f,106,60,140633,30500,110133,96,68,170424,38437,131987
d547b513c766f3bd439409b59c50dfeb,134,87,554840,111669,443171,159,116,475346,122510,352836
d057603070dfbc0baab08b8e9c7b0f2f,55,39,52086,22408,29678,45,30,47049,18931,28118
1111d9a24570eec8f326c6f8ca63f4fe,85,59,168037,36770,131267,93,72,155784,56654,99130
7422f93dea1a701d84312ed99cc6119c,19,15,2319,2732,-413,21,17,5828,1741,4087
2545b8f8f8f157c82437f4732d84e525,21,14,4373,1723,2650,18,17,3627,1780,1847
f9b9705d46dfc196fc5162df459e64e8,48,36,49931,12292,37639,35,23,34035,11945,22090
d77f02cf9b8569c999601d9682b91e4b,31,28,13006,5308,7698,29,28,9530,6658,2872
0eb1881171900ad9feffcae0666db501,62,40,89413,21796,67617,59,51,82782,20711,62071
1b196662809c871bb80592924799de0a,39,26,22935,6296,16639,40,22,17755,8430,9325
39ed758d4138695390eb6e361a70eaf9,82,60,169552,43313,126239,117,88,250816,39783,211033
208ae42099101976ca1235e89c1b539b,49,43,58882,20270,38612,58,39,66189,19743,46446
92c7d37e622fd4fce58c50a5cc737d7d,146,117,390704,69059,321645,115,93,322338,74152,248186
91f939b7118c73597c8f3162d1113a0a,28,22,19666,9751,9915,24,22,30151,10249,19902
3c430bef7bd46e1ccffd4854d50b5605,91,70,129362,54173,75189,84,64,129408,41657,87751
68762f025c8c5167f410360e38eb77b0,81,59,106691,34765,71926,108,87,160959,30205,130754
fdbb3e7233b915a77e2e35430fd0ba38,67,57,107374,37928,69446,80,61,121776,22330,99446
08adc48a9e23d82154f18233ee1bb3d6,128,92,184060,35213,148847,114,90,204995,43381,161614
9c9da77c3b45bf367cdcd5db0d0381f1,206,142,1219766,206657,1013109,207,146,1111884,242649,869235
06885c3da91824f9588d57c44b2234e3,77,70,129335,33790,95545,66,50,82786,30042,52744
d1b2234b195e5b584b65dd592af2329d,68,59,138750,39587,99163,57,42,171069,37729,133340
3190350105e3e6445c9c7a68ebf0be52,146,98,208554,42490,166064,137,109,240431,36488,203943
192f222704db96537241057f78532f7f,99,88,212968,61969,150999,159,123,265103,59781,205322
efb68168910498d18c019b382bae458d,146,120,484259,69465,414794,166,132,542692,70940,471752
c57a0567c1125d638b40abf2e46a0a45,22,22,13055,10447,2608,30,24,25335,6816,18519
5cc7ed64a309fe000a6b993b58e68454,35,26,22034,8850,13184,40,22,23957,9764,14193
1d229abdc6f333690e8dc9116a558b98,78,58,89144,35031,54113,103,82,159012,30344,128668
60dd6243507a4a5dc10ab18856fc0b06,66,50,56330,17897,38433,53,37,49799,15062,34737
31b798e197c59ad5f02903585a2d9190,49,36,35905,21323,14582,51,31,53104,13869,39235
e8fea72935652a603d52c2bded65ec46,65,48,89830,22889,66941,50,46,65255,16392,48863
12221bb3b75e736f97448aaa1e2e9d60,92,65,247005,52662,194343,104,84,217230,50665,166565
d9f50df97f3c64d514281f388d27a686,22,15,8288,3135,5153,21,17,8159,3169,4990
585bbd3e1e166822cc47a961614ca43c,29,22,21215,6897,14318,30,21,20798,8538,12260
395118af07efbca13638328313a8bc55,155,119,548497,83577,464920,189,135,690895,92318,598577
e394dd37ca3d719c9bc4d2e527f9307c,134,108,318594,59800,258794,177,131,418279,63380,354899
3453dd317ef5c47c5e19e9741b631e61,125,99,231979,52473,179506,147,110,296792,54792,242000
64bd6ba273dc344bcefe84a15e4ec169,77,58,145913,36135,109778,98,84,138016,43540,94476
0468d2694c4e71ebffd25778d75ff69c,74,45,66122,18073,48049,84,71,96532,23988,72544
20d1bc9ef3b81905451ec282988e4414,33,27,32200,12003,20197,26,26,26293,11126,15167
64d4b1bf350d11150548e02c8ecb931c,90,81,157535,29969,127566,81,62,116110,30059,86051
26856f6596658150384676164b320fd6,70,61,72253,27092,45161,61,42,77212,22636,54576
6ee295aedb1b9a6011c9148b746d7bab,138,101,317702,51375,266327,155,107,312940,54873,258067
3524a3190353ac24f91393ce7294b9c0,204,145,1224974,227135,997839,195,149,1475864,202204,1273660
313c9e2fade48c5d9cec352fad751c0b,18,14,8742,3376,5366,18,17,5753,4232,1521
706e7733132ec53f78a4edb7871fc0d5,23,12,4184,587,3597,10,14,2197,1911,286
6cf6ba06c5cc824e73bdea7016e5481c,92,75,168351,53460,114891,110,73,200427,31263,169164
fa73c0ca1506b0f2f85b4ae22b8db7c2,31,25,16494,5663,10831,24,21,8941,7075,1866
a3d1638fe67be275b28f419684506b5a,4,6,591,865,-274,6,4,865,591,274
8074d2f99ca1106d4c811d74cd58ce4e,61,42,66533,13877,52656,57,46,65510,17994,47516
5964a09eaa9543c2f39d0eee1e95289e,28,21,16968,4193,12775,24,22,11996,3566,8430
9a440a9b3fa2b36f780cd5e1474850f3,27,21,12077,7242,4835,28,19,16461,4921,11540
17cf7edbfb27552d14e681badd1aa2c5,66,58,91761,12681,79080,60,45,63012,16100,46912
cd46dfa379d8e143890c5789cca12e35,147,122,429409,50967,378442,128,100,373241,40714,332527
cfb408c37fef8bf52b721f24214bfe5a,119,92,260972,32489,228483,165,119,282899,39262,243637
81eac0c138fc12501db43e5ebe723e42,40,32,29066,8291,20775,48,44,33341,10825,22516
427de414528870aebef3ccac84e41066,32,25,15930,7113,8817,28,22,18435,5763,12672
b1beb38bfbebeb4553be8773eb983793,148,104,309903,77728,232175,149,140,408585,96797,311788
817631a222b7896bd463b5c68c46b377,33,30,17098,8443,8655,38,27,19672,8182,11490
6bf6ab52b9a6e0d81efa8f5de3648ede,117,94,216385,65030,151355,94,79,138749,40530,98219
10a884baff090b71b53e0614bc1194ce,67,48,72603,12058,60545,50,40,38369,14373,23996
6bb5db066d8d739284e713fbe46d3f6c,5,4,618,240,378,5,9,327,654,-327
f348933eb169e27f60a3832e25465848,40,37,57846,22912,34934,54,44,59863,21144,38719
d34a2029a0d97cc286cdcc730b2aa49c,195,159,617620,122331,495289,191,149,690509,109975,580534
9a1de771426bb4032b15f57d8c49590c,45,31,33131,13107,20024,42,35,35013,14182,20831
6344b589637ebb7be4c6fa79053138be,34,26,35781,11321,24460,33,25,24321,12252,12069
8ba08748893fa16616b5e3f6a40727a2,105,86,182976,43312,139664,107,83,201687,47008,154679
b4b6a93db7271d50fd5ed1b5b524a829,159,115,1171322,215174,956148,213,131,1389371,234021,1155350
c41041b4ffb26e5509e3babdc5a9c4a5,142,109,386060,70940,315120,115,93,366124,72369,293755
e6c87119a2438f3746d0cf1b32bba475,14,16,4507,2434,2073,16,10,4199,1914,2285
446e19f1e3ec3a3ad4408b1edacbd1a8,114,82,293930,84760,209170,118,87,247762,57847,189915
44f8c9398840df3fd2f87c1a7bda9507,63,50,94409,47985,46424,125,95,257341,44534,212807
06a0e0b3c3debba32469200c51961bde,43,42,45790,16088,29702,64,28,68498,13595,54903
599fe6962093d7eef93492c50163b707,57,44,65566,16603,48963,46,37,51706,16749,34957
63b026b0dca99e37e67b46006940f173,120,88,182813,54018,128795,129,97,222329,45253,177076
72adc9c2752b41cf280306697d1dabfc,116,97,283141,71650,211491,98,84,251953,57793,194160
57c6e92f931edef6a75e1c46d221d6fd,84,61,116572,32135,84437,75,54,105425,31441,73984
573f32f4106fc33865874f4e8daf1e5b,69,50,113100,29035,84065,81,63,141108,35513,105595
db7c9ba7c7808a3f1f3c1620cdc3d55e,54,42,83733,22325,61408,45,39,65504,25515,39989
d4ceb7f021587799aedd9e3fabc4bdbb,87,66,158547,34210,124337,71,55,119928,43085,76843
2695fdc7e755ca5d358a6885fb422d09,179,114,514902,148042,366860,183,136,647745,135818,511927
dd78f0a12e2b995ac97b5ac28f659288,32,32,12119,7313,4806,34,25,28919,6486,22433
9c3efe927c58ad41cdb16d7447f933ac,66,47,77417,21915,55502,55,50,70778,21551,49227
2c7d74f41a3b7eeeeebf3dfe73280225,32,31,35521,19611,15910,47,27,46239,15110,31129
0d159d027276732d19e239cfce51690c,54,42,61495,21576,39919,69,55,57872,25729,32143
e35b6c5f489a6d84bb43ed4ac4d7633e,220,132,646091,145705,500386,203,155,913108,145228,767880
1cdd5731ceaca23179902ade26fdb5a9,37,32,38630,30997,7633,54,46,117817,21224,96593
8e3d5e8ef33ab48cefb17e9f81562fee,152,95,277421,56662,220759,119,83,271716,78718,192998
48909c32855c14229e1f86fecd60b1c1,62,45,73921,26896,47025,85,53,97847,23126,74721
e76fdb815c2b96848a52caa331d15bbe,107,77,254718,80968,173750,138,116,351583,72781,278802
69c90140813780d269f50c22c6cf2b3d,152,115,291418,77721,213697,132,92,217603,74041,143562
c80d39ac39e33c391ef3f10e08769acf,23,21,16480,7317,9163,27,22,20507,8827,11680
c5fcaaafe584e324096617d96970e072,5,7,580,443,137,8,5,579,580,-1
5daa8ef70f4349f2c98240cce2bd4d4f,89,72,126082,28947,97135,52,39,64018,22637,41381
f09d219f0de97098bf1c1e6db60701a8,35,19,24291,7544,16747,32,24,36855,5127,31728
fb9266ff011cb9fcb8249e44730eb25b,37,24,22058,7532,14526,31,26,20680,9289,11391
502e0d2f09a9f0a5fe40abb87fe84316,87,67,120679,22181,98498,82,80,76512,24613,51899
b60995fffe1427bf401371628ed6d128,95,79,197323,60585,136738,95,69,185247,61574,123673
1d51c04131adb45238a881b2103dc8e3,144,108,440971,71257,369714,129,108,372986,85884,287102
1ab784793f2bf23bcb68c65ded8a07bd,23,22,8964,2242,6722,22,18,4374,3171,1203
9aed902d4352b846e2e4364cbbd2913d,107,68,193211,43745,149466,128,94,209617,38752,170865
5166e5354830bdf771e99947cccc6c54,70,49,90547,28103,62444,101,72,123384,24308,99076
886135a5d0707415e5c83aae6371c1b7,19,15,5865,2697,3168,22,18,5569,3180,2389
302e5253fe3027500af063d0390f69ca,1,2,130,376,-246,2,1,376,130,246
cf7949764f95591aa8ecf4c949e2dfb3,129,104,271228,78208,193020,111,88,257429,73230,184199
a53763033b968fd26e99b8ac53e9f4f0,121,92,309224,119022,190202,157,115,462012,112926,349086
809a5ce75ff394b3c6cd803b2b7d5e83,109,87,225425,65587,159838,125,89,258263,62220,196043
bb4f6199e3e885a39c6f23c6adadaf01,14,13,3214,1122,2092,18,10,3092,1018,2074
02c5f6ec402addf0ba8925dea70414a1,85,64,150929,32099,118830,77,57,135306,34927,100379
7810e3c41c47ecfba74318074f7ee956,47,32,51966,18885,33081,40,37,55418,16745,38673
4b255985976319de3d0ba3d732d1e602,181,125,537204,104772,432432,161,123,584915,135122,449793
d8b915facdad118ec795b45955d80785,92,76,185372,56604,128768,119,98,223406,47445,175961
259606d7ac9978d83e677ba7725fb318,118,90,266063,48127,217936,131,111,272787,49817,222970
9d9e22b4b93fbdee2e8847f1653583fa,129,109,365724,74818,290906,159,139,516198,85194,431004
83f3e0539e854da054004e564ba8a6d7,31,26,10165,4899,5266,26,24,10598,2945,7653
77ada571f266eff66d66cfc08fcedd98,133,103,326612,102433,224179,139,102,365891,86103,279788
cd8586dee9e921eb626c01115c809b05,91,80,192316,47660,144656,100,77,190960,44393,146567
e75ed5dce956d3186da381142bd13155,27,19,14620,5078,9542,20,16,16322,6076,10246
714265992212587badfbac90eac0e972,26,22,11920,4987,6933,24,24,8853,4768,4085
d21655908d7a538df57419cb7dafc091,25,21,12257,5425,6832,33,17,24950,4289,20661
9f733c2bd74494353f6992acc9b7291e,78,66,97044,34891,62153,86,65,134609,27720,106889
a035409dc6bc164d1ea4d58eff2e5a17,136,119,346503,61654,284849,119,96,278007,46578,231429
1c44bf39a39c57d7d257de0c8889f2c8,60,57,59546,28607,30939,51,36,77305,20608,56697
2bc5af17704a8a7bd9ad02822d176158,148,85,382781,89466,293315,171,137,417884,108564,309320
3669903cf54e6a97406292a1afc7ac6b,60,36,80683,19926,60757,57,47,63456,21924,41532
777d97f4a87aa64798d8658b6f68ee25,161,125,576482,92786,483696,150,117,506742,95655,411087
2694360f359040200307e48a5f114303,44,31,39803,9884,29919,43,30,22997,13392,9605
9233d574993dcb9fcde577ac41324bd6,26,20,14033,5444,8589,33,22,14076,7175,6901
0f6a009cf4dd8fa8251fc4622a3c0baf,85,65,126048,25167,100881,103,62,142482,22938,119544
07af4de7ac67ed60fe69949ab469b31b,167,130,485803,113570,372233,151,93,321020,116114,204906
dbce051358127bc52a1d0e125707a16c,147,111,338472,83855,254617,150,125,481755,110702,371053
8ccb7235a10ab01bed9f2352dd8c56c5,52,37,70833,17829,53004,45,38,72084,17620,54464
7cbd15c6c8335a4cb45536a87bfde377,109,72,207269,45070,162199,120,102,228917,69001,159916
66c11e89ca844acc92693d3e5cfcebc7,76,52,123753,33810,89943,83,74,129540,35078,94462
d32078dba924db131f6e68e97400cc25,57,48,73621,25225,48396,93,77,149279,27426,121853
fe3f96e42b9e6c4fac14760a90555d5a,107,78,182816,22876,159940,91,76,111519,28086,83433
9fa0a56b2650d4b1b6e25eea8b273ed4,138,91,291552,69610,221942,157,119,427648,62860,364788
e26fd12d84da5abdc4e7d078523b0836,108,86,175555,40356,135199,102,88,204103,37081,167022
6e06cca99b225909f11938aa067b0591,128,103,381452,73437,308015,123,108,290383,81130,209253
c3383221078ac7ca4ae0b77466ebccd4,163,124,387228,138873,248355,158,89,343798,85415,258383
49858b7792754534c2465e5aaa634c9e,105,63,272865,72366,200499,136,107,429085,81044,348041
011b93124d604d92bff3ea1009497019,49,34,75665,27514,48151,44,42,61641,30578,31063
3bc756b645452754170f4bd12c6519ef,38,40,37721,22870,14851,36,29,38306,17420,20886
7ab98c95163a850dcdf981fa082eee0b,165,110,551136,197817,353319,204,177,907040,210604,696436
3f799fb345a33bc72bda1b3ed37bf0cc,101,86,203994,47670,156324,100,87,168946,38810,130136
9b765bdd23070b0a647886da9165f5eb,137,93,343788,69300,274488,147,133,501402,68145,433257
c7e61421fa19982531c2a9717c138178,66,56,119230,41518,77712,67,56,107263,42257,65006
6ff10846683fac2bb65c5dc81135791e,77,55,159276,72331,86945,87,63,217664,63633,154031
8d9c66cadcccb899df1b489003603b35,97,65,125155,28855,96300,120,75,124539,27426,97113
6719a920725c5aa9c2c351256f36a3a8,33,22,23170,6303,16867,24,20,13188,6324,6864
093cd20a967685baab7ef890743875ea,17,11,3460,601,2859,13,10,1478,1324,154
b0adedb297ccd18caa93ac09ae2fb46b,160,112,354430,73160,281270,138,111,351820,65763,286057
8476190e7cc0ee1439c8ef54fe619534,53,42,80346,24648,55698,70,49,88760,18314,70446
00674e2c5c9929d9d0d1f4be22a1eb08,20,14,4647,2869,1778,19,16,6006,2600,3406
e96a3b9fbb492a52b5410c665dffd944,28,21,17732,7540,10192,26,22,20180,4783,15397
c0e9bff7865aa5a078fe829c8c275c78,30,23,17506,7730,9776,26,30,17556,8107,9449
697dd12aff326bb9b3a723c8f9b1d63e,28,24,14942,8444,6498,34,22,21249,4736,16513
57b7afb4de58da630c23981759c75551,225,164,1209285,167674,1041611,211,137,924084,174049,750035
3def20d104ca7428abf6267e52d98962,76,64,127382,40411,86971,78,68,96527,46470,50057
42cf889e6e4ba9aebc240bdf05e2a2e8,119,109,431444,127198,304246,138,106,510017,122377,387640
6d22cd79016e8fe507fe67a90aff507c,108,70,291723,75795,215928,191,129,550296,115688,434608
591296f47d3fb9faf5a42720cbab45c6,92,82,284777,65435,219342,137,126,334050,78026,256024
77d0ee2f8994a5ac0aa4b0b7f58b250d,27,24,21288,6755,14533,27,22,16777,11056,5721
2fceb71670d7c74f00a03d0969fa28a9,29,14,7259,2685,4574,27,22,7586,3499,4087
921c98166bc1f41802ad948176ef1736,39,22,20015,8186,11829,32,29,20059,9876,10183
57c395f03104222959fbf331521f0661,22,19,6734,3484,3250,21,19,6546,3720,2826
05de96195a533b00b12ab07dd1e18d7b,133,111,433834,152342,281492,144,102,386726,134274,252452
8fd766fbbf8edee41246b8c489fadafc,19,16,8261,4231,4030,22,17,8726,3225,5501
9fe5ddd53df8f30dd43fac5785ff32d1,163,119,350475,77259,273216,120,105,276900,75594,201306
e4e8f86e3f04d891662319a8b6d90244,23,15,4394,2748,1646,19,19,5680,2364,3316
1e6716231c10d01acbaea37132fb84b3,21,19,6765,3013,3752,27,15,6255,2643,3612
f30bbf888495ffefd85b63f9922b163c,15,10,1771,940,831,14,12,4247,989,3258
878b05592ac2acf322c0be48681f6413,27,22,21114,10242,10872,33,26,22951,10094,12857
bd0b24316991bbb6f6486e94a05dd443,142,103,370027,100360,269667,139,108,485740,72698,413042
c3a95fcad96b6bada32527d8001145be,1,2,50,185,-135,2,1,185,50,135
d529cda131c8099578ca5d6af6b87b85,43,44,38377,14976,23401,57,39,49484,16882,32602
c208e8a793ee58704b5caccd99cd46b1,65,47,93054,15364,77690,53,39,54188,18851,35337
6a9d4fa866c3e9abd6ebdc3f49f6bd13,74,58,142114,40447,101667,63,62,116141,42663,73478
8f8f433f129501afa42458f2e89fd28c,123,106,393548,93516,300032,156,131,515679,86889,428790
ec0d198e58749d738efe81c77e3e7049,87,65,138359,27704,110655,73,65,107045,24190,82855
36e5007b74ed9f8e54dac2b608844f81,186,122,423041,88544,334497,164,126,580133,83031,497102
44628ccb6505f46d0acd9b9cb15d7ed3,143,109,506765,78848,427917,135,100,398340,106070,292270
6db924629f4e126bafef55d6c8fe90a3,174,140,582015,99509,482506,141,123,461356,130124,331232
2a368c66d778750dd64d9a8bccf6d5b8,66,55,78365,26418,51947,85,64,124993,22630,102363
6575b6affccb26ed5ace9200c7ac500d,19,20,8401,2884,5517,22,16,5840,3399,2441
705c3809c9349ac365c61e0589be6ec7,100,87,131178,39744,91434,84,65,102248,29257,72991
a63fcfb034687cb226f3b74e06a34398,63,41,64295,14976,49319,47,38,37633,20177,17456
b6f107da412aa7df8a0a83fc84c72106,177,151,737791,139534,598257,177,129,849181,114049,735132
d204f5050719ff2a50a213b151077724,125,100,376430,88465,287965,127,87,339099,75849,263250
4496594ee3a769ad256df6b748033116,150,121,525246,100838,424408,182,134,561838,86389,475449
72b29135b1ad7125fd2cbba409533d2e,70,59,131973,46709,85264,95,74,169511,39692,129819
535e825100e933607afe7bc13e96affb,224,150,1041467,234131,807336,138,96,637971,114975,522996
15d356fe4dc3c7b3798163fdb098dc91,35,26,43704,12896,30808,48,28,40733,12937,27796
e2621a880ca5512529f3cc43da8a95b4,141,98,462815,84190,378625,183,133,627768,93132,534636
2647db06b3f4610c3fcf5d7d46473e13,29,21,13986,3818,10168,33,19,10261,4142,6119
1464b78fcce0b1712da1ebbef05657bd,184,122,808229,123100,685129,196,158,1117810,149888,967922
a4953061b2e63cb5f9f9b431a119c8d3,72,45,91644,29481,62163,62,54,100477,34143,66334
2f07807622682a47eddd5cf1040e28e7,88,68,179426,64483,114943,112,77,216141,43860,172281
8f82cfa6e8718b39246a9a786d4f3350,105,72,159783,35894,123889,71,55,81338,43199,38139
7cd0c65e97b7fa7d55d31d93544371dd,71,62,123221,38080,85141,79,65,129909,29880,100029
68aed75b6ec7720b2b068265876ebf58,119,87,352745,95636,257109,163,111,470306,81054,389252
1bfe2bcc827db62604a8f3c6567167b6,27,20,12508,6766,5742,33,19,19006,5648,13358
57a37a350e2f0587566cba007b3a10e3,38,34,44734,13393,31341,30,21,31029,9570,21459
27584a2007fb3d5f1b259828ab2c6cea,6,3,681,219,462,6,4,597,352,245
bc77f5c854b3247bf0177c403d3dc073,18,15,7904,2944,4960,18,13,5038,2079,2959
1227492745a8ef1369c075db3c05fdc7,147,103,401193,92209,308984,180,132,461529,73457,388072
048f6b3f764d7899eede74e4a38117fb,129,86,290182,51165,239017,73,53,159389,52158,107231
3d9123a3e30291a3df36ffea90bc8657,87,61,141541,26751,114790,123,74,167862,31899,135963
7af075e8b08647fcf8f4948ce14183ae,155,116,447462,87362,360100,163,117,448127,105623,342504
1b8446ab0d9c7170ec948b3c2bf4318e,119,82,282419,78286,204133,144,124,361145,82650,278495
ee5e11d15ae41c9233439e248d200a69,135,94,243563,94883,148680,146,104,410580,79657,330923
8f1d5926ebc40c9e66b9d59f4ee8f925,50,45,35982,14056,21926,54,44,45226,15891,29335
dd1aed41e4ff383642b07d8720bf068e,95,72,227636,97644,129992,116,90,354211,58312,295899
fc21aa63ee5e23723e519623cdceca26,70,59,115495,43534,71961,70,52,84276,38030,46246
f813aa931a0e94b15c03626d8d4a0658,114,69,393612,61276,332336,155,136,416695,66281,350414
cd8e5fd8ee1747b3f32fd6c99f1c8be1,74,58,108553,27410,81143,54,50,101471,24824,76647
ff1171f443e49c3e10001e291d03daef,52,45,66009,22835,43174,62,50,68829,23973,44856
25ba28e3c2cb46c15ea1ebc5b983f906,81,51,73865,23394,50471,60,52,54202,24222,29980
a8a456d6b75c9db664736b1f4b4565d7,108,81,220050,43006,177044,74,59,133388,37455,95933
c9911db5a65d9e1d98235c8ede8912b8,96,78,203469,65228,138241,153,118,328615,60269,268346
2f18c0a0acbb9ad1c6ed49a1a2d6d61f,41,25,37288,18452,18836,46,33,53409,14095,39314
8406ad9b54498a2581eef5c3262d67b5,159,115,408071,77032,331039,105,88,236733,107387,129346
4e07d92411699795be05adca80f113c7,133,95,308417,60266,248151,137,112,409017,64718,344299
992bf03653f77e86169720ca176fcd88,169,127,684337,105572,578765,174,120,425392,82500,342892
c984fd4b23283e49e2e1dc46d053bbfb,28,29,17206,5695,11511,35,29,16755,7251,9504
2e4e62e1a0e8e1ced3803828736fa57e,79,59,146066,49716,96350,99,85,234372,51547,182825
c80e52c0bdb6268abb02f688ea0c102d,54,40,97150,22747,74403,48,39,74858,20689,54169
bd09fc8831220628cb707dd64bb491a2,86,59,150331,27539,122792,65,52,153205,48252,104953
63e59eb7ac1e4a641a06c9aa6e31e32f,39,43,29075,9066,20009,51,38,34600,10393,24207
5f866db4c8d3e21373c6b8fa473f6a37,46,30,53856,12196,41660,28,27,34598,14432,20166
462e226edfcfad91e01636b5879d1f8f,37,34,28961,11273,17688,49,48,39257,12784,26473
98b4689ef36ea1712455974aa9800822,118,80,219966,34416,185550,121,81,161068,47797,113271
087b658211fd61eb211d0ca9577594a0,94,73,146102,46411,99691,95,72,170969,42705,128264
6cdc6f51e73b9fdbbbb769b1e1aeb953,17,16,3958,3626,332,19,12,10239,1540,8699
b001da755de57aefa63967372ff3b984,174,142,914088,158971,755117,187,151,840479,156569,683910
2d48d8cdac0a960dd4b336e2ca33d0d4,19,15,9542,3496,6046,24,21,10680,3842,6838
4664cbf1bbfb29d8e36eff5b4bc5cab6,150,117,463546,109717,353829,153,137,522842,125988,396854
63b50a06be72c3f05428d3fab8155d49,76,53,83417,28084,55333,59,53,104732,23958,80774
befdc216c517f915e61f30f465ddd2ad,39,35,34219,16505,17714,60,43,62714,15880,46834
ef3c9dbe8e9b5a7bbfaea0785ff9fc95,66,53,91192,32740,58452,100,68,129642,27745,101897
0b42d2ff6a56480ce5effc38bb1bfffa,122,86,278158,75106,203052,132,95,339535,80449,259086
b10bbc8cddec309993db5e529df71ca3,50,41,43911,15106,28805,72,48,81484,16090,65394
aadf2982b7efacdbe0e987cfa16107db,71,49,136954,61524,75430,87,73,173785,54486,119299
006f9deb0f20abbc1cb0a00f9d0c0dbd,38,20,30097,7600,22497,39,26,28715,8160,20555
60a26636865792c1709e4234e0d36517,79,65,100585,46104,54481,95,84,188147,38946,149201
fe05e053f638ffc25300ebad795a7c77,44,48,77494,21539,55955,50,30,52967,17726,35241
6a1fdfc9ccb367255b351f61da9d80b6,58,39,72377,20496,51881,44,42,54238,26707,27531
e5dd7033b4f1090901b15510793e9556,131,118,573564,106511,467053,151,106,404143,87316,316827
b3cd5ffceb7c13301179ae26e1b9540b,87,74,131436,42180,89256,82,60,148274,38079,110195
04df523a5953e288a2a69d04adec8332,5,9,618,896,-278,10,5,1753,382,1371
c6d9c2220857aa31d53c1a4af3bafdf2,43,31,46355,11844,34511,38,33,45796,16876,28920
2120800862147cf93645251b16835bef,136,95,292107,75291,216816,188,152,397306,71358,325948
324e7677d150316875726bd95adf671d,33,23,12284,5093,7191,24,23,8528,6455,2073
eecf648804b251dde5156adca1e9794e,191,135,774513,119083,655430,187,146,589465,151734,437731
09f33f9cec9823d04d571ad4622d367a,112,88,240766,32010,208756,112,90,193413,42449,150964
c31844d03c321af93aeeec4f2de52c8c,37,25,19280,10834,8446,33,29,26628,8740,17888
1ceed527e552cdd7a9e287f5dc07b320,133,108,381007,67326,313681,137,92,334322,66396,267926
2eea6d0623db8f5f3f4367aac5cca982,121,72,267355,50588,216767,81,65,146053,60696,85357
c50bd1bb943b806e227b1fb28cbeddaf,51,46,40321,17803,22518,47,36,35254,15986,19268
987f32787f0577baf25344070b1bc210,53,40,58714,24093,34621,44,42,59169,22176,36993
f74f3ea662b32113bae649d1b8b65af6,120,88,314747,44872,269875,101,81,161104,57826,103278
f14fa9b0bc38a7249f5a06f7ea51538d,51,41,80532,28947,51585,72,50,95101,18876,76225
5c00fa29df816b65b410023ba12a3a08,102,95,199018,62593,136425,121,94,236403,40380,196023
8b7d04c0719cbd96b66ff0e142d1d4dd,83,71,96718,30745,65973,70,54,83302,26530,56772
562694731e937d4e2dc18566bda39494,144,109,476640,71084,405556,194,160,514304,122285,392019
58a4e3051ac02d7a45083031944961c7,27,20,10650,6066,4584,29,22,13296,4909,8387
586ffb5021d8337bbf64661468d260c1,91,70,165038,48467,116571,122,113,214276,42612,171664
737ec8522fe3b9a959fd927e5f42dc3a,211,147,997429,243180,754249,207,146,714981,187297,527684
87bdda57776eba465d9b6abf1741aeea,21,14,3677,1227,2450,11,11,2572,1541,1031
17edbb1c6f58c4624f663864ee91d1c0,114,96,301414,67343,234071,104,79,218289,70704,147585
c1cffc8d7cb7e31a3bbbfcd78bd94e6a,41,37,43558,21285,22273,58,44,68604,21219,47385
3d96b25a6cc7f611277cc63594e7c53a,176,121,477605,119434,358171,153,122,511785,100125,411660
84aed169222d485ecb6785644086aca5,85,76,154016,33652,120364,77,66,130679,24796,105883
4ac45e6aa7cb97119dbeda2d951fb8be,90,70,183045,27545,155500,59,44,85058,31409,53649
c44cb9037bc6ebb0717e89b9256818aa,115,94,281570,53917,227653,122,83,233618,37372,196246
60b21cce17f89018bf4d74ec046dfb66,21,21,13361,6700,6661,20,21,11059,6919,4140
d59f7587cb6b2a0af43263ec6d972039,128,86,247026,41030,205996,139,131,246748,68519,178229
adc2e4c3f38fd01230a30a45ac6b3006,61,43,64627,25985,38642,90,71,119093,19640,99453
783ec3bab881fd58af9031269a83264f,210,141,947160,179722,767438,226,167,1051991,158112,893879
636ef235094781bf2a48ee5a443656ca,65,53,92737,21521,71216,51,41,53274,18299,34975
70116449acbd166239a885bc5e7f2a69,93,78,255581,54589,200992,130,99,300268,38331,261937
dd4bf190b8830e81278a9dbc1e07bd47,25,17,10199,3637,6562,26,19,16075,5356,10719
15fca716d57a9d405292421717b65352,82,69,125837,38076,87761,88,65,98805,27072,71733
409ad482476874dafb9998781aa2ea22,26,17,12403,4887,7516,22,19,12649,5759,6890
5f6c7fa5acc0f30716a96cf6f53f28b6,34,24,25794,9487,16307,35,24,25234,9881,15353
21122cfb8d58bbf7e8c20843715c6ac3,20,17,15973,5981,9992,25,21,21994,6640,15354
26218ea964b5ce6a9a3e8a134819e0ce,77,68,113062,46481,66581,66,44,114115,32006,82109
69ff67fed0d21b863e7fc0933fffdb13,84,75,152972,41221,111751,102,72,136637,42114,94523
2a984ef46a5c311a0279d24485a2c45d,37,31,21245,5654,15591,36,29,15001,8548,6453
2aa946c4e40793c63091a5ce08fffb84,130,107,285316,61938,223378,165,132,469733,57369,412364
c909a2cc1863cc5d5e8dc6d7266848fa,113,86,250366,103780,146586,132,113,429480,99304,330176
7befe4149bb2108628cc8607a63faf55,108,81,198936,57536,141400,103,82,191334,44702,146632
662478855719398c617f3d285a25dfec,135,113,419408,98972,320436,197,161,700976,98903,602073
03db70fc1c790b431755c5422c834ed2,99,83,213204,46020,167184,100,79,149383,38311,111072
0fc661fa21ecf8ee0cc00cc867a41a0d,140,126,305873,102997,202876,99,78,266569,63648,202921
ce5f7787d0b86a65dc6e77a6bb35748f,56,48,89920,27342,62578,65,48,99152,22512,76640
a49689f1c783ae5e470fe58158ad5a83,205,147,785536,103542,681994,139,120,515075,116019,399056
1b7e3c31140269e49be43c25eb5c5692,84,56,142848,33134,109714,128,115,235967,47728,188239
64c7003bf49315de5bbc6ee7be0781a1,184,122,591301,122732,468569,135,106,462899,116463,346436
dfe5389fbcbdf0080d7b7029fc8b4c38,36,28,30075,9876,20199,47,31,41713,8873,32840
3e85e4d32dcbf73b27b8b5e509d0c089,47,35,59517,24933,34584,46,33,58639,23634,35005
f547488c90fa5b20ccdaab358fb24162,72,55,113363,27607,85756,64,46,102146,27252,74894
5ebb4658e9c8f3bdfb1314dd6c4a95e3,165,113,372907,56406,316501,149,108,350166,55762,294404
f48a8aa46ea800e989016d5c4bdedb28,104,67,189824,65146,124678,114,80,178730,68114,110616
dbf184d28b44b0fb7f66dfcaed1c3c86,69,51,97513,18456,79057,55,49,48419,17883,30536
8203f5dc87fb574dd0ea0503c861060d,134,84,318092,63534,254558,95,72,193609,96008,97601
e0f18d58d84fbb01aba72a78856b14fd,1,2,69,210,-141,2,1,210,69,141
100b74df528c8665cc39d0f7cc90d79d,26,24,21600,6692,14908,28,21,24724,7045,17679
82ef75dbc9f3ecc481958c37b505d923,103,84,204009,33786,170223,108,91,198949,40948,158001
f932e26f0b75d6cc307a15575bdd255c,29,27,22855,6475,16380,27,23,31282,6650,24632
b1a97aa7e2840a77d2229c2ff89f1911,33,27,26414,4219,22195,27,22,13832,5295,8537
431328d53e6505f1c9897c7025a5a63a,67,48,73672,29613,44059,64,55,98514,26061,72453
0bd0517dc73faf2fec346138bd4b5875,139,102,366893,80650,286243,192,155,516407,59201,457206
9e9523e46b7cf1a3ae931c55e277e7ce,52,41,47882,12548,35334,54,36,56296,14346,41950
c8104863d734e0e8a78db97a06e7bab7,115,76,200062,55971,144091,141,121,289062,50159,238903
fa1c0283a82438a965bd7c5ac58ed09e,112,99,263245,83898,179347,135,118,290357,82339,208018
1ab771635859abc6562512db0d3efd47,63,52,88975,30456,58519,78,63,104183,29888,74295
81245c203cd4df0786ba290a78be9577,20,19,5347,4426,921,23,15,5981,3290,2691
d352c9b5cdfd1f4ccbbefd7e2f9a09ac,150,114,425388,81316,344072,143,116,414827,71302,343525
a8ba4dab414910ee0def88cafed1a112,214,150,616783,159546,457237,225,135,885544,140621,744923
f96e9b8ca9b35dc34f4d810abf5e952f,147,108,349349,67571,281778,129,95,288571,63412,225159
5bd8187af983992378c8cc3ee1a80b46,145,108,398470,84346,314124,214,157,685289,95780,589509
bd8afcb40ff7ebfd70218951c7908304,5,3,932,403,529,4,5,523,740,-217
79f8cd2ce9005e1393b633499902dcb6,7,3,1114,483,631,5,5,1680,763,917
e504dc12ae540cc006a6d8c05c7bf74c,61,49,77306,19586,57720,44,42,48309,20654,27655
3a58fa59971ab9308006f445ddcbb29c,15,12,6484,1673,4811,16,18,2784,3288,-504
5728818eef19e4ef9748c8b784179f1e,88,64,177537,43821,133716,122,93,221525,55919,165606
1146326f945ddea5d2d8c05ee11c7037,194,140,576637,87892,488745,194,103,490365,65470,424895
fa6f4884341ced41da64c7941077c006,86,62,119914,26822,93092,75,64,117218,26110,91108
204ae75ae8793e5643cbae9601834d7a,112,89,403050,77487,325563,144,128,508614,129797,378817
a4f74778383fd288838d68e2a094a999,156,125,542404,124878,417526,143,114,469038,124034,345004
bb0250891dc012ff1a926f7170e7b3ec,111,77,210241,60217,150024,122,79,227680,52093,175587
0840491a3e3d366adc7296b23d827f05,55,47,69809,20057,49752,57,47,53310,22832,30478
0eaf94362a1d7f862755519d22f19c2c,90,71,130020,43498,86522,71,66,117084,43474,73610
09590e1b8f1db2e05106f029dd425922,42,33,36851,14360,22491,36,31,24405,15166,9239
af8ac3cb3c06e20a5c2703fcebe3010b,104,77,170824,40364,130460,69,56,120310,34919,85391
b816b6ebb062054dd5cc84a54ce30ad2,137,106,303733,66770,236963,145,106,331933,66800,265133
926772f5baab4af9bb82c00198b835a2,146,131,414116,89241,324875,157,117,403368,69657,333711
5c62214b10643e294161a11cae83c2a8,110,93,281801,87084,194717,168,125,453092,105509,347583
c3713eae3ae590ec770daf199032da84,68,53,82644,27490,55154,47,28,61980,19825,42155
7b3cebbb6f9da9c05d0de2fecb64ed45,37,28,34439,11894,22545,43,30,36479,9181,27298
5e88982a0312d9a635908452c433da7f,165,119,567528,102149,465379,123,80,407447,92258,315189
bdbfdb86d788f57abc8e75e6c0af4782,126,114,351978,71546,280432,133,97,321633,74706,246927
032bcc64e32cfbf8f63f0de789b68bd9,80,61,137245,48249,88996,102,83,214004,34880,179124
48d4b7f9b75b801e0449357e09990700,34,29,25124,8638,16486,53,38,49898,10379,39519
1a653dabf5c9a92dc7bf44d4c8450aad,140,105,267469,55265,212204,128,112,294628,46693,247935
0d4e368391578765011b94d22493fd13,173,136,458473,88793,369680,121,99,296081,96301,199780
a52c3d78b8c99c586e8563313c933947,197,136,927026,142468,784558,194,142,841411,177598,663813
5f4ca28519ea5a9fe330c5073e292125,169,133,499600,57832,441768,90,89,263023,82536,180487
e57f8a594d15244d91359405be6b2829,168,125,480963,97326,383637,155,130,414100,141222,272878
0c5a0afdb472db52497e553c4ba9a438,137,121,272679,70262,202417,126,108,317358,57946,259412
55c5eb677d18f1358f64d8a0754ea628,41,32,44242,17801,26441,40,27,31066,17251,13815
49a95d81463c840076c4079657fa52f5,116,75,418231,179378,238853,161,113,570340,168628,401712
4448d4eb545f64f77683926968aca293,103,81,205575,61819,143756,94,57,151299,47383,103916
25c2d7f732973f57a75c8c86b1b391e8,78,49,93894,26511,67383,56,46,92938,36409,56529
d448e236d2f6d4f75935a4c8962f714a,200,129,836149,142483,693666,229,137,698423,121615,576808
045f7d30f53eca78096b034f56263a49,44,41,34452,13805,20647,61,45,55919,16315,39604
6543b3708220b1944757acf12a2f7501,99,65,258404,52703,205701,104,85,290022,74560,215462
8973a7f5ad3e2ea8a387e9ea38ee0a39,18,18,7525,5929,1596,25,21,12877,6639,6238
11c2ecca355317edb65e14553bebaf41,76,66,88311,37538,50773,96,80,123700,40956,82744
cd28f27320fc49f49873c6318557c674,42,35,37225,12675,24550,42,36,25904,13544,12360
aac8a8c4b5c6b20be7be76b5db82df96,156,118,530517,127022,403495,198,135,634774,108049,526725
ae2d62acd4bc9b8cd7383e0c32d8640b,100,88,199275,67425,131850,107,98,245271,56765,188506
fdfb452656e1ec89943ba48fde0d46ad,138,116,376785,72994,303791,103,78,222074,76791,145283
6f2923a0fa3a29d2e95652fe02aa734c,104,79,178260,56534,121726,153,115,320996,45309,275687
b4fb01bf075147c9d5276e7f1400e8ab,76,70,112865,24477,88388,80,67,108747,34541,74206
315c1b0bf5526e6eba6c1b0dceb0460d,53,40,67009,13421,53588,38,29,57760,12602,45158
180fb623c701a675a2636207a3071d27,26,22,11950,4791,7159,28,22,8454,5410,3044
3f64016d8cef3db84b898e85a40aa8c8,87,56,96150,28038,68112,95,68,119709,34157,85552
37aeeb3f6610d5a01c89ba9a74f2c2bc,91,78,235545,50918,184627,114,77,243569,35703,207866
fe8d0f3a02e49cbcc943220f6cbc8b83,84,72,121732,42469,79263,98,65,163717,30293,133424
72b75a24d44df692e67a3e0dd1f53ad3,92,77,166848,51057,115791,111,74,183884,60482,123402
d78b715728660113560e1d4f0721afeb,91,72,173092,49810,123282,92,71,176820,45021,131799
b0b0f5961fbbd85a5fbaf26a14f51e70,179,126,583223,127651,455572,164,124,558196,223460,334736
8b5dd72c6168f9c29faf94b433eb52af,26,20,19205,5370,13835,29,24,14707,7306,7401
d07013e8e075e051b02e2297720f9ee5,204,152,721787,175855,545932,152,111,660370,112911,547459
c3d6c39e4e5805a9cf99d0dc7a610042,57,54,90589,26754,63835,62,47,75416,32005,43411
49dd7416482c818175b5dd199fc99d77,25,19,8511,6822,1689,29,17,16094,4750,11344
3c8f584c3d16812b33a9700a280c1a1e,135,119,344496,71979,272517,144,111,349682,59755,289927
1772381a54dcef883d58b19f18803671,182,145,1061703,210251,851452,186,156,1142515,146363,996152
6a72c76b718bcc88ab64796e04540f28,143,99,375060,90498,284562,135,110,343924,76843,267081
a71958a14159571577a41c7c4ba7d2e6,119,85,356092,105798,250294,157,113,360358,84816,275542
0988244bfa9e46ef6ab9e3d14e9e6a1f,115,86,158726,26428,132298,92,79,117295,31255,86040
f0df3001f0a443f56a1fcac6c903ad8a,130,86,270001,42921,227080,133,96,236794,70735,166059
6b387b8fc8d7712ffafbfd10ec6ddf82,179,138,419367,103227,316140,166,112,436405,92956,343449
3108601a273e585a92425bfd7b9c94c0,127,93,285841,83450,202391,113,76,262947,89476,173471
f53a8148db1a4280b54c30bd29faf2b5,168,124,415317,119367,295950,154,124,440698,98126,342572
57c75d1b44e2acd33015f05f68c067d3,26,22,11789,4990,6799,26,17,10798,5601,5197
a7d339657b208d0d2878933f36af5ed0,150,103,340653,51293,289360,87,64,173794,79371,94423
e7c5932b127dea6beabb9e2c97883061,59,40,87234,25467,61767,61,49,76773,23862,52911
b4e34c4b8ef1e900944b1c96403808cf,25,22,12294,8559,3735,30,17,19456,4503,14953
04f60eed7e3d90c640456a35d33439aa,167,136,539035,118527,420508,226,149,627911,97910,530001
54dc3ae77360aed0f8de2c512f645ebf,21,24,9331,3234,6097,24,12,11203,2737,8466
5270597af1b1f6b7537e7d35d5c0157b,91,71,220272,58366,161906,122,95,314189,67459,246730
3c5c66a2266a300932cd9651b25ec60a,60,35,68453,15132,53321,44,30,52222,8789,43433
7419e2ad1c580f0ef66c6a316caa0c73,109,72,202665,25843,176822,130,105,265616,32181,233435
5bffdeeff23528f0c3aabf3996493fb4,117,86,257898,71458,186440,137,102,293308,65202,228106
7d5cdad9481e8e69405cf330bc10dd67,80,73,135172,48359,86813,86,60,123103,53184,69919
af64f5c61aaeaa2d252db15b7ae0af2a,93,72,191080,64780,126300,78,59,169749,66640,103109
b98a696c261117053ad3a0287e169f60,66,63,84844,32721,52123,63,46,104446,25100,79346
daf78b72dcc3d834c4959691d2d6c855,157,105,318370,69313,249057,109,74,261702,68747,192955
6b2f657851edb0c10806e5525aa0afea,8,6,656,804,-148,7,8,925,504,421
28df284fae7228e2c0f45e18c9ca5587,38,30,44552,13891,30661,39,31,36900,18011,18889
98c2582d98dd4f0a946d004a601d9b3a,38,30,19470,8626,10844,45,35,28538,7774,20764
75a6d37c37d11d50ea6556347fff2509,165,114,550479,154049,396430,201,155,806647,159131,647516
e9011ce8d3d1a70adc4b789a056a3e82,213,149,623806,84598,539208,162,114,491536,80549,410987
976ff006c596b0faa09db24b210c503c,15,9,2706,1386,1320,14,10,2246,1741,505
fabc8c6a56c38afac75aefb5b5b3de87,78,71,118823,41017,77806,72,55,112135,28116,84019
60ad3d9cbc5dbe004b93b6884c687651,111,83,186955,48717,138238,115,88,208583,45318,163265
8790245b253436ac4b73f61d821f8506,22,20,5179,2002,3177,13,10,6054,1551,4503
fbf3f24fed34760faec939642f904c2e,40,27,37246,10693,26553,50,33,51059,9673,41386
abf83d9b7cceee6d4b2df25004d7e11e,117,89,249185,46126,203059,145,124,309337,61967,247370
1cf9b4fbf21c3c329d8326b1285b6b8a,209,168,624267,98423,525844,158,126,537305,82134,455171
c34be8e42cc3e5f5d858838818792878,70,61,91542,30102,61440,64,48,74809,24234,50575
4315a550b5734ee9e3b08afefc459aa0,8,8,912,759,153,7,5,1576,469,1107
be0f00a5676db03a42488bca11ffb561,155,101,488675,91202,397473,119,81,386118,122024,264094
8939c022bc678ee830c5c7569b7329c2,88,68,201885,46376,155509,66,53,124023,52365,71658
cebea2540ab934ef4725a21ec7859669,152,122,408536,66754,341782,105,76,244179,57652,186527
88dfc6e70a0fc9d59c6a40367a592bf7,141,110,380179,61645,318534,138,110,312432,71744,240688
e73f00370c1f6b5c1afa957c3031f192,0,0,0,0,0,0,0,0,0,0
0f795b4191f8bbd3e4def16c59bf9c60,26,19,20581,9262,11319,39,25,25364,8765,16599
73959fa4f25c0f446a16efd445ee6630,153,106,522330,100610,421720,120,97,459836,118401,341435
2cf4732e6e810549b07f155b16df2960,166,135,654954,145172,509782,178,131,642288,141519,500769
3c65e981ee075db59c47cd8665479312,45,31,26763,14199,12564,34,31,22686,13227,9459
09f6e56f0649f3918e7cfd556ab2d869,31,23,19702,9972,9730,35,32,27868,10621,17247
3f69ab79b4bc14ee8aa47e141739851c,149,128,531823,109344,422479,156,121,499844,81029,418815
df4f27ca130a81584fcd833041052446,58,45,88320,24025,64295,70,54,78784,22776,56008
c327a208a82bfa20b6b2316341cbd118,82,68,178793,65786,113007,104,102,259971,50143,209828
d317931286bb4106d72bf23da5db832f,186,131,576947,119316,457631,138,107,445010,108831,336179
0ebbf523c08e8be19ca2c1b12406cc2e,24,22,13848,7548,6300,25,22,14200,6768,7432
2cac9e2e4b1c7a799eba7ff085a746c0,55,41,80595,33275,47320,61,49,85334,30132,55202
5e8d187076c059bd570fe2713229ea2e,39,29,40858,12027,28831,38,28,37584,14625,22959
e4fbeeabc70499ad8ce481edcd1ffd52,119,81,131447,31614,99833,95,71,106784,29475,77309
a9b7c78de418103a442229f171938e14,34,29,38201,14020,24181,43,29,41022,11248,29774
08bcd6f4ab8804f91a7acd8b5da5782e,130,101,372034,94661,277373,155,84,349079,56380,292699
eab3c9bddd8fdc0fa70ecff001430426,123,92,315277,62375,252902,139,92,358905,84708,274197
43a948dc3084a384258c21beafa2ae71,96,59,110353,25875,84478,95,84,134120,37396,96724
16779e1c5afdb51dfb74678699385a7e,3,1,737,89,648,1,3,89,737,-648
bf8374d14712cdb570dd67c3139df7f6,76,67,104016,36294,67722,88,55,98328,31175,67153
d0077959753c821c3b3fcdf000856a25,57,44,60829,20137,40692,66,49,55644,17863,37781
3564c3bc0bf653d996ca25fe9074481e,149,116,384168,69178,314990,128,105,345539,92131,253408
8a7d96fecb952cf9d981b60527abf19d,147,111,315905,65036,250869,159,100,326295,44895,281400
86b7ad54ecf3559459ef0f4f9e48f5b8,77,66,171802,55404,116398,110,89,256408,50145,206263
dc468993a8521381a66d09806fd79779,183,118,365427,98365,267062,150,113,405631,93957,311674
62c90b337384976229290a4f9f4bb774,165,122,512221,75787,436434,148,125,471181,88298,382883
d312241e21860eeb12f878219df9a855,39,34,30945,10577,20368,48,38,26432,13297,13135
ab6cf47d6e00bfd179f651753c432a10,139,91,271941,66182,205759,110,68,207960,61970,145990
c36199dc66a1ec6428c3f3d786feb831,160,105,342920,82101,260819,91,65,185851,78762,107089
df3207a6f0778337384b10ccf574c4b1,150,93,407802,83646,324156,157,117,516370,103337,413033
855201722ae0b1c10d76979e6e965335,1,3,69,780,-711,3,1,780,69,711
35250574e04aae0a39df4e09701f2eec,62,50,79873,38158,41715,69,50,127297,28228,99069
11325fadc2bb7274f5df0eafab2f4944,29,22,24200,6799,17401,27,22,18943,8026,10917
022052f1c2307779534a22c945abcacd,165,133,428699,137775,290924,130,110,482362,114157,368205
c956c9cff71c555d70fcf030b33d31b0,10,11,2431,1169,1262,17,10,1963,1044,919
4dc902c6bc70af8182ab95e302cb28d8,94,63,146294,52120,94174,120,84,179403,45320,134083
1818b3afa67224e4872a745521fa6cb3,34,31,25097,11046,14051,35,35,25213,10349,14864
61697dcda20d9e4d6c49267375aa6adc,32,29,18733,7926,10807,28,20,14951,7053,7898
8b4156fd2adb90ed09d11244fbc341c0,92,73,214918,46612,168306,105,94,227814,52205,175609
9eaf1f99041839b5ce7759853a4f554f,28,24,17942,7995,9947,24,21,15389,9639,5750
1b758bae764e241618bca68fb119d313,151,116,408245,69148,339097,175,146,483992,82816,401176
604939cb8d1c2e822325f9e06b0cd6aa,40,27,35976,20660,15316,51,52,71209,22053,49156
0fcca869e139dc6b6740aa66cb3cb1b4,39,33,52766,22746,30020,40,33,55694,16922,38772
3352380bed47321f88929952ba17ae3f,135,100,601133,125847,475286,175,132,529824,131958,397866
ce36504888b1dcbab8f6cd218a9052ea,41,22,23822,6595,17227,26,24,18455,8260,10195
ef4092b3083d1f9109dc9ad8a8951a17,36,28,29170,15165,14005,50,34,64035,17034,47001
49b086346133daa2ad05c797d08dce8e,90,66,175906,42583,133323,100,70,207426,39042,168384
218f52a4140820e1b5a88413e7aa1727,9,7,697,801,-104,8,6,1240,623,617
8439079cc1fe9974493858e8ee255c7f,51,41,30651,11730,18921,59,42,47198,9912,37286
f2511ddfd36a24e19f9e37a33be41687,153,96,400179,94290,305889,160,125,584283,93758,490525
832bccdb10276dcbfc91f9bae44fb5f9,29,20,11843,6038,5805,29,26,17432,6676,10756
119545c4fba7cf3861cb6a3519b6d30f,37,23,27500,11703,15797,33,27,26531,14871,11660
8db00c302f42685837090c5e10030ebd,162,92,363340,72737,290603,143,99,297659,73868,223791
13e2b6ff7ecee5f37375efa168207146,167,154,540990,89211,451779,154,121,453997,68674,385323
dea5a989dc974e6770324ae0b50486b8,131,89,347775,55685,292090,161,128,420606,73600,347006
05beaf9f29404075b137bd842ff8d877,52,36,41921,11841,30080,52,41,30475,15353,15122
67b65c3dff45eceaa3ba34201591e9c8,114,88,257114,54471,202643,108,89,232989,48138,184851
86ad943dfb0c90126b5523e4b1fcd4cf,82,54,144213,39677,104536,132,108,265921,50524,215397
48d5cdc2ae68cb9c77cb833f8ecf94f5,45,39,46196,13957,32239,47,46,40382,17539,22843
0c9621a7d5a477f850e8ac8576d815f4,50,45,104173,35915,68258,67,45,120531,34421,86110
c1da25f3ebc12a8b84af072f660a3afa,25,14,14804,3235,11569,25,18,8948,5740,3208
f31ced5f6af49d2a3cb71d1674673cdd,34,33,27300,8513,18787,38,25,23383,6759,16624
58595bdd660f01ed85b5d244cefa3d78,144,99,269935,42321,227614,117,78,208180,57395,150785
bb1d5302f7278271decd3ee42dfba469,44,39,48163,18678,29485,59,41,69253,16711,52542
c687d78218f1cd205b8087c15dd1671d,113,96,223000,65456,157544,97,83,140768,43710,97058
34753c8132c1f0cbd8a73b926953ed4b,93,78,170805,48025,122780,112,87,206419,33456,172963
8de73922b47f03d5023ae2e54b4bae3a,38,30,22072,9789,12283,36,28,23793,8471,15322
abf6f045f6fda72d15814e8c1621f9fb,59,43,109070,24544,84526,49,50,67683,44304,23379
4ed09e0015a3093e98fcb0cdc8e6ceb2,232,179,1708487,362044,1346443,182,141,1616689,259828,1356861
592951d7b3579621bcc8814a82a5a348,126,86,241518,81877,159641,151,102,285950,68795,217155
39843f7644260836a797107c530e1030,63,51,83269,23986,59283,107,82,152426,30692,121734
16e3b1bbd14768ed2ec1824fc60056e1,99,91,240714,54253,186461,110,93,219944,44949,174995
ef5aa1dc54a34b8e1e17cd7baf7e5d06,110,103,259100,66594,192506,119,98,261568,60597,200971
670382732bd7fcf523786dfc64428f9e,136,105,397008,70015,326993,162,120,414134,72222,341912
80cea3ccdd804d51f1fb158a53c0b0b3,77,52,119003,24223,94780,79,61,86774,36083,50691
78a60fd5d4f6e1f7d3cbcccf3eaa71d1,138,100,329987,80095,249892,129,76,320631,81092,239539
69e27aea9f29430eaf738aab6c79de4b,29,23,23226,7045,16181,26,19,14061,6579,7482
87acecd07b504f5403491d38203b8ec9,141,106,852210,169820,682390,217,157,933415,128213,805202
220e66d0b9a0e7a2ef472e07c50c7b13,9,11,724,381,343,13,6,1701,186,1515
380ee04cf9e2298fb5431dc55ba174eb,41,33,33117,16362,16755,55,48,71251,16493,54758
4e110441063fdcb44473c1fed414fbe7,100,74,187693,74569,113124,89,77,214941,57667,157274
238c3f63281ca4d627f65733bbf1ed01,43,29,39079,6634,32445,29,23,13174,11346,1828
dcb605366ea747f6cd97d99bf7097707,138,97,464026,146226,317800,159,120,478731,141065,337666
27805f9316c1e06550935830d728d6b2,101,69,133643,38985,94658,117,74,175045,43565,131480
b8fec0001e25fa300bcd9cdbbdce24a4,84,74,252194,81712,170482,123,110,347544,59832,287712
696a56ef9cc8363ca4f4ab77fc6ec8ca,50,34,56268,16035,40233,58,51,60823,20766,40057
c1eef51f7dbf542ca9f808444bbfc84b,70,48,77727,19123,58604,68,59,75743,17358,58385
50c09364b6f33c38cc3e2c074281accd,85,62,199955,63125,136830,115,88,233281,70844,162437
02cafc3c90c34100cea408a6036df3da,121,97,346888,100901,245987,161,126,479946,77497,402449
b9414c4c9a75a49d3c809440e401de72,136,101,280196,49629,230567,107,85,214170,56466,157704
81bd9d0a10c8aaaf3f3df680a0c09e42,60,45,94279,21996,72283,58,46,79283,19895,59388
dbfda3c9ff0c4f067f999346437cf428,161,120,432779,118933,313846,146,122,435909,83014,352895
940dd0ab9595949b6a95661b9ec80b46,31,26,18849,8443,10406,29,27,30739,9417,21322
5612a1c0f08cc556864aa5fb567870d3,124,92,393016,93807,299209,184,152,565699,117153,448546
cb9ebb8d12b3463425cb9a476a287240,36,25,18819,6992,11827,27,25,13180,5488,7692
f8fc6d1cc2db30d4ea1b5bf2ae1c87bc,36,28,23455,7319,16136,32,24,30091,4384,25707
558df91290184c093d2e3485ff15bfb7,44,31,34175,9365,24810,55,41,63610,13840,49770
973380fa01f8956954951ce9be592f79,77,71,178752,60815,117937,65,59,128928,44901,84027
ad1a78b800bb23fbc9ee3e815b311ddf,43,32,30012,17108,12904,47,35,36105,17640,18465
ae75b88407a5723d4a47bdeeb860af2b,87,63,106866,30774,76092,68,49,109967,29658,80309
b5d8869aae0330d47b094d5b7a353528,49,39,104058,28229,75829,72,51,149905,38557,111348
2b858b7bbfe59fdb5336575ac8975eca,172,132,623100,91038,532062,149,116,542979,124963,418016
d8c56aa355a3069b1c5e10302159ad56,94,73,129438,27981,101457,67,50,105193,28479,76714
a0670f0783d5db7491268ac13207ebd6,31,30,39637,13303,26334,33,30,34223,15186,19037
faf45dc2632be6b2353d5c9e2132cd39,122,91,355228,65104,290124,114,95,343456,115486,227970
357f486d095b9f1681b92de8af8b67db,31,21,10871,2747,8124,23,20,6980,3965,3015
e0fa319200b29cdac65b2c79a29e0f83,145,114,405094,61326,343768,117,89,335765,51369,284396
76ef9da4f1f60d1c3164686a79a098c4,52,50,49743,18370,31373,47,36,40976,15479,25497
901482d423f3309ccf7939be0c08562b,44,28,31673,6990,24683,26,20,18234,7895,10339
175666bc242c3ebd66f5827488579510,48,36,46847,16450,30397,44,37,44824,13593,31231
b0231fd251ff9b2001721e24ceb74a27,125,96,293806,87612,206194,109,80,290836,79996,210840
c305e61beb630d18d199d869f665f0aa,41,24,19795,6243,13552,37,24,19485,9508,9977
8fb7392575e94e8c3ee3d6abcf4aa55f,59,42,91268,17781,73487,62,46,58189,23664,34525
f448df37884c5fd95fccf8b465c427de,135,117,506841,104015,402826,156,132,516302,115743,400559
fd3368fd96192212df1c2e8a2ae3d4c3,77,73,118389,29338,89051,91,56,96093,30466,65627
3fc5f0db5fbc91307b95cd1ef898a684,128,94,320438,58841,261597,131,111,294364,89328,205036
e56d626a09bd548d1fed67befcc4b570,39,33,28720,8739,19981,39,31,31416,12890,18526
536b6c31307470adab7bf6c537ff1ab1,49,41,68881,20097,48784,44,35,44083,13923,30160
20d0e65925b9851781015fbddcd88d46,115,95,303528,57459,246069,134,101,375600,50997,324603
5012d904dc31ce7e4e5a68945bd2b290,165,115,400685,113596,287089,105,79,326446,82877,243569
31606bfd202fbbe90c7c7b967ab6c953,178,121,418089,105067,313022,118,92,348080,101998,246082
9d16c0103ccdcb0186e0706826b5c320,257,179,1866943,254081,1612862,226,148,1104279,247485,856794
7a3be22ac4c5deb1dae49d56e0182462,31,26,21947,9383,12564,30,23,15266,9475,5791
6dda12fe16b646a21155ace787a44832,138,105,279047,63175,215872,113,89,224795,48713,176082
670f1693531e520833a2c907c869556f,35,23,33511,12155,21356,36,28,37267,14589,22678
2907356ff490ecf79007cc9bf2ebc9bd,106,85,255817,64189,191628,137,77,284270,46662,237608
f1d96062c1d0e161d64827378b26937e,34,24,20572,5230,15342,23,20,10828,5106,5722
e2e8998245bca588e41b6cc1fe17b390,100,70,180025,45882,134143,85,71,146418,62656,83762
64b9983b3132048f9047a2824345c15e,151,116,470623,109229,361394,158,104,461475,82562,378913
0c66247d0d075350b39c0a6f6717aab3,122,97,365799,119614,246185,177,133,562053,133465,428588
2eb4af92bf07a3f4593d9616cccf3341,32,16,11727,4808,6919,24,23,9056,5567,3489
d3282591bdb6b65504682eb504e1b902,165,93,431622,88432,343190,165,94,344496,103292,241204
8f96c40350e0114a5b5662a52dcdb455,5,2,350,204,146,3,6,302,359,-57
fc0ca2067d0c92452992df59813846a5,47,29,69515,12416,57099,36,27,41470,13531,27939
fdb2f5f0ab90110c0a3383cb79d2b7df,20,13,5563,2512,3051,17,18,4695,2887,1808
178f91875f7f596863fe186bb4ba683f,184,123,439411,62792,376619,112,92,211761,82779,128982
e5bc576561d6f35ca420dc24b7facded,25,18,13296,3021,10275,21,23,7447,4996,2451
4caafc873e1dde208ebe1b64a9a49c20,47,36,52642,21436,31206,52,43,57222,22528,34694
c9f53a8d9b504abb6ac9cef9ff4c6be5,120,71,218416,64962,153454,99,84,176830,60382,116448
8ec3951785093c2d07f320befdf1d8c8,100,75,255367,90728,164639,127,91,308151,68925,239226
b15776045b7df33bea96e05fff4d878c,27,19,8718,3619,5099,26,17,8942,4048,4894
b9bd0cd0bdd6f519069fba7c02003cfb,50,44,42912,15603,27309,53,43,32137,17197,14940
bce47bbb8691e9a2f1576ce85e3ef70c,39,36,34345,18347,15998,51,40,73446,18368,55078
ffbcee4d8d3bc146525e94426ed89cc9,145,122,330374,77894,252480,153,116,380105,77624,302481
7f62d31691e1eebb000ac0841f31c8b4,25,19,18091,7425,10666,35,25,35370,7292,28078
d6f77644c6be3a5ed8ed33fa406f76da,85,65,124543,31192,93351,86,56,103020,28421,74599
4228ea0474ec70664010fe32b5d38ef4,24,18,8034,3509,4525,30,21,11500,3562,7938
5e87a67c9d0ccd2fed5d78ba6e33615e,172,133,716218,200419,515799,200,155,915168,184624,730544
23c82af9b727c960cff55799af64615e,22,18,5258,2594,2664,14,17,4173,3074,1099
0996523dcba40ea394553f203b18f451,126,99,231177,46473,184704,92,79,136548,52361,84187
8e41482b016f54a60d3e1c494bcd2696,54,35,48692,21454,27238,70,57,87615,19119,68496
b844b15dd0911f4121867caba9e73adf,18,11,3664,1338,2326,15,18,4827,2124,2703
315377b46dad6362e38eb46bacdbe049,136,101,450998,102479,348519,148,92,476433,71269,405164
df736ff71af6386c8dc2f7d482b15072,53,33,58584,15107,43477,47,35,32411,19538,12873
b7e2d78ef1c4e6e0cd41b43e8a12e0fb,35,27,35339,8980,26359,33,30,23074,11302,11772
37aef45612a3c9b221ab835656b2b53c,145,120,476953,82525,394428,129,94,361461,92229,269232
fd32cabd1076465c05bc48af9cc6e217,87,73,150694,31788,118906,81,72,120346,36675,83671
f1e7546c92aa37f01eb7b92ffe4db09e,31,24,20292,3383,16909,25,26,12503,5164,7339
187748988eefeb11a28d510dd41a61e4,87,77,194108,55674,138434,110,83,210140,56048,154092
d99ab7b2c5927450de1a663de3a942c0,21,14,6982,1738,5244,17,15,2776,2634,142
f04a2df4b1f6b17bd23107d4c21f15c4,27,21,9356,6204,3152,32,33,17538,5561,11977
c76f20b2b8d6e5950a62087e8d0a6901,224,152,1298031,224928,1073103,249,147,1152492,224618,927874
3c055a2d5fa4980dd6b9bce6ca9b992c,71,55,107426,42030,65396,101,55,138520,33221,105299
4436f9d06d59f076b5dfd91f4452ad3c,38,25,33120,11899,21221,31,26,45954,12636,33318
45d0970c43ed53efff673983c08de570,84,57,169729,47375,122354,108,77,179362,60989,118373
e45289f6f62495fdfecc0b894b01dbcf,132,87,226434,36162,190272,99,65,192725,41735,150990
2451c446079f7cddf3928b4e3858509c,79,48,130727,34595,96132,110,78,176735,37615,139120
c369d1ac473a08cde6249f5c1deb7d6f,121,95,340901,66988,273913,135,111,381602,97991,283611
205cd47dc6a75b7dfd04328808626c8b,47,35,37387,15443,21944,54,50,52419,17490,34929
32565c27747ef2a464b22a2dc9d6b497,115,84,146215,37814,108401,97,69,134675,37591,97084
2f482ae252e8046ba80bd8595daf736c,53,48,37536,16788,20748,52,36,38095,17991,20104
0080cf7fc113814c984a18007d5260c1,55,46,86183,29124,57059,48,41,70775,31767,39008
e052d689e6acaf002da4d30427eb349d,118,79,240195,52934,187261,119,83,250056,42476,207580
e65a0eae10c6cb2d95c81a138faa7e03,67,61,100083,30092,69991,49,37,63316,23123,40193
e9b8bb76441a004c382cbadf88415ea9,123,75,346220,118966,227254,227,108,606296,59927,546369
5b8e5da2d9e3f85d4ae349fa00ae72e2,73,57,96990,33675,63315,82,75,184149,35189,148960
4838b5fe1974520998cec401e735d29d,42,34,48438,18953,29485,50,41,74396,20339,54057
e619c7054e1e4be89cb54ffcced124ba,106,84,236964,74605,162359,125,89,260854,47964,212890
743a55859ef0be0fff79d596a0ee9cb9,129,95,238396,43849,194547,119,71,200709,41488,159221
297296a75eaae6084d40ee82a9756a1b,62,38,67597,18332,49265,46,33,46436,22645,23791
849a3a172e3432947945e0bc11de8369,39,27,46287,16160,30127,42,25,54593,12873,41720
d6c9da9018c5032d535da21066c1bd7b,201,161,674843,143557,531286,160,120,927149,150099,777050
f74687116d1e434ec20780003bbde8f3,142,105,395368,106267,289101,130,97,497679,96848,400831
11c8847db9ec2338f197a397a3b6f43f,3,4,408,738,-330,3,2,590,260,330
b235760956aa8318f7c9bd3938511329,104,83,189957,65532,124425,107,82,191273,54793,136480
ebe079e33aa635f96d98f58b022fa72e,31,28,26411,9907,16504,26,21,22403,7150,15253
1c5b1b83529f797a59b37413aeafd1e7,143,113,447074,118730,328344,129,99,414415,108990,305425
0cc6e10c5595da043660a3777d92e0bf,56,50,48030,27016,21014,67,42,67046,20952,46094
d354be25469dfe9b591e7cd85c1baa9e,165,117,820496,214103,606393,201,142,795283,184827,610456
5f9bf1ebb871309ca1a26ecdac06bd69,44,39,43334,26054,17280,56,34,68856,19331,49525
aa0d64bcea8dcfb674f2d340c239a2a9,39,36,51219,25336,25883,40,30,47217,15730,31487
115a310fea76e93c83e81ac691ccb57d,154,114,467779,128820,338959,164,116,555734,184947,370787
d8e8b1fa5af9a75a05ab98a5ebdd589d,152,107,449792,143700,306092,133,118,571831,104191,467640
98f72b2bec75b9475a599cd8d13c063d,68,37,73789,14531,59258,51,32,45716,15231,30485
040d06b6fe6c38bd0a259604939a66e8,162,107,602295,96627,505668,209,159,956500,98732,857768
c2a6b1f3f54dffb7300aeb1a62664714,25,21,7231,3372,3859,26,20,7509,3586,3923
c1e63bf1969e5e23909d27e1451415e0,80,61,176408,45704,130704,85,64,171162,48497,122665
f90cb3d8ad1080cae1f13385182ecbd6,26,24,11913,6905,5008,24,21,12496,6261,6235
66b0d561ef429d439dc1ad7c231a252c,78,53,119902,32478,87424,78,51,92826,27781,65045
c64d09ee450bc2de10746fab883265ef,52,50,43561,15648,27913,78,55,71781,12465,59316
d281a6f8bac8d7c38cb2caaaefda6d40,41,33,32581,7915,24666,29,23,24069,5041,19028
d2522b9719c789cc14df4dcfa41ca577,54,34,76255,22865,53390,60,44,60311,25318,34993
f4e49726be80e0da6c429172e42baaa7,81,55,116580,30119,86461,50,48,54953,44834,10119
4c2b9181809c8efbdb747334fdb8df3d,94,72,179130,35565,143565,80,67,112429,44242,68187
c6ec8f8d25877246a35bcfe569e2c52a,27,24,11146,5622,5524,29,26,12601,6275,6326
fa13315eadb4bacabcdb848d0eb221e3,97,89,180350,60834,119516,70,61,164055,39753,124302
ec2281ab3a571a172690e7c30b2713c7,110,92,244608,61270,183338,126,101,261054,63565,197489
a7dd3b138945be644092876d91aaf82d,142,73,239354,41500,197854,82,56,135732,47668,88064
2c1b7a10241eca1449914b824810080b,168,106,457619,73054,384565,134,93,355273,71364,283909
f273e67eb02e527f3e7132ca931ae056,167,93,423381,40767,382614,117,88,227728,98313,129415
ed28c0fd239572131a0080d1c612e39a,26,23,19960,11113,8847,49,41,49665,12369,37296
dac0c15904dd1063e011cb7d7bf9afe4,46,40,36489,9972,26517,40,32,28903,11233,17670
c65405b3f1e70804090e498a7cfbd833,87,82,155932,49314,106618,66,53,127440,35396,92044
0e39019565097a00181d2e79eecbf35b,126,93,356062,46425,309637,137,114,340602,59564,281038
d04f53bb45c8219b16b6d7489b749809,215,176,1258681,252185,1006496,189,157,1313816,193522,1120294
2151ad4d1d8c40d5b0b926dd023e7dd6,145,102,384260,125476,258784,178,135,654723,117226,537497
0a495bab068b82f8ba116904a8f4f92e,144,107,358075,78449,279626,121,101,291642,68406,223236
882ea4d5d285e11fef26dc07ebb2f1ca,128,115,311274,69483,241791,113,85,311807,68556,243251
dd7a55b2201c353a21ab66a3181870ab,154,110,797429,156748,640681,204,150,953350,251757,701593
0f8a78d058b1988dfb4dc26ee0f7a833,196,128,667805,127436,540369,167,133,509908,128198,381710
6a312c56ec75f851a839b6fd74c02c51,0,0,0,0,0,0,0,0,0,0
90f779d7fcb777549c983aa5f1fabe14,88,66,170549,59432,111117,112,78,219276,62558,156718
17d1e838d6fa6c76b03f128874405b25,121,92,350116,50026,300090,101,80,254944,50797,204147
7269345334d855eda5fd4ed4ccb7d3e2,109,84,284739,73761,210978,97,78,227087,73628,153459
11156840283e83c91913b4e34d567d1f,50,39,79737,15108,64629,61,42,55921,27644,28277
bae22f58932cad77883fcfd493ecb3b2,194,138,722365,99484,622881,120,79,465899,114558,351341
e7a925c40a66c23a5263322457b39899,135,108,502266,143128,359138,138,106,521193,153481,367712
254b8359bf032cda9861033e7f83559e,97,73,172900,41653,131247,98,78,160249,50524,109725
ea2e0ab08ffff718d13a2efab2239e08,29,19,20895,6694,14201,24,18,18772,6410,12362
6992140d8ab2a15716474752b93401af,70,57,121779,25836,95943,54,37,70652,25362,45290
06c78c978c33491e583a0d1429b6f434,11,5,1235,780,455,9,9,1351,1025,326
ce63a057fdc3db04c04775d6aa304ef4,147,129,411388,68553,342835,102,85,223497,64529,158968
a0dfc63ab5999453d07bdc64f2867e12,129,89,352782,76467,276315,113,87,285624,87009,198615
4da17693fad5a323bea33ab3f317fdaf,154,108,568954,85555,483399,176,114,498074,77566,420508
5a3da6703c51e8ce43ec96f1096ed5c0,16,18,4208,2849,1359,20,16,5122,1994,3128
4e7dde296b75b411746cd8d316108dac,141,104,260431,68876,191555,122,101,261783,60053,201730
2f9aaa45c1fac6d2a99cb1acf1c4d9e0,75,62,121532,31303,90229,62,51,76234,45467,30767
bb51345147995a7ae3eb15852d05a63a,64,57,108839,38356,70483,86,75,127641,35480,92161
48c3ed09ba0b44c5bd2d7c606e1fbccd,53,44,57340,22405,34935,57,52,53853,25042,28811
63e69769b6978ab5134c735153315156,108,87,237230,58967,178263,124,93,236847,66505,170342
3058bafc40b4c847cb60ac8801bad6f1,53,48,77384,27231,50153,59,42,71693,18271,53422
86e8991df3fa8b1f5fc79fd4676bc1ce,196,136,545293,197530,347763,214,120,580822,82851,497971
ac5fde5c642b2b1f7953ae7d634098c8,27,23,21131,6945,14186,27,19,15595,5088,10507
6abe16ef36c844e78452db8e404381fc,187,147,673942,122032,551910,188,119,742474,80940,661534
91e345f1258e969055bb30c5e70602c7,127,91,318304,82881,235423,127,120,423927,87867,336060
1224c7328d7f694e0a6b407249cd0e07,197,125,651273,88909,562364,142,103,519352,92812,426540
b501b0377f0270d516d10e5e14324427,69,52,73753,22069,51684,62,49,69052,22299,46753
44a83a5366a021c75c8508df199704e5,215,141,1038981,165349,873632,200,150,956104,198572,757532
85b335513ed1a572eb2073df3bfa7552,66,52,79799,41160,38639,95,67,136520,36094,100426
3dcbcf45676663368ad931d2a321b1de,79,69,96868,27319,69549,61,44,59829,20357,39472
133ba01f1b65326338fb0650064a6205,94,66,147416,38045,109371,100,84,128049,51615,76434
865dfac002706fe85d3e68ed12b653f3,86,67,145565,33288,112277,95,74,118875,44019,74856
14d6c690870f2b7d72725da0559e2a8e,86,61,130921,52456,78465,84,65,154192,36165,118027
897d43d5385bc5f55146b15e43ccc17a,152,100,313682,57620,256062,137,98,317187,65928,251259
1d3081db87e7d56199f3e578b5fa4e21,68,55,95244,35357,59887,81,61,144186,30307,113879
a9140ac7dc8e9395b45ac1e990e8ce46,84,54,155019,66164,88855,126,83,268945,51132,217813
892b8a9da960defa8ba9cf35e330d4ff,65,44,88700,17223,71477,96,84,123885,33013,90872
6c5fcec6fd0754a9d785ca8947a22c05,67,59,122216,32604,89612,71,41,106174,32468,73706
4d3d1734dca2407afd1b06ae3980f020,38,32,35249,11703,23546,56,38,40160,16753,23407
9c137ea5883ea8cccf7006d16a2cd9af,76,49,101591,23640,77951,63,43,78573,20322,58251
93cbf5cf746002aa94177f5dabe23407,9,7,1442,1136,306,10,8,1651,1250,401
31c4e2f53e547f8148cf9581f2fad0bb,63,44,75003,20116,54887,69,55,89788,21270,68518
dcc1c66035a165b7b5ef715de97358be,33,27,36669,13034,23635,37,23,45043,8854,36189
00e9af0e83db9f7d51492a0d6c3ca02f,126,109,303624,69608,234016,140,121,377018,58245,318773
4e93074caa5e365553ad07307c8b4760,81,55,85968,19701,66267,74,50,67095,20178,46917
03b8a063cc84f4eda509b927720e38ba,61,47,81630,15841,65789,90,54,92739,15651,77088
bf94b0a37a7787ce416807dfebdb8ced,14,12,3227,975,2252,10,10,1386,1817,-431
2d7a4b01fa767abdb6e21a1adaae194f,25,21,15253,5312,9941,31,26,15759,10873,4886
437386d2614fdaef7f58e35f43571ab9,38,30,32102,15038,17064,35,29,37239,13748,23491
b84a879a449ec8c97151e3b738d3f777,105,83,222211,68059,154152,126,109,300733,83746,216987
c2106e1f6bdfdab3361c43bf3fbe14b3,26,27,16802,7012,9790,30,13,13584,1589,11995
47bd8f6aace15b77f440d8146759818b,34,28,29006,14194,14812,37,26,29682,8760,20922
1ee26a522319a9fb68b05b76fb4128c0,155,78,224777,42344,182433,121,76,208065,44470,163595
913b4b52a1dc16dd2600ed1074134250,52,39,44581,16127,28454,54,30,72382,12822,59560
02fe8504ec2784b9635eb70abd98b975,29,24,11998,6104,5894,23,22,9876,5778,4098
ceda6ce5ca815de238807ccd501d90bb,59,45,64296,18075,46221,50,46,34053,15808,18245
2ffd4c60bbeced92aae06022f2a5005a,59,45,72770,17867,54903,58,41,78136,19284,58852
328f94fe95b5e3cf8c8077ceeb57c3da,17,14,5689,2460,3229,23,13,5529,2167,3362
87169e0052a98e224c6876840fe3c11e,163,109,516744,74721,442023,194,144,655943,110377,545566
cd8c984f1f94b5b05470521f517f2f2a,44,34,33859,12141,21718,38,35,30207,11691,18516
bb003a44515bb6194e47a57ab560414e,88,64,103172,28827,74345,88,74,151124,30296,120828
5a2a5f17936bc90b43babc98f005d73e,169,131,600275,111969,488306,155,116,509985,108415,401570
42ea8f5e7b7b03d84528ac0684700471,100,82,230409,60596,169813,143,114,319613,51858,267755
ee8f3653f12fc2eec1dfc79d00927915,26,20,9068,4575,4493,28,23,12345,4626,7719
5786f89b93b99a67fd5c8af8328f1b67,6,6,1448,303,1145,8,7,1275,585,690
7a3410b138d33979207a6d42199a66eb,146,117,397820,78727,319093,164,129,477608,70981,406627
1d7f6a14fe8c63652decb002082f7533,182,144,726818,169290,557528,177,134,754264,180802,573462
8fdb94a6b4767b9507b5fe66eb1b8ae3,139,102,295692,91337,204355,140,89,281954,97119,184835
9cf6074015ab2e1331ee374ddc1899e5,51,43,40762,17807,22955,51,31,64892,7491,57401
8952edbe371493b63f779207f985f60c,3,2,251,115,136,1,2,83,219,-136
5f512dccc0049b7993edcc56fe01664e,76,69,151296,25669,125627,79,46,89221,17821,71400
659a31201e240310a4308194cb4908d1,140,112,470287,80174,390113,174,135,514771,96370,418401
d4641855313514d7eaa528c74d5ba688,33,24,23154,7129,16025,29,31,23750,10049,13701
a8ae84dcaac045d56f98015091a13530,112,96,250393,82639,167754,127,98,374650,67993,306657
8dfb158ebde6fab6e4a5483d860ac47f,150,119,406501,65490,341011,128,100,356078,73099,282979
c1a7b16b4241ceb7e4de722acdad169e,120,101,303144,99912,203232,141,88,298894,82630,216264
ac5d49acb24b38bbe7858bc3a320b5e6,98,80,212410,66620,145790,109,95,218067,61088,156979
af630f8b3d2cabf626075650daed9e49,26,20,7270,4886,2384,24,17,9870,3731,6139
4e05e62e654512bdfe8617cc6a617256,12,11,3445,1278,2167,13,10,1820,2717,-897
e998a523d726c861d121f90fb81296cf,42,31,47442,12150,35292,50,35,42680,16049,26631
4a66435c72b3f7f3527f16f4f4919d6d,121,81,197017,60648,136369,102,81,170925,57862,113063
a1e82340dfba80f161a74cc11608aebf,73,57,116678,40546,76132,55,42,91339,41830,49509
e4825ab2e2e273b779b0f0074b5d9ad8,43,39,42311,16962,25349,56,52,59727,22214,37513
cbc625c017ee3712176121cb767aa6c6,114,90,307964,92988,214976,152,114,411129,78272,332857
750a2f1bb352a4a5ad5b20e3d485f7e4,107,74,231471,63075,168396,130,101,323679,58195,265484
93856a750aac283f5dee720d5940f6ac,179,143,510651,93906,416745,106,77,293388,72613,220775
6a8432b9603f7a894319f851a7587b90,54,39,59831,18663,41168,44,33,51474,18439,33035
e2cd6187fadff7124fbb46f8fdde54d0,178,122,361628,80463,281165,179,134,440831,109112,331719
6df1ee839fe89ef94bda129975db880b,26,23,10219,4047,6172,28,20,8346,4268,4078
c6172814b51f54ff0edaccfb86618664,37,28,40986,11601,29385,39,27,54688,14313,40375
714acd63786425d13ac4d6876ee9197b,168,118,712093,128195,583898,154,124,544832,211923,332909
6cb5d130b4d125177bc4160dadd08513,97,65,263745,60413,203332,76,63,230789,33938,196851
237cd9af975b7906ec1ff9641c9ab6bb,61,49,149425,50434,98991,64,52,156661,47592,109069
5e796e94603a630c1bd7cdc469f9fc1f,46,38,31687,9497,22190,39,34,23124,10357,12767
4ed2d137564080ac3ef0c8911c209bf4,136,107,351009,88733,262276,148,127,492798,81085,411713
4b04094fb2429d30e42b29c6716bcc9e,198,108,692832,125820,567012,164,121,772723,120362,652361
97a7a69a19eaf9c7460c57c74172d105,23,18,11385,4278,7107,22,19,9663,5814,3849
2d4ab643ff8bb44ec6f8d940b56bde92,87,67,145990,26612,119378,91,75,135870,33834,102036
4acddd5b982a9ca869245320ca555cc4,66,53,101743,25800,75943,95,71,134439,28528,105911
b501d3c6a71c475be687b47e0c53f591,27,17,16641,3834,12807,24,20,9047,2998,6049
b165ab98deef6ea9499e92050f408486,51,50,38492,20286,18206,45,42,48487,8059,40428
8d50695967712b5427085bc61a2a1cd0,155,103,393564,45173,348391,145,110,389448,77941,311507
8df83a345c8c3d2a5b8ead8f092581f6,92,72,200668,48738,151930,75,62,162519,50199,112320
d7d971d36d12d98e6a373d488dde5f8c,211,133,1219187,232317,986870,204,144,1039689,234763,804926
6748a42ece64fbfecbdf9da6d9c9dd59,44,41,56656,14964,41692,51,43,72923,17546,55377
f48bdc507507bde81eb5cfeab6d22fa0,3,3,480,479,1,3,3,479,480,-1
1297b8557bdb662b6f0cd591d1162431,175,119,538150,126217,411933,182,170,670627,180938,489689
d6a72eb4990303b4863eb84cf9fb9ec9,17,19,3731,2052,1679,24,13,4110,2389,1721
aa7221b6a1f8867fce89814bd1324d28,149,124,343027,63992,279035,101,80,159182,45107,114075
ce40966b52933e53771186544bac5cff,90,55,125071,38250,86821,139,111,316808,50208,266600
869cf7138e8b7627463f8f5b01b94f74,97,81,247330,83115,164215,169,106,349306,57014,292292
03a9ae20d74ff3b13aec9cdbf53fa488,57,39,83768,24653,59115,56,46,87120,33210,53910
ea81e68712b819caa93ba611d9c04188,33,28,20744,6709,14035,35,28,15263,9350,5913
5c033ffa5d467e321114350b0342ea66,143,111,316055,47959,268096,102,74,229603,58271,171332
4e0718df040526de9b6b4a3a82ba0a89,115,81,199898,39488,160410,124,102,269312,48608,220704
cb65525dced52fbd1ff2005706e1721f,124,101,249057,51920,197137,144,126,295088,44308,250780
dfa3507f86ebac876ff406456101a970,112,93,251550,125654,125896,131,86,269279,87218,182061
63b6b0a37cbf35ab3c5a51ba2e30139d,59,44,63368,30717,32651,75,52,94955,24115,70840
85e3c822fd5b50124f1da9df29d46006,195,143,467138,95674,371464,143,97,366599,108931,257668
40cc94736faf1fde43299e73e45ab66a,154,115,504036,74164,429872,180,118,408847,69303,339544
a265c2fa81d8414b38a799e154610cfe,96,65,148204,28858,119346,73,67,89374,30230,59144
b5f10e860d00ef0bdc830179f4e99a12,64,47,84883,41320,43563,85,70,125808,37138,88670
b507ec8ea39cbfb1f44bc9395adcde25,28,18,24435,3966,20469,28,20,13332,8418,4914
e0af105bb5b1206dafeb1894c389814e,62,47,74456,13508,60948,64,51,52859,12931,39928
7e04b8dd928aba11de173c5fb57866ab,128,95,269163,39310,229853,74,72,116784,64540,52244
0ef7a69e33a44836aaada0f1e58f19a1,27,22,21194,5444,15750,27,20,18453,7384,11069
4fd2a883f709bdca44f13e03fbd2c320,48,40,60409,24409,36000,45,34,56417,18133,38284
18f2669576ebc7ca7efa3938d30f6c7e,41,36,48282,20127,28155,30,31,37630,17481,20149
3f8b7c9a25c8d2c56349a01241aa15ad,89,59,145606,25711,119895,91,66,143722,32475,111247
d32fc0ec92ccc8701d25271beb7a52ce,48,37,90923,30656,60267,51,42,93435,39080,54355
9a7c752688d85aebf6863fc2de64e858,7,8,1007,695,312,12,8,2081,966,1115
46e56009f0f666899a4d56299a9682c1,33,24,24003,9450,14553,49,38,36916,9805,27111
fc755f526f2b0a4f0af0dd67dd44d828,47,31,79409,20394,59015,46,34,59336,22935,36401
fee8c368a26e8a03017974d0cbdedca8,29,23,18857,3096,15761,28,22,13176,5662,7514
d28dbc71c97a0f04350c33f4b2aff3c1,22,16,3531,1813,1718,11,10,3254,1814,1440
3f8e7bcc7268bf382456f5288e405fa3,217,145,2302557,190727,2111830,260,178,1063877,201473,862404
a4bb6f608fd16c367decaa5a9711bf78,212,134,1669143,179306,1489837,233,165,1357193,187586,1169607
1d3859d1cf50b9a6fb40e40bda2cf268,79,71,125365,53944,71421,92,76,188386,38258,150128
6e6b1f9dce1b0bd247699cdac9ce1d95,60,39,63419,23394,40025,45,40,52452,29707,22745
31a157788a56e47f9ccf3b8c6595137c,114,93,226006,65162,160844,92,76,223710,55558,168152
b9c5259daa99e84b5edfdeacba793aef,100,75,167449,31944,135505,84,61,111418,32526,78892
49150ff82cf0e862692d8a98bc64f764,35,25,23670,11856,11814,36,29,27788,10732,17056
9c2efc2282a8c3f10f577409f6b65bd2,40,33,34418,10269,24149,37,32,26246,12729,13517
617f7c954a05a839cb24d5eb066268a2,53,47,52697,34353,18344,69,52,116361,25271,91090
e1e151c73019031378e832e2d6f8de5c,114,110,316820,131901,184919,126,99,554357,120875,433482
ada7d41c7b7b15bac71ed10478c72761,153,104,497663,99326,398337,185,154,558783,136280,422503
a763a1aa9efbac3a794d910e1b8445b5,160,115,472419,75165,397254,135,111,343591,104626,238965
a9b14138f7ca22640478b3c9b26cb83c,47,48,41680,24855,16825,51,47,75806,16828,58978
0f53e8de744ab9d1b3d5021d0f14aa4c,25,22,8748,4420,4328,21,17,6665,5243,1422
bd2be9754f5ca0e4ec1b5848a2b5e09a,69,51,75678,19033,56645,56,41,60075,16281,43794
dd8bc73080596a962785b73e0edea447,78,71,208592,48110,160482,95,88,206324,52778,153546
adbf6b084105b5d7b392707c9269e766,62,53,88319,33732,54587,56,38,109997,20620,89377
b34c55cbbfff3f0e6a65551a411cd9aa,27,27,28910,9858,19052,32,29,32690,10497,22193
2da4b35c6b2b926a26ad090231becf9f,188,165,860638,114581,746057,188,152,720774,90299,630475
7c80871d3ef89247513b411bd1f09b24,162,127,588067,123614,464453,147,126,463049,124698,338351
73afe1f54242e92a4a5b7fd776aff953,35,23,23362,7727,15635,34,24,25303,6041,19262
6b6344ed0aa3d3b21c10c18ebbadf704,93,72,117151,36192,80959,84,63,115176,33235,81941
e7ab3b619eba92bf5a37bbf24704688e,70,56,100772,27740,73032,77,54,109903,24146,85757
544d3843331479cf83175d8d5782a4e1,50,33,47712,8518,39194,55,50,63217,16474,46743
d8648ceae60b6ef2c35cda7b06d28ade,29,25,19998,8947,11051,32,27,20442,11101,9341
bcf1be2c74ec7bc1c0e1252494a451c3,32,28,20033,13323,6710,37,26,27299,10625,16674
9db8778a31db64354bd820791b504b9a,60,38,86009,20901,65108,57,44,88951,21528,67423
a8a010112840d3046c30654bdd52db6c,73,55,97970,27399,70571,49,39,85976,23942,62034
0b12b8ff1b61f47c50ce26cb64b51760,54,42,47662,11420,36242,55,42,35879,13462,22417
85798938c39ee2663a4a7649bbb01892,59,44,99118,17210,81908,50,37,42199,18876,23323
497fcc3427ed9cb8ec5489c494cef51a,168,139,612813,117885,494928,174,135,520957,112043,408914
c507f7a34dc5e550964abb1570ba34b0,97,75,127283,43598,83685,68,54,101939,43593,58346
9ff266826ed21e353a236113923836f1,63,49,105453,27865,77588,72,57,100682,26131,74551
48b68e59e662765cf886a74776230f40,40,34,25508,11999,13509,41,33,23529,10404,13125
deffe9881777f82ee35436aeb89655a6,24,17,13438,3221,10217,26,18,14340,4321,10019
5a4106997d554eb39a83fc1c66e37b44,110,85,242020,45306,196714,86,73,157597,42303,115294
fea7396bc119c0146a2857788c16aa9c,25,20,16669,6079,10590,25,20,22231,5009,17222
330a6d42c86a1a24b4c62f39ba3cf2f2,91,67,105043,30298,74745,81,72,88222,35987,52235
205d13c07abdf3dad5f598ad3f2d4033,92,80,171263,54974,116289,114,102,232877,52568,180309
31a3e3e4f7f84713f73c2080e532a193,61,52,96131,27899,68232,83,64,104549,23607,80942
4ee4f1be157f0c8d54c57c3550f76ce9,133,75,283939,73576,210363,139,96,291657,85607,206050
5b00322e6d8f343ccba49030501cf549,184,147,739682,147627,592055,205,165,944441,118179,826262
7063a0e82ba4c498392eee03cd894b63,105,81,165049,49957,115092,109,100,323941,59133,264808
1cb8a31e9745e3d59488cfabe1e47f1e,31,21,16613,4407,12206,24,20,16762,4652,12110
a26df251cae579cb5342d5ee32d14004,29,22,15376,6540,8836,27,28,16309,7624,8685
0bea05c773d0d0c1087187db1a145c7f,28,24,23161,4215,18946,39,20,26534,6120,20414
3992a8b6c641c5077d4597017b323893,20,13,4908,3034,1874,24,21,6237,2811,3426
4649ee90dad6d392ea0519b660af53cf,177,154,700486,112601,587885,176,159,642200,120992,521208
a94e44fa1a12a4d071c06628f073cb92,49,39,43060,17465,25595,57,51,59061,11846,47215
60d1a0138cb05c6dc744ed1f878fa82e,84,57,113506,25193,88313,80,60,102816,30203,72613
a098b7071304fc7053ff40e3020adf60,160,100,359825,80119,279706,125,102,295159,97535,197624
51850f2ac33a465f141e1d1555299006,14,12,3688,2122,1566,14,11,4725,1792,2933
786aec430e2358f2c23bb2b18b58715a,57,41,55171,26006,29165,56,59,58843,24938,33905
6923c1f5a02554f4837d5919ca4a4c0c,159,122,617143,209171,407972,169,155,778836,188718,590118
132c831475b849e47971e592d70e7ec7,79,53,114867,41548,73319,104,87,173135,44451,128684
716e1851a3b6c3640b595a16bc509434,29,28,20696,13065,7631,35,27,26595,11977,14618
51eab3ab91482978624adc3cab34c783,109,75,226847,76997,149850,148,111,312676,62557,250119
57ee8e29ee7f4b17812d15df5f6681ad,89,70,175301,60170,115131,107,62,207647,44155,163492
24f812bf62de2320488d0a6e2c5d48f8,27,26,18154,8293,9861,34,34,22638,6991,15647
2e4a9841028bccdad656abbc0d7e9caf,75,65,144996,54809,90187,49,38,91669,41357,50312
182ecbce2d46a2a6cab0b3cedc85805f,71,62,89615,23236,66379,57,40,78571,21291,57280
c325f21790cda11aa242b9719a08841d,131,95,419479,96742,322737,171,137,452441,132655,319786
be76b4200ec4ce4965f8819db1043eb9,124,108,288226,55369,232857,108,77,162371,61812,100559
90f06d542a8d4c4a056bc410508fe602,184,135,1151948,157606,994342,210,137,850913,130908,720005
d3717825faf4afeac5a73240a7ead7a3,183,144,555906,100690,455216,130,101,399256,80983,318273
5f6aeec9dfa51897f94942a1ef7dd460,77,79,159910,35594,124316,131,103,208055,36160,171895
4b90217a80a01a01b55f0e3f41905df3,159,112,457889,50320,407569,115,81,250465,76095,174370
6ef2af0c3031b108c6f8a109eff2c498,91,73,276475,69533,206942,111,76,226880,70910,155970
7eafacb50cf4d29e049aa08f89edc879,188,139,767484,188407,579077,173,122,638445,150926,487519
9475cb112cce8c0b3e5f67666f2c9490,129,92,329836,97673,232163,136,105,397352,107562,289790
49cf8770abd92caf855fe4cb71a878f2,113,83,298108,72061,226047,141,127,422313,81143,341170
9e53485430c719a61d5b4e6aa4f79b0e,113,93,224255,45424,178831,99,76,171735,44393,127342
cddd48a420a26170621ea94bce7b075a,74,46,92934,29043,63891,73,51,132188,18868,113320
dafd971e883f6dff6a6e6f2137265624,23,12,6681,1836,4845,22,16,5160,2989,2171
e03e23ed58bcfd2876f035932ce0a745,31,19,18457,3126,15331,22,20,7170,4292,2878
0f6173900e17fe1848f78c269fd9eb44,175,135,722893,145112,577781,178,159,644494,115680,528814
cfdba632c61e14e5f5a9d1a1d2fe65d2,31,24,23280,6156,17124,28,18,14924,5201,9723
35a55a1c2950c470e4d4560a3c049d72,64,52,56559,18393,38166,57,42,53033,15203,37830
7fcad38c557da2fe4d4465c98c5a9b79,120,83,237952,64739,173213,126,85,351342,60264,291078
e0bc809399b82891348fb295d26d64ff,73,51,70648,19835,50813,50,36,65099,18998,46101
043b41f14549a43e6c3238b07d50f6e8,196,107,563207,78898,484309,195,163,673468,124592,548876
4144e3fd1a043c62845d266801ffbe2b,163,111,409351,93332,316019,115,90,302405,72244,230161
933a82bd8f1ea3de28ec730350e7a395,145,88,392261,52044,340217,112,92,219371,41592,177779
598fa50c7b3d0fec761b48f43fd71502,21,13,4112,1765,2347,23,15,3845,2143,1702
4769f65125980100c690f74d6617788d,71,58,100831,31068,69763,66,52,78524,28170,50354
2c5d2dba6a1615460ec5a2eea4914efa,21,12,4234,1766,2468,21,23,5103,2826,2277
83850d2bd1c84d630c2a9fde483767ea,139,99,450888,91639,359249,165,111,467011,95507,371504
122ffba5c491e828a96360e1871f4207,164,134,517713,132386,385327,151,98,467453,121580,345873
0e76bf6140dac96a14753de248f03a94,99,74,189632,57614,132018,118,78,238932,57213,181719
413dc57101694c69c68d57b5ec07d016,144,92,354615,87728,266887,128,93,292151,93328,198823
ef9929cf730c77f4d12437eeede6681e,147,81,214954,38190,176764,128,71,200246,37851,162395
97ee2d4496c08717e71a07756be2eedc,169,143,534527,104688,429839,152,99,408737,98228,310509
c0eb3e12e7c92313861a5ffbae3a135c,108,84,231704,53991,177713,102,78,189057,54803,134254
123e023245aae6a6574d72e393dd376b,102,81,197225,53686,143539,99,66,176372,29981,146391
b897f6423ceae070210a3293b33a2612,43,36,69163,24672,44491,39,27,60505,21441,39064
23aaef25cbbd2dec63261adde8273244,134,102,567462,143013,424449,166,116,646675,121199,525476
f4cfea09a92e49e009556e84ffdb300d,42,30,36486,11979,24507,48,38,57797,13343,44454
4b42cbf3721d7fee2eadc13412e00c51,114,92,247427,68744,178683,98,70,196177,52531,143646
81a64b44a4959a5f676479abb20d6eb5,86,72,141009,36291,104718,79,73,130598,34221,96377
6ffa14b45d073b6cd68f1c1e19b48630,26,24,16132,6061,10071,28,21,17743,4898,12845
a4268033b03bc34675b78706c77729f8,119,81,266715,73143,193572,143,107,364819,62203,302616
de793998961f4e5cee17ee280f3023ed,158,95,336639,78848,257791,169,119,460607,86157,374450
40a61f60050a45378cf86acb39f53848,1,0,52,0,52,0,1,0,52,-52
433f7dc13d68c0d471f0b874a87d5d4a,30,23,34289,14112,20177,30,21,32727,11779,20948
e59a7548f6d6b2b917d265d071778d02,236,171,1137366,206860,930506,203,167,1138882,298288,840594
5cfbb588be330f563d315b9cc85e1221,48,36,40670,23096,17574,42,41,54647,21364,33283
6d3750e47ff8b37e8bc2481a406a80a4,93,54,170755,39558,131197,145,116,289616,59403,230213
f9dbf538687f8b7ca8b0035ca411b042,112,76,237850,62669,175181,138,89,298003,48851,249152
6b8344542d479d832e3be88fadd36238,109,88,173343,44361,128982,87,62,123793,42620,81173
2f13170d69995858fcf1ee15ee0aec53,124,88,238415,44250,194165,96,78,169827,48096,121731
62d20abc8ddfc3edd926267f11f04848,32,24,54041,10499,43542,30,24,30405,11022,19383
1e993de5b8a62387f16c090a522c9fce,24,15,8501,2789,5712,25,18,7963,2655,5308
7dfbb88bbf7aa608d3834c105d3f7867,29,27,29178,17547,11631,32,24,48771,10339,38432
b5a9039d3ecccc2d86a782e54c7ff383,28,26,10093,6573,3520,30,31,12166,6604,5562
052bf0cf405944717b4b600a21decc93,20,15,5122,3438,1684,22,22,5306,2504,2802
12ecb26ac296b58104ed7740c4beb29c,65,55,99954,40745,59209,76,55,122837,39873,82964
2b8e9986e6c59041d736d6c26be61195,106,94,203739,46951,156788,109,86,185444,39674,145770
5d4ee6cec3a8caffdebd4bef3fa5e06b,157,135,563168,130695,432473,162,101,454521,104714,349807
c57ef3180a38ccca69170dd502252e93,45,41,50158,19934,30224,59,43,58472,18126,40346
272d1a8c88ae1d9f99345866845481f3,37,35,39329,22840,16489,39,32,45039,20976,24063
219c0a60c4373cb380bc91893adeb2de,43,31,41495,11665,29830,43,31,29677,13508,16169
707a7c49e51755e63462ee6c0ae6b01c,20,18,6949,2794,4155,25,17,5532,3345,2187
75016e49e3c54618c6509159dd0ada4e,215,162,937695,121108,816587,163,134,749968,191791,558177
57089c34e624288cf55b2a280f3e1310,84,68,174086,52600,121486,104,71,165328,49310,116018
9e33a4e9316271d30c0be36887d290bf,171,150,704356,123239,581117,143,108,510788,104250,406538
139ae0d560e0e5a673ceb65913f1e41f,51,36,50093,7799,42294,38,32,31933,10146,21787
15ed2ba624ba6d6413440b0e7f7b74a4,47,43,79196,22735,56461,53,42,75584,29686,45898
cf5c7b800d0abea08c44affab38233b7,56,40,72057,30787,41270,59,39,96292,27863,68429
c730aae95b95d7cfbdc242161cf9c305,120,86,296716,44842,251874,84,79,185851,63206,122645
dbc8f7080c007e71fd67e720cf99eb30,64,49,133894,34929,98965,89,59,103943,35555,68388
cde8348aa8b959a69bb96ba40a4be1ac,27,24,22184,7692,14492,32,20,16808,10302,6506
aed0f77b891993372edfc588392a7fba,84,59,136634,59975,76659,94,91,208935,62266,146669
0631ff3d41a4c41a03b414f9419bd955,130,82,262494,67224,195270,145,116,367448,48023,319425
add5b697305ec886f563aa5673972757,4,4,1461,1332,129,4,4,1332,1461,-129
1cb886d6f1b32fde25599988c2d7d301,174,130,729699,178383,551316,171,123,806776,149517,657259
89470302f18133e4cb4a723fc33656bb,94,79,153794,67633,86161,101,74,227281,41381,185900
744fd76cf4fd42379e5bb16ee709364e,42,27,35736,13939,21797,36,24,51580,14969,36611
c40ed08e854c9429356377ee3ac1b5b4,170,136,603363,112828,490535,143,114,505576,84489,421087
ec4f0b632a3f5ebc46d33332ff67e152,50,39,52413,18571,33842,53,39,57297,14515,42782
5bfaa690423be2e77da558689aff785a,152,113,346047,76961,269086,122,108,261944,58608,203336
40afae25a56c9fbfeb9d44c8501e64a3,87,53,177226,74136,103090,117,101,214344,88808,125536
69b8f526e75f70aaab85ad41eacbca5b,116,92,277500,65006,212494,115,90,226311,78037,148274
8088a8096550fddc1e0163f81c94bc7a,104,85,240845,52755,188090,67,56,147767,40070,107697
118805bb1ee778c9d610e4ce58685e65,95,73,167747,55689,112058,96,82,227659,44968,182691
05cb8108353343de2191c5113d855daf,53,40,65010,20604,44406,64,32,48917,22901,26016
01aedcc5150e332adec7dde6cce58b83,93,64,143049,31977,111072,107,93,159437,41608,117829
fa54dab179ab0343c45a3c350db04e81,91,57,145803,58587,87216,65,62,113945,65961,47984
853cb33dae5c828fd90a1c5b60a3618b,23,21,11155,4914,6241,24,20,9022,4675,4347
406427c53faf3d03898871ba2a3eb065,65,59,150197,51641,98556,66,54,165902,45953,119949
63f8e2af06581197fd14d6c9673e355c,179,132,458324,96452,361872,106,80,321419,71102,250317
fa25f1d995aae8b88498cc8ce151155b,98,59,108333,25995,82338,72,58,84032,29626,54406
fd000856842e76f41b38cd3c2bc2fdc4,29,23,15929,7685,8244,32,25,26961,8258,18703
cc84ee9cf2ac306ca6a60559b5f9e6f2,12,9,2826,2038,788,12,6,4142,934,3208
2b2f03671d4c9319849041fb3fa095ce,112,62,328032,80893,247139,166,124,465930,98551,367379
7a6dd522fcb1889967f651080409432f,37,26,24183,10645,13538,48,27,26474,9357,17117
b73272f9bf64cdd24570391ec7e3f505,121,102,328465,59432,269033,111,93,290584,57563,233021
0977f9c3042bb5e5808c1ff1bd99703e,85,64,126425,38468,87957,104,85,137247,35587,101660
341635b30963fb928b311ffd12646372,67,64,100899,30957,69942,50,40,97300,19297,78003
24fe7d2f4dac9710e5939fc070f0fe6c,96,55,143828,20158,123670,89,64,129338,25144,104194
840c34e5710134b885f65d40e90198d7,20,12,5397,1683,3714,20,18,3678,3873,-195
a99ab3c6807561a2504254c472143ea3,122,108,363729,85804,277925,92,73,245176,97399,147777
24ec86102a7668a0305d053dd8d18f52,61,49,54512,32354,22158,65,46,101527,28652,72875
bee7fee0f1cc6930d8cb99299f94b04b,17,11,3288,1739,1549,19,16,5026,1736,3290
62a418357ed19ff9168a77b163175ac1,201,155,550454,78197,472257,113,85,262226,120689,141537
a7c7559b7697b1cf1f7a4095776e58dd,134,93,345208,68957,276251,103,73,204758,57821,146937
6a988e15034607955963f978a39cd4ea,34,25,24624,12314,12310,57,40,53108,12901,40207
642b46f62434208b12cec184e44a0727,215,146,639942,105494,534448,113,100,470395,122548,347847
e854a85dbad0a9a5666eb210a5a5e10f,55,42,92976,22381,70595,62,36,66745,24369,42376
e56d503877c404c0869f00768c40f927,123,82,265871,60526,205345,110,79,298482,74684,223798
e11606076e569af752714735d021ff0b,167,131,488836,94315,394521,149,120,484395,109399,374996
27a7a1361c110b00e202b54d0e2fa895,76,59,123086,31363,91723,48,36,97264,23950,73314
931c6e62e7cb222c2fddb1977d6b9f72,23,21,8727,5043,3684,18,12,5444,3829,1615
a730ef5cebcb72b1b6713c0c051b9ea6,1,2,41,23,18,2,0,131,0,131
4a824ee7319f0049c3218b32724b4e78,73,62,114541,53882,60659,97,72,165271,52594,112677
3ae74dbf601b56016b23cb522272fe3f,69,62,220399,114778,105621,151,107,430813,90139,340674
ee0f6bfa998658636ce2f36a844159f7,115,89,209379,78668,130711,124,91,333332,53607,279725
40d03a0032f11c9517ed70eb664153a8,26,21,15392,6264,9128,25,18,10798,7088,3710
76b438d98f6b0aa6339668232934c640,121,97,356061,73426,282635,137,111,412831,91453,321378
5c4fc0a5801d4b0d46f3d6246e7833e8,56,47,109075,25412,83663,60,51,89700,27958,61742
e1f4ab2d2612fa221b9b2d27c8256604,152,122,643143,155116,488027,164,136,707933,131888,576045
3970fd09d9c2b056c9f9a62f18b3e979,113,98,271471,56770,214701,120,90,285045,53361,231684
6836492853ad4d366632dbeabd9ab019,126,104,331662,57934,273728,138,90,266108,79952,186156
ef4cd87923afa671ca76784710342f7d,44,31,63874,8192,55682,47,36,31536,16827,14709
e136e7a760dea6bdea88a7f8345d80a9,30,20,14971,5649,9322,44,33,32686,7645,25041
19551418c22ccf392e460c3623f28456,180,116,440016,89020,350996,179,143,601679,113533,488146
d02f4d97ed8a0e21022ee139d19a9bd2,134,101,347052,96413,250639,163,120,474279,109956,364323
17af0e1d23de555000b160431c400530,86,63,138684,29057,109627,82,68,124305,28685,95620
6c126454d8022fe6bed9c820a8ee1f07,174,129,748655,113509,635146,188,149,882768,161585,721183
fce853af6df2f3f04d5b7a239e55fb72,211,158,670515,139516,530999,125,114,476282,135833,340449
66f1c521897b00e7fe6ffa8966774a6c,26,23,30161,11505,18656,31,20,22422,10132,12290
e20f7ef6cabd9d1183b3aeed1c84b673,104,84,143105,41112,101993,89,69,128754,38798,89956
37ba933d3bad6ac2b708171f04f0303b,91,80,232811,88164,144647,171,90,375610,85799,289811
2a1c24b5c3f486505d7ef5387c66d71e,54,46,127652,24782,102870,66,48,73294,20224,53070
094df9e747e38583125875fbdf6f0801,42,33,36626,14836,21790,43,32,47240,14110,33130
d5f010b8bd990d1f36a48a4acbd9f05c,62,42,67751,10434,57317,72,53,65283,20551,44732
8338b2b58ef441ba4177c38f4068e572,146,122,400281,82354,317927,138,107,318549,78475,240074
f6abab14999979fee7b8c3aafe46c02a,34,28,31065,6135,24930,29,21,18371,5410,12961
95450ea1044b085b810a9fdd52752b89,26,22,20372,7450,12922,26,24,18028,8526,9502
ae8ca8635e77f1090f8a270762eb4925,103,77,198628,56470,142158,67,54,132384,48743,83641
758bf3936e324061892056b82d0d5e8e,117,86,398931,75422,323509,217,182,698052,104612,593440
50c7a0255fecc2760630f7852ae4eb17,80,63,171075,65684,105391,127,93,221830,40683,181147
b4d0cfb27996ea985276777fc336beeb,121,96,220315,38209,182106,83,66,155726,33699,122027
58d168450401cc74c8c42a2965a54efd,113,93,236793,51505,185288,126,103,375212,62426,312786
28afab7148638cdc14429120c4a95d6e,17,12,3585,2692,893,16,13,4403,1583,2820
9d3cdfd088f2edfa435c6005011e819e,158,126,383695,93951,289744,136,87,396442,101448,294994
486662c1adce6cbb0ed32d146855e674,128,96,287752,77619,210133,140,112,371521,79818,291703
d40cc09d6d815f708fc5c628fab40a30,105,82,127872,52068,75804,104,89,230490,49285,181205
8fc0a182900e07f1edeea0e4e3a36409,37,29,43902,9990,33912,26,20,23047,10091,12956
eda36fe91a007a81e67ea3b5bb46995d,146,95,243680,46957,196723,152,98,275033,44848,230185
5bf87fa37cd132005fb0bdecc056c2b2,27,18,11412,5701,5711,28,23,21154,7216,13938
f29e685bd0f6f57069684a0c8c7b1f05,32,29,30663,15555,15108,40,27,41105,14807,26298
76fdb7b3acfa659c33bf995cc9a5d632,132,91,463620,137273,326347,151,113,431693,151696,279997
26e6b4aa17aab0d57664308972298412,23,17,9678,3633,6045,29,24,11386,5159,6227
368f80767a7c5e6c75ec6bf4bb2c22b4,37,30,84540,19493,65047,46,36,89197,17639,71558
3dfedaef25cf8e2e2ad22ca15a6539dd,19,16,3648,1980,1668,18,15,4197,1942,2255
1876be6c6f59fd98e7bab01946c2c918,100,78,229296,74385,154911,171,112,403949,58154,345795
ea7631e6da7be881c0a84a0e9dba2905,39,36,35117,14472,20645,62,50,55450,11614,43836
b7786d91aa84f8fa1e4e16c45bb0b022,133,107,463998,120661,343337,202,144,602813,113605,489208
2615f6b4156d329f1f72671d07143e33,67,55,99208,46723,52485,88,66,163459,39612,123847
188f1461fe28468457b350767ba38d25,73,52,101918,18695,83223,73,65,77880,25766,52114
dbf29833145b9dd88273ac1beb2c67e2,141,105,491601,111450,380151,168,145,518712,122732,395980
c5c777b3457f151730c1f40f5d581a7a,1,1,280,60,220,1,1,60,280,-220
29dc67cc43d05e4cfde31dbe65521605,178,140,785058,165903,619155,175,122,814244,138899,675345
a0ed2adffa2ed804c2a9e334272789d0,43,28,27148,7702,19446,33,22,19532,4843,14689
cff7e008ef297f516f670e81f07a8280,47,26,62360,21524,40836,57,53,73799,33209,40590
fa373b8484ac49322b38e5ba39865366,38,37,35519,12335,23184,32,27,51840,9146,42694
5818c8c560a5b2f0d808fd9806b64f70,59,54,79337,34948,44389,78,60,122812,25709,97103
d884f8dab8a3fd2be27fe870ec8be2e3,143,102,328948,73869,255079,167,129,368307,80102,288205
f899b7a6b07bd35c613bb55f312f771b,72,53,118908,40260,78648,86,72,170583,32100,138483
ca6251eeb9e42a67726c47fd2581f92c,73,63,155487,39603,115884,62,51,143950,39346,104604
81f627f73cf941830d702d16881781b1,30,20,14207,4090,10117,30,24,10073,7219,2854
cef97e547e82fce705fb634f57183e12,42,28,35467,16828,18639,35,27,28165,15402,12763
3ca5967158cf05f59a26bd8727ed33b4,91,67,130776,51069,79707,96,77,166323,37264,129059
37e3f11b3bd974f092e379dd4d9eb038,21,19,4324,2541,1783,20,15,4832,1911,2921
bb0751799f33a2d10214abc52438ee83,23,19,12424,6210,6214,26,23,14669,5494,9175
33e5ea30a63482abd3653a6722f85a5f,24,19,13469,6297,7172,24,20,17639,6820,10819
48eb1746c882fc5ba2af8e009563e30d,186,122,527999,77066,450933,163,130,658296,85673,572623
6377dc21f9b1c53092674d59fc9214d6,177,137,340141,80624,259517,126,100,326056,75273,250783
b04394526aa050c2be02ccff9fc99368,19,17,5203,2749,2454,26,19,6579,3113,3466
4a122f28ec66aeb3e8c1bf563179e666,145,106,355572,69802,285770,162,123,327288,102929,224359
797def8f48d1423136e4856ac46f0080,44,40,29896,16209,13687,48,46,40325,12040,28285
3d19aebd6dc011bb2deb71eb8c081e82,77,64,150171,31225,118946,83,74,135577,35403,100174
c11ee8c4774cef76209c907065917686,66,57,91611,48922,42689,71,56,111284,35667,75617
79894cf788b881054e0c3955cae7d795,127,106,230417,52926,177491,95,79,173959,38698,135261
edc2444bfe8b3d698340343b1cb8e0f9,121,88,248889,63456,185433,101,77,171058,50462,120596
843ca8035af1624542e7c808fb22630c,22,18,12261,2982,9279,24,20,9095,3051,6044
61da36e0752b493abf11cf627f6bb4c7,18,16,4318,2167,2151,23,13,5340,1650,3690
07968110d7002384f4e3ab426988b133,27,20,18673,4410,14263,29,22,14175,5185,8990
220f97daa7e6e8a7a92252a99cac0c11,13,11,3602,1830,1772,12,13,3092,2038,1054
762d9b486d930d17112554e83143ca1f,31,30,27969,11478,16491,41,39,34016,12379,21637
feaa0697c4c94a043577f22ead8d2cb1,74,34,94544,16879,77665,40,31,56685,18114,38571
b41f28b1a4f562935c684a3ebaafde38,5,5,601,650,-49,5,5,650,601,49
9f548feac3e6b20be35e12cf7c809d3e,47,33,22998,13801,9197,47,35,38902,10025,28877
872f81c7335a7b9aaf122ef5232e2365,61,45,78068,23688,54380,47,36,51750,18376,33374
501fd51e972236bdd85b1ba5ce975fbd,144,114,391320,83170,308150,168,130,415372,62941,352431
00f7c3b5d6eb54e50dcbbefcea33f56c,104,80,178471,51684,126787,120,98,236790,55026,181764
29ff146220c66d0a72dde774ae58c5b6,69,55,60501,20478,40023,77,60,87379,13905,73474
3b63b0a343ac7aca937118ee8df6a8ba,35,28,54644,14008,40636,33,27,34965,18565,16400
4326c37cd65d57cd21760b9641d0ec16,27,18,6979,4576,2403,26,17,12318,3074,9244
0f30184333fdcfb925d0a7276b72031c,126,94,372449,81779,290670,150,120,394643,78469,316174
88c19505000e5d6013c4143f1e92b759,42,29,30981,12825,18156,40,26,47870,11092,36778
068f13fba705d34d9287fcdff784f190,132,98,271728,54153,217575,109,76,253845,62665,191180
f1c0d911aee359f92045695369b21704,102,78,196653,28483,168170,79,61,107041,39216,67825
ee193c65b2f963bcffe16c136ec8dbe7,91,65,245643,86423,159220,113,88,317903,85486,232417
940af3be8f576c4dea4b066094a04534,35,28,21149,8604,12545,28,20,14744,7872,6872
86e8feae2c254c32af37531bdc4ae048,157,118,416329,74138,342191,132,99,276305,67104,209201
322e35c7b4bbe3b876a8ea9285d5b0a7,98,64,216195,37038,179157,128,91,286857,60081,226776
aade6698aba7e090d190c50e132a9f77,137,115,430208,100816,329392,151,109,570620,116621,453999
ca19b5789d46748cd71e8b203cc5008d,47,32,42464,13512,28952,44,28,31184,15696,15488
ca065775f46703702a97e7f92e90fe64,140,102,306769,60157,246612,161,112,336225,52024,284201
5f2016d571ca3c7d56ad59251833d5f8,44,35,45664,17147,28517,59,41,66879,17607,49272
0eb196ac066823beb2269f8f4d9b565a,90,77,275627,114785,160842,146,131,479220,98846,380374
8f5c2673b6da992c718a45bf29beb8cb,62,42,102281,23031,79250,58,44,79274,27009,52265
11c8c4cbbd6eb6cb41bdca49b70d8ffc,80,60,139227,35363,103864,93,81,166938,39149,127789
e300aa39a63509993548df3619bd57a6,53,47,75076,26357,48719,82,69,93809,26459,67350
2e76d06490ee048723159d40ca11553a,40,31,38206,12755,25451,34,32,37051,12299,24752
3efc43df9d489073d240e02d6b6faeee,27,20,13405,5437,7968,26,19,12995,5753,7242
08c292d54ba81bd3ec831bcb12549b38,147,109,459304,114228,345076,111,94,329073,123802,205271
7977ac5e7d8b5e9911bb1a1650ccd91c,100,82,195455,51243,144212,105,106,217351,49537,167814
57c4379f440fc097b52e712f4139e7b1,31,23,18715,7248,11467,21,22,11236,7779,3457
49eddcc19bf7c15aeb7a8d4934555b8e,13,9,1725,1155,570,14,6,2512,1242,1270
8b523bdf8eb94b7bcbceda896b54fb34,82,70,102344,21768,80576,53,36,57199,18258,38941
118146801578c7b6acc91a07f9464871,91,63,148774,39553,109221,72,66,129187,48086,81101
624f491a1e6ff4f16b59b5f70761b48d,102,78,203731,36926,166805,119,101,264283,47484,216799
c19c6c1f07e11e9c64c7470cbb943328,200,148,877662,139879,737783,234,181,1080697,144612,936085
207c5f6263e3b0261f3c005d3d99ab8f,104,91,184925,29857,155068,107,102,128496,45682,82814
aa1b7ad55096d8d1715574993bc809ba,97,76,148552,28664,119888,97,69,143788,39083,104705
f798ebc80cb9613953ffbc0d4ad05f23,20,15,15496,3825,11671,21,16,10569,3726,6843
25af7024f7330b672d5cdde6978edad4,24,22,7652,4445,3207,25,18,8423,2066,6357
9fcd0b96141d38edc5e54ac0534415b7,76,60,101585,18726,82859,85,60,86102,24597,61505
6432ec7b3c4afd7c97d59c6c8b6757ad,35,31,26015,10540,15475,30,22,22931,7647,15284
e0287ab92785e70c329a3b3beb58bca1,24,17,11205,5639,5566,18,15,7415,4549,2866
fdcec9ce577d957d049e009d1b3c0afb,64,50,56709,18603,38106,63,50,65472,23410,42062
1eefdddc6474e5c8a4feaccbcfee3c3d,140,103,260786,58695,202091,125,103,297440,69550,227890
372c834b749de6eb676bf2643389a1a8,107,79,216612,51914,164698,117,76,180355,45182,135173
bf18e629d898e29f2f706a39e81d5fd7,128,98,556867,115369,441498,184,138,692258,112263,579995
9bba3d360ed662cbad48fe49faa56205,115,93,244872,48854,196018,100,64,171510,38435,133075
258e85f95f297d244e05d3c2cd87a641,102,84,167936,32768,135168,99,81,131588,36140,95448
0c7b6b08c77a0a56feab621ae9fe20d5,46,41,47338,10620,36718,38,26,28138,5844,22294
b92630d65d06dd9f3c6f9268469c0625,43,34,38243,12658,25585,57,35,77457,12832,64625
b753c7a500e5601779fbcffed0124434,54,41,61331,23901,37430,63,47,94996,21863,73133
dd29a542aebfd2f15898691495758772,58,33,86796,17375,69421,46,42,78357,25068,53289
e45dd629919cab900bb0c984772d1cd1,244,196,1530131,250903,1279228,228,172,1170654,225890,944764
bad9d1751071589ccd7d587d980d5dc3,63,52,106242,43113,63129,83,60,144364,33729,110635
f3fa6a6aa7ddf1ab003a3370706e91f0,43,31,33179,12966,20213,36,26,33378,8867,24511
9bf555b3ee0a44f551bfe127f4745fc1,113,91,298291,80543,217748,149,116,382228,78679,303549
9f9a659a0233ea7384d9b85028798d4c,76,54,150530,52367,98163,70,57,134520,45000,89520
710dd94d496b148b781d76b66085121e,95,81,214469,53872,160597,108,85,304721,71957,232764
b1988ab9b9d8b8c5b8ce57e434ebc459,50,34,72609,32127,40482,68,57,114851,27966,86885
e7568b21584911671bf8d552e8083d5d,32,22,28081,8724,19357,38,29,40591,12820,27771
5928dcf0853d67c27213bf10bca99b67,116,85,244212,50518,193694,123,106,255790,47040,208750
3e0bee242f7e020fe1455ae3da9f1883,118,84,222659,58475,164184,120,91,257632,44373,213259
50f6a1f05da51b8514585411aead9149,124,89,243745,62952,180793,130,98,284803,50765,234038
0a77fa8cda4767e0977c6db284b889d6,6,7,623,302,321,10,6,734,173,561
a5ff46024a3adbec688405ebdd084fd5,39,35,40192,11229,28963,38,34,29481,14306,15175
6d511a106220326085d2c862c30b0fae,76,61,137061,28152,108909,83,65,112589,36338,76251
2fbccf96d82fd747aec5ad628a34e59e,46,38,44262,13921,30341,51,41,64482,16832,47650
11ddbb7d41f16cd4e0aa5b54009e7bf6,171,105,384243,99548,284695,137,111,362115,116925,245190
93e648f9ba68d08dfd88837d63044881,45,33,48226,15884,32342,37,33,32215,17915,14300
8a98da41b9c24ee949694e4406b974c9,74,59,116482,32356,84126,93,70,110696,44392,66304
1f70010180ac6f9d104dfdaf24012cf0,169,123,399351,84444,314907,119,76,301914,51321,250593
356576d30144d1a1556eeb97b70bcba0,95,78,202760,58801,143959,108,93,306076,52109,253967
080a99553650bb8d87c518a3441803a4,59,52,79235,38437,40798,56,44,103985,38096,65889
401b43ae3b1097e4eeab0f92298bf743,162,112,387974,102026,285948,103,91,295147,82678,212469
bf65d565b6b26521f6747769db47a691,130,92,317103,70521,246582,179,125,378526,57550,320976
e49440cf3c4179b9fc4c842a2b19e9c8,99,86,184361,54447,129914,103,84,204538,56594,147944
c44665d6d166a940df7db006120f9a9f,26,21,11555,3734,7821,27,19,10888,3812,7076
503e9a2f3fbb13171b79a7bbd1fcb50c,32,23,18521,7855,10666,24,21,14769,8552,6217
336e54582bda91317a161951bb5d6372,38,32,31596,14881,16715,44,36,39846,15953,23893
a210733262cf90e88573f2a700480cfc,79,63,98152,26673,71479,82,71,105717,24285,81432
04e73ae4449aa9d9a1de393a8f170290,158,111,417542,82759,334783,219,145,518716,67755,450961
922d1b47c1fc6a7ff88cb95a7c68fd1f,69,55,92021,27380,64641,81,60,96176,28595,67581
23d16555615266af5b51722923dd2a64,108,95,248972,77922,171050,147,129,465825,77711,388114
427df4b73bbe1a4ef167a48ccf015088,33,31,26822,12572,14250,50,34,31946,12698,19248
2c31ff3a48381ea898f1b2e590fa8c77,195,118,597833,129118,468715,162,108,742318,143828,598490
069ebd2078e56089a7708965fac8d3cb,167,117,435725,82793,352932,131,96,344399,98356,246043
45802e9ba3f932e0448a48f01093c21b,38,28,30520,16038,14482,43,37,35924,15736,20188
15be45bcc099c2e951421bb436aaaaf1,114,88,235933,77281,158652,83,73,182268,78290,103978
1667ebb82a1e5ed171136d2ac717de4d,166,113,384801,96138,288663,115,91,334988,88609,246379
133378f7b6654e37b19a57f0256b4daf,87,61,108780,25939,82841,64,55,88600,35061,53539
f583d739aea419baef54420f51654c4d,81,58,104167,24588,79579,97,84,170212,41175,129037
7daa74a6160ae2d523f152f3bdaf2052,19,11,7683,1894,5789,24,13,5708,2430,3278
59f71157313d40b1e538e7602e14d5f9,172,128,491008,81737,409271,125,105,306672,68087,238585
f7415271d2235d5e8e82713134cc5f58,136,88,338274,71039,267235,71,53,158205,109139,49066
aaaa8ec483d21283f79acb70be27842e,73,56,100800,24416,76384,79,59,94502,27246,67256
cc991cc293c9a3a71467b74e42ef8510,27,15,6285,2629,3656,20,18,6423,2929,3494
9f66aa3f3014be01f1681acc56967957,26,19,7756,4331,3425,23,20,7757,2715,5042
2272d88d9d2beff55b5b4436e4be5e7a,16,12,6411,1856,4555,16,14,2644,1768,876
5b8fa5c96d7eef0673b42beabc9df0ba,131,97,227402,52443,174959,94,75,190830,44457,146373
d7a986b3fe49e913d2b1ea6c0d2af189,51,39,69395,16744,52651,63,46,65364,19399,45965
865c9ab61fef35953ada6d7f502d832f,53,36,56721,10308,46413,62,50,81612,18012,63600
44a8735524722e0d13d035f6ea04b9e0,24,18,15478,3217,12261,25,20,9981,5924,4057
f42924d13ecd831df98814e676aeb942,50,39,84766,17120,67646,73,55,81951,25201,56750
25ef28730b950eca4bac2b6124d74b45,107,73,266460,73520,192940,124,100,306682,85051,221631
4d3b8d4fa7fb7ef5949ca8568c8a07e2,12,10,2706,2329,377,11,10,2651,2103,548
69cb5b5d9bdfde5e44510792d2c61aee,206,137,823397,115263,708134,178,129,689918,139295,550623
7983a71e4fc1bb3a944c89667e362619,18,13,2808,842,1966,13,10,1811,997,814
d4e0687b894544435cf79d2b12fd9381,120,92,278594,70006,208588,131,98,251687,63544,188143
ce339d42d056885c3a9271eaefb8488f,151,120,559271,113450,445821,185,144,706048,135762,570286
3467a00f1628c5b08e2c114124d03bd2,166,123,537001,128374,408627,186,157,746948,155850,591098
9dfc89f5bcd3d030fa4b3039c5d27aa7,81,65,159672,74039,85633,97,78,223081,45706,177375
8693917ab3f158d5b47a51745872470a,51,35,69375,20791,48584,55,48,79294,30613,48681
ccd33e548600c398ee6e6920bc3bc725,35,30,36423,12568,23855,39,24,29657,9821,19836
9878b82c479f119964e49fafc1583993,173,117,936552,176383,760169,181,136,1079930,201119,878811
0769e8eb34d7e6ee0c74c85e657b6594,24,21,5017,2817,2200,25,19,5670,2925,2745
8f27e545c4bd8974e7622a0f5a12f2b5,70,44,123590,25106,98484,59,47,123346,33189,90157
ca0174edf3fbbdad161043ef28737ca1,82,55,143582,47140,96442,114,101,235295,54148,181147
5bbc14ab21a4ba30f76d0b1afd2607c4,222,170,789128,141494,647634,185,129,604426,111819,492607
5dd8589b570315486bf9c95551d5f9a9,65,60,93079,50486,42593,114,100,204491,36680,167811
d1333d0c987f56f0b5d2ca97cbf4fa40,55,40,73595,31699,41896,60,51,97908,34101,63807
34a53880ab289b62fbdbc694b4eeb008,52,48,84273,18118,66155,43,34,42645,9867,32778
64f96d944f7f2799ecbad6458bc4816d,15,16,1445,2216,-771,24,15,5228,1151,4077
a2bbef515e7b99d983bc76cc2ed34dba,164,133,858377,147272,711105,171,120,755950,146056,609894
d306faccace2afa255abe0b6ff729758,36,34,41506,13533,27973,37,29,26061,15630,10431
7439c47e1124ee403c251dbecc351a86,42,36,37256,18858,18398,48,38,49143,14126,35017
8f8d68b6a595a89ee8984ef5d4e8a079,115,83,216190,58035,158155,121,97,289266,55357,233909
8730e55a64d525d7351d33c0693e0d73,141,117,398051,70691,327360,143,110,372311,62740,309571
50d821151c71fc303451c8d42692d8ea,47,34,57383,11377,46006,57,49,62182,14156,48026
2b7c89037cb8b9193a0f64b773e34649,138,94,270721,118968,151753,109,95,244318,65906,178412
dc042bd26c4a65737ae632dd49f22343,106,82,143365,32362,111003,82,64,122616,32762,89854
639f97e48bb2590c29bc4b648ae2a2fa,62,48,71867,20300,51567,58,45,64686,25423,39263
4d3da574b099bf68b84a14533d67f8af,152,138,475096,63879,411217,108,76,230122,52279,177843
65ed4b01cdc8194157c9ab976053561c,114,91,286446,77927,208519,120,86,385008,64540,320468
c4db124166abb4086c1e391cbcdc76fb,122,81,288927,50326,238601,67,62,166680,80963,85717
5a887d47b3749876dbc0f8115cb458a1,56,48,87288,32820,54468,102,60,145064,21904,123160
bfdc9c6a0041dc2c7e93f721d12c4dbb,25,17,8416,3133,5283,28,16,9526,2965,6561
af458dd2e75e2b7b45d24669552a19cb,90,75,172036,38707,133329,98,67,150822,37341,113481
5ba11b69d7e5334c50ab6e3514a6eadc,33,21,9689,3528,6161,27,22,9391,3955,5436
e74a100e9a1cac5878e7f03bfd01c070,63,44,79783,35007,44776,89,67,141898,39959,101939
8687f01b7a018d09667f3516e9000bd7,74,60,112629,29868,82761,71,71,78104,41432,36672
d5dc46d54e5045208e598f0b47689c97,167,153,713232,162811,550421,187,146,893711,142406,751305
815db53f11d06b829185cca0e116c4d9,95,69,271375,76575,194800,123,98,314753,86719,228034
c5e1056482f3426ede3cf53898daf05a,84,59,144700,58369,86331,91,62,159826,61874,97952
f8a3d3a39539a0f57b33db73a43d5311,112,84,253575,54897,198678,109,93,245421,59259,186162
8260273b28448127c397ac6ba7c37586,78,60,115834,30955,84879,52,44,82685,23291,59394
3ceab29fc2d8e0ced363ca9088e03c9e,101,68,132880,41250,91630,92,65,212865,37406,175459
348cbbd3550b5e5ebc6b7660ccdda181,36,29,39677,10952,28725,37,27,25952,12707,13245
d90e55773cc20943e27ae43ef166eae0,22,12,6398,1646,4752,21,15,4696,2240,2456
111caf261429a44cffa03b3266100bb4,83,65,89556,22613,66943,76,58,89193,18134,71059
9459f5b77e36c13dccd6efc05ee6a460,113,79,175724,38819,136905,114,78,186009,47799,138210
63aeb1577c6ed2cc47acb46127c02dd7,31,29,25795,12597,13198,36,30,26911,11453,15458
18a8cb007ff7ae1b761a317017e462fd,206,122,568253,135753,432500,193,129,685454,93781,591673
b38638d7c475f6c49a6ce35a8bf789e1,35,29,42209,14195,28014,32,22,33159,12614,20545
4d937ea1f9884338c57d3acc6ae167b7,172,122,551063,93381,457682,160,137,442906,121158,321748
fbf0df0e4f503ea6cc14343a7b56be29,93,71,223054,49674,173380,100,77,162927,43855,119072
3141f190f0c511614bb74b4cfd386567,170,132,604590,123527,481063,187,130,621551,112212,509339
58abb3903e08993aec3eaddb12273cf4,3,2,558,25,533,1,3,40,757,-717
2c36bacc14fefc28ee549cee15255e4d,109,81,257452,89192,168260,123,79,298587,59961,238626
b951bf55710e0ba9b1560f2dffc79d91,108,71,282701,105677,177024,135,106,369918,146742,223176
71ca4bd45b73c3fa4c1d6c83add5ca9f,142,87,300144,85349,214795,162,114,365330,72118,293212
df98499f3bd3ed8fb9b451fc84dabf75,128,88,281646,36523,245123,86,65,185277,36250,149027
140551ba76137872d61516da608f5c43,46,38,28769,15254,13515,58,43,61991,15201,46790
ef5e3123ac2d212a4816fc3e2c784f52,89,58,200482,47039,153443,96,63,207811,49010,158801
8f676a31daef68ef584d714a20920642,165,130,512743,55611,457132,158,132,453251,79914,373337
c2ec3a05fd153df01a5e8ed0023da6c9,21,18,9739,3779,5960,25,16,9624,5464,4160
6b79e29f3059ca740b91505294b73b74,42,35,42022,19997,22025,50,44,68543,19537,49006
6c09cc216baeb4bc8ef809266546f4b6,29,22,17233,8313,8920,30,24,16093,8066,8027
4c27460b5c9ed9581f5595b796721f9a,172,116,522461,108179,414282,189,150,684299,119702,564597
c69621a251248c0720904394a11ec2c1,19,14,5315,1543,3772,14,16,4001,2830,1171
97930f3bf2bb67272d5a3a9f86dd1d42,184,142,611428,101625,509803,208,141,508861,105743,403118
f564bac25760a7940a8f0c5298c7b0b7,22,20,9486,5721,3765,23,16,17870,3741,14129
eef94cbaad1583c87172e420f7dbea71,99,78,136874,38369,98505,87,61,136841,36664,100177
b9a2fbb308d217c52199eaa731506be1,140,82,372074,103577,268497,184,152,643347,102232,541115
4cb40acdc9a753fc555c27304695eb5e,109,89,238325,55029,183296,124,94,300654,57940,242714
f6c5cc646dea1d1616dc828009c7e914,151,120,523302,110457,412845,164,141,528704,133465,395239
0b37d167ab099bf8679a82aaa8d68805,96,75,198045,52013,146032,144,102,260127,41494,218633
0e9867b51d38116c507d8fb14142d4a1,48,35,59454,22317,37137,50,38,74437,18018,56419
3a36beb47dd4fde8111db5ec4382aa1b,26,20,12316,4992,7324,23,22,7902,4907,2995
f1bea3f6764b64074a92e556d35f462c,65,48,106149,35215,70934,73,52,89611,28383,61228
298544cb2c996fcd3044af0bd789f656,196,146,975497,311235,664262,204,181,1069756,206019,863737
8531c8b9e03e7f08bfd1f52e3bf28899,163,110,611520,104885,506635,148,95,666068,96609,569459
db5aef689d5c319cac97255071676a34,196,152,773500,147189,626311,186,121,631211,129655,501556
176a051588041fbbe1ab8d0767041af5,102,89,162517,41533,120984,136,110,233163,45729,187434
c1be74adcacd255eb87925f79df87633,36,29,34337,12237,22100,32,27,33288,14863,18425
3401deb5425715eed96a2a8217d3a756,52,41,73604,23071,50533,45,37,52675,21703,30972
9a88bf4a1887fb0065795806e9a5ff4d,107,70,289549,73532,216017,130,114,454198,88643,365555
50ce9138e77acb39dc332b397338d1a0,82,63,174335,37383,136952,103,89,183109,54634,128475
11f17797b8518b420750cc34e48ff88d,142,104,456794,86762,370032,166,128,460075,124433,335642
ca9ece7686aaf7bdcdecec15717b6f01,46,34,55120,9982,45138,31,25,19302,8605,10697
8e33799b1c2d6f7e7e2276851a18c1f7,34,24,15903,5330,10573,30,21,13513,6601,6912
e9c2c30eeee91ff01a31688c24435395,70,54,81049,21927,59122,68,61,84125,21440,62685
d057b2beb381c74adbd696898778ea20,55,44,56694,27134,29560,66,53,87655,21738,65917
95072b69c2a66bbf3ccbc269a0ca76e1,65,52,87412,23999,63413,76,64,93684,22915,70769
c8261325a91c0ea7f8da4510bb65c9f9,88,60,129441,35432,94009,85,66,137318,33720,103598
b0a1865342d914194fa125c3263f1988,107,105,187279,45872,141407,73,56,129505,25436,104069
e8ff6d6712e2722b876978aceb1f2da0,75,60,142696,45331,97365,74,56,135970,45299,90671
69478e9525dadd630ac62bc5e5abf9b3,71,61,93163,26810,66353,50,40,72255,22874,49381
d9f78fccb24b93425778ead76991d459,28,24,18667,7434,11233,26,22,10822,9373,1449
11e10cefa35dca9c91a59fff9ad8f0c9,46,33,66536,16625,49911,35,25,66649,10242,56407
7997895bd9c5dabd83bd0d71539b55c0,62,59,95413,43456,51957,88,63,127478,33396,94082
8d55e48e55584cbe9793c0cceab820b7,32,33,27717,11078,16639,34,27,20755,11430,9325
f8493474835252efcdb6dabca1d8e5fe,60,43,66532,15880,50652,54,41,56401,19096,37305
282c50ac299b1575b64f988dd062329f,114,85,174523,38159,136364,119,101,194004,43480,150524
88a8d9560c18fa050b66146b42e82a98,94,67,272185,80509,191676,123,81,263571,64217,199354
02b21a1d2c42a1a039ea0cd4420a5df7,104,76,253497,61860,191637,124,101,242981,66697,176284
f5f6ab503dd04e8ab2ff6ff7b739cab4,79,65,102183,31477,70706,72,59,97129,31408,65721
1ab004515f138d905a186719f236c3f6,201,141,637701,155965,481736,200,135,759669,125011,634658
c56341543c88a6c331fbc7f25f545887,148,94,473712,80448,393264,128,81,358616,100049,258567
b2ed53674d92cd285d2d22fd50b30a54,37,28,30633,15923,14710,42,35,50081,16892,33189
72ebd0215ca5026f48e23a077ad25306,62,43,79084,25893,53191,49,45,75864,26141,49723
42a51fc15c124d4ac2aa604fbfbe8f37,46,37,48907,27976,20931,49,46,59631,26979,32652
c5695f49c3866f5a7889751835a96eff,184,141,1135157,190124,945033,247,192,1114082,163389,950693
6a5b6d9f21c544b33589ec1c140e3a00,55,51,69192,24212,44980,99,70,103462,21025,82437
ec1b26a0d3d434fa6ee6bd7a2670299e,106,69,164604,51602,113002,78,61,154621,48706,105915
76d92dfa9d3241251986e9622591be63,104,63,286076,59274,226802,106,69,297562,72105,225457
7cd0817bcd87e13bbb23265c82a0ae24,62,64,77249,22348,54901,48,37,52775,19875,32900
41cc73e97cecaff4e3707bd745444344,34,33,17950,8562,9388,38,29,28178,7407,20771
da6d6e18cba27a9c13d3e1083cfc3481,101,79,157835,37451,120384,78,57,99656,43017,56639
94a4cf80e97a332983b94f8c26dec833,60,44,115623,24220,91403,70,49,122037,21774,100263
cd86f7f2e3de03463155df53524b7695,40,30,54538,21080,33458,52,48,63041,19345,43696
d83276741de28e0c58b9837fc97137ea,58,49,82114,32542,49572,52,37,86818,22903,63915
2849b9b77bf71c1cf764422656e224bd,68,52,129401,31853,97548,78,64,148901,35077,113824
5d6f70dfc4f12964a695c81e32ba6195,65,46,87604,19902,67702,51,45,76337,24969,51368
22de30648d37738704ee2ae6bb281e16,27,18,9415,5074,4341,23,23,8745,4482,4263
911c4c7c4e88f3123cb0a7bb66fbfde9,21,21,12902,5941,6961,29,20,13388,4644,8744
e20f2c1d5cf3ad75fea4a6faf158c6f0,26,24,11021,4644,6377,28,22,14220,5362,8858
f749fe2016ee964754abda2d476dc114,79,57,79820,24223,55597,75,72,90685,29099,61586
4893241b6391039c2680b0bf8e20708c,133,109,568447,166832,401615,173,119,613906,163988,449918
da5937027c5a926062d3cca8f8b1db3a,139,85,351448,59863,291585,121,101,263090,80997,182093
5d60b1996aea702a51e5885b319d1250,139,99,379815,91669,288146,145,108,317288,95251,222037
13643bd2da01a449c5d5003df7495dd1,21,16,7838,3894,3944,24,18,8465,3326,5139
264652ea64067be0f80c22c2511b0857,128,94,261692,58704,202988,124,100,283702,80991,202711
118539c821bbf0cc62cd729438f50959,27,21,7300,3150,4150,19,20,5071,2416,2655
d39a803d014a05654b9dbf3cdf914592,177,145,890998,236488,654510,231,154,944361,156640,787721
fe655b083efb0027d7635ade906a7af3,153,116,293385,67051,226334,80,51,149667,62787,86880
57196941e13f8a2fe37d84eb220935a6,40,31,36047,8979,27068,34,23,19030,11801,7229
150704c1a1d676c75d17ed8d1dfe4ffd,89,76,129482,46192,83290,74,62,100271,38362,61909
c3fc822f577ede94c37d768646f907ee,88,66,160436,57053,103383,108,100,221768,47321,174447
4bf7a84cc32d57ca9c4d30809a35e738,123,103,259914,59402,200512,115,96,210554,62463,148091
4a8dce80e28d0120c354dc5c3bb3043c,119,95,327055,77517,249538,132,99,347069,71528,275541
3f9198462a7fca56e9c3d9f9fd3f2e19,45,33,35164,17231,17933,51,40,47652,14034,33618
7364d66fde9569565b06154b2f18b4ea,19,14,4466,1795,2671,17,11,5332,1279,4053
cc4c5046f6b3175aa0bd2f78c13c1587,103,71,207455,49941,157514,122,101,237597,50858,186739
3e82ef0e0e14624066aa444c71d47737,33,24,25719,10765,14954,32,27,28401,13716,14685
ae3e7e0be8d5e3049bde9f0a1add1b46,81,57,157286,32936,124350,71,57,101999,32759,69240
3c1305d55a4f4bb11ecd092d2a2930c4,203,150,543493,98664,444829,158,132,451777,109885,341892
5bf625dc1c354662e6e5a7c0a65e6345,86,71,165354,55103,110251,98,69,176463,39346,137117
a985a6ef28a642b9cbdcf58aed95895a,113,86,298494,59559,238935,151,121,328759,64088,264671
712a9c3a07acdd5e51ee54d94612c312,69,56,85127,23498,61629,53,38,53022,18730,34292
e873f7bc17e719b409b8512857f6e854,131,99,303730,66084,237646,116,92,300015,64485,235530
7659e2b12142782e0a008f3e4d9006f1,39,32,45132,9341,35791,46,41,26506,16570,9936
188aa1a2474f75d82f7ef401ef3428ee,25,13,5275,2813,2462,25,17,5254,3176,2078
acc8a15da767e29a3bb12fe1df240a00,189,122,904543,87369,817174,208,145,753754,165993,587761
34d8d900d5dd3146fe4577c9194044f3,66,59,75569,23933,51636,66,53,59791,29467,30324
2071890a966afc0fee25cfd9a58a1530,132,105,299290,105256,194034,209,155,489351,87888,401463
b775fd57f925bc3f6c348dfaf4c91c56,184,120,592900,107282,485618,226,163,898071,141561,756510
304a5be56666e0ccfa52b9e1026a10d5,89,70,161527,38769,122758,98,74,110150,41977,68173
e25be02359d78b0219a6224e6fa4c6b1,33,29,31467,16012,15455,35,35,34140,12859,21281
ace03c26340ca70142d1a49a8aff08b6,21,14,11691,3118,8573,19,13,6668,4968,1700
dd351d171eff178cdcbf49ac3427b1b8,30,27,36931,9662,27269,32,23,27708,10983,16725
ab8e16f5f9de39bb7f21dc16465ba161,74,57,105865,30585,75280,64,49,102988,26946,76042
fe3864b14f674ec028b669d97e7efec7,126,91,331651,110644,221007,116,84,302678,81754,220924
2d709c2fe97f208fee4135fbbf759b3a,111,90,185307,78413,106894,97,78,202545,64110,138435
d1df7a72823692f6607a09eb80d92db5,54,43,91020,35160,55860,67,59,114010,40330,73680
ff6770419442467b6e6fe20d4c1bd602,86,71,234086,45774,188312,113,92,283223,55330,227893
aab53bf53259d85b9a7f55fcea81099a,145,107,264683,75532,189151,133,105,237975,60097,177878
99b5563782d1ce2d6febe7cff836d4ec,142,111,352995,83662,269333,138,107,417195,70467,346728
02f08ba43585a3573f5af25ec35e9723,101,78,206230,52425,153805,111,97,250124,72570,177554
baa2ebfda95e270bc220b791927d452b,31,24,26471,9379,17092,34,23,18618,9443,9175
b52f65ec848079755f6a4d63103e2d0e,133,114,354727,95572,259155,168,118,497053,73206,423847
9d8ea8123021afebcdbb533501300194,37,22,23272,5400,17872,34,22,13816,7036,6780
3efec2452eda59d25c20f3d6d8a2a9cc,45,27,25356,6624,18732,32,31,18590,8818,9772
e07a0be3d8056c916ece52695603ac96,89,64,165049,57783,107266,102,83,189433,54125,135308
9b980d7abea497b1b31dd6d6cbe2dfa2,83,59,127676,38689,88987,91,75,122860,36067,86793
c273b8d2836612f7ededbd933d63a328,151,121,256355,65689,190666,102,82,152609,56815,95794
97ee724809a589a5eae3852c48a15b9f,18,11,3493,1126,2367,14,21,2140,2464,-324
054c98e8db3ae0e6aac06f8b0432303f,60,58,76639,47882,28757,124,78,170710,31234,139476
72d71f578c9a7a1911808731614292d6,198,162,665123,116585,548538,171,132,572283,88161,484122
931848f83fab27fdd5a3296f3cece6f9,41,37,32767,18059,14708,70,51,80598,17102,63496
cf9a3a42dbd9a046659089686e4daae0,105,81,125478,49485,75993,102,69,165521,42071,123450
f8d21b863b7a5cd3e101724f2f3cdcaa,181,153,627515,134017,493498,128,115,500673,137563,363110
723155754adf51a97128f34a227e98a1,47,32,42834,16058,26776,39,28,35849,17429,18420
38f50de4cd2b08321ba25eeaa222ea5c,22,18,20358,6838,13520,33,22,30875,7064,23811
cda2bba8aa472176dba16be773c404e9,60,67,146251,42775,103476,100,83,167664,45498,122166
b102d5d7cfd767f969dae46551fb8de8,133,116,401382,115447,285935,132,116,368046,87169,280877
ac66707317e7ad00668ec65e5cda5a9e,206,114,577550,107595,469955,189,120,648891,120887,528004
2f70a3d12d719a94bc3f20fc88f5a483,100,77,209795,52749,157046,117,88,224769,57843,166926
b0b37d6805d206cf7cfc6640532e1c86,128,94,293921,48013,245908,111,90,191164,65752,125412
5c651fa05b855e2377e71a96cac2238f,126,103,283622,60170,223452,132,108,274889,60016,214873
aeaaf0d96250bca7ea1ee321e49a3db0,138,107,415927,83522,332405,179,141,632770,84726,548044
4a56482c3f55affc00a965e23adc20f5,43,33,32926,13190,19736,47,42,49700,17668,32032
4894657715aa4b44690b1ede70883770,62,54,91065,26648,64417,70,50,101148,28484,72664
3ac267bcb5bb0d20cda1a2924640766f,199,144,607672,116259,491413,178,129,620956,134367,486589
1804ab4dacb6f2360b81441b33558bf7,188,116,493196,123102,370094,182,107,547484,93672,453812
60bac687bc28c7ac26a3b9c39cd86250,180,116,402344,116130,286214,162,114,495526,127533,367993
3a9416a697db887f9bc1a5c7a04be7c4,114,77,312507,47807,264700,140,113,365832,65124,300708
0d051570d1430c27a501192cd59dc28f,154,96,356023,70335,285688,137,104,279940,67259,212681
e819b22cc56c8a9a14306b89048a933c,124,86,288509,66102,222407,160,113,384732,88225,296507
d73cf1bc65117d535ed3c13989c04d9d,103,80,300252,70382,229870,147,103,354762,59214,295548
20d92d6677227888d845fbdf13caf8f1,124,103,290382,62857,227525,115,86,284004,67419,216585
ee307660191b12a9d659675d09cbbfac,25,19,13542,3688,9854,28,17,10477,4122,6355
6025e649ea70cbb29dc5b2b09d3b005b,47,38,56628,16252,40376,70,70,64064,28105,35959
d6b712b668e1e6a8894790a03b442417,43,34,41863,16030,25833,35,31,36275,13946,22329
2c428e425d319d52182d23f213c2842b,26,22,11099,6352,4747,24,22,15010,8279,6731
19bf8bbe75c57625b6a460d9327d246c,50,38,42768,22190,20578,49,38,48637,17580,31057
0db835f64319aae3122af7af21466688,38,29,49354,13964,35390,43,30,41511,17066,24445
026c6da2b4c586d7e4461d054ed0cacc,29,26,19764,9382,10382,35,25,22689,9141,13548
602ed17f263149ff13c6f57bb8e40021,33,22,18899,8280,10619,30,23,17222,8296,8926
fe995f137782d324af4acb4e777d89d0,37,32,20222,9245,10977,34,31,20757,9909,10848
c525e46b7f9788ef286d17009bf9f966,174,107,388919,43135,345784,109,76,241280,69428,171852
581bc7e3b408206e5325727b45b3b131,106,82,173725,41667,132058,73,55,105950,40245,65705
5a42cb2353d65ac6a9b0b942cdf8c0c0,98,85,161861,51797,110064,89,81,133908,45618,88290
a76a8f46ad98bc2252e7a0fca2751bc3,70,51,100899,25801,75098,93,75,142504,35500,107004
0d8287fcc88b89349f93836087cc9ca0,42,33,23325,10757,12568,36,32,22567,10783,11784
d90a7e2e84aac448e07db4831490b749,32,25,13731,6362,7369,33,27,23872,8394,15478
327363401175690bb2110dcbaeea32aa,133,102,367778,80650,287128,114,93,335018,73254,261764
89a1092f28d458498372c4ca9a9ca2c5,84,65,162725,49156,113569,77,55,167660,41037,126623
93bbe9df4fe1077374a606ca950bae9b,3,2,254,90,164,3,3,94,254,-160
8e09513a8500626b1403367fc9fa89a2,170,113,438326,76647,361679,156,136,484535,99675,384860
8060e2f5ff6ab4ba15d9493e3f968a76,126,72,342467,67810,274657,103,83,237342,68823,168519
13ab2763e2d2eea2f9b7259aa1f708da,24,22,12214,4567,7647,33,24,10757,4621,6136
429f697d9676f637eaa4f2678b43acaa,100,73,191613,62899,128714,128,105,259035,62011,197024
9bae67d14d950856a9693b7efd9bce3f,113,82,225881,87600,138281,128,102,271444,85644,185800
e0ef642b5175fdd36c62899229e1709a,131,89,348588,64141,284447,143,129,339135,84689,254446
6c5b0a6b01ab54c994a6cdd2173e3789,93,72,249120,62081,187039,118,97,277905,60917,216988
f4bad70f4268c4cfdb4b2390cb65e60a,143,107,314952,67179,247773,122,94,240270,93277,146993
396e9431a212d6bf704631987aa14b94,30,21,14842,5001,9841,26,22,10434,5340,5094
8c251cfe95cecea8e6472cf17c6f85cc,111,85,205678,40176,165502,109,79,188161,44696,143465
ad500572c082d90c49bd48f7d3b633b6,1,5,73,420,-347,5,1,420,73,347
e10cd02eb0ad825fae76f7b97b134c2c,119,95,286906,86907,199999,125,102,299295,75473,223822
8504fe3eccb5721f16654180bdddd8de,115,86,201831,41399,160432,126,95,250381,49045,201336
01cfc0c0d74b564c9677269f4095f1d3,14,14,2518,1262,1256,12,9,2013,1524,489
6b8445dda6e6993595bcda940c166489,154,120,253020,82702,170318,168,125,354854,75523,279331
73c15211ee974005fc6732fb32155b6a,10,8,1716,1535,181,9,10,1917,1082,835
a3abd5cd37ecdd38e2cfc90ee50ebc74,47,32,70102,32634,37468,63,56,102267,32206,70061
454e7e0755e312909b4438ff1cd20721,158,107,343132,54317,288815,156,114,355164,51981,303183
59f624326d86b1ebbb2451cef05f7d87,195,130,856560,152124,704436,249,195,1005823,165563,840260
25d80f82af32c1ae3f03e6a7e193a26f,150,104,364086,67475,296611,176,140,436678,104423,332255
e743d44593864b202c63a692cdf10efa,81,62,91274,28395,62879,53,38,56445,17646,38799
3305d89e51a73f1f177add116b63c1ec,96,83,182921,69439,113482,107,83,209309,63367,145942
6036683d6ad84cd38986191a32035d6d,34,30,33852,16731,17121,48,42,53293,11979,41314
f885dfcd4869d03867c4942eded32334,11,4,766,351,415,8,4,591,273,318
da830bbc34e5aa16c5f0c8c71373e585,85,71,144747,47385,97362,88,75,160762,43791,116971
3d04826eaf0297d0b4ae0705a50b97be,120,98,385983,62398,323585,121,84,287993,69326,218667
3e3b84fffa9004622a9c33ea535fb7c6,89,76,178154,41635,136519,112,85,177265,34141,143124
e51b71ac743daa00e57233967dfec9b3,54,46,69680,22046,47634,60,40,75872,17359,58513
25d1828d18ed2cc25428fbf0a5b2be44,164,110,351308,111442,239866,113,95,322543,98952,223591
e77641c963c5464affc55f97f5ca0513,171,110,363277,83259,280018,113,99,283448,104029,179419
15093a7676abfd2230c498e8c4ed0329,44,37,66696,35019,31677,51,45,79031,26338,52693
08ae4a03694375fc935071e2e9311153,151,94,318560,98030,220530,120,98,293887,100981,192906
a94e7a03f4ae7689fdf7563a88afdce0,21,16,5411,2282,3129,23,13,7297,1291,6006
75ed119033f68d01f009e664bb4b27f3,130,98,334092,67924,266168,136,99,328765,53857,274908
83f0b8b2e8f643b48ca8b840823f78b8,37,35,35951,11852,24099,39,31,28190,14186,14004
0d8e11b43766d135168a91a8d6ac7dc5,159,115,337895,69959,267936,83,77,151985,88970,63015
ef44d16cbdd2b465551c1a75c62ab897,182,111,624786,102937,521849,172,84,562728,122814,439914
52b69c75ef2be7424934a3373575b525,180,151,522738,103020,419718,177,136,470292,94164,376128
9342c07d2c324a84e002473ad43a7b48,92,66,131183,33821,97362,86,64,104070,32622,71448
5b89d4455fa9ea5d8606c41700f6d74c,88,73,144538,39323,105215,68,47,138394,24000,114394
96aeac01befada4af354f7c9cb50f007,29,23,14051,5163,8888,22,17,9862,5671,4191
ec05182c7a9235833e8f8f134bd9f4c3,163,98,465035,78447,386588,180,124,590924,104541,486383
7bbb41e17065d1566edf90578a67098d,142,126,479777,128429,351348,148,117,431802,132040,299762
f22ff002b3b0d7edc7f843468394c99e,61,56,79879,19703,60176,39,31,49135,17150,31985
d7764867bbb8cb307e5b1e100956e7d4,192,136,807633,195506,612127,213,160,703104,191817,511287
d9c0c079a687e8cdfef1a34d8b9f4719,119,109,368739,120437,248302,123,99,356110,107608,248502
ddacb46699fb2144b6329a1a174bad08,94,74,205014,50653,154361,119,105,305722,63002,242720
5698a6ffd2f7487a826dbc49961bbf0d,61,47,80409,20408,60001,73,48,86770,23272,63498
31a4f3cf1d6b264167774a9132e17327,114,82,294507,31955,262552,102,89,190607,46399,144208
fd962a519282770601770456668a258f,60,50,61961,24743,37218,71,52,113977,18220,95757
c734055a4c9e39b580659a4e41f7fcd8,77,64,114316,24814,89502,79,60,75680,23213,52467
00b7bf3908940d27dee77762723c8c4f,170,134,566718,132698,434020,182,137,795064,113598,681466
0ffd34bc71b4b108be229c691c33b45e,170,132,433228,110350,322878,181,134,508976,82214,426762
e0bd8efc4ce07fd7bb0e893f128138a1,110,90,250171,66137,184034,143,117,359966,67736,292230
483887c0a92bad5cc6d208496f8d6aba,189,139,593049,120196,472853,139,111,529600,86068,443532
a91372bf0022837d541f15b4e84c3706,41,34,37047,12094,24953,56,43,38121,14356,23765
302c141254d31eb32ec1870f29db40e0,272,181,803232,138036,665196,174,154,910508,116520,793988
c558b3fbba1daf9354c0d632a04f8e13,139,126,362157,74876,287281,125,87,270826,49315,221511
048a475f1326056424bbfdde35ef78b3,30,21,16220,7478,8742,29,20,17121,6057,11064
700e9e1a8a91cfd8de5663af518604ce,30,22,11559,4338,7221,26,23,8369,3987,4382
50ce8517db67b73f4db4a1903e55fe1f,144,96,236783,51911,184872,112,106,182302,59056,123246
ebbffba659a2f3699293b8ba5c675673,181,146,687086,93827,593259,172,118,477201,109005,368196
dbd94463ad1b42937382f7de6f008b48,189,148,1253143,195232,1057911,193,151,941312,210344,730968
45ecc01bdf4c13b74c5ffe53a6aff74e,80,59,167045,63420,103625,93,66,204992,64577,140415
921a896cfff8866289fd3cb5b67e9afa,34,35,34976,16183,18793,40,28,33174,13012,20162
bc3bb75ea7efcc0b4181c676569532ca,33,24,33925,4761,29164,35,26,21525,12231,9294
e62ee5fba2205f1d9747f9e50ef84da8,186,106,347010,73176,273834,119,93,297240,96677,200563
bbfd8a02541ca12bb1a48e1cf69c1a76,182,118,919944,155020,764924,185,118,694119,110669,583450
82225032e03176051dcf08959d97290e,132,110,306403,48240,258163,141,116,365582,59208,306374
6f7f78ca78beaab3e8605e681785b249,198,154,649608,127737,521871,186,112,553139,96158,456981
d31e51926364806c4d72bd248d750e6f,111,88,213310,50790,162520,115,92,210588,54357,156231
61efe2ea981b795875fab66688e80af3,196,157,523574,116535,407039,146,106,344010,103250,240760
2c8b6ae6cde665647b20e2fc2fa60613,59,55,83053,50186,32867,104,76,194641,37072,157569
189c2360a8a069824757c10aac7992bc,161,125,588825,113847,474978,151,118,631460,109277,522183
2d1786c0cc1d32c672bd33fd8bc7b7d4,36,27,15462,6998,8464,31,27,14611,6898,7713
a5e2d4bb6db24919e76b82a55e3bf6ac,112,75,176303,42134,134169,75,58,133347,35471,97876
653c95a6e1e917911e470cb47975a05a,58,43,91400,22129,69271,72,61,102984,28134,74850
28be43967862dd9abfbaaea155f364a1,33,24,21809,6077,15732,27,20,14669,8788,5881
28b2b43e49caea2ddb540c8a42c7290c,55,38,58055,10620,47435,62,41,80891,13630,67261
b19b9b630fbc68a54cbe226d6a479f00,24,19,11394,3431,7963,18,17,7552,3076,4476
e62212901d0351f861134446f7e2e2ef,91,73,137508,40617,96891,63,48,79770,27731,52039
86d6ce538b4ae2abf3aa03154d74ac86,59,50,56679,20211,36468,52,38,63108,21855,41253
d4173ea8f11af59936356ac6a1527afb,113,97,209938,42054,167884,66,56,101374,38232,63142
c24c66dbf2fa9b99682fc4932749609b,82,69,227409,49738,177671,47,34,119165,35633,83532
38b45ce8c95899c37f0fa8cae4a5c25e,31,22,20259,5810,14449,32,29,14840,8929,5911
d48ab7b7aba529bdf37c6e828c12ef01,154,94,448276,89499,358777,176,114,460428,89564,370864
9d27b3a7f4eefa0b63c96c82a4e97b4b,105,79,180458,36191,144267,85,70,128760,38771,89989
6e9db65f08e127753228445abede6807,106,91,159695,33524,126171,88,74,129675,32500,97175
93bf5032b7ec82530467bba3d4c96a8a,122,74,253254,52402,200852,121,99,222251,48004,174247
f49e3aa27ebb18717798f4796b4a4b6f,93,78,195015,47211,147804,119,108,283054,47679,235375
85be9d65fbd02b7f6af642b194f83c26,75,62,106462,58259,48203,74,49,161010,29111,131899
882c4b41b19ee5c73eacc25eadc39e86,152,96,506854,105638,401216,151,121,503057,113214,389843
bad8532db59f3b622f9b56724747f060,51,41,67949,24545,43404,71,60,103545,22711,80834
b2c7adbe539a341b5abe7222a78fe589,132,107,322218,80948,241270,158,116,426919,61202,365717
e3a6043d2ba1f47edb9afa7d2bfc07f2,137,107,440509,119737,320772,191,165,594729,146244,448485
9dc69ec366b00baad3c72eabe986b001,180,127,643483,132137,511346,222,163,824910,150891,674019
3c80023eb89c9b8a43729a689f767999,163,110,363026,85827,277199,138,109,363667,75391,288276
683ad974b05b418c956cced7e438925b,125,108,364638,73855,290783,103,79,269706,67756,201950
9e688bfad68bc598260301488f6799b0,150,107,600880,78738,522142,150,109,416356,89743,326613
add8c3786603dd84deb070cda6a6ccb5,61,54,73585,27867,45718,51,43,98442,17353,81089
1026cf727c840060bc318afb4ea844fc,73,63,83773,32161,51612,76,71,114856,31300,83556
8b9d6eb59a5bdc5958c0c6d844e3ec18,80,55,172616,53691,118925,114,86,218223,46538,171685
7dd959a4fc907d1fb4db5ce5ed0df112,132,86,295702,92863,202839,83,62,174254,88080,86174
ae9e9abf0c262590592be0db6d9d59df,101,96,206993,61535,145458,69,60,144856,43998,100858
a39a6c8dadc58d1ff97a900a295e8f3d,162,92,447366,86969,360397,176,115,494573,147504,347069
b31e63bcf50541c2942ea6b2072922c4,125,81,244021,30281,213740,75,68,122674,36348,86326
088b648cd12ac604a58ce140043bf579,47,38,36793,12516,24277,38,32,26558,11651,14907
5a76b67f17f7455c94f2ac62dec8ce35,151,114,581585,137828,443757,188,135,700263,125819,574444
58655980bdaf2ecd2043697fb05582ed,50,32,68945,22235,46710,51,31,68166,13790,54376
4804d41953cfc433b12254e497111d7d,77,57,98132,22756,75376,68,61,82286,25050,57236
fc77997aaabe63e94786ed9b2267c720,29,25,17897,10384,7513,36,23,28022,7508,20514
e9e3ae6116919937f58083e5932dea77,95,77,212901,70131,142770,179,139,424137,84129,340008
55eaebfc160b29142953ab964558ce33,132,102,320725,83579,237146,87,71,261628,62439,199189
a5e2a89510cef39a0781a83c89e5ece6,59,52,97631,29819,67812,95,63,166925,30331,136594
932c65d7901627ae1fe72357f0bbe59d,25,16,6728,3776,2952,15,15,4942,3743,1199
fd823c273f57835f44aceb8ab6bf5854,112,94,220743,49416,171327,109,80,200390,55268,145122
247fee0d8b59cfb3fe486f796a3f4a05,38,31,36350,11125,25225,36,25,36976,9506,27470
c022421f2142bb9be99f13724f52b57c,64,47,119368,40451,78917,96,83,196309,43591,152718
acb62944716953f3ececf85f2955bcd1,84,62,142325,33915,108410,102,68,119877,32324,87553
f0fca69a2bcaf2927fe4e7170a213814,69,54,85822,26560,59262,95,67,116706,26815,89891
23461a0521642e1946af43d5d1cb2b66,107,89,199344,54485,144859,126,79,266316,41097,225219
44f933403852a6c49936cbeaae31cffc,98,79,195467,55628,139839,121,93,237557,59461,178096
ff21cb5da5d2bcd8b5b94216ba1d30ea,59,51,89750,28069,61681,58,40,77103,25691,51412
b75a4337b460cd4a195c78ea3a51ca5b,79,63,97106,21699,75407,48,41,69144,21495,47649
2d8750161a50906174714a8eca5bd2a2,4,7,408,618,-210,9,4,1138,282,856
e69c5d3549f1715a6d3050e1445f702e,34,28,33597,9142,24455,31,22,25668,8790,16878
e732c48198d6215e180a104323447660,185,147,761498,147313,614185,186,142,647179,133864,513315
a1f96e3423f84f30af2ede3d9b314f8e,167,147,607980,99500,508480,175,140,573609,119621,453988
5b937d6fde482588ef4912fbc3712137,86,68,132580,30293,102287,79,72,119418,39704,79714
40e6a3706ad78d11c33e2b9a2f6f07b5,137,109,477875,103903,373972,188,128,850789,107098,743691
c27cf3ad65aa26b213533120b9d0c4ed,193,123,616867,100643,516224,184,141,722747,124716,598031
a45f15faa1ef4d3f4ca3562f1cdbf13a,87,74,128132,42593,85539,105,76,157663,35486,122177
32c59cba8f05e437f505879bb9884a38,124,103,276538,73028,203510,136,118,276035,85652,190383
ee771d2213a3996ea8dcbb9b7fd0e44b,72,57,128655,21913,106742,90,75,116825,31788,85037
b9f10ee30af0afe7db56bd766153ae93,53,42,54881,20439,34442,59,62,68277,24260,44017
9a47198218fbb2da49d5ef6875ad4fe4,55,46,98033,34346,63687,77,57,117536,39253,78283
e422b5927db54ab300498055ead5eb28,94,74,145855,36227,109628,78,64,109441,41665,67776
59345669ab2f555d2630fa975b716805,27,22,19288,8416,10872,30,17,16250,6865,9385
3b8207403c823c8a4875f7298e3bab16,108,71,256200,76871,179329,152,102,305619,57258,248361
a024f1de3ae443a336baddecfa4f0927,164,109,473784,136390,337394,148,108,602027,112536,489491
3ec72748578113e340700e839c584ae7,83,63,115991,47766,68225,119,82,166051,36515,129536
59190fee267cbe09aa52047a57223219,73,66,110367,34859,75508,55,47,72276,29775,42501
5fe2a02ff76146d7cb445d3fbd44ca3e,80,66,158905,50227,108678,67,55,110998,43200,67798
296ca5c0d27f26f48329913c4bf58f46,120,67,123775,41862,81913,95,56,148014,41538,106476
7506dc74846a6c339a76612c0a024588,45,42,57736,19617,38119,59,46,70127,19739,50388
c22966b8bcdcd55fc63382fa7bd9ccd1,40,37,59983,26104,33879,63,49,86326,26900,59426
57795c0b25d12ca6c7c4e76f442512b4,35,32,21452,9472,11980,32,33,18732,9555,9177
9ee24cd5073ac4c971038b0e8a82cc1a,75,61,106278,34676,71602,56,42,83551,39641,43910
52116489732d6295945fe45b7e74eb68,170,128,541499,122196,419303,180,151,569056,109938,459118
1d4e3d778fe6fde1281d19c532888c40,157,95,442175,79533,362642,219,155,549524,97274,452250
cf0658e21bb333816544e98233906d61,1,0,37,0,37,0,1,0,37,-37
d56d08181660d5c5738a350b2937ef14,152,116,409880,111851,298029,149,106,377208,107696,269512
7aad827bcccb3d69a8cb1504e6713f35,35,24,21809,6560,15249,31,25,17840,8061,9779
53a0e8d752bd2283a06e2d743fe5b185,20,15,8051,3484,4567,18,17,5840,3775,2065
85bedb56a83c07e8888497c7119abe09,49,36,61325,16298,45027,58,36,60673,18371,42302
a1ffc241e588c898679b3b651f8d059d,60,51,78375,26963,51412,59,47,94462,29385,65077
fe6ad370c9a6a51749db6a0fabf79d33,36,28,16310,8098,8212,30,22,19522,6107,13415
403cd9ccd5eab3da1a103c1f1aea2179,34,29,25208,10080,15128,35,33,20188,9782,10406
b0d5fa530f852676e62f926c22f31f09,74,55,124166,39259,84907,76,64,112083,38127,73956
921fe8144559f229ffa98909501394a0,25,22,13358,5720,7638,26,22,12643,6817,5826
4b769e8780d89c440eb4a7b2a3c07736,48,43,54108,21041,33067,53,44,67407,17370,50037
f35256f68cd8ef0b7e9451c851f27e44,56,47,62755,30468,32287,93,83,137145,37917,99228
1aef1c0123c4a4f50044ce967f1f4334,58,32,63708,16853,46855,48,33,65745,15452,50293
86c088dc12a2256f99a1ea8fad0ccb0b,138,114,348822,81989,266833,138,100,309726,78763,230963
4a0645e55833f969aeffc038812a7558,131,59,136313,21722,114591,76,57,128013,23445,104568
7d0abc6bbc5ee50e2aa6928e61e99616,44,35,31724,9855,21869,36,29,25094,11357,13737
22d3d09281ed1cc60161383922aa9249,52,40,64474,13211,51263,40,22,29674,6687,22987
b21182bee60eeccbc7a3fe4cf468e96d,33,26,33853,14325,19528,47,44,54841,15394,39447
5a6e29a80eee0d029a40652438d54354,169,131,541878,104705,437173,185,131,615497,81817,533680
b7628f26a25dfcf9008cfd87cbc430a5,143,105,563265,132377,430888,184,143,797099,116445,680654
d8b3798118be5137d12a45bc91689411,40,26,41699,11600,30099,33,26,30500,12735,17765
112efd9bb8c37e2038445cae0fe5edcf,168,126,356303,84536,271767,194,140,634240,65936,568304
98a4d83ba692f5a01cbf961b6bc84395,38,32,29938,15195,14743,41,35,37438,17103,20335
b856e907a0dcfa563973637f798fd170,45,39,50963,11508,39455,41,30,21677,15957,5720
4ace2ebc5944e1c832dc93a28ad964b8,33,19,11862,3775,8087,28,20,8802,3519,5283
e3bdb07eb5010ebb99c600ad6c717408,157,115,496738,93472,403266,144,101,366461,90468,275993
0051fc32239a944fc961b28f52b74ac7,81,65,197811,90458,107353,137,92,251526,92124,159402
752ee5e3aaba2ef4a25fb28778b3bf26,39,40,65680,25068,40612,40,34,68568,19064,49504
aa22206586d8fc34c5175df6c6641f41,177,114,425363,102959,322404,120,88,301392,81997,219395
ea136c5395af203f7dc10401ced453a8,84,53,115328,26547,88781,84,55,101734,24623,77111
b8f29cbad2b8f80becfa80633693542f,158,119,379081,76471,302610,137,107,454926,84626,370300
799046496136791816724da7733ebdce,102,68,220677,48368,172309,117,89,226497,47757,178740
81e2a75c60b9051df621870940ec71e5,13,11,1422,1029,393,10,9,1372,948,424
d9b3e15de7aa127fa51ee171127025e8,19,14,4015,1977,2038,14,13,3085,2655,430
5eefdc689126308b651341504bb5c1cb,45,38,79709,24135,55574,58,46,74421,32772,41649
6f08349702f09cd85231cc6adbd732a1,92,66,154582,33463,121119,85,65,118200,26104,92096
327b5057b9d0fe6932de022a2f0d3294,11,4,1653,994,659,6,8,1243,742,501
aff95386610aaba8985e321f57edce7d,234,155,1278872,231361,1047511,164,123,1112714,175243,937471
986e67079deaf0186b338105ad4e2c0c,244,150,908437,139141,769296,194,138,1069855,213003,856852
115d2d1663925c9b10af6849e332e52c,34,24,29793,11512,18281,34,32,35614,11547,24067
5e2528d9df06c23b531c313ef953ee13,136,109,249111,48003,201108,71,50,169621,23716,145905
821d100d29104f1268d7bddcf63af583,23,14,7429,2291,5138,14,18,3268,2714,554
68082347b8c38f668b5889839de0e34d,138,107,355533,72259,283274,111,81,250077,77097,172980
76f80b6236292ac011579d8cbad6b72a,148,112,389305,107525,281780,158,120,394972,108579,286393
e678763a1f5633a27145d23af984a3dc,124,84,204544,48577,155967,131,88,216999,39591,177408
bb7c5287f49368418d0e931b2c8704c1,37,36,40875,14382,26493,45,28,29426,13467,15959
d2cabccf24587c9f18bac478bcd0b853,217,176,995756,234138,761618,194,145,942697,188033,754664
9b840a5c53bbff90144d58cf40137e5f,144,101,492817,119880,372937,173,127,589056,113937,475119
32ad9ede1508261c8e6b3723d5f6ad10,10,4,1036,226,810,5,8,365,592,-227
65c7e51e975ca73163ca2411fe62cb77,80,74,186207,71942,114265,136,114,334135,93476,240659
bbeb6592749d7aeaded793a5cb100593,120,97,248787,67952,180835,108,81,243502,58990,184512
ce35a7efecec592ae82a3b715e86f034,134,99,371806,85028,286778,97,79,277395,106044,171351
b1c0376e90e04ea8c3ce5fdbd262c9df,36,34,26883,9613,17270,45,27,29818,11079,18739
0041898b9c6d927ccfe6b3e3546bd18a,27,21,12710,5286,7424,26,19,13890,4077,9813
bd277829c44f44f558eb73bc48a335b2,75,61,102318,38787,63531,84,69,148644,40013,108631
94f33ad7eab4de02f5bc87465ddacffa,110,82,250987,60069,190918,129,105,295203,63770,231433
e0a1e0e4fc9655a5e7c2a0e2edc5abea,112,89,257131,48401,208730,98,71,134978,61526,73452
7f53e022dac46fbd8fab062db63eb63c,106,90,173149,45909,127240,153,103,248143,40156,207987
302e0d04c942f54aedff42cb0c887320,95,64,142609,55068,87541,79,51,133434,38129,95305
311c7146c70d86e09027c07389b9ad35,19,18,3428,3134,294,19,22,5697,3033,2664
357e3421f48a9f47e8053cd4017ce4b2,98,58,187653,39320,148333,111,92,244075,58061,186014
35f012241fdb19644bad15a28d3bd14b,273,151,1236350,179670,1056680,247,166,1439912,228923,1210989
9ed2d64e9d4d1e2aa48098c6f42a487a,16,14,3961,2140,1821,17,14,5579,1815,3764
f3effcc8600e9ff322087943c6179cfb,51,46,65263,17024,48239,71,62,79316,19296,60020
c308e21f74e8d84d164dc676cd3076d8,139,97,266896,53773,213123,93,75,165976,51750,114226
5dcf5990ca850fb48a289b879de618fd,91,71,190154,66623,123531,81,60,203527,31471,172056
8d81c9354052bddea63450349b16e822,139,101,387725,205463,182262,172,115,568763,88810,479953
0bb5134d4a847cbf8476fd01dfd3ffaf,17,13,2489,2051,438,14,9,2530,1460,1070
37b0cf8a074cfdec19f80d378e8c51f1,63,50,96980,30431,66549,82,71,115075,30670,84405
dc953e220c07be980fdce90571067dbf,133,101,465863,105877,359986,177,126,458418,113033,345385
66a56eb9b95a8c1f89ca4b1d69364c07,49,43,48550,15889,32661,34,34,38343,21274,17069
577d13b12d823d36223c5e24ecddb68f,4,6,268,623,-355,6,4,623,268,355
839c81b8054b37e1dd562373a8820e52,149,114,395385,108969,286416,210,137,566987,102765,464222
be694d09cd0b152b48eda778ebf5677b,162,111,519576,95333,424243,141,111,409056,137041,272015
db4f9cce10bf39c3b6eb9276df6aece6,186,105,366218,71150,295068,149,108,476814,73665,403149
8d7e340c20a3587e8a475d2e994a373b,137,114,343541,58128,285413,86,74,179153,65145,114008
3440011d149ca67f273b1faf862a45e5,150,121,480368,100034,380334,137,117,471997,91306,380691
320dc045295e48d6bef0f8ec01d86ab5,140,111,460001,130368,329633,209,135,813954,143841,670113
a0da57c5bef781d8c8ac3930fb8e6e4a,135,115,325806,65647,260159,127,112,338121,65547,272574
0af93c7a58d28238a9c50183962924a5,179,144,635088,112136,522952,177,127,556113,144137,411976
194aea8d4df35d48648089a79cebedc3,21,15,9819,2975,6844,23,18,5532,3520,2012
4b0d0386e26366cda850ed9331667355,97,85,411194,156763,254431,128,83,414294,116121,298173
3699c05ce641cf463907f4daef2bbffc,83,62,85981,20165,65816,79,47,85277,18665,66612
00a9b6a4eedacfa1ef25a6686886487e,80,68,147696,54545,93151,56,46,119564,42147,77417
a9952a2df61bb9cb21dcc6f89786b456,40,28,26536,13386,13150,38,31,36989,10557,26432
2909acf1bb426938e6380e5242af51e9,26,14,7400,1312,6088,20,22,5788,4177,1611
5899d48d821a67c4032db633a5f0d35c,174,142,744737,191674,553063,194,157,822333,145210,677123
3acdaa2b6d57b18966769ef23e195b67,129,118,401917,65565,336352,116,93,288056,82293,205763
c5e2c0b63254c1d186cdba95ec322ef5,175,121,569125,102050,467075,172,129,445731,96477,349254
6ec005711eda9ec1f9b41de8635b53ce,92,78,113339,35942,77397,78,67,99849,33794,66055
5e123d1dd4aeb48ca9b8cea2d9a53462,104,76,220257,100314,119943,172,105,469549,70674,398875
df2c1c11108b7ab5d4ad25508370892f,224,167,1028842,134764,894078,244,169,1166824,126986,1039838
5906ee73ccaeb8c5a34bfb96bc79d4f8,116,91,243744,57630,186114,105,79,222950,54514,168436
45f98f2153e8d38eb03c53f6477542c1,150,121,505590,114098,391492,163,141,511143,125675,385468
75e75df9a9940283ff9a62f251e4a27d,38,33,28336,6694,21642,34,28,18493,9696,8797
e8f92e7893606234a57dfa810e16ddcd,48,39,85585,33717,51868,82,67,137471,27725,109746
46e3ccb6f69c181416d7d22b957db3ce,156,130,419278,131964,287314,152,117,400158,88161,311997
26c570ba1e1a498d6102aecf2d85aff1,59,47,90562,14901,75661,66,49,65936,23747,42189
f755373c75468ad2d0cd001c6df5fbd3,76,63,133428,30738,102690,72,57,129248,36428,92820
9f47f0451044914f6fd8efdc7f8fe38a,113,70,132812,23649,109163,66,49,93460,25020,68440
99d81693b7aa0ac818c6d8dadfc09c2b,100,67,186722,48738,137984,110,81,190917,70507,120410
1f728408eda8a28b7e4731b402fec6d2,121,107,251571,83796,167775,138,104,301383,58266,243117
27a3aa5bae3b023356323fe99e26090c,68,44,53535,18734,34801,74,59,85349,22749,62600
2dab859eba4fbd05a9dc8573ecbbf929,115,85,268459,106556,161903,122,93,287423,66585,220838
8dfc5da40c7421f3c0a8789a17dd5319,75,44,115767,29673,86094,75,58,83263,29004,54259
fbba04531bd5adad202c09e37cb95e43,179,129,439048,94823,344225,145,114,413741,85103,328638
0f903138943d370bb786ab9c98d10142,45,29,45796,14899,30897,40,26,48619,16375,32244
dca87171519f1b36c508fd6a9727e71a,151,112,473468,77312,396156,140,92,323560,56920,266640
575533361a6e8015e4c977c1004fa1e4,90,72,149100,55926,93174,108,83,212206,56520,155686
1c91a0228307f5dac77ae41879c3f215,203,162,912348,152089,760259,217,171,988022,167906,820116
032a78ffbc62d6ed76eaff8b2244ed29,110,86,277874,68261,209613,99,80,177823,47018,130805
44e19c25728a37d5f52a2e04f83b1a70,79,62,153997,49357,104640,128,104,222316,51620,170696
a6360ff3ec2d231c11d40a63e71826a9,52,40,61707,14117,47590,36,26,44072,14699,29373
2ca546d2a5ed693e8879e1c8a51833ed,55,44,63834,17627,46207,35,31,44337,16207,28130
e629e7a1b444580d004e66a81a8f681b,117,95,270689,53575,217114,119,90,224739,45057,179682
b049268710a05bdb7204fc012235d831,39,23,34405,8974,25431,45,37,54567,13139,41428
04094429488732ca44707bf717e9eabe,74,40,90066,16808,73258,60,48,79054,26622,52432
dd296ecfb8746e9bdd861914c247dcb4,74,58,122077,25874,96203,88,74,143586,32698,110888
a005e536ebf1a7b6d97fd430a62df164,94,74,138902,34080,104822,84,69,94375,24736,69639
cae377389d44f33bf382462277036ff3,24,19,9889,5325,4564,26,19,9922,4320,5602
558fa2ea5298d046653a61b2102a48cc,72,61,94508,28315,66193,60,47,97991,32357,65634
84927b2101a2c43e9b3dd40ff566486d,33,32,17352,10959,6393,42,35,28376,8106,20270
baf15337220300aa3014d374581b7636,25,16,10317,2902,7415,20,20,8119,5137,2982
5c18a502eab98636f91007db456527ac,213,153,698615,127497,571118,189,130,768017,116904,651113
4c2869c90464ad8c50cde5f4c89d3c1b,38,24,42633,8596,34037,33,30,27395,13577,13818
d217ab8f2c3435072cdaff1688cc5424,33,19,24613,6184,18429,24,21,17663,7143,10520
e7a4fe3bd68dfd1004d2177fb086bc4a,123,104,293731,69796,223935,122,106,274386,53407,220979
3dabe5ecef14993e18c6225c510f159d,43,34,49679,17180,32499,50,38,40530,13699,26831
3a353b1bfd24aae757cffe972232cb84,65,59,119150,37383,81767,101,79,168013,52030,115983
b132b0f9072a8db0130166801e3132fd,32,26,23790,8273,15517,25,29,19487,10053,9434
5943e84d3422a8985e6a5a22ad5c2db3,109,88,282767,69548,213219,104,75,239601,51972,187629
83aefa7a46eccffa34d330af9cd771cf,87,72,140023,32709,107314,92,72,124327,31893,92434
f271655300e47985c737fd71e4c691fc,170,122,480024,124171,355853,143,98,454946,114466,340480
bfc9cb81a02cc9b3db288000fe982119,34,19,30868,11972,18896,35,25,28456,13296,15160
b84418b2b81a282c2ba64875ee75322d,116,102,237344,59242,178102,129,111,284716,52554,232162
b36ced328d54d035becd6fced6aa7fe9,158,105,426551,75235,351316,116,99,326301,66018,260283
109139a8fdb4f3801ba3fb5acf89e43d,70,51,95836,19437,76399,64,52,92617,27418,65199
45f5675535c77690d7d6323624eeab41,21,14,6566,1324,5242,17,18,2188,2409,-221
c7a4e75d8e28d00ed0990ac0a37180a2,66,54,87387,20277,67110,36,31,33068,22384,10684
a4b82e87a9f00ef050fe8f773640865e,55,38,74496,26024,48472,62,45,68943,22220,46723
71b5c83eb3a92e62bf823eada44d941c,63,50,123897,39935,83962,55,53,103803,43987,59816
d4b40b08f912efc0053acd1bbffbdd96,100,68,152114,28528,123586,140,106,230068,65468,164600
ce782c490fc58abace79a25f5308c2f6,112,58,216176,35411,180765,120,80,204282,41725,162557
7696819c4e23e06b24003dfb00de6430,101,75,210466,60067,150399,132,95,261216,70762,190454
ab701573253eca95c462238d865c8e3f,36,27,35624,8146,27478,38,30,25529,12406,13123
7de2cb3545cb656c095ed9e435b0a079,201,153,785708,130761,654947,192,174,913363,121990,791373
4eb50a8c6dafb18bdb859910868a3cc0,213,147,958275,162519,795756,208,111,918691,163967,754724
615d8d296cee1838fead02ac1af3bd69,21,18,13402,6096,7306,30,23,26294,5264,21030
7c6f8faa46ac85bc11e921c0f148896f,18,12,4073,2209,1864,21,14,3654,2688,966
343007559c399cad2dc71d32ed53c0ce,51,37,67484,21011,46473,58,54,69657,25718,43939
e208ca552289667ac87fcacf046b0455,66,48,77539,17379,60160,35,32,41169,14414,26755
be069d3a9887d46fd4b476d1bc11b222,154,113,423434,103433,320001,165,123,444627,91287,353340
d381e5ba4f8f4f1065af6b0919a5d3cc,33,32,27868,13741,14127,38,28,31372,11501,19871
9edeca38aaddd60d8704397ea5c54c1f,125,109,259829,61206,198623,120,88,253839,47028,206811
79982df56604ef71107d9bcc1bfe8f16,162,129,665568,126695,538873,182,141,816337,112205,704132
8f0b057a39584a1c0e0981a2341d5f22,143,104,445441,88259,357182,139,110,420706,124830,295876
91a9538c3de68e3a77e98c78a1f2032f,98,74,183154,60711,122443,99,72,171354,44987,126367
8532b6bf3da25f769ee6d0d3308fb07c,126,94,457564,142612,314952,203,126,782731,108859,673872
934bce9c6e3baf02e4f9d74a1be13446,64,50,81225,30000,51225,70,57,99940,32970,66970
97641bb34dcb2eafc6e90665b538c83c,6,4,830,325,505,7,4,541,375,166
c1963915846498c0fb03d0dcebd7860b,32,24,16898,6068,10830,32,22,16050,5221,10829
2b9484e4e03473fc9e5bf283b750a2b4,134,112,316869,114276,202593,157,113,439769,87887,351882
7679ce382e1230199b0582f3a0ad3c2d,51,49,49358,25395,23963,49,36,62910,19140,43770
d4b368b5d6c3223ddf33353b169bf785,128,102,475005,109884,365121,164,115,470002,132921,337081
98f469027bbedb450a729f10fc5ca315,166,130,480619,111411,369208,146,121,413224,128915,284309
bfd92a4efcc5d094e1c28398b9f87195,139,97,275291,48383,226908,125,103,276489,66574,209915
30d37c1348dc76b7c14d528a9a808044,131,95,293687,46229,247458,101,85,172020,41090,130930
806bb28a630c9cee4fb4515e25cc5c19,28,20,16403,4913,11490,26,18,14677,6692,7985
cea3780d8ce52e699223fcbc3b0d653d,26,24,9608,4533,5075,29,20,14195,4441,9754
fc4c2bb9817a5c86d28c0106e00020a9,136,108,317645,67583,250062,80,71,176849,81243,95606
395e2cfa27da2e3b10f15493c5a2544a,69,60,88954,29658,59296,70,64,95802,30441,65361
b9ff8f8685a4d35583d0618d1003b294,56,48,139356,50464,88892,89,79,181397,48967,132430
664be6a65653b7e6a2404433420787a0,193,127,556671,121798,434873,183,120,602377,134389,467988
08ca453db6fc5d3098ed5ad20b3b5690,155,118,460366,132830,327536,150,111,656018,163203,492815
920284dca73c4ee9130d398b6065787e,166,121,510668,96832,413836,124,106,549563,97193,452370
532a322518713141e69a4867d885b72a,194,139,750074,137672,612402,190,138,662470,187412,475058
686d20e1a65274012dd9cd77716f6dac,13,11,2752,1078,1674,10,10,1954,1052,902
8566a3ac2618ba90330d70d9bb4f9420,66,54,94228,22798,71430,56,45,74493,27714,46779
f0ef409345ef32625fe8e49885493dcd,44,30,41336,10444,30892,60,45,39588,16962,22626
57c415810974693344e8f462f6275ee5,66,35,131814,17131,114683,73,60,109861,26344,83517
ee59f3215f9ce68316c9d1ee0a2c6b65,96,77,178639,42403,136236,104,73,196115,62642,133473
740655b7eb302734079c6337593367ff,115,87,200289,48503,151786,114,77,184564,41519,143045
7a2aa8648f3e68128da9f680fab9c22c,79,56,96264,34330,61934,70,66,106818,34938,71880
08d6ea0fddb07d14c6352f98690de447,46,42,53886,19931,33955,65,49,71307,20806,50501
1eb0c2ff119d3ca0f03a7337a4bd5ccf,28,22,24864,7668,17196,29,20,19328,7776,11552
8914d9d4199045ee717689b676a35b60,70,60,97526,41491,56035,69,48,121659,41814,79845
40b980cf4c84cc9c3c3c880d6f16f001,151,116,397658,105469,292189,175,131,543377,75504,467873
221a502965aa55bc11c11daf1e8469c2,29,25,18082,10425,7657,37,29,31330,6749,24581
a6d265bcd626697e75f465a279f7ebda,54,38,59905,13339,46566,44,34,36562,15563,20999
4dc4a9c50c88406b00553ac75f87e47f,17,14,6322,2757,3565,21,13,6276,3441,2835
ec73e287ec36be75e67271535dac5bb7,137,107,543131,142589,400542,152,110,573187,97258,475929
7e20c0ac7d2f4a6418fb92b1d0d8f7bc,117,68,282675,46438,236237,113,85,244628,74019,170609
8e251f6b90172d13309638b0c56e8fee,48,44,63154,17636,45518,47,34,42711,22474,20237
cdec4aca01d8b5fbde666e6377a7e60c,107,86,256473,76309,180164,106,95,290623,53365,237258
e65455375e9ee44665fac472e29d29ec,127,87,307146,84392,222754,119,95,294068,102337,191731
305198c02a6fcf17bba295b20ce3d409,140,98,367414,69762,297652,80,70,148956,79460,69496
33471373c1c7054b356b2d3dd1000763,99,78,221176,49888,171288,75,64,151450,49729,101721
fd7c80b6a3ad6597141d3e9b532c0acd,197,132,550240,87859,462381,149,103,539644,113022,426622
ed2d121f426ceb7ab13c9f8bfe4760a2,29,27,16747,9920,6827,40,29,25032,8030,17002
2e262d52a1fc27f036360b23a254a690,28,19,12344,5187,7157,25,20,10465,5199,5266
3a36258fec9df118073b77d589145f86,67,44,77341,27588,49753,72,67,112269,26993,85276
2beadc966f736b1da9b51ff7ee349b71,31,22,28516,7006,21510,41,32,30378,9938,20440
63e979dc79c32f73909986e64c68ade8,81,53,109618,27935,81683,67,63,104920,38901,66019
4e0695407256897f89099f7abaaef93d,26,20,10946,8705,2241,21,20,18020,5701,12319
8ed46dd66a9f303e205b4d5dca22fd6b,51,37,53566,26562,27004,52,40,57190,24274,32916
80548749e0e308fe3cbac4ae08cb68fb,102,95,298853,70006,228847,155,141,455946,96199,359747
f01f344b4c5007d65906c4a2951bb397,25,17,6929,2990,3939,19,19,6459,2572,3887
e649a538f2ac5bd88170a1696b88d63c,29,23,19394,7636,11758,25,26,19970,5043,14927
d8fb1be799d256236c7859b89bb2bba9,110,73,150214,27915,122299,82,58,113677,27263,86414
0d8469d772f74448c5e4b72751d6cac2,65,47,120528,28982,91546,83,68,107754,38070,69684
a7bcb6a17df75a35a4c1d75f8c970fdc,105,77,271592,55507,216085,130,115,302880,66218,236662
5e57fa7b22d39183febc50023ac92bac,103,80,167076,43291,123785,81,55,191255,34444,156811
7a9e821e9a499f81e874f936a4933f88,129,110,310516,42292,268224,139,103,375656,57173,318483
aa779e2a99e4d1ae3a7551ed5ac91ebc,64,57,92065,32897,59168,82,77,126312,37020,89292
2d1c238f3294a733a8db34d085096203,99,69,212981,45374,167607,103,67,187834,38145,149689
5776f694e8e4323817e2ba616e74b248,93,71,176932,30411,146521,50,52,66924,34037,32887
4b321437e26f7c4eb2168d4041ed78ba,125,109,285561,63814,221747,159,128,370607,60624,309983
7f22cc0c978bb9bbda4ce9953bf0383a,24,23,16901,10505,6396,31,25,23132,8374,14758
5d624adadc780207b80635e6d8cb7bc3,86,54,140614,38713,101901,128,96,258860,49032,209828
7f837aa273c26842c2289f18696542a2,119,102,273453,51263,222190,99,81,185551,40504,145047
6bd6a2b3610b25d2c4032546c57ed373,35,31,34673,14107,20566,42,32,36162,16206,19956
e23caade529b09d0fe5ac22490388d2d,54,44,53770,17725,36045,67,56,106186,19260,86926
0e33d213326cc9dce9dcf19cf6c0d74b,171,130,969912,155851,814061,236,161,853209,169140,684069
1b909beb9e3cf5999487c249dbfffa4b,66,48,94813,23627,71186,73,54,92953,20872,72081
06bd448c0c7bddf88b03714e92048da8,109,95,230750,55408,175342,95,75,200813,51464,149349
7957a17b77b93b713834814a59a29541,27,20,11296,4333,6963,28,20,9042,3464,5578
98d3b9427fadf8aff581bd19087ea592,100,82,137055,31830,105225,92,70,117714,31233,86481
199bb639c328b131b4eebbab62294cb4,64,53,104370,39429,64941,94,72,204123,41963,162160
bb687b6859575dbe301ee34ecb16567a,94,64,165329,34126,131203,80,65,182165,37800,144365
b2961491c541789b62a97564f359de4c,64,42,89194,26042,63152,62,43,74726,25511,49215
ea4aaf6becee522b61b814200bef633b,60,46,86929,15380,71549,66,58,66575,28179,38396
6fbd1118b267cfb147a55201e1cc77e6,10,11,2087,1164,923,12,12,1153,1384,-231
eada4fcbb905b3209b5a9888528a204f,116,109,395766,98248,297518,200,144,818953,93497,725456
1c9ed97842c22f6957114fd4ba2b0ab3,1,1,36,67,-31,1,1,67,36,31
586ec41f44fc9bdbe3ef60f48c34fd95,28,21,12588,5274,7314,26,22,17164,4287,12877
6181f99c7abe555daba99ca3dd2e8668,26,18,6098,1719,4379,23,23,3659,2829,830
20165d82c6d5889b6400e8e7f26b75da,55,49,80010,32947,47063,62,55,84472,28240,56232
1c7da6c49638d9f18ad2aeadadff94a6,16,12,2300,2137,163,15,13,3079,1982,1097
0bf0a3ada7b3d233d828fb14bca3a333,139,127,325302,73009,252293,124,98,264241,61474,202767
6dc793098c6fdd53e657045d56cdbd81,78,55,155705,28599,127106,106,80,212194,44164,168030
1a1e30b972e336973f83db28b0e9a148,28,28,13906,7521,6385,30,22,17338,6695,10643
dcf3a8423003736b48db8037f6ef70cc,132,113,362050,134089,227961,114,81,315950,125850,190100
47b5daa13f63678b0ec52e602597fd34,78,74,162682,39676,123006,87,65,154787,38101,116686
d769a0c8e60fe99b31440c5db624285a,178,139,652432,99112,553320,119,96,366216,80877,285339
296432b3d5623d4166b0ae7fd2976b98,161,120,688511,101600,586911,151,119,438184,107305,330879
25d2174f3befd7c8013fa4a27ba4e911,55,46,66331,31315,35016,49,36,71517,15361,56156
2d2cd8a0efe7836e1e40d22e6bf99bf3,41,40,36229,12235,23994,45,35,25165,13636,11529
bc87e39a492b655588bea367286bdd5e,171,133,448022,81636,366386,154,113,359310,83916,275394
d2f778e6ce654b9e61b12b3e6642ef21,41,28,30567,17811,12756,38,31,45824,14962,30862
23511e8b51c37693f4b59006949bb282,179,127,483058,93560,389498,147,112,442845,121788,321057
c8ec3567f3a91945f76790ef60ef08da,144,107,296297,59123,237174,152,110,381445,58019,323426
f6f79536121b2af226611e13006a8267,156,119,455206,97935,357271,170,111,454297,104493,349804
79629858b12e9d2f0685a8dc6fe0efc9,86,80,90784,22085,68699,59,47,60676,18937,41739
6bb26939ba9cc41a340c65fa13593897,163,106,393284,88925,304359,133,111,372925,115857,257068
b9595e413ba9e8520c3f46a0f05ee97c,4,2,290,136,154,2,4,136,290,-154
3db8e32b9cf7fbf8e6e5bef835fe0a44,98,60,160274,41056,119218,107,65,178906,38066,140840
e9bb6f173f00c06f82dba60966cc6fb4,75,69,126083,53308,72775,84,67,139753,33135,106618
1946ce1af1ed38981d2d19650979f930,188,129,611445,120481,490964,185,132,590685,108116,482569
8263e02ba436b93b6a3284fba1818f84,42,36,36603,7762,28841,46,37,39279,12942,26337
41474d8e2739938751bb4f92d0ee81bc,53,42,85664,28765,56899,55,44,83676,26276,57400
adcc2f34f1fa4de6e46b12b343a797a7,21,18,6547,2429,4118,20,18,5813,2895,2918
56ce26916f70a5d84719214ce1a5cd7b,26,18,29493,7462,22031,30,21,22007,7973,14034
2d178ea37a3ae20be921406223d7e5f7,116,83,233169,55102,178067,109,75,231852,44447,187405
f65c909837d3e6683d7a5a9b40a33b2f,124,89,383126,50766,332360,170,135,453471,51878,401593
24698fe21c56172298e232642f296fc9,114,108,336800,69588,267212,113,90,243037,66665,176372
95e1aee7e799deae7445de3ec2f3bc5e,39,36,36910,12378,24532,44,35,35082,11637,23445
0b583d173f641fc268e54cf52255a890,89,70,125867,35345,90522,73,61,92936,40013,52923
15a2c347f54a772e53730265769216ed,31,25,24861,8576,16285,35,27,24816,8785,16031
55026cf040a8370a01a682c832b43785,6,5,548,636,-88,6,4,704,180,524
24b1a413ff7f9075bcc65bb6d6b19548,164,116,445520,135476,310044,185,117,490168,130747,359421
6c1bd5c3a79c9911106801e5ff30b684,93,66,160315,42642,117673,87,81,177507,49415,128092
ab771c4a4df5f589f35bd607572365ca,150,116,412845,101897,310948,120,90,324099,103429,220670
a380565aea041a75f0b8a73da13e287a,105,84,175040,47495,127545,81,68,118251,35965,82286
c0c7070fcfb197fa7399ce4669520f36,17,14,3975,1952,2023,21,11,5966,1537,4429
519b2604eaecba4456e378d8900be044,55,41,68534,18945,49589,50,46,52313,21447,30866
c5b66dc8fc8e9a5bc41a736c3d577a29,114,81,237368,82910,154458,131,101,310806,75004,235802
0a3f8b2dc808416f0ff605db7c37c550,75,57,106573,28145,78428,81,61,97130,30049,67081
4dddb9cf04e85d938581a266b01299bb,47,45,45864,11549,34315,62,41,49456,14761,34695
6be83d80e8de6c357388c27de2d7944b,33,23,21756,7283,14473,31,22,22418,4817,17601
1cb7d95e73f53c1236faa356f8c703ec,103,84,204475,90308,114167,147,119,377104,60903,316201
76250cb88a57202841fecb9a247ff6f3,146,100,387226,67313,319913,147,103,351529,85888,265641
0cb76810e2fc8fb297a4b7f3a868ce86,187,108,493880,85156,408724,157,123,531416,103405,428011
18a15cedf126c8b14ce1b2f1f0cc67bd,11,11,1317,1245,72,16,14,2241,1194,1047
8ff512731eba32f469a6933a2f85941f,91,70,178658,51908,126750,110,83,288918,52003,236915
fa348a755a84613e651686061d00e622,76,50,205264,56428,148836,139,79,278751,54462,224289
e47406fa1fd53679a6fc1ab0d4444c65,70,62,99493,38871,60622,69,50,86168,36343,49825
4abae72c42baef87b78c641b466301ca,63,45,78558,18530,60028,45,38,59468,20856,38612
73bc4ad4ddad26ddf7947436bd1a1421,157,106,334670,62081,272589,176,141,424817,69312,355505
5029b07223746c25e81e0b92d21f15bb,62,53,108809,49258,59551,85,63,130093,41865,88228
88e3eb360e61a3d36357b67b023bff25,127,104,230847,45078,185769,94,81,178663,49202,129461
cc9098c9b07cdfe19640368fee0e3bf5,59,43,68526,27457,41069,41,34,61568,22396,39172
a2c1e08f3ac7bdedc0ce2d2385b757a0,77,51,108807,32915,75892,75,52,98620,33820,64800
099669c1497e4a3a2e5a4be9d9e0e22d,35,29,25070,13200,11870,33,30,25512,9932,15580
33af7f84868513de954ce60633fce8d8,130,109,360375,51313,309062,96,85,246967,84932,162035
a6371c42206a5d22c3e58b08920584fe,42,35,31832,11449,20383,48,40,31709,13757,17952
bba65737b265e2c2e7ed02ee8106cd08,45,28,57650,9231,48419,48,39,37571,15876,21695
d962e1684d6442dec714a2369e62a003,89,60,154123,22580,131543,60,41,94540,17970,76570
70ecde6683797248f8d1ed78397b0be6,138,126,334146,63106,271040,148,100,293198,63381,229817
11b242e208205e31b45e87eecffe5ede,175,134,516050,83904,432146,191,135,595710,99339,496371
c0db5800aa79bf3bc2c500ea9193d6f9,153,115,395065,90389,304676,161,127,467639,77702,389937
b33cd949ff716867432ab7e7521fe4e2,152,120,436726,95863,340863,132,96,303387,68393,234994
78d9ad0bdae4da1e2cdcd7b783d5ac94,65,53,101204,32963,68241,90,73,174559,40113,134446
2a4ce1f0e38888eaefcafcf9ce82846b,113,84,273360,77165,196195,121,85,225052,55842,169210
9841a20343ea8577913395790f27fe18,191,134,655254,86159,569095,158,127,613338,90770,522568
72a9a6c71f32479328d9f2e64f071656,137,113,362789,96927,265862,143,109,359655,72023,287632
ebb70a905828a40233c09db0aec134b7,188,126,733739,123558,610181,206,119,679919,136306,543613
3b7a177f7b181b7c42a703f845d4d13f,79,60,133882,38904,94978,61,52,111600,48115,63485
ad9a3a0e8050d448f63e8b2afa478b31,152,122,582054,133589,448465,112,85,431378,104548,326830
15dd4d5733f9c701d107498e3198be8d,116,81,350439,84601,265838,199,137,649082,78098,570984
69f071dea353cb2df81353aea19dcf56,128,108,309980,70004,239976,90,58,223659,54616,169043
b3c715202b9e5abacd49a6d50eeee50f,118,93,231849,42941,188908,85,69,134213,34954,99259
7ebade70a82077788b007734db548b02,153,119,397386,58230,339156,185,153,597445,66434,531011
a34a28d2639fae4572e305e226e9e6a9,101,85,197165,49459,147706,95,74,134437,54660,79777
314d165441286cffb40a2629cccd8d12,104,86,232169,53283,178886,48,41,98738,47254,51484
9a098cf4677efc4904cf60dab5f16550,142,104,300528,59591,240937,110,90,196654,61077,135577
ff4f12810723ee7b563461fc77433a7e,159,134,412675,80705,331970,142,119,442502,86643,355859
24c727d83a65060af7bdf957fc4bb093,182,122,512394,98431,413963,156,122,709262,131323,577939
3772bb6c2ea83f253f1c55d9772e7375,33,21,23018,8004,15014,32,23,17200,8130,9070
3a60ae16f9cd77771f639233518c1c6f,101,77,194494,45002,149492,86,43,100083,28228,71855
91a38cc8899a44946a02cbc980d0806d,67,55,84519,28840,55679,65,44,98491,25498,72993
6c8a8e16a36ed32ffd9304a5e47eac15,95,84,204774,54974,149800,90,75,122847,35335,87512
1c92dc328f800590f2156923ed9cb06c,62,47,88889,21272,67617,56,40,44527,19340,25187
b78b8438aa8ff724ee99bca77b3b40a4,145,113,336513,51834,284679,156,136,357652,88420,269232
e70dbccb8de4e87e663d1535554c6268,77,63,230353,47639,182714,62,54,137956,61927,76029
7370965eb70fc9c6bcf78c036922d454,53,47,94207,21580,72627,49,44,74028,31745,42283
a3a7361d50e5f1c0d6e69317ec8b69cd,160,123,399587,107172,292415,163,132,486996,113052,373944
4e21847847cf9ab2834bf58b492a84f8,182,144,668424,85274,583150,188,116,510190,65700,444490
b7b8a8e6b6c8c99b945ae8ac2aea61e1,141,102,527561,96493,431068,167,116,430818,91816,339002
bda800c4eba840ed9a659fadcbce994a,94,76,143991,34434,109557,128,97,253024,38264,214760
f6dc14b6d2a01bf6f48d90664bc7d36b,61,43,69836,23191,46645,96,68,177355,26224,151131
cc4c173705904966aff05ad28edb965c,103,78,261713,65644,196069,161,133,487821,74958,412863
728ea10cc01b81e972388ee1f0f614a5,154,92,279209,76043,203166,114,83,229022,80216,148806
7e948f7c7c6ae4566c3d87b9778bc6df,43,28,62721,16170,46551,39,25,43163,19303,23860
f19c371e158c545c619dec97d02c72f3,32,26,17462,9015,8447,41,28,26182,7001,19181
41955e89a5d5a404a598f622a3a4f5a6,123,97,260697,71871,188826,157,117,344358,54718,289640
3e991dae595bc86af6fd77050721d12d,137,107,384545,56117,328428,125,105,229177,53678,175499
9301bccd1fe67fe35d881bf067f85ac7,133,69,213198,24200,188998,122,73,191063,28041,163022
dc94bd074b4387fb3b7fadb361cd1793,57,43,93279,18544,74735,42,27,49151,18229,30922
2c944c2d0f1ebc610f0e5aeec7e9eb8b,98,90,233797,74818,158979,121,89,306236,73479,232757
857536bcddee0a2d8d0d34b4d955f4f8,43,40,42461,21458,21003,54,32,58407,15588,42819
8cddac259c7942d88be1d229f394cef6,32,25,36925,14335,22590,43,33,63519,15256,48263
fc13d22a84555ada706e13bd2ac8d7d7,148,118,373698,43249,330449,136,118,310190,57368,252822
69c4eb0a5e34fabc4c376fb2d4e83ee5,158,111,502670,64779,437891,121,99,314389,70523,243866
abb5699fb89cbd1b937aa008f8d222f9,144,116,402489,64661,337828,120,80,307578,62395,245183
dc9c7366cb01b0972f7fbdce9a997216,29,21,17726,8557,9169,31,28,28537,10591,17946
e1707ce1f8c1dce708b5db5ebd3f7b6c,191,140,526348,144312,382036,166,122,566336,105094,461242
fd6652b4b64da49d177b960392c79de8,29,25,18788,7775,11013,42,32,16681,8183,8498
69bf0c1b2fe0ebe262c788499a1f4582,183,146,854415,250441,603974,205,161,851638,199079,652559
70a9ef177150894b79d982ecc42c2992,47,36,72978,20247,52731,62,54,99943,24649,75294
63dbde2d809ed528ffe851a823f82284,74,63,90069,33885,56184,71,44,136210,21557,114653
65a59b781301577d07de260e6cd0a3b3,126,94,356070,69710,286360,137,103,316535,87813,228722
1ebb5b634381e028608f56fc32cc105d,45,42,44688,20778,23910,42,32,55493,14856,40637
e71457212784f12a0f670b387cb46af7,34,32,44799,14490,30309,40,39,40773,14314,26459
f36b8fefbf42d90d2e9fdd2ee39370a9,117,82,329872,63743,266129,115,86,257809,69454,188355
f1df0a31ccba73c5ae18de199af25d20,132,110,455313,96953,358360,153,124,468013,98104,369909
8e31c505ea2eb470d2d96275d54bea02,111,93,240721,49593,191128,91,68,157247,58504,98743
5e01e7a796961f7d87086a435abf8892,56,49,60159,18432,41727,67,48,77455,18314,59141
0da86a2c6f683864d94c4d24499957eb,59,48,81245,22448,58797,67,56,75029,23181,51848
350521b21006200cf3ebb1a89f2fb208,5,3,409,167,242,4,3,256,178,78
95346b8ef0fb3797119e7ed1c2c93ae8,26,23,8689,3966,4723,26,18,8233,3228,5005
78f8075d88b5724555a33dd9fa2db5cc,38,26,38184,12424,25760,37,24,37021,11438,25583
bf8e2b7589e966745972cc3c5e357f04,229,157,1039945,213104,826841,146,106,628112,172490,455622
a6828d1ffb9414cc7233e03ac7386fe7,22,14,4083,1845,2238,19,17,5387,2398,2989
d68410d95a4e43aeef1a3a7910fcb71e,133,118,402737,75843,326894,146,122,454187,92715,361472
7d68368c3f693aa45532b7fbfcfe97b6,135,112,430674,141205,289469,165,121,580073,103579,476494
af23334f14e35f2b16ffa3cd89292c1f,58,42,69997,28123,41874,98,71,123777,25658,98119
1d59e35d207056fa7a4184ecf40142aa,38,37,34138,13311,20827,59,54,58213,16402,41811
d6c0d97a9080dd3dcf97de6a2b91cdf7,80,66,124042,40091,83951,107,70,181369,30505,150864
869bf7c456ff5acea977456932772894,51,38,50828,13287,37541,48,37,43422,15919,27503
c78841a97bfe38f8e694d6192509f90b,167,124,625552,156865,468687,206,125,786080,117351,668729
ccb8eeaaa2909ae66997d83f912d33cd,187,134,518024,155323,362701,125,92,371243,101181,270062
1fdb9b37a0e93ecd55b818dda3555bfd,160,135,531128,86551,444577,155,123,555447,103107,452340
ca7804b7366f3a80d7798bb878aafd72,53,43,78471,21665,56806,72,59,81251,22615,58636
28e80f898e9a3af6b24b049520b6d046,136,89,281244,105884,175360,157,122,560360,66333,494027
90ec21811d0c09c944f47f2c1c0db86b,3,3,214,156,58,2,2,148,206,-58
fd473cf39dcd86a70ab8c03327106c87,129,104,259595,47536,212059,122,92,206121,43546,162575
24561c7c531d34eeb70613fc4cb904e7,86,58,176083,59099,116984,106,78,204160,47490,156670
7f1c2e208dc7f91dae1cecb47f016349,194,134,641376,144804,496572,172,138,856019,171758,684261
c5798dc6923eccede22df90fd4da918d,98,76,154773,29069,125704,84,67,122627,35839,86788
8061badbdcd6ccdb5ef81eea2d02a6cd,140,92,269665,56658,213007,114,84,213194,41600,171594
caa7d4a9eee30890acfc911811ff5e7c,75,57,96887,23342,73545,64,58,77486,20686,56800
537c1e3a63d58a13348a4e14e9113b32,14,7,4401,1118,3283,17,9,3066,610,2456
c257643c0da0f4e0345ac1a0fbcaec4a,104,86,199964,48499,151465,86,75,171253,51046,120207
9507216a01691398fa3313e615bd7a9a,10,8,1043,528,515,11,9,1861,695,1166
9850ec23ddeadbe087ea36f1873e1c86,38,25,40472,13584,26888,36,24,55043,12537,42506
7549dd9779214420d429d6e16f49dc3a,161,122,415173,110248,304925,161,127,405297,105330,299967
10207d9125de11928c5428047314175a,183,159,978588,169686,808902,184,139,597004,182145,414859
11b9cacfa0d9d3ae40124daf11a30f59,38,32,33479,19526,13953,50,35,45650,17896,27754
106a511ceb087dfd573b34bde3dce181,150,105,830865,127636,703229,200,142,729928,139789,590139
629105d1c491d5d9cea4d0041144ede1,78,61,86561,42315,44246,106,76,177968,33781,144187
11e5c113473c268171534a8e08408cce,41,38,50517,14035,36482,38,26,43873,16702,27171
b2a146e8234694baad0b9230d4dacede,38,32,30545,9226,21319,32,21,16040,11796,4244
d91c6c8aba519b4983d092879b3f4fdb,44,41,52336,28159,24177,53,43,67199,19466,47733
364d97e1670c0a8b0a19ffcb3e98aecd,77,60,179418,39407,140011,54,34,115308,40102,75206
6f2aa7c57b901989e26c3ed7b261ca7f,170,122,462692,70718,391974,126,95,242925,65355,177570
06544be597e5c9ffce3e5a0d2ff6828d,40,44,57832,36435,21397,49,43,72678,29111,43567
59b7602c92bc4f1b38af7ec09dfd2a8e,116,77,227331,66983,160348,79,73,168164,53905,114259
54dc0be64664e776b93ec84b1829f141,40,29,28923,6858,22065,44,30,32497,10690,21807
9211986b87ac7ec9fe0cc172970464bf,46,34,42051,14221,27830,57,42,66940,16370,50570
2c9ba37581ab1a16cf7ab9de3765ad43,42,29,38077,16478,21599,53,40,57208,15638,41570
ccf48a02191069e56fea96af8da8f2d9,76,63,252228,82547,169681,116,93,354750,137940,216810
a1d97a873906ec6a0e977463b3815790,71,40,65723,14388,51335,57,49,75300,20877,54423
8628b878f05586e6d197a98f00d7dcc6,109,86,217593,61319,156274,89,56,167093,60344,106749
acfc5fb14e239c9bf71ca43d3c7a042f,116,89,314851,49702,265149,114,96,263557,56810,206747
0664b0cd6760abd70feb3fbc561b0630,54,43,53987,20846,33141,58,39,51378,20726,30652
b594e579c589bd1a3f224fd4fd3bc57a,35,35,25701,10584,15117,43,33,20308,9709,10599
51b860691efc8ad67bb6a3f6903590f2,165,134,651815,138850,512965,213,134,697786,85723,612063
8695cf7984ad67d4f72d2ce8ee861f05,80,57,201788,46010,155778,95,76,241927,48802,193125
ab8c1ba6b15237c257aeeda0c1917f93,45,37,32326,11922,20404,46,30,32040,8395,23645
072de5efd7fbff544d70830cc11711fa,80,61,119796,23391,96405,92,76,113551,37969,75582
9057d45c1ec26d44baa58839f1f3dc41,59,57,79013,30494,48519,50,41,77031,30215,46816
270bfd3dc627c1911f31c4c871793cf5,160,126,468782,85162,383620,146,119,384644,96538,288106
772e5a7f2fca14f24b699db4003e8e63,7,5,444,664,-220,4,8,589,494,95
9328ddeedfc9bbde2be8a195ea276156,72,60,107749,22597,85152,65,60,81028,27133,53895
fc6e52dab1c53e66edc8cd27e71a23b1,119,85,252378,73913,178465,111,91,252837,65893,186944
2fe7b1bc1dcefc32285d27886bf847e8,62,51,84463,31366,53097,56,42,92004,27426,64578
b196885403b5c20bb4dce7c21a7aa51d,136,110,286890,65008,221882,129,113,280972,59061,221911
6e38f717a96cbcd49e19e743a2adfa41,43,38,38406,19240,19166,53,43,50003,18378,31625
f41c3913e4e3056bab35c760ff3fba15,70,54,82018,32656,49362,70,57,103265,24686,78579
e5b522fde182be324cedea4614f4dc05,212,153,872627,181542,691085,179,135,818204,143475,674729
2409388231219f41e8b3f43ba3d51ad5,52,48,61701,17727,43974,39,30,36990,14393,22597
f45a59b9733b633d4edbe2dd39e6f90e,138,118,395942,121970,273972,150,106,369199,96232,272967
3b808f5704f46c813c2557724b5a52f4,71,57,95885,18313,77572,47,39,46142,21154,24988
6bfc5d8f57bd121d5c761c98723c61e6,115,94,164294,45919,118375,99,67,158853,45204,113649
45a7cdd5ffa4c986ebf7f165e3e25747,18,13,7016,2156,4860,20,13,10951,2490,8461
498ad1c6a076147315addb60495471a3,21,17,7932,1992,5940,21,17,5631,1603,4028
6f3b56476eae5ea1243e371a9bb52134,27,17,26869,9856,17013,33,26,24367,9590,14777
f811ec57f543f76735e92d0ea93ded6c,85,71,79481,27507,51974,97,73,114386,22614,91772
3aec5935d15ecfdb4b0d662c89222bb6,34,34,54797,17051,37746,63,41,87211,22502,64709
0f779ea317d5d8e4d9986a1096ca5686,126,106,274048,68003,206045,125,101,269673,40297,229376
62d4b091ea23eada249068a43b2553f8,39,31,63523,16587,46936,40,32,43594,21224,22370
d6899b6a9c5828e8b2645191c386216a,70,44,113206,27862,85344,67,48,161966,29716,132250
a9573df10a0dc146d266193fb9c2a7d8,42,39,46866,21073,25793,69,53,86025,29272,56753
3cd2909ed6e1a8c9fb0b2d76966b0312,135,106,503686,89897,413789,135,113,416672,70395,346277
8f8d5b6d23f438a500043862b5df319c,111,70,131568,26830,104738,81,67,95340,33244,62096
32609946f2e5118b351fab547967f576,26,22,14701,6004,8697,25,19,8865,5254,3611
fd6791ea1a1d8855b56c101799d79254,43,39,70700,13676,57024,53,43,48436,23634,24802
6bdf6011a85c3d8b9b5ad72fb7300f36,209,141,572842,128086,444756,156,143,467303,106466,360837
199920846d25028fd8ff60195d79928b,97,74,252483,48006,204477,114,88,262870,46073,216797
7d362a004c9669d3180c6ef713512889,25,21,10476,4931,5545,27,21,9672,5938,3734
f65157bd56a027e04965c17c2c5f83de,42,40,32384,18409,13975,61,53,62282,16545,45737
75415dc63a0f81f6c8a25c71e2d70312,16,15,4361,1916,2445,17,11,3699,1233,2466
90112e498e10cd89d404ccd256b2c6e9,229,173,1184599,143764,1040835,199,145,1085512,142984,942528
56ba7cf89d838b9db9037b465f7d2cd1,184,118,802429,115796,686633,146,119,562287,148491,413796
013ce5f01ac208ce8e74e0f3ec1a33b4,76,63,148397,40165,108232,109,80,194191,47848,146343
9cf6cf904691598b08a44690e358b57a,90,78,212098,85490,126608,101,72,200386,71535,128851
794a80b29fcaefa69f75b3f249c20388,137,103,311170,63250,247920,159,121,385330,69619,315711
d7c4148ab558aaad463c03a17f562aee,130,88,262615,52859,209756,82,72,168549,64574,103975
0859eb456e1a363da93c13f4aa9a8058,141,110,363728,102191,261537,166,118,469391,98510,370881
d27e9529a0f9e1983887ecb7b560c931,136,118,365791,79896,285895,127,93,291239,70633,220606
d8f6415d66ddb215f8936b5c86677d48,122,91,301810,89247,212563,119,108,248022,85450,162572
6992354477c4bb404f8f54a99fe71b15,154,112,425294,91930,333364,182,148,606373,107782,498591
5120a649acc27135874866d7aaa80720,97,76,200620,53192,147428,126,86,246634,42697,203937
f9da8204df733998375b143a4ce2f1bd,135,75,292917,55818,237099,118,99,325157,77135,248022
a3b5dde3dfc5719f931f564ada63100d,43,35,47481,28139,19342,52,36,50421,21510,28911
846bab614148ad84a2c96859e8d3ade4,130,93,414442,95600,318842,167,154,668602,108911,559691
3695122f50c8869037227b787722435c,87,53,159270,27083,132187,84,75,110349,39105,71244
caa52d5ddd2001178c478e85e878233f,176,104,503586,65813,437773,168,112,413940,92163,321777
285ce20e6e5ca8f2cd4d8baac9abd648,171,120,735825,178211,557614,195,145,843358,177896,665462
ad55c56c4a1879f00c2349173a889a06,59,30,53879,11161,42718,34,34,25894,19536,6358
b5e67211b493cf2489ad5cde266f9bf0,16,10,2880,1515,1365,17,11,4312,1840,2472
e33decb6154c5b5b73f0e85744c39d71,60,48,90102,27807,62295,61,51,78241,32078,46163
f97e570336a17ebdcc08576f9f7086c0,174,130,435435,82456,352979,138,111,322460,79913,242547
9e82768b81d168aeb6399e6802adbe97,4,3,405,680,-275,3,4,680,405,275
8a0f64946778a4f1e24fe8e46e1b94c5,49,40,60172,18970,41202,43,38,55592,21867,33725
42de1cb158720e389806971c0ded22e4,25,16,11948,3123,8825,29,22,16456,4266,12190
965a4d8d29145c5a13d276878c766a90,28,23,20043,6929,13114,27,24,16218,7600,8618
ff5b09e3b2cd70edfcdb213d7d351ab0,72,50,117103,34639,82464,83,54,160331,49054,111277
c1ef9399165efb7e30dda598b3e3d2be,125,86,276740,43752,232988,148,100,340256,73391,266865
98124462f7b646743714fba3f0417fc8,51,37,45008,11101,33907,44,32,30852,14302,16550
3f0648ef8e15ee48697c05dfc3dc550d,142,103,312383,81885,230498,136,100,321630,66917,254713
dff7ac9bfcb22ccce5f8ce957ab9d41a,54,43,89325,27284,62041,82,72,121638,30492,91146
f57c168752808d1546b1f2765e23c05b,235,119,556953,92316,464637,181,110,486474,135550,350924
2f26832e00e12f686d723bfb616327a1,0,0,0,0,0,0,0,0,0,0
dde4937343bd309607f893563d556177,75,62,114338,40656,73682,95,70,133918,39100,94818
3fa1653d5f8069175f1d86c339e09025,17,17,5632,2771,2861,22,14,6086,3063,3023
f0898eb5d264561039fd71f1b76aa320,166,141,681931,106729,575202,138,103,498727,117361,381366
c49bf3e5b57c77fb4580bf83013fbf9b,43,25,21394,7610,13784,37,32,26700,9416,17284
eaad693bdd1acc878ebde64c9db1c0fa,183,134,692541,129683,562858,177,128,733072,194860,538212
d858e0b09387286e507172108bc17143,25,24,7126,3604,3522,25,23,6664,4662,2002
e72a20aeb03867fff32ffc351fc497e2,149,102,443460,70912,372548,137,88,318662,74032,244630
97bdeababf76bf44420c5fb9523f59be,180,136,627244,90274,536970,202,155,608059,96260,511799
dde1a975a9bdbae10a744a54ffad8006,30,20,18686,5488,13198,35,33,25421,8966,16455
7fdf9470b3c635aafeb618789d0062cf,118,107,359382,121698,237684,132,98,468909,77937,390972
9be80b0812a9f852e9d29db9519c5a89,65,46,78567,18480,60087,53,52,63996,30238,33758
3de1853f5b7e147327dd16d97c381676,87,56,143086,30443,112643,91,63,122228,31481,90747
7f4978a5f0f9d93c1cc7daf85076d470,125,98,314251,84263,229988,117,75,238644,85366,153278
2c7c217b096c6ab32044c689c7f48f93,133,95,385151,53697,331454,68,49,155599,61515,94084
7cfa9e8a3bca2dd60156ed2287f5ae88,18,11,3392,1457,1935,21,13,4235,1704,2531
deb44d6344fa99a98f3f75639c7ce30f,10,8,1305,1537,-232,10,8,2149,858,1291
527177dbc3c5299fef706fcbb4990096,136,112,340287,79815,260472,161,90,355392,67240,288152
c79412e704f13009e79bbe62a847b19e,102,84,146540,33705,112835,99,72,169009,36860,132149
dc4d195ca9880c55e2b01d07059236ae,124,93,217744,60400,157344,124,100,285176,86573,198603
bbcbd2fc4c0aa9f8fee819d7b937283e,24,21,16433,3734,12699,23,17,14525,3860,10665
c3a8f5e0d4c8830f3aa4795b0683be4c,201,150,1174369,169151,1005218,175,147,1060664,184482,876182
f6e1abcae3390e266d26159c85265619,157,101,421393,137317,284076,167,149,715976,146886,569090
fd8e2b14a88bab7a989cb04c348e0bb1,181,131,573888,84371,489517,154,109,421762,89163,332599
f161a980396b12f421590644ba50a72d,49,38,68901,31399,37502,63,53,93111,24264,68847
ec487374ca6809aee2f7f29f3c3d3edb,52,41,38856,9093,29763,40,31,44296,6717,37579
5f80b4f327e123b896054f1f3aed6eee,34,27,28791,8987,19804,26,20,22345,7036,15309
6ce8da874a4c204a738805169ea3f22d,113,85,244807,43333,201474,154,113,383319,49860,333459
8465af34e87b3bf3e5b172680ea39f0b,62,54,55790,23780,32010,82,62,77325,20082,57243
083a386a90f6303d6a2f57f04abe22d1,36,23,12146,3996,8150,24,24,7050,3312,3738
5e8aa2d8aef3b924bb3bb4ffed0a8e12,12,11,1994,2700,-706,15,11,3834,2096,1738
b6ad802f732e700107c081ee3f1c2e2e,119,77,225188,40176,185012,124,93,259387,31926,227461
13201bdf5526ff1b1fea3126d963fdd4,223,112,744189,117336,626853,117,105,452091,147566,304525
ec1a1cbda2deac2e05603dc6c35cee71,118,106,269947,61644,208303,147,119,360990,61672,299318
fce05477c7f8f31fc8ddaf661ae2c5dd,37,26,26170,10790,15380,36,25,26679,8919,17760
f78748408d82225a6933b024243c4992,107,88,200700,57372,143328,81,59,117752,61328,56424
78989be5d4d9df4800355597efcf012d,82,70,170998,58899,112099,80,64,163658,62518,101140
88d6c6a2fc80daabb589dc8fe81aaf11,99,84,179397,56702,122695,110,82,192097,60013,132084
79252b5711114aebd455db49ba01b9cb,33,26,22673,7653,15020,46,28,25487,9057,16430
de4870d86b943a31c8b9cccf145c4c22,24,21,13172,7156,6016,31,21,20680,6022,14658
29e7e0fecc006398c610442235761b84,205,159,962544,148031,814513,228,170,1121181,219027,902154
8b3c7d27e599357c49b291426c5c9e50,48,38,71077,17965,53112,48,24,59057,13926,45131
c2bcfcc09feef3472f3140c7dcca4337,30,24,16643,9769,6874,33,26,29196,7123,22073
0139a4a1ece069d306998de880374bbd,30,18,15540,5478,10062,30,22,16854,6417,10437
57e29145f7163fb5d985fad387f05213,84,71,143780,45123,98657,92,67,142035,34100,107935
85b10e85ca0087e501f12f310305feb4,25,18,10562,5254,5308,24,19,11916,4532,7384
088e7ef8e6343a67986740a9febd90e4,100,68,109724,34456,75268,143,81,172825,23264,149561
37efade1bc38860d769822319c7cfa3b,94,73,156977,45710,111267,115,92,180425,47299,133126
0d89a71e417df51819dbc274afbceded,19,16,5838,2230,3608,15,16,4114,2278,1836
478ffbc0a7dc5fa477eadfda45d27cb1,144,105,387763,116655,271108,145,108,472726,92714,380012
faef11f152df21bc92ff7959f3591622,136,62,195924,35706,160218,124,86,188353,42929,145424
565e194a3e2ba9e0fe0f670da4f71e71,20,18,8153,4217,3936,18,17,9814,4129,5685
fd5c9de2e179fe1d037edc2b4ab55d00,60,50,71505,25646,45859,64,55,83154,21627,61527
6b022f1d295884bc6247e19232522bbd,82,62,138329,68881,69448,116,79,223949,53492,170457
e3820c679ab7dfeafef3895cd4508185,31,25,18309,5524,12785,31,23,14146,7319,6827
8ebe29deb45ec4ef1328e8870450eacf,115,78,246174,92780,153394,104,83,245068,98545,146523
9940ebad8802d08cfbb96b6126676043,45,28,53936,17058,36878,62,45,63668,16912,46756
509887d3f078dd38363f86b4a9252987,95,76,168570,32315,136255,86,74,131774,43221,88553
a8cbfd353ed7ab72ef1887fa15006ea0,54,48,93637,26245,67392,59,36,62233,20141,42092
398d6a19682891c3a1ac887539349720,239,155,982841,184567,798274,188,139,1298526,185367,1113159
c8eba019f085ac27a714c2131102baee,121,81,238084,62103,175981,99,76,215154,42431,172723
5278eadaaeee821625553037141a1a16,19,17,7463,2720,4743,15,17,4068,4467,-399
92213828fab90b539b70eb433ff00e04,112,77,199576,36474,163102,107,93,175450,68514,106936
4efe11e440eb1826c611032ace9aec8a,142,96,566041,123864,442177,195,141,823926,199162,624764
77a16863b58f80c3e9137a34c1c2d2a9,166,130,514462,205701,308761,190,134,734436,148386,586050
179190e660f813a8cbb231fbbbdedc9c,141,85,342837,87079,255758,150,113,376269,97622,278647
23bd1fe1e1d0ca0416adabf452b46b56,22,23,5590,3182,2408,24,18,4968,2370,2598
67d974e3e7cc61a6113d474186edfba3,64,49,100052,23752,76300,78,82,128483,30301,98182
aaf953786824881ca8db768729cba980,167,126,520616,122684,397932,186,131,585619,98406,487213
949c2ad01aa0a80a1e969697903b6671,102,78,174022,39453,134569,107,83,183164,35625,147539
0f08c77320a83870fe4f4fff556d60fe,182,121,563394,141298,422096,176,136,582795,114135,468660
fe5ad96e02492f0ef7754b57cf99e60c,106,87,284343,83826,200517,150,116,465128,68455,396673
2de938ff7973849cc57adaffad873869,57,50,69912,24495,45417,63,28,55657,11475,44182
91bfb617d731d15fd9c2514f425dc202,39,31,33258,11087,22171,45,37,34263,15745,18518
25469305816411d900c571466bd4b0d7,63,42,88255,21887,66368,63,50,74568,37498,37070
32bca37b251f31079e94902c115cc1c9,205,165,772152,163451,608701,154,104,633458,93448,540010
501fe7668a6869764eba5a73a985f04b,143,111,468371,61024,407347,144,108,253243,74104,179139
d750f3ea1ead21e3f67929c968c9e8ae,52,46,62279,25047,37232,54,40,56987,21124,35863
d571277b8bb27662fd3e575e6abfb418,125,101,338771,66834,271937,179,136,467867,70499,397368
53bc52248371c344bf32ae7e48e1e206,112,85,192872,49550,143322,98,80,152480,52937,99543
e1a4d31e0500f474260d5b228e3f48b7,125,93,310325,78335,231990,106,84,264496,60131,204365
e210d4fbd0263867ff28bacdba6133e7,60,37,79027,18368,60659,42,32,42363,17938,24425
872cb005574c3f6f6d521b007062080b,0,0,0,0,0,0,0,0,0,0
88fa3d86895da498b729828fe6254935,149,91,831030,216440,614590,208,124,572564,224707,347857
7230ea36ea2603516274d38fee0c28c3,173,114,544522,86829,457693,148,138,593868,120903,472965
6ee0a20658e80c4f8c0c059181e3e6f0,72,45,73387,19670,53717,64,52,83979,21024,62955
4e180f6b9b56a958a56afb3bbf4f7e1b,140,109,249975,54850,195125,106,96,202071,40465,161606
329bcacefea82da8b22dc4907e7833d5,106,95,279483,34260,245223,92,75,176194,48101,128093
482c671e5b18192e5ddf28bc1b5a3ebe,3,4,311,257,54,4,3,257,311,-54
00c9fedb8e6d6c15fb3e1d982c569681,82,49,140366,25663,114703,165,110,323393,36847,286546
f5cefdb7f8851f4f6e52d9e830e48659,13,11,1623,405,1218,15,13,1898,995,903
0776a58b64178dcba80b827cf3bcda2b,190,130,949285,169703,779582,174,109,823294,92862,730432
e3e5f66eac080d5684474e2d6030e72d,190,143,1067756,90853,976903,129,111,389785,112227,277558
fd1aac4baf88455c8e7ceab33c8e4908,158,119,610471,104440,506031,184,154,588328,185446,402882
53898d4773c8828b37e41ef5f41a7be9,116,101,226832,45541,181291,108,91,223902,51865,172037
3e9809bd522fe2b9c3d6132ba092f88a,26,22,6558,2734,3824,25,22,5405,3456,1949
2b657bf5131d8efe4e3eab27ff96a0f4,47,35,65022,24742,40280,49,45,74956,17116,57840
9465733ef1ade24dcc7e817afeab8e56,53,46,73489,27611,45878,64,56,64958,23957,41001
ddcb2fe419b0cd237187b3d806b24733,61,51,119249,28233,91016,47,38,68904,28245,40659
42bdd0eb926cee4ffdbb7cf6c7a0b4d1,104,100,184295,47635,136660,83,69,160396,31714,128682
551c6f9d67b7be8c1b5adefd6b170637,119,100,347719,69921,277798,160,99,258982,51002,207980
f11c322e7b50fc5efb9eddec1b71a470,48,44,55462,19997,35465,57,46,75563,22428,53135
b3bd42a7dddd923b566e565187d244c9,74,67,98914,26861,72053,62,46,82067,20509,61558
c120c9b31321df2e0a4d1335966b4c5e,49,37,59806,14770,45036,53,42,63266,17863,45403
d35b67e054f91188beeab5beca867f10,191,122,609352,144214,465138,146,116,486471,113012,373459
99b55485cf6c0975996b60b7206b558d,23,11,4308,1689,2619,19,17,5457,1652,3805
3c387d9b66ad1e051f3a38bc0d0e834f,86,75,162836,44628,118208,59,50,101608,35994,65614
703f8f357b2bc57f1e7c93352590fd67,161,114,353874,84902,268972,120,95,262384,110218,152166
5e3bf3609a35913558eb9bede813bb5b,79,63,107014,19442,87572,60,56,89524,24036,65488
07f04ac652dc5d00c74344a9f4bd5082,23,19,8812,2796,6016,18,17,7054,4578,2476
6e096fe5cb33bb1cfab9f7045d22a904,17,8,2332,793,1539,12,12,1281,1396,-115
5e6955c2b7fa49e2ed6b76c1b18df1b7,94,88,203420,48864,154556,67,58,115041,66575,48466
4ec7b667bd2e9f3b971081d8302b5aa1,193,132,929545,137810,791735,202,148,695100,143453,551647
b291ccefdc1768a36dd5bc3589656f06,155,133,357113,105599,251514,108,80,275081,92030,183051
bfc9d24b204ded799603e65728bedea9,132,88,257308,46460,210848,101,79,187961,48546,139415
d32fd3ee93beef0f720b69def7432554,14,9,2667,1506,1161,17,16,2675,2485,190
e9c28c7a1f5c968038b3b9a7cc361a0f,0,0,0,0,0,1,2,80,41,39
a2d51e529aa020b5a1febf7eaaffcb7d,194,153,904218,154752,749466,161,128,818441,114671,703770
b675f2a007406df090071d90383eb745,101,69,208757,84695,124062,158,112,447308,68491,378817
24a2ba54d759eaf471cb136201253a7b,128,97,244275,70567,173708,142,110,319892,73028,246864
7a91cba9d4fa2d9830a54e5ee315e32f,133,101,337428,106839,230589,150,125,374893,89327,285566
032abf6317c8f0ee376ca366236638c5,28,22,15714,6006,9708,33,23,20268,3578,16690
1b8929164712d8f6de87dcbc36ea4fc4,211,119,595198,102820,492378,157,116,593225,110351,482874
b55d8c8002ff8ae1519a9649ca964c28,88,59,105645,35156,70489,74,57,111558,25051,86507
18693213f577bccc4e9ac2ea9b8a9417,43,30,27700,11187,16513,49,37,28020,9064,18956
3c5aa003845b57bfeaad04cd1a7b37f2,29,21,26149,9895,16254,28,22,23152,9413,13739
338c6d5cfc2a171c86ce1d9646ff7bbd,28,25,22261,6732,15529,44,32,42540,11237,31303
2a1082e191b669c8d0264912693e2b68,84,66,133893,31625,102268,82,59,107747,31678,76069
d7052f5e47f162e8758e36724aef561e,95,84,212581,48360,164221,155,125,273299,46300,226999
1f682c76004953e049089818c90cd120,139,136,326606,75188,251418,85,70,172512,61089,111423
f8120e2781d04acb4c63b4bf233cb824,40,28,36597,16374,20223,51,36,48383,17144,31239
05378da99ffd19db4620ca41505a39d7,126,75,271846,48970,222876,96,85,258272,62286,195986
91d9cedda25bd16c5b529cc1c29c1f0c,153,103,430455,98135,332320,210,133,563157,104073,459084
3be3f5648c328115d8e599c29553fa71,138,116,331244,61518,269726,139,107,330448,64286,266162
43883e6d18e805d4e8d97cdb4c359827,33,28,14472,6298,8174,27,22,13869,6010,7859
d0115823dae73030539a2af71281be87,77,69,115910,20162,95748,54,41,64977,15410,49567
5eb5591e11ece9fbff3956e7431faf96,70,49,104856,19390,85466,71,41,79507,23281,56226
faa67953c506f334899943b0ea6b13ad,106,87,170129,37012,133117,93,80,169703,32837,136866
1e443000cb5b750c8894edba75cbcaa8,186,116,453322,93276,360046,145,99,352241,74877,277364
4a6e40ca0b4238184a6bfd95f1f5112e,117,75,175850,67880,107970,129,80,210875,58443,152432
b6bb26e925e25af94e48f094fdd7b744,25,21,8946,4795,4151,23,17,8201,3571,4630
5f0917375a461d9fdf31f6a113fcc3f6,90,64,135428,36725,98703,87,76,124394,34445,89949
236d39ba81368a12c7601ee1d82e49e9,96,86,306661,106948,199713,129,109,466565,61702,404863
9ce42d2715ca1ab3d07bb84d9986421b,75,58,141236,37074,104162,63,54,131974,31108,100866
8a4993c003939ce553ae23951dfad0a6,37,27,36234,6551,29683,38,32,34305,6134,28171
86879b6df7f1644cbd521febbefc33e7,121,78,207673,34908,172765,114,88,222693,46571,176122
ba8e47653a4bf66848d250a78b9ed103,79,62,130584,43119,87465,100,79,172402,32494,139908
1fa81554f5f1194441c3dcd9e436b848,28,23,20186,5376,14810,30,28,21480,7592,13888
84686174477347c8db2583174fa5f5bb,32,28,10671,5084,5587,29,19,10288,3817,6471
d9dcb38c6d1db2580595f159b306448d,40,29,42616,12789,29827,77,54,63921,11480,52441
ba6cb466644e6471e1e823961cfe2b70,109,90,221137,62859,158278,151,128,317561,81061,236500
03161ed118f774b8507c5a6ee136c0b2,174,134,537981,85081,452900,155,124,465640,97715,367925
95f2ce720f7363e032b800818268a0fb,39,30,34311,16653,17658,40,30,40241,13920,26321
064b42157362976123b8c1ec065679cc,97,67,161174,46421,114753,109,90,196019,54588,141431
5fa3b1f6813a8c76e1515b51f95de564,137,127,368202,80245,287957,140,95,335012,53407,281605
5c34f6d7fa469af126c9ed3cabb973e7,1,3,40,331,-291,3,1,331,40,291
7139d856a42f7e7f60c02c5b03c0e41c,196,141,851361,115314,736047,174,144,757586,139029,618557
eb74f46dcca0786ff95c59e66acb2f42,68,64,70098,32311,37787,88,74,127235,34046,93189
dc597713bd6a0980dff27d85f4b92286,41,32,45134,23177,21957,45,42,62647,24882,37765
d26c67666df13418b2c9fea4e9656736,40,24,22483,8548,13935,37,33,18866,8821,10045
b7cdc2ed67eb2516de9d13fba60a27f5,52,35,37163,8530,28633,29,22,22248,7962,14286
41fbbe56f2f0b317fbe70a5a2076e68b,46,35,72040,13161,58879,46,42,51964,19995,31969
afde17f77c7f71855935fad87ee22780,83,60,162268,44935,117333,76,66,139959,50139,89820
6b65f5fe34120bd5dd47c6b5fdca04d5,181,136,615917,108992,506925,172,142,713720,157577,556143
d7f80c374886f3b1113156c4e31e8631,51,45,66006,23975,42031,46,27,44487,16317,28170
3a1e6f15c4558207ef175db9f09ab0e1,168,119,524695,92950,431745,153,98,469919,120575,349344
6d8ce1606975f90e3a8629af701df60b,165,108,609804,164832,444972,164,141,887952,205741,682211
9fe85a963ab1f05d5e1e8a46f0a1f54e,33,24,25794,10104,15690,42,36,22183,10415,11768
8cd24bfc261e6bf1888cf73bec84d204,96,75,201992,52537,149455,94,85,190712,47506,143206
3213c9982705395221fa9fa3ac05b31f,13,15,2332,1580,752,15,17,2550,1504,1046
2af9e31bd4eec479c7a916b7b5058846,112,99,346636,109798,236838,140,85,408007,85902,322105
0ecfbcabf8349c8def4bf4b0a0fe1409,4,3,534,377,157,2,3,333,490,-157
4b0148ad1c6a2b6c5def4fbef86a60fc,190,123,565670,100518,465152,157,115,515069,94092,420977
4d3c9a3599b09c05d8ca40be3e1cfd62,77,66,97378,35001,62377,86,73,143460,31601,111859
b4be39bbcbc2fbe2e8fb17965c3c645d,34,24,20823,10580,10243,37,28,30252,10943,19309
82a0b9b031c2a834bc959fb0da7e3b69,34,29,28931,10620,18311,32,23,16419,9650,6769
365889fb28ca967777a20f0843218e73,30,22,13275,6045,7230,25,21,15567,7233,8334
15d9beebd8c7e5aca3bd9d09d63b8a8c,60,48,92387,24736,67651,51,36,57622,20319,37303
eca0fdb0fa7d9f98611907b510e01e99,151,123,540936,91310,449626,160,126,547008,71342,475666
2526c7418c7d0e79b0e5af8bf0cd9876,49,41,65175,19524,45651,40,31,48786,12307,36479
d0eb1240dbb455482e58ed257f421ffc,40,30,57093,11111,45982,51,47,67866,24693,43173
24b99e7b588a1d248e0e462654489148,91,68,171105,17597,153508,111,97,211419,35154,176265
0d37de23e74f74c81a2b11caf6765cd6,53,43,96335,25383,70952,39,34,73979,25079,48900
7a075f0490a11b2d511b8a1d03789ff3,70,62,169562,34865,134697,78,67,144633,27751,116882
b9be90cc8631dfb51f6497d12bbfcc8e,5,3,408,214,194,6,1,648,59,589
4dad844a0a72362b6497488ed05668bf,134,95,294159,48206,245953,150,104,318128,51783,266345
69f5a6052aa0624c9c7403da8d1f9d34,16,14,4685,2070,2615,19,14,4760,2152,2608
207253668dd9789ad902fc485fd839a9,106,92,313863,64142,249721,124,95,276940,79737,197203
37e28f360fb8edac23b5bf3b13831de7,102,83,176368,37047,139321,97,81,173975,38668,135307
0eecd7e80e6ce3d165f3315e0e57002e,115,90,237453,40557,196896,118,85,170279,38483,131796
a771f5276df0585d95482245d1bdc62c,34,23,42447,14828,27619,36,28,42044,18093,23951
672bfa04a7d0643f269fa661912b2710,30,25,15457,11070,4387,29,23,19942,10058,9884
9c5588afd5d62ad783703951fa0536e6,129,59,150897,37574,113323,68,43,90246,34447,55799
6cf355822ee0e1239b61c38571c4ddb3,169,120,518547,116102,402445,179,140,612351,117183,495168
f8d93c92f10f74f0dfe7ed7a80054775,138,102,285781,93161,192620,123,110,308178,98160,210018
9f7ab59e79bc8912056bbf528467a5be,68,48,65538,20410,45128,68,55,73531,20066,53465
ac045aafff3eae94b5b1167bf8207f28,71,52,83404,30732,52672,76,63,121637,27801,93836
99f117fe5923568c645c5c1f2e6bd264,30,25,21244,8257,12987,29,28,20828,8533,12295
590850a3e5ab6e333a82bf63d7c029d1,51,45,60843,15408,45435,39,37,54432,13132,41300
f5a20a2527aedf88afa92da89923d09b,182,135,685435,185726,499709,193,126,761374,147000,614374
e13039457c36e46ff2d373a488e2b6cb,75,65,128258,46613,81645,100,79,169279,42271,127008
3ac0ea48981e7db7aef9779e1b0d40cf,92,61,165686,43081,122605,103,78,167912,37284,130628
c1ad9b6517d8746e267db6fd9bc6648b,85,77,183919,54717,129202,147,120,266685,50457,216228
5376c6c0e26ad2425cfbbffbe0e1af67,56,44,62029,17576,44453,35,27,39137,13451,25686
4028288ac084dc9ab7ff64ceaf19ba74,113,80,174111,34609,139502,74,49,133355,26227,107128
a25379b182a248cf7dc888e8a304be09,63,49,73616,19539,54077,46,30,42141,19040,23101
abdcee05be72854ac7ca6c0128c9f5eb,25,17,17743,6658,11085,23,18,13553,7548,6005
5e859a56c709195f1e50185432fb3d12,83,69,192406,33307,159099,84,56,163579,27356,136223
ac9c4eedf64a15c95eee54e57126a53e,45,30,35552,17041,18511,43,39,50163,15466,34697
423f0d33e57f3180c3468b9b332243bd,138,107,325346,77140,248206,136,104,377104,66528,310576
9d867aa5e51626fd6922d7fd93bcc28b,41,34,33874,14409,19465,40,36,33995,12085,21910
dfb76a048cb45b16d1c3c9ea4bb3fcf7,126,89,370715,119195,251520,128,100,423476,99033,324443
e8239b50b2f082a89c3f0f9e9d24e3ae,65,67,74058,44059,29999,90,61,119028,29484,89544
d6e7f24e7c012e3af595860ce03c1aae,114,88,334408,80232,254176,153,123,440887,85548,355339
d7c973d54d23ee4c465d4c88e33f0e74,135,119,419313,107625,311688,176,119,384576,70098,314478
e2e0a34c1fbb31d2b6aa0953ef810494,70,52,91090,35818,55272,91,76,162884,44440,118444
a3d8c71e2dd4ce838fe42ec48045bc69,126,112,302430,71500,230930,96,81,253821,95043,158778
7e5ebdc8090ec8ca56ff7d9912648142,38,29,60547,18627,41920,42,32,62589,17488,45101
93943112ab63de344e7c5e77d07d1a17,112,87,229247,72440,156807,141,109,338104,55305,282799
f04b3dd72e98dc1c7f42bcd723f3aef1,164,114,372875,86644,286231,96,65,201827,74629,127198
608de4de30c3b24ec6deae1aa251ca8c,39,37,44705,20005,24700,38,28,32302,12407,19895
2e56b9cab287027e0b48cab1104eb9ee,132,110,418340,103907,314433,161,127,539048,81030,458018
61bab8b00d3fd4e2f7099de0af3cbec0,108,83,294089,59503,234586,100,74,253850,90625,163225
2c030d79cef43e766df7cda4c9551d2d,186,124,390527,84454,306073,159,130,424881,75880,349001
2030a44b0da4529e538bd8d6bf72b217,77,65,105622,24979,80643,85,51,83372,18226,65146
f6f690d4296788a42008c8e274264e9e,178,109,422701,72921,349780,110,96,250551,86634,163917
2167e6c835729443e22d1bd9d3d76d48,166,113,598618,77340,521278,180,124,642598,70209,572389
c13a16cbf6bc76e24c6a59f017916bf5,97,65,192876,70022,122854,175,94,301655,52890,248765
6f746bd23147341980e0a32fad461366,103,75,256731,66762,189969,165,105,300833,74966,225867
09da676b9d7c5c685fd34fb2725f0648,11,10,1574,715,859,11,8,1008,870,138
7a40ff012df675df416c839f864fbc8b,29,25,20329,11305,9024,35,28,19969,10077,9892
c2e0ac353f27eee21d250d964770edbd,88,76,199003,71787,127216,113,92,264312,57896,206416
e975c5927ee68815651d8d39885c0d88,103,70,126721,24740,101981,96,74,99187,27217,71970
7afe9da276568fdbe73742eb56320175,108,84,194405,41309,153096,108,55,145707,41526,104181
35cddb1f6e98b169fbcf6ba332871832,82,69,142541,31430,111111,66,52,84303,42559,41744
2159274fce9b8228a04b2f5ca38540d2,24,16,9378,3307,6071,25,21,14135,4508,9627
b4516a1c243122781a506f4bfa5b1c32,78,62,92986,26826,66160,81,67,122980,30604,92376
f4e50a020b8d2c7335c1dc4911b0f988,47,29,52066,15205,36861,60,52,89848,22377,67471
e44c2b7ae191f1ed858d127cc31382f2,144,83,378769,109794,268975,144,105,446943,118997,327946
87c381def9a9263575aab0604c96b857,188,127,500833,101377,399456,122,95,339331,107913,231418
7950dafdbe61aac0177440026ae77124,156,122,362338,103458,258880,147,96,377090,69323,307767
7acacafd2a22319e18e807fbbb64dd42,118,92,186186,42301,143885,64,55,107207,37084,70123
f69d657ed2ed938bed4d9dd956989a8b,20,16,5018,2161,2857,21,16,4811,3825,986
ea051fee25ff00bee93af92e10b9750b,84,48,120951,24959,95992,59,47,112533,31086,81447
4ff67473edd12733cfa08d3cbb624482,51,29,41194,17091,24103,46,42,56662,19727,36935
54427aed7507d94b035a0383f343d927,57,41,58942,18859,40083,57,45,64200,17575,46625
d9cd483f71c46cbb5685c291bdf26bfb,166,107,453871,113441,340430,156,99,497677,87864,409813
e89f60fdd07111d293ab5127fb9b8360,140,104,549678,106127,443551,199,155,646342,221711,424631
84db7162665c5636115040bfbdaa536b,79,61,119954,37461,82493,83,72,124342,53820,70522
444b34a2bbecb21b5cdf411fc26d9176,43,26,56994,15539,41455,54,38,80390,16041,64349
b5d1dea5d3592bb6baf94321319aae25,86,64,138526,24048,114478,57,42,63251,35413,27838
234c27da646d80d191779b92a4c17343,129,98,349498,61043,288455,129,108,339850,54238,285612
77ccc44f5631144820f1d40ecc452e3d,141,101,302102,62973,239129,161,127,348709,64154,284555
a4760ba5fdade42111b94b87648368d1,172,110,365565,78768,286797,213,151,562659,64985,497674
1f22ffe89a07b628e25760d32d525efc,141,116,395214,129343,265871,125,86,328531,94782,233749
c7da353f9995a92f627bbaf56100b5b4,75,61,160135,44105,116030,81,68,142712,49867,92845
fec60fa6147d37a5234a7fd1d0188c1c,81,70,141350,37468,103882,73,55,112118,34472,77646
98ac3ec26c68262e0632158d45ac43aa,23,17,6125,2995,3130,21,18,9483,3407,6076
62134edb26cf60c42965a355b8a423d0,89,70,152673,52117,100556,111,90,168191,46528,121663
170b89c33f879f7695940eda5c5506e2,192,129,740354,204642,535712,176,141,708290,186504,521786
1e5673b003adcce0fd83dceca7218d99,21,17,8127,2805,5322,29,14,12947,1855,11092
9f902c25095c6ea2a6b97667a5349217,136,102,358150,98397,259753,137,104,387610,96154,291456
38d65d1be5cab84553ea0081c515ecef,181,125,539407,56441,482966,131,94,325746,62346,263400
741044b9232a5d69bea7dd1e44d83e87,77,58,136001,22816,113185,73,60,118191,34911,83280
c1d5271f499b76d44f71c4ab6fbf674d,24,22,6494,4485,2009,28,21,7030,3034,3996
580f9df6de8352073d495ed47acc2a34,57,48,78795,22459,56336,54,40,77567,15372,62195
4d421b2aaba98d465ef8ea60789e4def,32,24,32920,14418,18502,51,36,40879,12056,28823
90d7fa621ebe609a65fa9897dc822518,106,80,165435,43830,121605,61,51,70198,49922,20276
397360363a07bf91e3f27b8a72274140,109,84,211586,56541,155045,106,84,223568,57435,166133
4468fcc8c84a18ce02a6cb7d392f3230,189,134,821577,92032,729545,156,117,636587,128265,508322
c1f252dc4cb967905d0317dbf027a482,44,35,29821,15087,14734,43,39,41586,17241,24345
21428b15279a0e269e6b4aa2f714ec43,114,91,406570,98121,308449,137,111,418246,103162,315084
a304fce9bbf48d0f293b5e9129eab5c0,57,46,103158,28786,74372,51,40,76950,31325,45625
2942ab220948ec1091ada7645e33cefb,108,84,179704,45999,133705,80,65,129404,28310,101094
071e55ed94a5f2b3338564114318b10c,108,77,263484,83096,180388,151,118,516703,88156,428547
d673aeee53a2c71f563a1c6f15312656,139,95,406503,130452,276051,110,94,426609,105430,321179
94f5b76351e33c536b698722ecd41e1a,205,151,762784,317812,444972,212,133,1110752,190593,920159
542d4e3113e62c271c4bd9f652d84229,147,122,449722,118965,330757,148,84,462704,93799,368905
4f131e63f4761fc821a0897bcc0a9cc8,138,100,371569,98428,273141,168,123,557701,142802,414899
819663f409fbce9c7a916c6bef7bd39c,129,80,250908,59256,191652,91,54,169246,56987,112259
3cb982592cb0a07606276408c70d40b1,92,74,234243,43951,190292,68,54,98764,63851,34913
bb52b00adb78938b7452639b7ea89932,87,66,119224,42820,76404,85,65,116921,40835,76086
5f76e7691b0e55a460a8722fb7a0c561,12,8,2275,777,1498,13,9,1579,1462,117
f0051027e9f40db57b7529d503c11cf0,99,85,242945,46874,196071,125,115,251955,47387,204568
f0e63e669a8aa7418286ccb646150946,59,40,118139,25826,92313,47,41,87608,33309,54299
063a1076ed0ad5f48bbe89b6c0d12488,58,37,56956,12195,44761,71,44,99395,14212,85183
53ecd02e0b2d1aa2609a6687d1c35571,43,43,36143,15319,20824,47,45,40195,14842,25353
403ae813eb2d4d686c1243bfe00b4efd,16,13,5191,1528,3663,22,14,6375,1846,4529
679258964b9ec58d373defbce63c42a1,86,71,120236,28721,91515,98,65,110467,28457,82010
03a65656b81ed82ec74aaa0192d3435e,137,112,349773,60870,288903,122,108,293066,74698,218368
fa69baacbb2a776fbc4844a753faf9ac,56,48,75532,23560,51972,61,49,74026,25037,48989
f394571204d380fee35a0b7c44abcfe2,41,30,48557,15146,33411,43,34,38541,17640,20901
4cca8dee59d4069ebc65b0f2334c86dd,98,83,236983,79209,157774,81,67,169036,61579,107457
74854a36e339f1e7c120fcdeac911557,41,35,27448,9402,18046,43,31,24199,10053,14146
a4df8c235f6d77a874655da18ec2a73b,82,78,183271,58429,124842,141,87,242035,44649,197386
9dac387613ac5658c96804ca49189ffb,0,2,0,226,-226,2,0,226,0,226
e06662010ff767d180e164c390af709f,89,63,131940,42041,89899,92,78,162779,41591,121188
8d2c1f635984a51e017523cf5de912a1,176,127,469753,75788,393965,134,102,404112,58885,345227
740a32be0e8399ccd0201b9d7131a14d,113,88,175385,33968,141417,119,83,140369,36949,103420
be405098001fb2382926bf8f0e1381de,92,71,98065,36432,61633,86,63,111718,28578,83140
43be2f8fcec7a6f0c163b6f4e81e5c19,85,83,153505,50862,102643,78,62,88552,51432,37120
163e67f209acc81802a322431ae233f6,129,94,356877,45899,310978,112,86,198995,47289,151706
27de901a6aeda06c0d6533f5d5419a34,41,31,43581,9312,34269,42,31,43600,9871,33729
0fee1afe0fce366887b9965d0161779f,42,27,28717,11145,17572,39,29,25953,10536,15417
b863690343e6c3bfd370611341287160,26,15,13859,3469,10390,23,15,13908,5339,8569
2a47f03114a211ecbcc3b8b52c279f12,134,101,485626,142397,343229,180,167,716707,157271,559436
db427aa0afb4d884b35c56b6d5f45617,200,132,682314,136978,545336,207,160,820352,113704,706648
b3be8e42997221c027e452bfce2336ad,12,5,2229,502,1727,16,7,3067,449,2618
16bf0141245691f8aa1c7702c7a62a59,173,111,410165,109623,300542,141,111,380057,114296,265761
1499ef2d35a22d2c0619ba82574cf95e,100,82,202484,39163,163321,76,66,129759,34822,94937
562aaa6d4a5d39e3358d1cd0e3109459,78,58,97965,16517,81448,99,65,110349,24395,85954
b8db4c332759b8fa523c487dcc7f9535,63,36,80787,24059,56728,41,41,45803,29022,16781
6c0bb2ae0fab1c643a902a3967901ae5,131,90,253484,57046,196438,89,62,169370,70758,98612
87919e8f3b335f7a7acb477f00c72e10,134,120,347357,118781,228576,170,127,359400,103484,255916
21fdffd708f99ea4d6f05fc8b5fafe38,163,135,498769,102163,396606,131,99,342357,91473,250884
d71337360492eeb3c68046eac301e589,122,98,241345,59061,182284,105,81,258951,41437,217514
d738f04ab0bde95cd8867f3a84c17acb,49,37,68134,20432,47702,59,43,93266,20486,72780
1368afb675d09e40b7fd9ecd35fbe0f2,238,186,1403289,312004,1091285,245,169,1485502,249880,1235622
c709868e6e525372b77bb31d1054c2a3,127,104,364406,95377,269029,185,131,664393,91866,572527
7225f5a1832b93520b0f9e8a1e20c9dd,5,4,524,152,372,4,3,328,299,29
5be1adacebfd7698513c3b63e8148a90,139,112,344179,109835,234344,108,79,261753,72848,188905
f34f327e8517bc11fa6299487dd643cd,36,25,21621,8009,13612,35,24,21143,7154,13989
6f51d344486d5c77f970917d6d5485c7,215,113,728907,104488,624419,220,139,791846,128798,663048
62efaa3362d9a1b8c3837728dffdb04f,42,33,39479,17680,21799,44,30,42074,13817,28257
8fb86af3cdb86f4f1a8d76de89447145,94,67,147976,30894,117082,93,67,164202,30443,133759
e2d669c3703e287feebfe9b187247bfc,143,112,364144,118042,246102,168,118,444385,89692,354693
7fc5956d6c7a333f49701e1217eb08f3,68,53,125706,37133,88573,80,67,102725,35751,66974
61c419b0b16a952e8f3f68b1dfc997a6,79,64,148709,52204,96505,84,65,129063,58219,70844
1f6044de6305f9a1f33c7ec7df72072c,66,48,88942,16106,72836,79,65,107503,31814,75689
d84683272e4f8adee7f7ee3979a844e7,128,108,312381,72503,239878,92,77,214021,72953,141068
58147be0c30b2fb5b6a36ff60397f9cc,65,53,72679,28490,44189,70,57,81390,28503,52887
feca8c04d63619a95d3419057563fa5e,46,44,54562,15870,38692,37,31,40835,16085,24750
29a8c74d35fe328d4b18c0a77984339d,84,51,172667,26847,145820,62,45,101303,40144,61159
093f5729f2f45391895781c71771f8da,57,44,85419,28244,57175,46,39,68476,20854,47622
f28a7fc235c41815c521d14ea0e8c353,113,97,244499,64137,180362,111,81,230843,30806,200037
c11e4bd819a78a9b35486070764e6429,40,31,25831,14789,11042,42,30,39969,14743,25226
6398e778beb5947170e893e6f084ac41,193,111,365970,65156,300814,171,117,363076,80372,282704
a04fff9ff55bd586582082e1ea22eb47,159,112,409694,93849,315845,197,110,491576,67525,424051
1e7a6d78e99a9e979951e675aab24170,133,92,290728,60334,230394,105,92,253718,53629,200089
602822b51ffc8d2e4451cad3fa5952ec,32,27,32920,11838,21082,32,22,26568,11155,15413
d0dc4e34bc72aa599d8f99d9474246bc,122,76,360718,61952,298766,135,102,334777,93070,241707
50c2e6fd581bf8c2aeba768bf01f3df4,124,89,238466,48087,190379,126,101,324335,53565,270770
3c4328a529109c8245fcf034ed458f93,138,93,368133,57322,310811,135,107,295642,72846,222796
844eadb2f068b01d7258ba1f877794d9,124,96,417653,107424,310229,172,145,470091,109853,360238
20c0d7476d9dae977d45b33836be45ab,37,35,46651,18741,27910,40,31,40696,19440,21256
f66f7dab349e5f54933ed122ced95240,116,88,254805,41959,212846,109,85,240775,55185,185590
fa8f127e8813a21449c26cc6b90f7c6f,183,131,856728,186301,670427,181,135,973734,203921,769813
7bdde3d48cacaa5911497a293d2ecba4,133,77,235196,57218,177978,104,75,209027,75364,133663
a834f364adfdf1507efea8db4903a2f6,45,36,83147,22769,60378,44,38,68993,25861,43132
bcbd456dcf9a9660a900e95a1d589963,51,42,89491,23527,65964,59,52,122245,29981,92264
14619c0f9a27d6c42286be1dedc1d16b,101,81,201113,58466,142647,157,123,387852,58644,329208
611ed52e4722e1425221d7f0a9378c43,126,118,460930,81477,379453,74,67,169402,51490,117912
6a293b31a2b1094d523eb1919232319f,39,28,23240,12533,10707,39,30,31465,12855,18610
80fe765dab054f9ef7467efb88c209ab,87,59,142675,27160,115515,79,61,117124,35568,81556
03c1566e41eedd51a33057be2eb0044d,48,28,42660,11282,31378,40,24,30554,9810,20744
d606c205bc604effb2604717655994f8,117,89,183737,39464,144273,134,94,199904,23983,175921
0e1273ce85e3f380c5c84c1c3291d32c,68,46,127063,32676,94387,92,75,168749,50742,118007
3c5a97a2f1b4daaac110a47f9647062e,141,124,361075,84506,276569,135,102,349046,81019,268027
f7a3bc7bb8fda2a0671d922df6fb97df,72,62,101628,39967,61661,98,84,193270,36260,157010
82c5e53d1108d17e4c4a92997c554bed,102,87,200664,55575,145089,122,94,268993,44994,223999
223a32debe62c8be4e49c84d4f6d5a84,61,48,84293,24324,59969,44,34,54308,17439,36869
d98e79f87b4a70b35ec7b1f2a8bd6728,76,74,115063,37737,77326,73,55,121282,20542,100740
16ec904dbc36a060e6b5af2fad646d7d,30,23,11752,7010,4742,23,22,11662,7260,4402
8ab23125a2b5a3531628ab419a53a6a7,37,34,57023,18599,38424,38,29,33803,19045,14758
52d0419838c81d7ba1fe10c0711eb529,26,22,15634,3622,12012,24,21,8357,5342,3015
0a914de64e58589835bc4dbe4e05a121,51,37,80096,22797,57299,62,50,114665,29024,85641
10abec0ea2958b0e08744bec5c2c7e5e,193,144,499831,70112,429719,123,108,409534,90602,318932
96ffeec10228070fba7428e750527094,131,92,255581,41862,213719,121,95,231058,53856,177202
d543739c1b329df86e94faf1ed6e16ea,153,111,378207,52265,325942,154,115,315276,62461,252815
4dbc4146e2ea14f44170ac2a48e7faa5,144,121,513849,126888,386961,192,170,940798,130076,810722
7ff879dd37f205224a96bb641aba52af,167,122,398486,71515,326971,125,96,216461,57518,158943
33717642703888ec13a567cf13f1c779,77,41,116324,30989,85335,93,80,146000,42690,103310
39df7c2cf5293fc2468ac6e1ddd41412,141,101,501061,82111,418950,147,114,503324,84796,418528
c154dcee207fdec9cd70d8ae14c921cb,34,31,27898,9872,18026,28,24,22318,12630,9688
2c6db34191e56816a518ec59b225b87a,66,64,67797,23094,44703,73,42,111842,18345,93497
27e3c365b54898c345712138ce1053a9,58,47,87041,28710,58331,50,43,67270,31102,36168
8a83614e785e1b48ba7ab4a30955c8b9,32,24,40075,8781,31294,54,50,42056,13825,28231
33b462de9c89f92eac14f15c9a3baf01,23,17,6031,3530,2501,24,18,10153,2441,7712
944f8a7b58566ee6028cc82791272fbc,21,17,5735,3392,2343,16,17,4922,3542,1380
dfe5fadd1d09499ec0d626311ed76ace,54,39,44305,17104,27201,34,32,46912,15297,31615
0d041a3440b478ac9bc9d5073b0f4909,31,25,15377,8078,7299,36,27,24606,7768,16838
bf17fc4fcf55cb0f9e12e8d9e99b4c43,46,40,67574,13363,54211,30,29,39912,14304,25608
62687d961fdea73af1c7ecce9f474d52,108,89,151415,41547,109868,75,65,128674,40477,88197
49ec99fd4ecbb9df48ae28b516535abb,114,104,267658,61267,206391,67,42,171239,45841,125398
05a2973999bb4f5845cabd5c8735e359,191,133,647244,140997,506247,153,130,589634,161106,428528
f0e7fdb6a14a94a0113352943f378275,73,60,132804,46877,85927,78,48,142700,32557,110143
e7305ec5c472eb41aa2298b37fe231e2,126,103,377245,65654,311591,135,104,426726,64617,362109
b3ae496bf86d9b6d9a5074ef286e9d17,105,72,194186,38210,155976,109,85,197556,36708,160848
044602f7c3b7b962ec08055519674ac6,105,82,219636,73743,145893,122,85,273285,64311,208974
01b8885f249d690766a61a46d54a52fe,81,64,149856,47668,102188,75,68,173263,45234,128029
fc74071729634590bd8aee044931768a,112,88,287278,59813,227465,86,69,217248,59217,158031
80e7ca05c28ce8611786eca5b37dc0b0,28,23,20529,6584,13945,23,18,13484,4736,8748
2aba7e916d9360daafa4f5908aff26ee,18,16,10329,2930,7399,22,17,9260,4412,4848
887fd54490a9cd084b4a40942d82841f,58,47,84183,25657,58526,61,44,71940,31263,40677
3a4be4dd8809305a288064b1f7cc1805,61,54,63461,22095,41366,67,39,86306,18487,67819
90038209b641ad7f26e12f5eea8a254f,197,150,472360,112930,359430,147,119,479150,70353,408797
f65f247daaae1c5b7a217f97e7593d0e,183,127,699475,114687,584788,181,156,753073,124363,628710
03b9738f2eca98037f20d09d6417693a,41,30,36709,9831,26878,45,38,36131,18739,17392
8ce495c397ca6e02ea0d84e57113de2c,36,33,24834,9637,15197,24,25,21784,7670,14114
253d4debc5308585afd249478a190f40,24,22,22577,5862,16715,21,22,10848,8234,2614
53d4ef339b0f4cb69d0d4cea39b98f15,59,46,54345,17168,37177,57,46,58942,23113,35829
12e3bb40b204c81386f5c32151c4d205,77,59,133775,36877,96898,84,67,144170,38642,105528
d84596cb43654f288ae23ce71f0d473e,108,86,260581,71837,188744,114,98,280750,75361,205389
3fbc7c60cce5d9ca645d7991c120d2e6,5,3,610,370,240,3,5,370,610,-240
ba0910185d3fc2912bdc5089086ba6fe,29,24,10261,3087,7174,31,20,7723,4378,3345
90f862bb279c8a69e6dfdd9a5e36f371,167,127,470822,58298,412524,98,89,230256,86560,143696
0246ba476101a9c166e9418c2b37ae97,96,82,182421,44387,138034,77,57,142032,31837,110195
2294f8064d09c7e74b52e7f5caa09cc9,25,21,21464,8214,13250,30,22,30686,5544,25142
130f4fdc0700d9f5022187c7a3ae1a13,42,32,44849,8724,36125,32,23,27128,8280,18848
ad9fbe695ef9b19f37ee8ebf48742c13,42,37,49625,23594,26031,44,38,58424,20482,37942
2c9aeb3cbb59ac3e3a0d17b4575134f4,117,108,274894,57127,217767,128,97,245767,70043,175724
da63c692b46b01cfe7a77417787ae714,76,63,165626,27291,138335,87,62,109982,25647,84335
07ccb2cce818163dce6703b2dc8e4092,202,142,783385,101517,681868,169,112,408766,77603,331163
48db6832f69bddffaf6d9c1243ea0f27,98,77,211769,55214,156555,118,96,276651,57004,219647
e0b2fd446c46819cb6e8affe42c64c22,4,4,688,1185,-497,4,4,1185,688,497
94a157219d4ea4db7cc84eaff82e6605,87,73,179800,50107,129693,100,69,162899,43211,119688
141982c0023230aa88ce03eac3fa0479,76,45,87002,31512,55490,81,57,121867,29333,92534
d9c26cd19633e2035e7bd3a070f09c08,127,105,412359,88173,324186,142,103,352116,102444,249672
d4ea20a7f801a25a0681f31cd1e926a6,175,133,423770,59783,363987,180,142,482073,74481,407592
907efc31d988c201147d296f4129c522,162,114,551429,131551,419878,141,95,448071,129401,318670
afc44f25a6d9a95edbb64af975f5879c,123,103,273450,60924,212526,124,94,256840,56529,200311
658f6bf387c0a8614dd86423231716c2,27,17,15922,5537,10385,25,17,15937,4523,11414
a952c9619988e8afc1446815d581e239,134,98,310190,104213,205977,211,137,574709,93144,481565
6d9b0f6986a50e25fbcde0752d06f0ed,52,39,75738,15050,60688,56,36,65564,19930,45634
4cb8266bf798a86e6528e67daa8008cc,128,83,311333,46062,265271,100,78,212325,45596,166729
b842b6c20d539e59582047e91d888df7,29,23,9791,3141,6650,21,17,6800,3028,3772
9402ee42bb1be2a2ff6a7298a9594ede,20,15,6945,3487,3458,19,15,4975,2629,2346
0f06950382450acab80be5c6d0a45f7a,74,63,165270,56967,108303,106,91,265099,57123,207976
372b00ba2cf3abe8229c54925b5cc728,74,57,120028,39901,80127,73,61,106255,34526,71729
41564cf9e56af6b575d8168f85237b65,53,49,112899,34021,78878,42,40,64458,25336,39122
61e3c6108b27df4101792af18027af68,77,57,84526,27871,56655,66,55,103749,20459,83290
f5b9121c00c5d792e2feab0847210317,59,54,72445,25893,46552,56,43,66384,19772,46612
30f218d9a37cff69b935e46dc03190e2,31,26,24702,8162,16540,35,27,21955,8564,13391
e47a9af1adb5bd1e2b2ab8bca793ad8e,55,50,69088,29241,39847,50,35,68832,15414,53418
2e0864e9b55aff31a03908bdc1eeb173,34,24,24253,11689,12564,32,25,33963,9991,23972
76d7cf577044a22201fa94c9c26091dd,82,54,148306,38568,109738,95,83,181803,26968,154835
956ead13eec1bc4d21615a2433ee51bd,63,58,82771,23827,58944,73,52,92059,21847,70212
0c92e4ccd4f664e214f4a846a96d20c6,108,85,181074,61121,119953,126,102,248272,46336,201936
8ef2c42fe241a57dc3685dd14a8389bb,98,61,294229,92561,201668,162,124,405337,92365,312972
8f2d3590d46f682c4d565031fde450c2,73,53,131838,32851,98987,69,55,142453,27109,115344
dd5d38ef3516563b3a9db82591f4c26b,189,154,720060,138383,581677,171,130,662335,181082,481253
4b53d21b22c62f288d18fa9d1a059e02,189,157,897006,175121,721885,199,127,893592,90997,802595
c1fc3882aabceabe51cd6784c8acf6a2,50,31,31751,8955,22796,50,42,29353,10774,18579
19b6626a9d746603ef2dc6a292ad099a,161,95,344689,103211,241478,145,91,385801,83379,302422
c3261b11474aaa56f7090a57f8e9e3f9,102,91,234286,57333,176953,111,98,172979,53173,119806
9382ce7964b382d8e33d1c88b57b1c3b,63,49,92825,26073,66752,90,70,103171,33704,69467
9cd88d6fef76bf805f6485038ca330d1,158,119,467320,87437,379883,139,87,348202,61572,286630
0fe3269f0707acd2f797cf7e66970790,22,22,4690,5090,-400,26,21,8330,2851,5479
658af77d12e805697e1e14972bad29d4,19,18,4965,2449,2516,25,16,5554,3698,1856
0e4e7e3ffb4c2c8e57e88d4672b71e25,166,117,749304,140798,608506,233,114,804861,99963,704898
ddb82fee3cce9f3f07a0618fde36a7cc,81,65,126966,46281,80685,120,96,198327,40389,157938
3460201a1f8a3cea69acf34dce0b2971,48,39,39832,16837,22995,52,42,38821,11364,27457
401e06ec107089a9016adb0c7f97ead5,25,27,17569,8748,8821,32,24,24131,8114,16017
5f455bddf52dffb0db500b4fe3b47a87,105,76,205321,44764,160557,85,75,190453,43185,147268
fd6b8082f61c961b17e459f322e4984b,43,32,26621,8050,18571,42,36,18583,9202,9381
f35555334f9ca279c2231cdf512ebdf3,143,101,429621,216671,212950,186,127,525341,138940,386401
5e2869aac16fbd1c47f7fa9fb52da2c1,97,65,131487,31765,99722,54,50,120179,32728,87451
b2ef45e9393414f3553e382d99f47000,168,128,485052,152381,332671,181,132,480260,115692,364568
ad79b3ead3e4f169895c27b9c574c086,181,153,661611,104651,556960,135,104,512826,85207,427619
20453fc90b3ce1a1676065be2e1da0ec,85,53,99821,24421,75400,79,66,87814,28094,59720
2e0f639c5bcc07103421afce0c54b62f,64,51,79970,22119,57851,73,60,83177,20984,62193
4d9485a81531255c5142141759a82c6e,61,46,49458,23320,26138,76,46,85182,17986,67196
06da13694961e50b6271ded535082739,102,77,214518,53676,160842,128,100,287538,54072,233466
130fbb34bf133ea9e8aadf2dd6055ce6,45,36,38917,18173,20744,55,37,68715,13526,55189
3973bf71d500954870be1527b96e0b48,107,71,232038,61726,170312,108,77,273369,62663,210706
5286522bb11a5c114ce0d028c839de3b,63,48,99935,28998,70937,68,59,100371,30089,70282
d0acbd842c55c5c009f2c3f39c3a02a4,81,69,223501,73255,150246,115,90,222247,81448,140799
381f1d3f2d8b218e16551ffa27c67d7e,82,63,138127,43190,94937,74,51,119597,41674,77923
09273f40480b9b06ca464253af66efa5,103,67,184234,32359,151875,77,61,101227,47554,53673
972937a14072a57bf317eda8a91e6971,57,45,70199,27760,42439,41,40,60945,31246,29699
5ea2fe64804b366be53941c8f0405eb5,25,21,20458,8857,11601,22,19,20425,5787,14638
e987a1cd7b6fc46fac18f4550d53a6aa,114,85,230451,52470,177981,98,65,171100,36052,135048
51aab212ba2e766d34f9567898082745,91,79,164068,45947,118121,115,96,227809,40228,187581
7ef6887c4a7cad567fa5e8124ae62c1a,23,18,13898,6067,7831,31,27,13020,6831,6189
090121ea4db6334b2a0a046b2faaf78f,91,50,123913,18860,105053,90,77,131580,33542,98038
65f2c3158e2952b809f2e5837328107b,98,78,281866,77638,204228,151,104,323913,74538,249375
49624842cab1fbe61292bac8f1aafbf4,13,16,1993,1926,67,15,13,3727,1517,2210
59a4f9a53e2910cf33e58c18cd06583a,10,5,1090,988,102,9,7,2006,695,1311
b18477d401da135bad5b302677baa862,146,108,337260,75017,262243,111,93,306989,91694,215295
09af7b5e9118a5f2af40b7fa0ee54705,65,48,73704,15028,58676,56,42,77672,17225,60447
8d53fc2a3caa2541da47539cbae070c8,169,113,497510,168873,328637,162,138,606013,125155,480858
f8437817a65c370587e858497030e245,99,85,228362,89945,138417,128,92,281340,57514,223826
589742cafdd2ffd31c97c1933ddc93b4,82,65,119017,35222,83795,90,64,117654,33080,84574
878cfe39f021f1623289f9b190ef561d,153,110,406574,86314,320260,146,99,426257,73189,353068
7c5402df26c648c015920b07eec41bed,129,101,322536,124239,198297,175,133,597398,94718,502680
50311e201c398458b82149d4e45bf313,15,12,3338,2700,638,23,16,8056,1901,6155
356b19f724486f7c631ab4ea96b8b73d,98,90,199243,57597,141646,71,66,149429,46491,102938
6b941203c165f82accb711dd28ad3278,47,42,47303,19592,27711,48,37,52882,16025,36857
bf8c7d9371969ccd470065a8860aaa56,83,71,129820,59036,70784,118,77,166965,42091,124874
c581abd70b5a6f1ab3f8b0fa50524138,28,18,12980,6948,6032,36,22,25396,5743,19653
5edca245f0bdb9a1e3a1b536a80941b0,29,20,10661,3551,7110,25,16,7053,2754,4299
95e3dbb7b905efa4e226c345afef0ce7,83,59,103739,44025,59714,100,79,195796,49632,146164
73617180a436196848e588537c2231ca,50,36,45639,20033,25606,69,61,85790,26012,59778
58c8948c4cdaf26c1f5efbbbf6fc9907,92,80,229549,54296,175253,107,83,228451,67209,161242
0afee84e3ea8b06b4de36c4a66135190,136,107,314084,85437,228647,147,108,319571,71556,248015
21e30657b72ad20a50a000660d1525ab,125,93,254838,47180,207658,97,65,155205,55022,100183
6f67206fc846c6745ff3a80b6dae1b14,121,98,302846,40693,262153,98,81,179691,44778,134913
be572748a83a6573a1c341ad66cebce2,174,121,380094,100873,279221,118,95,305176,115511,189665
d918518f346aa277d0b7e0c9fb6571f5,48,42,43719,24334,19385,44,45,63377,17712,45665
e60b5eb5156cc7e51a03813dddbcbf53,37,32,40627,18079,22548,37,26,34089,18647,15442
a4fb4ce2ac986cbff095724a42e2b1a1,24,17,4410,3955,455,23,23,7773,2249,5524
7a216ba396645b86f68e4b210c7295fb,25,19,9790,4319,5471,28,18,10477,3792,6685
535bf03d73e05e8be8182007512bc9b2,158,124,761921,159032,602889,177,141,757226,203915,553311
cd38b55bd5119e1f76012a2cffee209a,155,124,473097,89030,384067,127,94,431258,101681,329577
ee3214bf7a66beef122c4f640638f1bf,11,14,2731,2961,-230,15,11,3693,2574,1119
357bc8c9a516017b38e9fb9dcd19116e,31,25,26509,9871,16638,39,28,26426,12656,13770
e13c2ef2c30fcfaa6f65c252449d6ad8,47,36,48780,17458,31322,48,50,59882,17132,42750
fe3cf529211320703205f47fe8b37ad7,51,39,38659,19403,19256,42,34,48878,20427,28451
2e8ffdcfe2b919fb373882cf03594088,39,31,47132,12896,34236,41,39,34643,14471,20172
576e0be31c1bc7d6b0003016e8278d99,78,65,156398,38371,118027,70,46,134294,50672,83622
5ba67b11e225d5267063b9a7ecb2272a,87,77,189597,50479,139118,97,63,181968,49317,132651
caa715c5a2f7121fb586e729ef1b7ec1,99,68,166711,44115,122596,120,94,217010,58793,158217
fc38e79e1ac642f37fccbbb8da959081,70,57,103743,45553,58190,65,56,111945,36968,74977
8576633815943f91fb8432c786deb1eb,96,80,196545,35738,160807,67,49,91017,38540,52477
6999ed50c0f8c42757da399ae2b18adb,161,112,456525,74066,382459,124,91,392802,68906,323896
4039022de94831e121c235b3b0e3270d,20,18,9693,3786,5907,22,19,13440,4743,8697
adc90acea6977f39562e2b8886057da9,128,93,373035,93837,279198,164,108,401644,106363,295281
4e29d255c314fe9944bcfe91aa386943,106,74,240515,65081,175434,125,99,271745,69268,202477
437ce27257f6d4046239c0178b184502,143,94,298306,69557,228749,148,106,320443,63874,256569
3cc5181b75fb81d93a1ad54f77ae24c7,139,95,269506,54529,214977,132,116,312373,76081,236292
e839089955e57dbdfbdc46e277cb835e,76,59,146422,38238,108184,85,60,174222,23156,151066
bc15c67a96f1194427060d5e0f2a924c,240,147,853278,133811,719467,194,124,722785,127292,595493
007055d2c08c0143ff0b3e92b74e7791,86,70,138606,32960,105646,95,71,156790,29203,127587
f432abf8ad8e6ea20b21d9222114d11a,46,43,38884,14629,24255,39,25,28788,12373,16415
e57bb1f1c14cbcbbfd5965b5799b3db5,66,51,96652,30022,66630,48,31,57589,20380,37209
c9304358851b3fd59fe44f35d6fe8c30,142,101,337490,53824,283666,85,67,176161,42060,134101
a99370b99b4083906d9a9ae561f65545,123,94,458810,92931,365879,154,133,418725,92718,326007
f271f171fd9a18737be3290f63875ea1,84,61,169149,37964,131185,63,52,121282,59714,61568
e984aec3edd77aea1b537ec07e591a23,191,127,604846,107006,497840,173,130,586475,111558,474917
56173b73607711b7578023b6d2dc771a,50,40,89142,24796,64346,66,42,85837,28964,56873
3d367287e9e720c18eb7b2593f940046,57,42,64900,21060,43840,58,46,57550,17394,40156
38224744f5ae38fda617ae6915f30c14,222,161,1092545,196662,895883,213,173,1125743,229327,896416
bd5ca76a857545263518cbd505537f02,65,53,84328,23888,60440,58,43,64698,24622,40076
330be498136a0017d5309c12906b74cd,153,101,382587,60609,321978,136,110,214377,74971,139406
0f05c1ebcf7ee9adc6e9b09383a96f5b,137,122,378140,91457,286683,147,114,385009,63188,321821
4645b51c57210b22257278829636314b,36,25,39659,13894,25765,56,41,71961,15446,56515
fd87e9f5087c2015980df73afc3a0f00,79,71,132165,37519,94646,85,68,130740,30088,100652
d8227fdd7ae5ae59424353d531034d9b,108,82,208030,55855,152175,112,96,184209,56879,127330
ed687ccc728d991253ef4c50da14d868,29,24,17939,6362,11577,30,25,13786,9073,4713
aef1abfb1aa81d48e649bad22e2d137a,91,72,197178,66065,131113,89,63,161742,61981,99761
5f075cd8328985e50f184e4cba07c4e0,103,71,150321,35833,114488,89,57,138116,29670,108446
9e01aa4f5289f2068c98ef9fe4f3757c,141,95,362141,72570,289571,180,143,456396,72018,384378
a0252fc8404501f6cf57421f6dc4d776,122,99,408373,82535,325838,147,112,439649,97570,342079
24f5e42cb44d4cd5fe7d663ab540729e,36,24,36791,8790,28001,51,44,50019,14202,35817
a77a50f24f53a4a399ab135a111e7c95,191,140,598901,64012,534889,153,125,504201,99724,404477
5533102edf20b1bbb78f5274f30e5922,99,78,213625,34116,179509,86,64,143693,35191,108502
4c564a19d83ea4e06293f81fba36aee7,153,91,296950,43272,253678,106,87,183834,61573,122261
b9d0d5ae7c438fa3e499fee3264e7f02,155,122,586884,110669,476215,176,133,654766,97723,557043
8d1ab9136231e11cd2d0f5708941917c,169,119,640931,85427,555504,183,155,834076,116156,717920
587981cf0ed4c00b262fa595f52023a8,123,101,304461,53783,250678,133,92,338803,38973,299830
ff6b7f4b745c5c13d6d5140231ef9ae3,125,90,496355,96998,399357,190,148,473182,85646,387536
1f84623bed8bd4799d117ec4ccb5f1c2,89,84,178604,48892,129712,80,67,155494,45106,110388
63b50ab192934624ad72272b11b964a1,38,31,36175,10885,25290,66,56,55885,14977,40908
ea6ae8f036f41d9797610f4f5f34ddf7,64,39,84651,40430,44221,76,73,157365,43155,114210
5aeb7d4f09566ef6661178687760b580,88,69,158676,47769,110907,111,83,274274,52086,222188
b322aab52f1a74845f69d87ba3a49663,152,117,579655,76414,503241,149,115,561328,60728,500600
17d63a802365624402b51a28fdcfeb46,182,119,463269,84670,378599,119,99,311397,75842,235555
77d7ddc1bdcbe98f017c5a4e6ad122fe,23,19,6614,3115,3499,22,17,6024,3145,2879
91484c21f8a8a769bdf32c2f456f52aa,117,98,308079,72259,235820,110,77,247180,64376,182804
d38ec236551ba602c88a84673cfe20f8,64,47,73814,28801,45013,73,55,101040,25201,75839
b57855b7f73d93adbb2bb8272e5d6f28,92,78,140723,47541,93182,77,57,131800,41031,90769
000a9891b8b7712e9a19e032b583023e,82,61,220352,39914,180438,102,78,200799,36581,164218
f9a0bbfbf2a8738633a75b06d782fc74,87,70,238454,66375,172079,82,61,241093,61310,179783
bc9dbeb16093ee05cc39cac4714f243d,49,37,45016,9899,35117,32,26,24046,11634,12412
7b2c8742325c75f8f69792033bd76ecd,180,122,549083,129630,419453,180,135,859679,198815,660864
1fb47fb6d5d6f7f0fb9a3e93eeafe37a,145,108,413741,71363,342378,86,69,178482,115236,63246
ca1828571f6bb979e07ad4f2ae8878f2,94,85,217520,78187,139333,131,96,326972,81705,245267
bc92493ca816bed18c7b701cfecfc527,97,79,254956,78613,176343,158,116,385454,80075,305379
88972d6096b8418e27c6247c83f09f69,134,105,401802,106725,295077,190,139,599350,136076,463274
0793ab032e357453faf17dd3af247513,137,88,502697,66515,436182,163,121,502530,121857,380673
677318988b3e468084fbd85fc3eef9c7,107,89,218474,43581,174893,136,113,302138,51421,250717
6e53c1b047f140743fdee398a09ec3d0,147,116,342184,60941,281243,139,114,338249,65117,273132
b3830ecd4fba83e3f5353a925b91a00c,133,95,254972,51480,203492,115,100,257820,68861,188959
e3b9c8d4ffa8363b2bbe7ec31ea7516d,82,67,112463,25961,86502,65,57,103450,23665,79785
3c3110becb390953044a52ec2b3c740e,52,38,42583,10800,31783,50,38,38485,10137,28348
80a1f410f5a1e3b6dbc5be8151254a94,30,22,14523,4976,9547,29,20,14703,5432,9271
2d7f2197a86d634ca7da51e366db1922,37,32,42376,26147,16229,44,32,64449,18782,45667
17399a5bb99a5f163b33730235c4c203,72,47,116063,23805,92258,77,58,95313,26589,68724
eb1fa12675d99e099204a015442245eb,138,95,282977,58167,224810,106,83,258451,60985,197466
d77d5ff3770dfa09a1d9f63d53dbb541,42,37,64845,29031,35814,57,38,79905,17097,62808
4dd007b8191fdde81ccc136b4e13f101,22,18,8907,4436,4471,27,28,13883,6819,7064
ffc23a5fbdb8b109ab4eb5dfc19bea08,137,102,260238,44962,215276,101,79,219532,44256,175276
ead67e9f9b100885f2ffbaa9d4e584e1,45,32,20680,6249,14431,41,33,21023,7499,13524
f144199bf7e032e8784ee1b68320663c,97,56,181984,84975,97009,88,89,253904,89128,164776
d039c51c146ceed99fa2b744b526909c,18,12,4626,1684,2942,19,20,8257,2567,5690
548bfcc80a57f9025155554ab890a2d4,67,50,58799,26568,32231,50,34,83876,23052,60824
091fe0ac6056b167a645eff06dd3b07c,100,77,286102,78650,207452,185,142,577235,105333,471902
ab539aaa41ffdcb66c26433b0c5916bd,195,132,594413,75942,518471,153,105,472601,89152,383449
ab3cce4b0d7e35110676361bd0dccb92,137,76,305652,55322,250330,136,104,268044,50641,217403
81d8b3665dd96572789f3fe10e38039d,51,40,60375,21657,38718,62,49,64224,24808,39416
09901cee3556a7e1a41fe6757d7c4c47,35,24,25650,9088,16562,39,30,35665,12683,22982
c20143e165b0841073587d151a709ed5,171,140,501314,83911,417403,135,114,312254,93611,218643
3c582842afc7b05ca67d119cd5507a3b,122,81,369291,94794,274497,137,116,273795,81537,192258
9d36ac76dad34d88d2f99af97184e8de,56,47,69775,14768,55007,52,36,75427,19106,56321
054c69d0e4347909f0c903189de3c07a,55,42,38960,14097,24863,70,54,79577,14232,65345
d5f58b3f801e5e852223ab947b2b16da,70,52,105912,69838,36074,163,117,336401,68092,268309
f0344b3c943110723691ce7fe569683e,57,44,61703,15559,46144,53,36,50694,11881,38813
b41a0da683cf9788a8f8e26a3ea62b6c,145,122,378256,91484,286772,123,107,307497,67188,240309
b32113dfba0e7eb8bc1254bd5c095e47,29,21,10054,3716,6338,24,16,14130,3220,10910
1a48eed1bba3486d51df37d8b45b7322,17,14,2823,1965,858,21,13,3981,1366,2615
7b45b0dad93d26ad89121f4f1a1f34f3,97,65,174167,44151,130016,80,61,168071,40554,127517
ba61809b94b01130d75c18f97ecbcf87,181,151,670141,128258,541883,239,171,695539,192207,503332
e4ba5dd5966042b02e22c893f240939e,111,84,216005,58013,157992,84,60,219423,51135,168288
f0ab119e6e8234108c6d15dd7f4ab49c,36,31,63038,15910,47128,43,29,27495,19469,8026
9dc85ce29e7ce7f5937779031b872cb8,32,22,16038,7808,8230,31,21,14476,7918,6558
31d159e03a03dec9b4500a442c162ea5,87,61,102435,21186,81249,70,57,94667,29904,64763
4b2e3c9d05427130183e1d48aed6bcb1,116,78,259393,100979,158414,110,83,287980,72332,215648
7f73093f3c213fa8238e2c5d7d3ba022,144,127,410131,92784,317347,142,114,421591,92710,328881
66b2aa8be62b99f7ef2a6ba399ce680f,147,104,647683,163914,483769,169,134,829326,182190,647136
94d306098094fdbe1a2facf5f50082f7,19,16,5053,2775,2278,22,14,7342,2252,5090
006a0d50bb65c0a04aa8e65b5890f977,38,29,38135,14295,23840,44,33,42850,17814,25036
a8f82a4213ddcb84422e124e5cf6371f,55,42,60400,17603,42797,40,32,58643,18556,40087
b108975679fb5bdf3a9c7290bc99f168,146,109,401922,55441,346481,137,119,399180,65798,333382
8c5f81a3728a99b3af6b8ee6c998cf23,129,105,343490,108779,234711,107,81,289718,80271,209447
d50d17d3e0b0502db68710eaa946d343,117,99,282100,51168,230932,116,93,285200,64684,220516
65ebaa9c65e86e03126f1f1e58600679,62,41,73965,18877,55088,60,53,60915,25005,35910
099cf5067dc18de66953e8f588f4ecd0,27,22,20675,10344,10331,36,34,30624,11211,19413
c719d40d23c5823b3831d1528ca4aade,45,39,60298,18683,41615,46,34,53760,22413,31347
dc1283b481295a7198f6c02aeea78c51,114,90,245388,52597,192791,118,101,251522,53905,197617
a1c9b3c6596dd0328239867669903c04,147,121,409911,68990,340921,139,102,374643,51557,323086
7fde597cc7268ab35cad13ab4bd71fd5,29,25,13774,6332,7442,28,23,11866,4547,7319
35fc2ddf07b4b947ed03d2bab0b5f372,190,157,668433,142503,525930,203,115,527973,122450,405523
316c106f0eaa60c5b8379973f8a63b9f,34,24,35794,8988,26806,39,28,31324,11095,20229
26aeca21c942e8747c4ce9108d404add,189,126,876223,175305,700918,194,126,854304,159009,695295
625cffd7dfc63d5e55ca74b16a6dee7c,37,25,25956,6502,19454,23,23,22361,7448,14913
e1ad19660cc653d981a75b3554ab0758,75,56,98154,24850,73304,108,88,194992,35996,158996
cde1dbacfc22200ceff2633b00678e20,138,99,322597,71337,251260,131,92,392863,63930,328933
09dab87553e6c6cd1c2a3332ba588a58,44,35,57417,17984,39433,52,42,78466,20321,58145
438eb7cc907f5cfc12cecbf0992ebb35,15,11,3595,1249,2346,11,8,3333,720,2613
6269e41db84c74a5a56087ef737c024f,36,24,28311,7400,20911,29,26,19347,11359,7988
5ec2bc79a2eabb1b5e6e8c0dc9c143d0,22,20,7819,3422,4397,25,17,7140,3490,3650
38539d6d5c97faaa16369ad83b347418,44,31,93397,17828,75569,69,49,111177,29829,81348
2f4ecd90377acbc602d6289bb9966130,144,87,353605,127608,225997,148,113,388551,115729,272822
9ef13968b9bda186082c703dc9883fff,134,90,276282,43152,233130,116,96,232124,44419,187705
de2572d5c0c5cf97bfbbd9bdfbfcfc03,34,26,26609,8605,18004,40,28,22893,13175,9718
365604d5986c24f8db03bdd2ab9608e6,187,127,758135,166190,591945,239,183,730259,160965,569294
0564df8b843a229823d94f090516de2b,171,130,635293,87752,547541,154,119,463299,86013,377286
b53210675c4dd845d7929ed1813d2321,100,72,193701,49509,144192,86,66,169588,74805,94783
4d20b016fa120848259bb6a895642336,69,46,89115,28314,60801,72,62,84872,27529,57343
3826b54a831aa05d1dbeb8b15dc18aca,104,88,253901,86199,167702,139,97,334073,64394,269679
8a0465fbcaa3fddb878c8238bd54c273,61,54,59817,22177,37640,63,52,88286,18191,70095
3e284ffd625d66b46fa47a101c058449,149,117,341052,58768,282284,117,88,269222,73713,195509
32583735fd043923041db2152c079162,16,14,3149,1697,1452,13,10,3778,904,2874
7ac09ae19cdddc3384b3ede6549a8f3c,44,31,37563,15736,21827,42,37,35605,16230,19375
06f0fcb75ec6c96d1e4930987d776603,133,95,332338,39854,292484,112,80,258299,44383,213916
229ce857e0d05d50b6caceb0e28a1e8a,57,50,101009,33510,67499,98,68,164968,26836,138132
e3bc1d701279b9671216afa4318c14ce,102,88,178825,45788,133037,96,71,164333,27713,136620
edb26dea381aeb949790caea4f94f424,54,34,47586,14434,33152,60,44,51806,15686,36120
a31f226a64cfc6e13b201e67e21fcef2,108,80,262275,77409,184866,148,110,338182,77057,261125
31ee103fbb556cb7e526068e140edce6,110,76,193089,52884,140205,98,75,182528,49549,132979
6ecaf2529c82b074e0ff5e48cfd0b165,74,60,125964,32449,93515,63,56,83601,38765,44836
d946f7ded6467f41de3c3a6a277d243d,6,3,1165,377,788,3,6,377,1165,-788
c392fea555ac0c96762d4a1fc9635bf7,103,87,285027,73697,211330,93,90,225869,74314,151555
d57209ae5d06fe4aea8b7729c90e68d7,125,100,322518,128491,194027,167,128,569514,103986,465528
06bcf6047b3eaa806502fe09853eb53e,61,55,84114,21535,62579,53,48,43321,17906,25415
e00773de22db2af58a4b44bf2a319632,31,23,26949,11277,15672,36,31,40650,11482,29168
8e463bfdca05fb7a2fbfde93b0febe8f,166,117,575262,122163,453099,197,144,672758,125381,547377
e9d61ac6ab52b83db08249cadf45ec05,118,81,321152,64285,256867,131,91,311429,68053,243376
6b0ae3b396098c9694d981e38828fa02,138,95,385503,72624,312879,150,116,411257,90033,321224
08cb1f943a9077663d26250b624fd367,32,21,15431,5234,10197,30,21,13320,4858,8462
5a3c72aaf6ecb244fe0428278cad158b,79,69,126902,46724,80178,100,87,177202,38252,138950
46f0f56aeccfab1ac8891e5fbbdfb6b9,74,66,122738,34743,87995,91,77,152877,31342,121535
67a28d98f639ce35e6efab24533216d7,141,103,387857,87895,299962,120,91,398218,89435,308783
07e8c5ab5b11f41e3789df8d8f6f7de0,56,41,72204,14054,58150,40,30,50451,9659,40792
12913ff374c007716d71830552030bc1,119,80,265993,88204,177789,174,134,395199,63986,331213
8b4f499e388c9048e7577a440a4c30c3,34,30,22522,10841,11681,34,27,31825,9811,22014
c00bd9dd81d5a1e79475a69d67e6626d,32,22,32992,10806,22186,39,25,28522,12117,16405
c32992ba947218ebb8701d4a33b2514f,4,4,1285,1064,221,4,4,1064,1285,-221
ee700bc3763d896665e18486f0a32f62,161,137,467538,67953,399585,146,123,416138,77258,338880
a042b1a620bef4de16686cd47d88924a,170,122,528451,129202,399249,188,105,522347,114555,407792
420542cc78655a1b5e65b5ab71354a29,70,55,153517,49935,103582,117,84,237713,51454,186259
2c2a962b912aed8eb0ee6e9dbdfd9707,63,45,101524,17177,84347,43,45,39062,24459,14603
d2e100f8afbf59e38bf8344c0908faf2,175,144,736733,104704,632029,163,109,457150,81538,375612
6f75b6a8c78ae7d2da5ea893e8b6f96c,88,64,165035,40145,124890,73,56,117732,40792,76940
a7a48f6234eacf0e7235f8bac2d96c1b,126,85,348515,93711,254804,156,106,533730,67987,465743
6b116fb1562ba0173020d93fa07ecebe,106,79,187227,43433,143794,92,73,129730,46313,83417
c9d328639222ca7808b2d4cc578dc306,142,82,301385,71075,230310,146,87,255646,61346,194300
2d9288be4defea88d628585bd5f994f8,57,47,52528,11355,41173,48,42,60539,11267,49272
fc85a97bb6acd0abb8fda46c2e1db61e,80,73,203565,51469,152096,134,103,239637,61954,177683
af81f66f265db9f6122cec57fba0dd1b,87,54,143834,36995,106839,84,69,126599,48479,78120
9b82382368c50aff5b947916de5aa17e,187,132,587738,122409,465329,203,153,974180,149727,824453
87129d3bbc61d0e338be8b3f0ffb678f,84,62,108031,39566,68465,78,60,103025,44051,58974
b16e3f08a7fcae82def31eff0470e076,93,69,95432,21536,73896,92,65,101261,26948,74313
0e93d38b06506150e94a46c9a193dffc,26,21,9000,2776,6224,25,21,11977,4658,7319
6c5c80018eb7830d0e115e5e28362af0,119,81,203909,41450,162459,115,88,219348,55148,164200
c06eaa2fe988e2fd04d56ab173f8fb49,107,91,295251,72813,222438,153,102,298882,78129,220753
7c374191e12426c4448cde770dbddb9f,101,88,170058,50042,120016,117,104,245517,51077,194440
3763fd2c5d2f680057800403f3533752,148,125,385978,89553,296425,133,104,349964,66263,283701
27a72138f9d2d01441894f2db4966e77,125,106,309327,83718,225609,135,98,306077,55701,250376
6678a7350edc313d8d1c1fa664e26594,30,22,14974,5697,9277,30,22,20375,5941,14434
60d95c4239d767bd67e180b4125067fd,112,79,387794,93740,294054,110,83,380687,100977,279710
6cc3f7e5f63dc26659b287a391e0a981,72,47,178842,62803,116039,116,86,229684,64720,164964
e44d87bb75624bd46e86d1de616ccc9a,20,12,6780,2390,4390,15,13,5392,2557,2835
9f84133ed66c913e309d77550d3a6a9f,189,145,619389,114366,505023,161,125,508666,87455,421211
db6d5795ee48312d85f5d8bad46d0e8a,17,15,4213,2089,2124,20,13,4126,639,3487
0485013bc8263c76958317bc2faf1e06,125,111,259323,38127,221196,122,91,238287,43624,194663
e77e451bb457000d53ccb93bd0baa34f,183,114,392141,104082,288059,161,102,397041,112189,284852
57507c15ebd87aeec0d16866e9734488,151,118,700944,153243,547701,197,136,582867,144620,438247
6041f27a689ae35f8da77424c6d49713,130,86,255966,79699,176267,168,94,336643,62021,274622
5b661e28ada2b85d8391561246399a1d,75,68,107726,28419,79307,63,49,84180,21448,62732
7ef7affb5f0de2c79f6b4d3214b1841f,122,84,241137,48530,192607,112,74,199651,44415,155236
efa7ca3062575b9b0c50f66f481824dd,120,79,210693,42089,168604,111,73,198672,58224,140448
5217d3b5aba1324f82f16bdc54914e48,19,13,5133,2401,2732,16,12,4946,2155,2791
b3cccbaf56494af9692bd63189194aff,6,4,722,963,-241,6,4,1066,639,427
d373903a2ae70a8a0ba16d2308a30839,107,67,204398,53890,150508,87,67,211554,62732,148822
7fdf49bb9a993fef00075f1ddec2193a,70,59,139494,52913,86581,140,98,286833,54354,232479
47245ff047b22049208dfb3b641f25a6,49,36,59448,13105,46343,43,30,39377,13960,25417
1dd5fb3f3a9ac0c9411f9a64736cc429,122,78,207072,57303,149769,120,85,226554,64704,161850
3b5ad18fe95a233a7ef1d32fb31aa1b3,3,3,374,729,-355,3,1,729,46,683
41161dd590c261154be6121d709c9f17,94,71,147153,47058,100095,102,84,190767,37295,153472
a52e456f4ae992fc204e11c12781240f,23,17,8447,4166,4281,23,19,7387,4515,2872
a403115f3347c7ae5bbfd13d5730f4bb,51,40,36898,23773,13125,56,40,71629,17628,54001
32affb045f4e5e40bc272502c1ad2c62,125,115,352429,70925,281504,98,69,238303,69806,168497
1741e23d5f2eec8fbfc61d515b7f3dec,90,77,200507,51756,148751,86,70,140684,52152,88532
6a49b2b9d90fef1af3be9bb6259c2ffa,50,43,94331,27802,66529,54,44,71822,34319,37503
e2859a9581e2cc43f45b0e44e01cbc46,71,55,95665,49056,46609,60,46,82324,33383,48941
b28c78405c9e9652444781805cad5b50,71,62,83175,26074,57101,89,69,91968,29235,62733
f5329966f7bbe58309fa9ce089389409,34,25,24698,6867,17831,43,27,24830,9461,15369
736fbc6db97a05945feafc128df1b48b,43,33,48228,19112,29116,42,26,57935,19129,38806
45cb4b4f6e2be3ec2f1f22fbc59840b8,8,10,1342,1390,-48,12,6,2409,316,2093
ecc18eb4f1135c4c600eae92b1854692,78,60,93312,31431,61881,70,60,107561,34845,72716
b5db1ad04984ac7d9b802055e547ba10,78,64,121646,29270,92376,100,76,157702,26798,130904
206f55f78eee664c61664f1d78896082,0,0,0,0,0,0,0,0,0,0
0065ac0f5631ddfe3f02c30ff09d47aa,95,69,209445,43639,165806,75,62,137472,44881,92591
97963f2a215ce5be07379667796d0717,146,102,352538,58450,294088,142,113,283487,73065,210422
b633bce00a9c848ba85f75ad0bdde948,99,73,248863,88856,160007,159,117,419325,90346,328979
6b8a3aa399ab170a9256c5504e2bc108,107,86,190652,31204,159448,87,73,131145,32780,98365
0fb15d37ab5cc2658c9ce564d668e84b,128,98,217108,66827,150281,107,89,246751,87578,159173
a199682f14f65e934c5694e96be1b627,164,140,531804,109971,421833,156,119,446721,102189,344532
1a3ec41aace0e70a23877479063eaea4,158,126,260652,51683,208969,122,95,210008,54879,155129
7264dcba8de9a896c6b5834d446316af,68,55,93889,34626,59263,81,69,98972,36996,61976
40c7e490313187f5e76dd11933171117,126,88,233437,77973,155464,151,87,302188,63767,238421
f78f045d7b9f6be220915809c700c934,94,60,119057,40756,78301,90,68,126253,36852,89401
d15b8db1a0f3c58283e57a0921749ff7,25,25,13440,7622,5818,31,22,17240,5952,11288
11d03dad9289f7708d3437e18d4586bb,135,103,429290,132587,296703,136,115,354847,112285,242562
06e0918889d0fa0016145cfbd53af1fd,105,59,150897,27358,123539,66,62,92660,42837,49823
1a43a6050fbce614bccfe9d346e7ab60,58,45,71240,23133,48107,64,50,69364,19224,50140
43df3aada5d4d2973074beeb70bdaaa8,203,154,534623,109922,424701,147,109,374826,86010,288816
3d837961badba4322d00255eae65423c,185,124,390262,104817,285445,177,119,380814,75021,305793
1dd3dfab02a2931b68e68acb03a90ce8,103,77,149180,37969,111211,117,84,238421,32967,205454
e3dfb1730fb7cd59072a2bdf85ef1cd1,39,24,17187,7321,9866,23,24,13432,8375,5057
b516b951406a35dd5d0c8b867a4412cb,30,27,28016,12527,15489,29,24,33947,14222,19725
f14298498943b9fadca33a1f96de1110,22,18,9333,3815,5518,22,19,8894,5078,3816
57234bcd0e6e10773035afcd381e822f,97,72,195383,58749,136634,107,82,265991,57054,208937
828d4549c9fe24644e2c983aaef36d1e,32,24,29613,9107,20506,31,26,25962,11002,14960
ab8825328e2715cc4466b5c9775908d6,91,56,133536,35666,97870,103,63,135670,35942,99728
fc0160d7cb10cce817c011380847c163,66,45,90643,17600,73043,69,55,68100,28416,39684
af78fdb240f069ebe52148320defa665,86,57,117019,31399,85620,87,49,89456,21837,67619
aa21a28f116049bec19610630df5ff94,127,100,450713,92935,357778,189,148,472136,104544,367592
57d3784f811def9646e0e5c5afea7eb2,146,114,434826,88614,346212,132,107,330243,89356,240887
de05547822c656d0da3a0c4e1aa3ef1d,44,30,32187,14223,17964,35,26,33475,11996,21479
077916b0f7b4dfcf767f77efa9063b47,106,92,213951,62087,151864,142,121,366007,77229,288778
e2b173f48eb4b69d035d01d7e7d4d003,121,94,248540,51730,196810,126,95,254019,58441,195578
dc557cb35112b2f047c3ec76db7f71e2,70,55,72590,24725,47865,61,55,87568,26872,60696
bec50ff27548398a7e83e621b4624a1b,70,62,80945,28922,52023,54,47,78055,23927,54128
ec4e7619f8aa835d02d073d4689a2909,111,85,265359,67971,197388,136,84,250843,52968,197875
9cb5a60f94cbba5f9919dd9fd914a1c2,111,90,350819,49456,301363,113,83,257370,61042,196328
7e1255c274c9c7b826d48b5ad037ea62,52,35,70229,14073,56156,61,49,52663,16799,35864
89d6069e8195c0fc0d0d38ba823ed7ce,11,13,2510,1137,1373,14,9,1449,1209,240
48ca8c7a7d48b00db1d4ac0db72d5e19,86,59,162863,37344,125519,81,60,146901,48735,98166
d781e11a9746380b688d2468e099131d,144,88,355522,51187,304335,124,93,322703,59906,262797
ff81cdec92bea358b7dfdd07782b3d39,98,69,142939,58107,84832,123,96,240326,38270,202056
30e84b634b6ab5ce52ff884ff9436c0d,179,132,602846,147806,455040,131,114,554039,144717,409322
04bcfedfa051463c861acd7a94a43278,76,46,136378,38148,98230,119,108,212991,56403,156588
cae9bb31f8792940fbe3111bb4eb01ee,93,72,173599,41883,131716,81,58,140390,41221,99169
bf20763222153c478a860c84d695e2bd,116,88,270443,44765,225678,91,69,158536,53954,104582
161d50292e48e78ff659187a78a05503,109,70,214962,38431,176531,109,92,203964,46309,157655
477bb9c3b8f810774150a85d91b5772d,185,125,740569,154453,586116,195,148,1153525,165078,988447
71ef38c9c4e071579031c9ba27247379,17,15,3435,3064,371,21,14,4693,2249,2444
059327b737eca7b5bd42ff4d13b148bc,85,73,145519,40360,105159,75,55,93179,41095,52084
3f2de362c45f1ab04620b5b77b4daf1f,61,49,70944,30749,40195,47,28,68739,21940,46799
8da52a917acdf5a88e2680074fcfdcfc,110,83,272991,46226,226765,137,103,300032,50465,249567
a46db64eacc57d75fbc081b8610f175f,64,49,126388,42940,83448,76,65,124289,43809,80480
f07136b170dd1467360f03a7fb1f6cb4,120,89,369390,61783,307607,154,133,359515,77580,281935
20442ed608610e580802bb7b3ca98633,171,138,818364,122335,696029,170,127,691530,120142,571388
73e40ba4e78ef104808fe2693f2d2aef,2,0,138,0,138,1,0,54,0,54
73f7e782cf24c4fac0e831771472813f,15,15,3285,1528,1757,14,15,2123,2224,-101
b4e36e1cab7dc8aff702df187f17754b,175,107,331071,82932,248139,131,99,274751,72051,202700
d1a7dc5b2d844272b86dcb3e7a792d91,40,33,48280,9431,38849,46,37,43951,15347,28604
2cddbe772b38b5e9a06339f02159214c,19,15,11131,4138,6993,26,25,26322,6080,20242
03de46b2e86a5988fe70ee6592dcfccb,55,43,60338,23437,36901,51,36,58983,21829,37154
fdc0b0d56d3d1d8b295c2d92a0eb137b,152,125,521503,93028,428475,153,118,548106,101836,446270
1136219e98a61236a46edb00227202dc,49,38,43719,30679,13040,52,49,75287,29264,46023
1f21b183516f48be761347d752164bc9,172,118,707295,198930,508365,180,138,602506,171368,431138
6cbdf2289fa01fe1362b9aa8747ed913,120,101,268066,52873,215193,149,120,356747,60124,296623
e432d7c6c0f08dd36e72015e13ad8593,95,73,217444,56302,161142,67,44,161460,52460,109000
e613cd32d09f51558a4ffa50da69ee31,80,69,159743,72038,87705,123,106,269243,62198,207045
63dbb58c83efa0d68369171867a5eb0a,93,76,192826,78668,114158,91,71,181882,68819,113063
e84774caf36f0f9c18f6c6ca05c9a371,80,65,106552,31392,75160,67,59,113265,35137,78128
28ba8d67c04eabb1eb1747bb7a8ad230,110,74,133079,33934,99145,85,71,117308,30950,86358
2e8dab962a6e2f12e35314381256f261,64,41,68149,13183,54966,63,48,53474,14623,38851
a67d4094ec6dee58d20f14e890e0130d,147,109,925422,340050,585372,180,136,965100,170460,794640
16eb0d282e29cb9a847b5fd69efd8b03,29,23,13276,5697,7579,25,20,15597,4586,11011
55587db4418319b6319674651cd5e67c,165,137,515147,102976,412171,143,118,362075,92622,269453
91d7769fef22a85f227285535edf5567,45,37,32320,11882,20438,50,42,35414,12281,23133
74599adfbd4a46ba7f5dd4cf165370f5,139,94,318424,63932,254492,88,67,178960,87677,91283
ef9d92baa9de6d7ac20713d7573b348d,139,114,361309,74273,287036,146,118,344225,64699,279526
21dd82a2d53183d8648b24c104abe4f5,45,37,52589,13005,39584,30,27,33574,14618,18956
5728c5a01d9820d43efbdfcf49f05291,63,49,81520,16424,65096,65,46,76935,17124,59811
47ff25be71db70baca0b572c46e283a3,57,44,73433,19238,54195,43,35,51475,19630,31845
0f68cb51b8935dd4ad1608ba5a90edfb,56,47,70145,22961,47184,46,35,38161,21953,16208
192ef8c258a8acc80bc3e8a7138ca2d9,120,96,239741,78333,161408,178,122,405756,100966,304790
919c6b262d23eeca7e6a1deed135989d,61,46,68259,40276,27983,110,75,210181,25424,184757
24d7931a89ff4ee4a9dda2318ae01680,139,113,321242,81916,239326,99,76,221095,61022,160073
0ba716c5971b579d712827c668c16f50,56,48,70818,21750,49068,57,40,70349,19303,51046
aa79001619ad08a3c1ad5da234e03a8b,116,80,181696,36280,145416,104,77,165339,41914,123425
c5fb82136e3028af6d9c6d2b3a007d1d,45,41,54165,15887,38278,51,44,64641,17416,47225
319207b6ac23a2020d574fbdb4f70e67,225,179,1179669,309974,869695,207,175,1223632,294632,929000
94e962b9d31c85210d5d4c6a357c326c,42,32,46099,17369,28730,44,25,33097,15841,17256
060160894919d0d7930b03779794d856,31,22,13176,4913,8263,35,27,14517,6043,8474
e81501bc801b58919187f9fbcaa4547b,24,20,9130,2724,6406,20,21,4402,3816,586
25c7e8ba4e14bb49f4bf8979027c3069,98,74,176473,54121,122352,103,78,204691,43363,161328
7b6a78173f5fc8e456289effa2261a23,146,96,345149,63266,281883,113,95,326905,83443,243462
5892b2cc79af9bb1a62b2934f1989092,121,97,241516,64382,177134,122,97,250222,69106,181116
fd6ab1098fd0ae0a2f9ef1e0e99dd8bf,96,70,137976,50647,87329,83,69,155955,52813,103142
eff10449bc728b1011c7df775060c1eb,69,61,117687,24037,93650,94,75,106415,38594,67821
a0a97ca7d55fc8fb16567d8af1365d96,26,20,13022,4329,8693,20,21,7142,3471,3671
fd16b9e597ee4d09453a53ff543d93d0,44,41,51155,17305,33850,38,29,34001,10877,23124
79e9a23518fe340b5644e29028ba8d4d,37,29,54679,12350,42329,36,27,23737,17221,6516
c07b5de78fe707509982323e5a73af34,79,63,139678,39507,100171,108,87,168907,39960,128947
cdf3b0128241acb315a9c6f52dabe681,102,79,191307,57024,134283,113,106,252752,63652,189100
118245f68e0c304cf52697e6c5b3bf2f,24,14,6588,2473,4115,19,17,5734,3463,2271
4414e8585f6346cfa86f478e1d93cf77,88,71,152386,33076,119310,101,75,197119,48817,148302
0c646de968f418b4e4ca3b99f4f07ce0,22,20,6312,3785,2527,27,17,7793,2046,5747
48a321db74cf679308378ca67d2b893d,26,18,15961,5904,10057,23,23,17479,7589,9890
18179fa007c6cb0cfe91f288d575d056,60,53,72604,29888,42716,98,86,113612,33196,80416
af435bc48ccbafe05f34ef3895d483b5,30,23,22378,11084,11294,30,25,30870,9561,21309
97d92542b3923e0f4c3f665fa517e417,39,37,30652,6821,23831,38,24,17842,7582,10260
3bb5127206d31d4d213ec1f6b0ac9899,80,59,111054,39458,71596,79,60,135118,35246,99872
bf2bc137ebb4046e3a69970bab6a47fb,68,46,104452,34141,70311,94,87,179362,45797,133565
c79b624f32996eef70b11aee6a04d1f5,152,111,328511,59818,268693,157,115,399549,66903,332646
101b719aa2446bf8e124c69c04b0817e,25,15,12386,4888,7498,19,16,11974,3347,8627
8113915f663b511d84935cb9716b5054,56,45,93869,28316,65553,91,61,123199,35296,87903
ed2247549bac35944043f0a01125536e,122,89,311964,92160,219804,153,124,442618,90978,351640
9567184dbd2e13d6c558eee7dc7262a3,44,37,51959,14910,37049,50,39,58951,18014,40937
2c4e3f751158dd7cf91667e479e2d176,0,0,0,0,0,0,0,0,0,0
449973cfd043e614ce71342eade8239d,42,28,39600,20819,18781,35,32,51930,17348,34582
eb1e52de6a7379a121455737d8b5a2e4,28,24,27502,9596,17906,31,24,27854,6003,21851
45dbc831d2fba3f9d34b0e6c67569d46,129,117,299768,48215,251553,94,69,204125,39626,164499
864a9e3f1703bb41b1f6029756073d89,49,22,59028,7052,51976,48,39,55355,9058,46297
60b6450d56f321b06cd62456c89b94b7,93,76,247683,53305,194378,121,101,277828,69729,208099
7e82beee2abd4f7185fc3426176d7374,33,24,16318,9036,7282,32,27,27481,8231,19250
02ee48d1516e092858aea7840387cf8e,170,86,457798,121752,336046,175,110,619228,95640,523588
b605449a642f0b27e76debbcda6a2c0a,14,9,2219,1322,897,15,13,2041,2125,-84
114a9a597ae9ec162b41e3889f7d5df4,142,133,504910,121025,383885,195,128,495695,94575,401120
e31be38f2f0ec5378b1e3690b10dc4d1,146,109,362919,91806,271113,146,114,323416,81452,241964
6214801e9dbc3d5b5a0aeb3d1f1ce1f6,151,121,419959,130767,289192,122,89,348180,92104,256076
eb2c19da640119a91e51ae131d7f56e7,48,37,42934,12833,30101,38,29,32523,11327,21196
4f9860738171cc9dbb0fd7082b8e4816,168,118,424044,114409,309635,139,104,401738,70080,331658
323e38ea67c3c185f11f7071872a9fc5,176,132,509814,60985,448829,106,78,207887,68823,139064
73dc48763634027a8d20f3522d01ce81,100,73,146203,51436,94767,102,76,205997,44192,161805
fc2ca5b262a1a379c39ab74e73bcd4a9,117,99,326261,65351,260910,179,148,463016,76485,386531
101494efc2919cf1822d51ea70ae06d5,98,73,178572,49239,129333,88,65,130037,52297,77740
e1d2bbb17677e192f7022fd793f689ba,50,32,43552,25342,18210,55,40,86970,27715,59255
5b7c8d613c438e6c26a6687c9d89f34b,178,113,446818,67728,379090,123,96,234550,88471,146079
f2c88f98a000be9b6cc1f5c29b6fcc04,44,38,77569,26794,50775,44,32,69330,22653,46677
f852532f15018365d81332587df89f39,223,147,776366,130020,646346,203,141,589307,174863,414444
31e61743992f9b31eca8da1311b86edd,153,116,478561,76053,402508,151,104,338643,68901,269742
3d8a0338f6164dca8a7404b93f9be63c,133,73,399468,110590,288878,80,61,311498,106355,205143
84b5c7f4deed302f486d2dbcf6466c29,198,144,845177,133936,711241,153,133,577948,159470,418478
9a83a25b230bd56a115953a885bcd4b3,130,99,367775,73114,294661,170,130,516000,86870,429130
fadd262d37daff30e5106001c625e49a,135,94,314513,38720,275793,99,72,195973,39580,156393
55d00fed5bb93cf62dbce3979e388982,71,62,134799,45637,89162,84,71,191050,50759,140291
5cd81c83995c85f11458dfaa1b4bc8c4,98,78,229212,68690,160522,107,92,183258,58064,125194
28ae4224aab83d0c5e7aa4b29ee68b23,146,118,347225,58629,288596,172,125,585549,91654,493895
bee1b231047858a923176f75a3cecfa4,88,70,152129,28175,123954,94,79,164483,28515,135968
d5a4ded9a41217f691a6f1452b120e86,52,43,39775,15152,24623,55,43,39127,13741,25386
2e0c7f898619846e1c0839aea28c51d9,64,48,97250,25158,72092,64,55,82518,22859,59659
8c1fa3e5ebb3226bcca565f36dc5974e,111,90,167516,55261,112255,83,68,165848,47490,118358
3f2c6a8ec7eca3196706574bd4683abe,121,92,280714,47317,233397,140,105,273133,58123,215010
dabb09ca49a2d9fa30d6d3b7742e9c64,79,60,117625,21988,95637,69,66,71721,28681,43040
3c5e3a2a3a9314268a2cd8783ba4fa1b,151,104,477576,98403,379173,169,131,509540,100412,409128
742ed894ca2245645024fb0f6c40f036,34,24,22845,8373,14472,31,23,22273,5822,16451
5933f25349f6f8dea1f6cfbaedb1bc0d,30,24,29636,9289,20347,31,24,20162,12617,7545
9f7d04d0f44f4c83c3ab55366b4f7fec,140,115,351864,99695,252169,133,112,299270,84480,214790
c145424e74a55e7871e4c6f28b01c20f,119,98,281137,79190,201947,61,55,127252,68375,58877
730a966537d99c4316ae9197d1d39a32,76,64,96927,31898,65029,77,59,167656,34460,133196
3ff57e87f961440db4100e628a00d6fc,12,16,1764,1394,370,13,9,2359,727,1632
7944ddee310c77f5639ec2e2b8089aaf,34,27,26386,9218,17168,38,28,22263,6653,15610
7aca2575d67d12e88c91585b53087373,93,80,175636,47582,128054,80,73,153147,63393,89754
d9c053fbaf329796195605e6fd88aa66,19,16,4457,1848,2609,15,9,3063,1349,1714
684d85229de65bc3d3b8db7c0f152c5e,57,46,88810,21826,66984,65,54,79408,29455,49953
dcf4aac7a918b07c39ddc79ebdb66125,35,29,25941,12315,13626,33,25,23382,12916,10466
84e83646183353fcfa1c93d79f1995f2,99,84,217902,42686,175216,105,93,231791,45401,186390
529b1ef0a3d1feed474e3bf0d3e2fbd6,60,44,80571,27735,52836,81,68,151075,31161,119914
4ee5ccccd99aba8dc571c4956dece65c,170,124,494332,85881,408451,160,115,431657,108070,323587
0ca2402881939fd99db40bd1413c1a90,155,124,464630,99146,365484,162,115,453689,106486,347203
c0940f653fc6f628995284713b3536dc,18,14,4943,2383,2560,15,14,4133,3331,802
516c7b0ff7cdf4f356c32b1cb0b8eacb,127,107,297914,91089,206825,134,102,316822,90301,226521
9d872cc15934150aa4e3b44fcba00af1,123,74,237627,70191,167436,121,86,230930,73016,157914
e957ae90c6713913b49a738b6e797639,78,63,121208,33194,88014,73,53,107690,23495,84195
bec6d066bd7e7a749940829994409393,103,78,143577,23927,119650,97,75,117306,35544,81762
a8029a452f83a5998ae234da64c2632e,138,114,379059,74685,304374,133,100,329998,83856,246142
a34d04ffb5f8fa3d81d61843c302caa7,23,15,6009,2328,3681,16,16,6592,2041,4551
0c724e9e6a4b61402a539f1e7a6810f6,221,141,752958,141014,611944,212,156,1024108,137873,886235
cea5d5dca506c3bb5ac74b0124db759e,71,58,118551,38746,79805,69,60,108100,28195,79905
5511553db1a4ebc7bea0392ae2a22ffc,34,26,21984,12726,9258,45,29,42600,11102,31498
472eaeb301c2c65cc4a89a9b34fa69d7,154,114,357601,68445,289156,85,67,202593,73435,129158
dc50f6ae04d57ad821e8d63b3ac67644,183,144,626038,99025,527013,147,117,572341,81128,491213
a37bc09ac134528b3baaeafec2a3ca02,67,58,98985,34418,64567,51,38,115431,25875,89556
d8cb28567730ad663765ba19e7e74d45,70,45,108059,21845,86214,53,40,70322,29851,40471
44b89c243a9af934867e719ad2fbc214,123,91,316155,73810,242345,121,84,254901,87074,167827
546b33398961dabdadc56427bf26f747,71,43,67437,19987,47450,55,43,82096,20883,61213
4eff8862e47be2d3d14d598c94797a9d,146,104,724589,136262,588327,205,144,918314,109662,808652
83657118ed7beec7313d3bba9c60d8cb,195,164,623564,97775,525789,138,84,354511,64290,290221
e2b75f6df57ce4435e9a81f825177ad2,149,102,294079,102457,191622,115,97,220420,78904,141516
620ba9b4c93de17ac7cc7d951cc8c702,104,93,212113,49455,162658,107,98,265722,36896,228826
31316c7553857148223670fd434a4abe,97,62,135417,35059,100358,69,71,106418,37130,69288
bc39eccb23cda98d9acc724a1a83e217,44,35,31130,7021,24109,36,30,23218,9583,13635
0066ed551734daf0441853b9052dd4d9,186,136,501941,69426,432515,158,139,480752,94363,386389
2dbe776246bf46f6ce33fca20954e38a,24,24,16634,7388,9246,27,20,12181,6654,5527
d13ccb5959e62c1b0e534077c4667b6d,53,40,46436,14524,31912,34,32,29573,12662,16911
555f78105f23a5419818bc8c09cd7c1f,193,148,410579,112591,297988,149,109,345304,76183,269121
0d92795487b4e93bd427d9c0d6333a9a,176,128,478315,79340,398975,182,126,359195,97903,261292
1e5f104950308bb9e768d312e9ac82d8,142,107,327357,85678,241679,166,133,443184,78517,364667
41c96989de601a6b4d7756301effcc98,162,135,853834,184064,669770,270,155,1047918,167533,880385
0496e7d99f76790041bd2b498ef7509f,45,42,49185,15324,33861,73,49,83122,14488,68634
c53f9d75e31d4e592c6e6185f6dfa2b2,75,63,106872,62910,43962,106,77,203585,64953,138632
004e4782f016a60100d63ab57fbe7ab4,108,79,225874,56808,169066,132,110,303731,50315,253416
5ed9964470a2939a3e468d678cd874d2,39,30,25885,16074,9811,45,27,48017,11720,36297
21f71aff874d9e11e0f9d979603b166a,64,35,95830,16083,79747,84,63,98245,12520,85725
0a67629166697c909a6558e221e4c595,4,1,310,82,228,2,2,86,206,-120
15adaf6566692e85e7e67fcc7540e4da,135,102,299633,66028,233605,114,100,240452,96958,143494
a5b39d3f5053df4cc60b4273e009989b,122,105,319138,81749,237389,205,135,527631,55865,471766
06f14d4aced25dafaacbb87c68c10099,25,22,15108,7173,7935,23,21,15085,6095,8990
144deb50784c03aa319c8499fa6ec5c0,116,85,235272,56753,178519,104,81,199310,57660,141650
2c2f0f9524a12d65d09b30b9101f3da3,37,26,35226,7726,27500,33,25,26278,13394,12884
4b6f4798b1f7c06cbaad372d3a578c79,99,77,186544,35856,150688,94,85,157891,44415,113476
1d11488068f6978d69d8b74c9e56095e,91,65,258445,106360,152085,136,115,433384,111285,322099
05c4f7cbc7c6d0647ed1984cee748d5e,48,34,49619,24020,25599,36,33,56272,18693,37579
54f373e70dae0dbfb52bf84c71cc3834,139,106,360968,96043,264925,154,108,357155,101775,255380
9280d2ef234566130ee7941a5a3b7a3e,65,55,91405,23059,68346,90,76,113322,24159,89163
57a20e7d9ec571ece84d8c65dc500923,223,145,956620,166318,790302,190,150,993547,210614,782933
68ecb5ef07885cf9e1a7ae80eefaf7a1,78,69,153427,41975,111452,56,40,99499,31899,67600
31896cac384f2de62c804240747f0ede,26,21,18000,5185,12815,32,24,13039,6078,6961
cd5cd5b7c4f488e3ab683f0fefffd851,118,76,246498,43559,202939,159,109,352934,53830,299104
a0f06129b454b5ae088014cdc00d0877,139,112,350641,55311,295330,121,103,345589,74636,270953
8d315edaa8143e59c84ccb6ba95d946d,62,42,42029,17781,24248,64,50,46175,14863,31312
eb0762139916385759c105f0ed86247b,145,120,338690,60634,278056,146,112,339242,69142,270100
6d396c544838524c919c58cddbabf674,39,29,43582,11853,31729,37,27,34960,11079,23881
c6ae34c2c4dd0d8ef473a7c027ceb9b2,85,57,132530,43805,88725,99,65,212836,45627,167209
f409c1100a191e9fff96656b8f61f400,55,51,50721,26123,24598,38,37,44975,11375,33600
5c7ebceebffd4b310e674cc3d6ee3e0f,63,51,76097,38005,38092,84,63,105160,39064,66096
6b932633bb415f9d1b28594578bac978,182,117,436288,88371,347917,153,119,442024,99872,342152
d652fd61b74ef4804e22f944c2d507bb,33,32,15126,7608,7518,28,19,14280,4445,9835
7068962a3313666a9586798a886e4660,168,130,517367,99790,417577,224,154,747784,130806,616978
738bb09124ae18cb6494407742f2d7d5,16,12,3221,2003,1218,18,10,3817,1270,2547
65896d07b7b30161710cc4c385a2686f,162,119,389811,72691,317120,155,94,343111,71172,271939
e773dc3f774ad1331e0e903ac5154c8a,16,12,5506,1298,4208,17,15,3524,2093,1431
206e441cb17b2b8de227cb7bd27a6fbe,55,47,60604,27163,33441,65,58,58121,21722,36399
308c0a85a75d54f7d1a9a27a73b62562,119,98,333268,63758,269510,137,112,397457,57513,339944
e4711625c1c1f6618250ad60477dde71,52,46,75112,22658,52454,64,40,81189,24353,56836
fc4d5b6f9e596de10bd32b3e86877b86,105,83,195835,59614,136221,155,123,326153,56997,269156
dd61439e765eececad73e75883a110b6,97,70,155547,63856,91691,84,73,203249,40747,162502
c4ddaf8c2743ae54f0c2e364b5e921ca,21,12,5371,2479,2892,15,13,4746,2911,1835
ac6a7c7233c15f3aa7eb3e2734fc7e8e,79,69,138482,29592,108890,81,63,154449,40938,113511
2ce22834469edf9bd42bab1e74aa8a63,57,45,79949,19241,60708,45,37,43731,20361,23370
e3221406e85899780d10ef351c769ca8,157,118,687204,151388,535816,166,123,757504,109104,648400
9997c4ed72fdbd8dc2cf1571d9c5ed27,16,9,3099,1421,1678,16,12,4629,2803,1826
7db282fbdb84047c5defc2b3421ee188,40,29,24398,10832,13566,33,29,26640,10936,15704
f7cab72f8bf1bee4123b224bed971c76,20,10,5098,1399,3699,11,9,4744,1529,3215
73dcfaaa1fcb79fc21a6cb711037944a,1,2,184,532,-348,2,1,532,184,348
2899f3eb6ec851bed94a7a18a39c3ea0,172,133,719737,107712,612025,192,158,798609,105656,692953
94fd7ad27cef6fa04445ff1679a89ac3,159,122,506485,120087,386398,186,137,520842,120895,399947
3c94182c4949f008934c762e2dbc07e9,93,65,114322,26443,87879,98,72,137815,30769,107046
5d768eeb9ccdafaa2170ea57231c54c0,179,119,883655,144210,739445,192,153,744754,181978,562776
b9f5bade1a3ab977a10406a888891a06,140,103,340565,45218,295347,149,112,317077,106880,210197
ebbd7440f138f052576033d8b215e282,47,33,33870,16455,17415,51,33,42591,14109,28482
b641fb20c7e22cd0b4544beac0fe5838,71,52,102718,43745,58973,122,77,218240,41194,177046
0ffec12793670a7833d306b982e2cdf5,66,43,69535,28276,41259,68,57,73386,24076,49310
391dc66e93d070f3953f28ad6f652d7a,27,25,21781,7229,14552,37,27,22432,5726,16706
ffdde0bb497096e0aecb7eb27fda6198,68,39,97897,24820,73077,71,61,103301,38592,64709
1fed1f516b11ef7ab41902b967175e30,151,107,420627,90280,330347,190,140,471352,101611,369741
d5c1566996f72843b80f12c4cda4b067,143,103,317225,67458,249767,119,102,280267,71318,208949
586b8ca78d670b88860b59ae395ef4e9,29,26,14046,6468,7578,24,21,17503,5574,11929
2cb06a29fc3996019de9bf33af4e736e,27,21,7987,2111,5876,20,19,5155,3270,1885
52695608b038f88e5cb5a8a3435ecb10,219,146,950104,142178,807926,217,169,934857,153753,781104
887c89946523fb79e616e94125e50c9d,52,39,104001,27281,76720,68,56,105519,32231,73288
10b9d4406cb84af5a0a9fc8c813655f3,6,7,882,802,80,14,7,1971,696,1275
35f0f54be17349c13348e9a3a7a4298e,166,112,660487,125841,534646,220,132,649153,117018,532135
a75b1585979b5e32e57939cf8c36d589,107,78,200899,51692,149207,145,87,204703,40607,164096
95e3604e3c79b3297477e779b78dfba0,145,83,223778,49654,174124,119,100,194275,56595,137680
22c5e6369402ec3109b5c44814bb8d68,28,20,14377,6495,7882,40,31,27434,7894,19540
bccbcd375bf545adec39d9b843e779cf,96,91,194440,46020,148420,90,72,147833,51258,96575
c7ade3c054e4c5b3ec65fc58fb817513,26,17,17067,5970,11097,31,30,25383,8800,16583
03c365414383c4a323d3ec3accfddd2b,124,96,444704,82338,362366,91,75,283172,83987,199185
13431e756f45cc1c9dc908dca3aabe00,146,102,326018,62946,263072,123,91,256315,74343,181972
cfd11ae79c4f3c025171af6fdf55e7fe,58,52,123216,43596,79620,61,57,106768,48595,58173
46f9b1f85a06a25d64c0906885ff21de,35,21,19759,6017,13742,30,31,18959,10027,8932
e9b93a7dd94d1286c87bc55b70fc83a1,77,67,103215,28620,74595,83,54,111689,21421,90268
284d4d65732628df07e5dc673bc9624d,205,153,770928,131144,639784,172,125,761777,152250,609527
b1ad1e70acd94cd6ebac3d83c6acbdf8,36,24,37214,15582,21632,29,27,39575,17364,22211
b4c7a8226de8bc1e1d77863865b025c8,127,104,354452,74126,280326,104,80,250758,67053,183705
b9601713b890098051eae3b4a6a20edb,196,141,834220,156702,677518,168,119,594208,131882,462326
9e17ab1f8e07f6a909821dc6635a2e6e,151,110,343493,107509,235984,166,125,453297,87970,365327
9ad562d22577fd7197a39bfef7ea7395,38,23,40864,9487,31377,38,25,25394,11363,14031
2ca227ce2d0e35ba8df5b68ead6826da,45,25,45621,15688,29933,47,43,50176,19218,30958
5bf284646a5aec0c0ea3a41ea47cc419,109,77,245531,49295,196236,98,64,215839,37624,178215
dd09e99699da69245becc66da4d35f30,33,26,17157,6319,10838,36,26,17630,7977,9653
49e06c6b91dc7c51e6525bf616244246,30,22,19846,5762,14084,44,34,24248,9185,15063
6517cddb6243d37e46d55854649e694f,39,38,67628,23312,44316,51,41,65264,33452,31812
d2897e49fce47223b7e251f22cc2319e,159,108,498769,90790,407979,130,105,485563,120279,365284
f966059e71909e64b7c04641bf743509,33,26,34081,9410,24671,32,29,37807,14591,23216
5674b6fc85433a9d2051e422f8dfc8ae,26,20,10308,3633,6675,24,17,8391,4845,3546
d5bd7287a291193c4c244bd03cf2f4e7,43,34,29881,14195,15686,42,30,32958,11876,21082
f8f190c63e1a7737b29cbfba442b40f2,41,35,31896,9181,22715,31,21,16004,7517,8487
7987b946a42b8de159d6c961aa99c242,41,32,45004,15885,29119,42,34,41088,20123,20965
d216b0e78c5cb510c9f713c133db7729,79,63,127279,31725,95554,86,65,127919,33383,94536
93b4af699866db553221260e6cf748b7,97,65,146708,54443,92265,138,96,249293,41634,207659
88632bd67951c327d6b439011c6e7e3d,84,62,157938,52520,105418,76,61,152176,46195,105981
0a91f4237aa385edbf8630e71ab45b74,25,24,13302,8609,4693,27,22,15450,5484,9966
0e5e4c85a89b1bb9b3a251715cbf06b5,20,10,5784,642,5142,18,11,4010,1082,2928
cee0f01e49b5dae732a4a5388c8442bc,121,93,251676,62682,188994,97,86,228979,64893,164086
8d3211edf9040129110d9b4ae43c26ee,100,71,161562,44867,116695,96,97,226601,53508,173093
ee462a16a8cf36056c76d9aee12fda6b,145,117,560105,159170,400935,154,127,461547,165087,296460
c6ce75760472777cc0c4297465687968,95,73,249717,63156,186561,118,97,242356,73174,169182
a48c5bb7fb42857b682e09eeeb693684,176,123,516620,91743,424877,152,118,525950,97537,428413
7cd5b2080e78e1ce9bca6e2433c8868f,94,73,293352,65765,227587,126,79,285279,59253,226026
0fdb23aa3af1de2efce5fadd0a16ab61,143,113,314618,59322,255296,124,100,270439,64736,205703
f92514f84257d27d74e8f5e423ba1417,48,34,40868,9793,31075,49,43,67427,14660,52767
7084831a968cc9dc1fc1e613f3382172,131,104,292674,54587,238087,125,100,269883,55438,214445
757022446c635ae6d247bbe871c591bc,123,98,321427,83231,238196,156,131,441567,62532,379035
08fbd1beb6d63c2f1dec404baa20152e,211,155,1745174,301826,1443348,237,155,1455700,239012,1216688
d21686222512701a234b654d9dc2becf,65,62,72614,29513,43101,63,52,88239,23180,65059
c5d46cd5a35f4fc5dbe7fe4215fc676c,119,92,244546,57788,186758,112,92,263944,59511,204433
4928d8841e657a07e328583099123441,71,59,100716,34188,66528,101,74,152705,30862,121843
11943fb5b808823d51e4b9871d2658bd,178,159,649706,102040,547666,189,137,635570,92646,542924
872af0eeb7f7883aab401b7022b435f7,32,25,31627,16517,15110,40,27,33532,15757,17775
d645db6f8168e6f557eb8e232a41f403,17,10,2583,757,1826,14,8,1766,1296,470
fd870ee23823018ead7ed2f06c4b3f8a,7,8,1008,382,626,9,4,1436,416,1020
fd589983513db98c4dbdef39627f028a,51,35,61765,16605,45160,48,28,56328,13535,42793
9cbb2cc825cf90809eb280efb04efcc7,88,82,126449,31664,94785,83,73,95721,28902,66819
57814d4e132a49c5c334a7513c5aa40f,94,53,169708,38968,130740,53,45,60850,46677,14173
16bd53ba9b29e2e8fefcf372044ec19f,91,52,130346,45097,85249,96,66,149905,36335,113570
794d28b5ff355068121acd911d3f3af0,114,103,266734,79128,187606,101,74,302224,58475,243749
3ac43b07eced5980d0958a415c6bb8c1,128,121,390961,142226,248735,169,123,415372,108793,306579
4d80cb0f0973024506dd7598259c2af2,117,93,183237,49172,134065,77,66,137048,48419,88629
fffd366d46e7b0b22f4d5ba1e8957f32,53,39,56192,19192,37000,48,41,44067,25967,18100
db835049fc4ad350608c5be09cccb59e,167,135,614162,139223,474939,184,108,635695,120720,514975
c32a8e0c612f425a4faaa38cc9758959,89,65,128806,38648,90158,93,72,139322,39039,100283
071d8653824e990125ed22c1e3575455,98,78,203581,64223,139358,135,110,253085,73329,179756
c9345c087d3fd25c20aa5997ede3a0b0,140,103,347674,91224,256450,132,107,443846,93983,349863
e027c6e71017747cfa22166824e975a0,27,27,33763,11493,22270,27,23,21425,11415,10010
48983eb0a1f6f308f35e4e015e9a7bb2,174,124,371848,89744,282104,152,112,415802,77380,338422
e299cf22ed97429936f730af421406db,15,11,2055,1250,805,10,9,1953,1378,575
15c64ff6c6fefdf2dcd12dfabbc58c08,64,51,75123,27118,48005,60,48,114130,17939,96191
d90618752405c1eaccb8fe7044947206,47,40,79004,19810,59194,60,52,64817,19742,45075
e6ef3f76286c8ed8ff7d1e9f91bb7d4a,28,23,23478,8684,14794,37,25,26851,10190,16661
3d4857ec3f338aafd35a4415f1fe5687,49,41,83294,32739,50555,36,28,69328,24112,45216
0482329b5802872d5da1462870748c9d,99,78,201593,49496,152097,112,92,255906,46007,209899
67dce1fd180805960bef280e6aa9a890,16,13,3253,1827,1426,17,14,6543,1299,5244
0f882ac344c761cd39f4b9b2c4d73959,31,31,18186,12038,6148,36,28,23797,9648,14149
9f9fe51066dccd3ca200b96d4cb0dc1c,84,48,127709,28331,99378,64,45,72420,35526,36894
9d20349c684979586a40cf4d91612a04,76,60,118589,42011,76578,71,61,124882,36093,88789
4351a6ffb09beaf377a21a82e2d2b75c,47,39,47377,14020,33357,44,37,38856,13683,25173
8d48eb67241f706cc18371c88fa1e2b7,101,87,284490,63954,220536,117,82,254532,71672,182860
376ffa8b4309c4407e7f3bf5300e5939,32,25,24604,8497,16107,40,26,36681,9257,27424
c2740994e0e6ab89721a958eb0fc35a2,96,74,153208,30709,122499,58,48,113140,27640,85500
6aa22327933a8d821161e1162ce0928c,30,24,15266,5888,9378,27,24,11783,5158,6625
588154d647f6b073b2af25fae689a213,155,108,414709,55765,358944,143,109,392852,63754,329098
9fb0fc1b423afca9ab0aeceeca9c9768,48,34,68696,14237,54459,31,30,15410,10690,4720
6ef0e49e7e635f2f25e9fa94a4a622c8,23,17,10015,5080,4935,30,23,19902,5521,14381
5cf6cc8b93905e55e8956b1a4652a8c9,72,54,77694,20751,56943,70,52,76810,20347,56463
35a8f79773a0cc9a8a3292dab8eeaacf,25,19,7334,2538,4796,27,25,7029,3334,3695
c30fc3720f9a66ebbc8d4edd73d1fdd3,178,107,501985,139298,362687,180,133,515522,113433,402089
66ea5e7ef440c57d08510cbd107edb39,81,55,136262,48464,87798,146,90,253079,47913,205166
9d7ce9819d6204edd7fd7aab576e9b27,149,118,437813,118179,319634,203,140,540925,108158,432767
5585496284e0ac859c4f315ba4e5dab8,77,64,135287,60392,74895,83,69,139976,57009,82967
32bcd2d6b236565c14519a4c8ca70861,127,107,291530,79086,212444,120,98,362344,62462,299882
b910a596a48ef661afa283610c7c5aa5,12,9,2445,743,1702,12,7,2385,635,1750
6d872857209e44dc9baa47dbb50785c4,156,94,303591,69232,234359,132,119,278910,90992,187918
781fa1bb0a3c5dd0d397faefe970b752,40,31,27384,12062,15322,29,25,23102,10019,13083
809de815b44e5ba4d5664881a9fe4504,39,23,20419,6622,13797,25,22,10443,6761,3682
c07934a43b3579b7ead622943426bcff,169,137,549675,117396,432279,174,143,512625,116589,396036
745f1955d17fed8f0e2c588b2d9e5d8c,48,33,36659,7613,29046,40,34,38807,13702,25105
551d26120439dd85782b93db3afc0895,158,104,371464,57750,313714,137,114,413898,73434,340464
2f4e73fea969359fa07fddef0b4b4ae4,16,13,2656,2517,139,18,14,4153,2307,1846
097f1134172b9f893f8e7c10ca853192,45,37,42313,13491,28822,26,24,23070,11689,11381
895082c913f312da6d390e625008bbef,15,12,5465,3416,2049,19,12,8238,2457,5781
2a232907a2faa5ffaac9488f58d55784,157,123,355833,63362,292471,70,62,113171,58358,54813
fd165c86b867900f479ff8cca6fb2628,135,110,427950,115819,312131,157,145,494063,130195,363868
e1524a859015593efc14f867565b3f39,175,139,687206,103063,584143,127,97,309677,103402,206275
0cd0c5f31ffb8c5d2f5e1930d84bd5fb,163,108,422414,86069,336345,136,117,338014,80759,257255
96b4e42a8af05eaf7136f9db222ef9cf,154,94,261440,54570,206870,86,74,151839,57150,94689
d02b649f2e5d3572c428f17276ee36a8,144,107,335326,60742,274584,114,97,269650,61186,208464
dcfefef506aa21a732d961cea16eae3d,95,85,219175,42170,177005,88,70,154704,54901,99803
316620bf979153050b153e5cf81916eb,114,95,229641,59614,170027,116,83,191332,60315,131017
022c120c13a847068ab6c638326d3ed2,74,53,122353,32169,90184,96,80,145906,31688,114218
06cebf73e6835297d25036fb19504a78,107,89,318790,73552,245238,88,66,255797,102010,153787
1c0f503d2fb1437845c21e432f83cfaa,141,103,208187,46602,161585,138,95,201238,35010,166228
626fb3723b6dba776f5dfc3ebcd16fd4,143,127,321837,113963,207874,165,117,469289,77077,392212
2772b33ebce44b3ebd32fef1903aa666,86,62,115011,27483,87528,94,78,122967,23725,99242
a53671cfee68580ad617a5552067f498,120,88,260188,35657,224531,104,79,207848,49649,158199
c06f846e9ed105e361a98bd77c2b891d,111,69,251521,42539,208982,80,66,137484,55137,82347
45842f6ad4ea8b02197440cd09027a4b,75,50,85624,26292,59332,86,59,94817,27353,67464
3c86704e55fa2985d8c36b3bfe14928e,42,35,32627,13228,19399,40,27,26601,13228,13373
376ba94287e2abdfe31651fa8d57c057,216,150,1007177,227694,779483,193,131,897380,179259,718121
580ee34f61caa2c78891a145f6016668,148,121,565209,172214,392995,135,107,524975,130472,394503
efe9d81270f83e91c96657736b552dbf,78,58,140413,27300,113113,81,64,104921,28851,76070
12b4638ecfc44970d25c7d10ba351332,129,100,436549,105075,331474,206,138,507903,106154,401749
962183cfd9f0a05fad06b381b8218dfc,37,29,31363,7618,23745,34,30,15577,10472,5105
93086e526a1e6d7da812f769348b1111,108,91,231560,54899,176661,80,62,155414,49151,106263
9b32e19943e1d6c21d1d1149f12109bc,79,69,146739,42246,104493,66,49,116515,46745,69770
cd8e049ecc834c804a49f22591e1ce9c,122,106,457122,122342,334780,156,134,484794,162514,322280
551fd137f83b36be13cbe1ae3a3171cb,40,31,24618,10330,14288,28,31,22813,11722,11091
be49fa90e69d448843c1f20e88a0ebd3,56,44,83776,26950,56826,61,53,91411,24631,66780
91a75ce774e5a2e9d30e272014d9ffc7,30,19,17938,6399,11539,30,20,15936,6085,9851
9219a074214f559cbfc1fc68230a970c,110,84,189555,52178,137377,98,82,218300,45463,172837
ba7c0acf5f41a71c616a87f349ac5083,203,136,788941,119379,669562,210,147,713850,163722,550128
9d8a3c2c2ca4479de61c72d47f07e66f,140,98,305538,48699,256839,117,84,211875,48685,163190
d87e8efe488288615646eade89493e7e,134,103,401910,75470,326440,158,106,396735,85672,311063
89e3f11ff3b8d3d2f3b210cca25d7678,29,20,22010,6801,15209,23,20,14660,5444,9216
9cf3f33e80121338f3569201a81db8df,19,19,4917,2969,1948,26,13,6796,1728,5068
fa9afe88c0f231dfe80f40923d6e27a8,61,46,99854,58332,41522,119,95,284351,52840,231511
022d59dc748a9231e510016c4738eb6d,122,105,297759,97456,200303,177,115,438220,149449,288771
f7005393fa0ba8436ba1d524eedb19bf,95,81,164328,54990,109338,108,77,163804,53068,110736
2cfb97b97c583161b197cef1db2c8b13,197,161,812822,140742,672080,146,115,635652,119316,516336
1e7540417e4e981a28883f29472ebcc6,65,46,154330,26742,127588,76,62,112624,38312,74312
586ced56f6412435f6146db1d233c9ea,113,88,250479,77610,172869,145,126,382044,69521,312523
4c343d381ce2b7c930caaa5f5b4650ca,60,45,89748,30009,59739,89,60,107309,26891,80418
d43fc341a84fd0069c1614a227f4e20a,26,23,16602,5705,10897,24,21,11103,5789,5314
3fd7d6fd0330c2fabf9afa7c708778e0,0,1,0,106,-106,2,0,158,0,158
835065f10a8acd3cdeb2e69fb5f6e4df,35,25,30024,9435,20589,34,27,28131,10606,17525
611ef3111da48fed5b0310e1f0434072,121,98,320735,54467,266268,163,123,374799,89729,285070
51576ae56a08c2637165dab536682539,159,140,564540,112699,451841,154,107,349246,86895,262351
7e79aed93575987e85f98693b73f7181,87,69,173358,34440,138918,56,51,97601,26544,71057
c316d6046b7231539a3981a5cae0b933,54,46,64188,15719,48469,37,31,42062,8736,33326
07f85dd5eeedfe3501d6013da92fbc94,44,37,37841,14104,23737,35,28,34354,11465,22889
b2bc6fa471d702457aa4e55ee19c2318,17,15,3255,1650,1605,24,15,4003,1460,2543
c8bcf35ad9a804a82b1ede80cb32fe81,129,101,286738,51338,235400,126,88,230771,52591,178180
3704e23d73f7ea3a0a70f76d5e1b5025,43,35,39882,20356,19526,54,42,58222,17623,40599
597b8f5fbd37e5099acfc5fa3e088d8c,144,113,440459,105797,334662,152,119,483127,84052,399075
048da20975e7c5129bdf1044286f575b,49,38,32306,9706,22600,38,29,24813,7057,17756
dd1facbd692c8a92907ba96fd4d72bc6,126,80,291894,83179,208715,122,99,260036,61321,198715
16c9c60679a193e51d7980466dc52b10,73,55,120408,54093,66315,108,84,222311,51943,170368
d201f4867207d7d349811faf4dd2e3a5,33,26,20211,8266,11945,41,39,22553,9697,12856
368b74f0b826e66c60fb83c0e0e22f21,89,85,186306,51890,134416,112,95,218223,44849,173374
6e26392a8695fd8748086d0f74db8455,132,110,341709,93694,248015,108,86,308918,75914,233004
d3d700f14c753b31c214a20cf8e9840b,67,57,99270,46385,52885,70,59,125554,46496,79058
b50de9eb52ed3853436e8aad98be287e,166,131,473536,128128,345408,146,107,407645,73763,333882
d2822b7a33c5ee5f5e99024fa3a40175,115,102,186915,57688,129227,127,106,255579,45267,210312
5fa65df1a92a8562e58c7c13b58e6197,150,112,412193,62382,349811,140,123,251068,80321,170747
1aedbf47e01d23d63f45c160bf48d6fe,133,95,212266,32060,180206,96,62,166503,26055,140448
a935bf61088ef67809bc93b829d79d85,161,141,635439,158148,477291,178,135,740191,80338,659853
c97f8e8027dd2e966e3099d572d5a7a2,115,89,411056,129697,281359,125,89,433073,170780,262293
f6d601f029411713292448b9b37be078,73,63,143479,41707,101772,78,61,141392,43253,98139
5bb64bb2d9ab2e44a1bc0e1d9ec676b6,88,57,100158,30592,69566,79,55,103895,26587,77308
244cec9c6885b7b7e21cbd6cc1a9964c,65,37,61607,23514,38093,67,46,73651,19513,54138
6d4aad656699d17297f2a76a973aa073,198,139,736021,127014,609007,193,170,850281,167325,682956
4f329b4f366d4e5a0f6cdd5a3cebd5aa,162,132,377260,59190,318070,156,94,313529,55637,257892
99af71c27508885edbb7bde66bd9928f,99,76,236573,93464,143109,158,110,423022,75653,347369
fc8f2e46e5a33e1ca401bdce1884d0cc,148,113,305446,60277,245169,148,106,349094,45076,304018
d90389220b24d0e004e1a4e2d563792a,88,68,156443,33218,123225,114,80,169567,42984,126583
430d17c17837dd7df702335d001bec7f,154,125,407632,79544,328088,153,119,486431,70260,416171
5536cddcbac95a77478839b46e3323fa,60,52,85307,19346,65961,74,64,92908,27538,65370
a8ae3a611dc308ca83e09c6ce7914654,72,54,130481,25174,105307,70,48,109222,23319,85903
06eb2bad7b9ff5adffe2be891286cd19,21,15,9355,2627,6728,20,15,5567,1926,3641
a2de12a2c0f27160f8b1175092d7a939,169,139,611366,151571,459795,136,103,769906,103205,666701
54ba0fab124859633c14c3f52cc13404,108,86,193234,46499,146735,90,77,207785,41733,166052
6b1e343c2af04eeddb701532bdf58ccb,103,69,139253,28612,110641,83,54,137274,32765,104509
493638c39701d424d3bdc30201bc40ab,84,70,115325,34955,80370,74,54,119202,29270,89932
16255ae2b822325ce3ae560ff1dca3f0,114,73,337887,98771,239116,122,87,243914,95689,148225
4fd22abe11b2b507a9e9c2a9bc2fcbbb,89,72,165551,41672,123879,73,65,174780,51149,123631
8a92beffef68e83289d26b523613f074,143,120,271998,76016,195982,107,89,232015,51372,180643
23a92c42bc2ebe5e66548cefca86f1ae,112,94,147988,44960,103028,99,72,140283,48966,91317
b00f14301cac82bc692b8b1f401e1c58,40,31,84118,17925,66193,38,42,63564,28171,35393
41a72f8442b2c6bbf2f0752c0e9626f3,73,62,91802,29444,62358,84,61,129962,30484,99478
f24be53c7cee64eb5b5c41d13a306e61,93,85,264946,58830,206116,104,71,216266,64662,151604
e2e3de8f6139b5766d70d8f8c6c93106,23,16,7225,3090,4135,32,21,10494,2961,7533
302e1d218d16df0fe6a2b539e6ec47be,91,67,177526,25331,152195,88,80,175598,37074,138524
3a12aa33f13155da9fa1af63418d76a1,86,76,141879,45272,96607,146,123,276839,40615,236224
5e5d04a7c0b60f3fbc472a9a5664ce7a,37,27,50757,9784,40973,32,28,28943,17362,11581
33a5737db8e378aec87a8ddfee3718b2,181,140,626365,175844,450521,164,133,696222,124495,571727
5fdb5e5b55a714fe83676f719744c2d4,113,97,309834,79777,230057,115,82,229366,72539,156827
0db17f0a36f631b99b707a0055d3ca23,25,18,12608,5277,7331,28,21,12027,5287,6740
93cf6dfd95bfacdce0f04280a0638980,150,115,355049,104427,250622,131,102,416325,109839,306486
b8ef387d43f6461d2f4bc07b50b8cc16,161,111,471743,88105,383638,184,146,516230,89330,426900
c31144a7087265fcfb0c5a76edef4db3,111,76,207950,41330,166620,119,80,178655,48179,130476
4368b8aee582f5c933ff6da4747fb187,117,70,335063,100641,234422,117,90,330195,146861,183334
75474b8bd5ee4f1097c9a77c5413e141,93,77,130791,34689,96102,93,63,104206,25470,78736
06c88e3c3832ac4d46e84a4b94f64277,64,49,67819,30890,36929,49,35,70937,22339,48598
de677cf12f816790e0800046e2322768,81,52,108241,31446,76795,80,40,118628,26403,92225
fe027e8b272c2283c58d7b7ada5e1663,82,71,95085,37110,57975,89,60,127195,22080,105115
5f24fe112b4ab6bd1bbe909890359ede,117,89,153462,29348,124114,99,74,121827,26495,95332
6eb42df357042b596fbea1111f51a2c7,111,75,184333,36366,147967,91,58,163706,42269,121437
2d1dff11f494853b650e52ad6f86f091,92,81,201375,47505,153870,141,108,215034,42161,172873
c905bcb119fb9ba73978a07c2db28ad7,146,91,345495,91375,254120,113,104,202227,94399,107828
ad97ad99875886d91a82898b6723e9d2,56,42,54600,12739,41861,41,28,42891,12824,30067
bf76422fcc06654e9a9d861ce8a0ffa5,14,9,2388,563,1825,13,9,2883,712,2171
da95c98161701a7c8e3c6158c3525048,52,44,87241,29209,58032,40,30,64524,23964,40560
f918323c5bda41619fbc7ba36ab31af4,95,68,157959,55617,102342,72,51,147629,42312,105317
efd3076cfa096cce71328b21165cfe78,65,48,98843,29259,69584,47,42,77109,26949,50160
696b4e21edc3a5d9b15985e811c2c44d,38,34,39287,11954,27333,32,29,17276,16708,568
baf13dc518ca4015b8e7568a59882f5a,66,44,112132,29030,83102,71,58,87971,35797,52174
ca12510f76ccc3928d89d50b170570e2,25,26,32942,12893,20049,30,24,31627,11820,19807
e99beb76ab18d0c67cd948677beaf991,54,41,63461,20826,42635,63,54,117802,25631,92171
6ee0ec2e69fe9c8f773d19d0227e9b93,109,72,194603,36614,157989,103,71,178184,37641,140543
2d13159777f9aafabe896aae7c6d846d,26,16,9387,5792,3595,23,20,13253,5730,7523
99dfb64228a5f4cca303399de37a6783,118,95,288793,51165,237628,103,86,205811,64082,141729
1cfd86855205aa2a9aec2d65df42733e,74,54,136311,56490,79821,148,105,304418,54423,249995
66f6e13d07f5aea869f11fc2cb3b3f65,92,76,160307,66386,93921,115,78,214994,40689,174305
3a3d36634bb07023475a5e2f4fc47c10,94,61,128404,24716,103688,90,78,156045,43087,112958
c8791476c72bffac5d92a1877eedf8d1,35,26,35501,10942,24559,33,23,34669,8015,26654
d9102cdff8df43bcaa53e3c42c9c7ac2,42,33,48567,14541,34026,32,29,37724,14048,23676
e9f530cff8333916b24d45550b696320,27,22,17529,5671,11858,28,19,16745,7437,9308
640fcf1907f24bcc4b91bf2a1dff50f5,92,79,198253,85297,112956,123,75,297706,61798,235908
b368c451bb2f0ef5c820311669e0d51e,73,52,102391,32567,69824,68,56,107737,29837,77900
430bdccaa3d58ef88569724a6782550f,112,96,429831,172699,257132,158,113,604440,121737,482703
6f0215b8bfa4cc6ecd2a646f6679a5f3,55,45,105520,24285,81235,69,63,87655,24055,63600
86d89e9cb4ca28070fa566fc47c8077f,13,10,5514,1798,3716,18,10,3850,2357,1493
f18a7cde024e3ab3de73a771553e2f06,125,93,241319,49606,191713,114,88,261727,44070,217657
316acfaa43c2974a4e48278c86cf649b,102,91,154345,71571,82774,108,81,198160,43040,155120
90d51bca7a493abd8b4d0469266d4d2a,12,7,2283,1120,1163,9,9,1384,1167,217
63134f89491509898a2803267a87ec6e,26,18,13552,4054,9498,23,20,7105,4870,2235
be0920d07cf1402f54c9dbf8bdad2796,49,35,87187,26250,60937,76,66,100126,26448,73678
e71d19d32cbbe8d14e58b51e10eb6ddb,110,98,246848,51356,195492,110,94,234518,47336,187182
ba2311f5a202b65b56eacdae4032c1e2,90,73,129559,29858,99701,73,66,121160,39194,81966
49adf7d2b0a5b6cea243bfe576eed71a,12,9,1708,913,795,17,10,3071,619,2452
5b77e6eecf5f3d1a17b36c9198a0c5cf,46,35,66208,19516,46692,42,42,50168,26124,24044
2c53dde012e95ea48bba28efc1745f28,185,139,510070,134688,375382,231,134,613240,88129,525111
5264d433ae956e7dcb6e00799bb913a9,111,98,225703,60130,165573,97,74,161409,45561,115848
f955bb09843326c21b187a36f49f1d02,179,125,672111,174863,497248,152,126,527504,162311,365193
2611e5643937b47282344a7a1e648d17,165,130,478188,118781,359407,148,96,469614,83210,386404
d7a6754003d08ca4505014c01411b44d,13,14,1928,1554,374,15,10,2492,1431,1061
045c8a1c618bce3f064b54e8a30772d3,60,48,111774,22738,89036,80,48,103086,33708,69378
1234a20588cca2ed18b504036f4b41a7,23,20,12555,5629,6926,30,23,15953,6578,9375
aadf29429e78d7cbc1dc61e3931cf570,43,35,42994,12358,30636,46,37,41630,12174,29456
77d76e65ac9f9318ed1c543fc4f23cf0,186,136,538817,77879,460938,172,135,537007,119279,417728
b222aee200a24890bf6b53dbaaaa4f89,60,53,127678,28995,98683,59,42,121243,35333,85910
2dd857102406f64a1313f9f52f0dc5b8,53,42,49616,13004,36612,34,30,27081,9898,17183
4c04eef55081708ad3be56232c836ba0,225,166,922898,117915,804983,166,136,639465,114838,524627
aad09e2217486f24209722cf8484b8d5,63,48,108075,35375,72700,71,51,111210,36146,75064
ef64b80c008d9f4929ef1388dca2ed7e,108,83,221041,24514,196527,80,65,132447,40830,91617
126904e3092be1d195265e74532b1485,60,51,101854,43000,58854,101,80,195190,32543,162647
c03ae9d6e988a0fc9d249d2060dac7e8,92,76,143415,47297,96118,81,72,172167,49140,123027
7ea14e1e66ab18c92ddae89cea7190ce,29,28,9438,4259,5179,30,18,12812,3639,9173
b3138dfe54e1b95f0afb79b41d45b93e,196,128,883622,121965,761657,217,150,736418,176426,559992
e1a691edac235d4f72ef345d5dad1643,47,33,63853,20526,43327,70,56,102888,19599,83289
4b847121930319bbbae529e5fab2d575,73,64,142479,66096,76383,68,54,132290,50740,81550
896938cfbe027b23d02be0448ced52fb,52,43,121007,26456,94551,47,38,96354,25924,70430
71fdaebdcb29d1cc44742aa153f7ddcb,18,10,4275,1375,2900,16,15,4105,1359,2746
4b6cf6faacdd91d51b42639a4cbb9643,28,28,7065,5092,1973,28,22,8128,3682,4446
2a1416f2c0c17696aff578141ec3c47b,99,63,154855,19107,135748,61,57,62608,40164,22444
de86b3824043210ebe400f12193f727b,154,119,536958,84996,451962,116,79,309278,78138,231140
0940a230a680795e83184b4dbaabf208,160,129,490688,68921,421767,170,127,549416,54768,494648
2cbd13fa239404acead9cedd582c65e2,105,96,242267,70344,171923,129,113,301711,71367,230344
a3ff6f6a83ddfb61b2da0fd8c554727f,142,97,362174,68572,293602,147,118,370310,92717,277593
47b3e29dd0bc9028cf3137b6b26da66a,137,98,394543,113556,280987,146,116,467509,91735,375774
69609829aa6978464a4c7bf91e4ead50,52,40,161612,17015,144597,112,81,246205,44601,201604
33f4b7132e89ce47f00bec31a52b9e86,65,50,110274,42293,67981,89,81,162451,52774,109677
155d1fb2a0673ffd18aa2bb528a0f5bf,161,124,431952,72647,359305,121,86,274249,77257,196992
1c69372bf7ccca9a270062d4d77381d9,185,129,652306,194289,458017,177,115,638843,166047,472796
47e501e32fa2feaa790eedef170c7182,137,117,338028,83766,254262,141,102,296820,57160,239660
0b1974202515ff4e69fc7d63655bd462,98,71,175708,26616,149092,84,65,86393,39982,46411
9e03c695aa0a688fb7f395b83f343d33,93,72,114779,28064,86715,101,67,179883,26060,153823
230b39174036f647c0813e134fb39d04,44,38,31748,13632,18116,55,39,45033,14614,30419
1601ba326a19888b7a24bfc53d233b05,139,104,350554,72936,277618,198,148,446298,65698,380600
d65691b4bcbf14506736042d3baa49a1,98,77,147291,23049,124242,87,69,100100,37813,62287
b78ed77efe88e0a843827c195d1450a6,31,28,24585,7882,16703,27,26,12693,9356,3337
1bc1482afeb540ce64593526e61c6c78,56,41,95953,24039,71914,96,77,149743,31322,118421
b5b5165034c935a511d724d8416aac13,193,100,585217,78890,506327,153,122,406934,94331,312603
ab92b9231b2730960d67636f153b6875,18,17,5026,2697,2329,21,15,5356,2290,3066
8c8359d702a1dffca7992f0f90153333,150,112,334080,49728,284352,148,125,331799,60499,271300
f3d8c549035ea65e4fdf229fcf8099b6,105,96,189218,34758,154460,102,80,126671,42959,83712
d56985b992df0b67ebac00dc5b3a67a7,45,29,43403,11510,31893,47,32,56711,11759,44952
ee4b50bf5860040f3cbaf151b020a076,33,27,34455,5053,29402,30,24,19584,8000,11584
a29a0031ae6bb2808a4390ba6386a0d4,73,64,110916,37651,73265,64,57,103440,31488,71952
31c96e7b54ba31b906097d717d07358d,66,62,88078,30279,57799,75,55,130894,25273,105621
9d125ac64b138ee5547a909a2425150b,211,167,738940,167910,571030,148,101,652588,121099,531489
2eac3b0b3e441f37bf7c8de40ecc384d,54,44,51833,18109,33724,44,38,35517,15821,19696
3e52404dfe7c55ff54cb9c4618766cd8,130,89,598008,124581,473427,148,111,597616,156822,440794
abe80db929c7e7537e8cdb2dd017f99c,29,18,14993,6040,8953,27,27,12966,7129,5837
ec26840d97f91a7b7cbb9219e7a99455,23,22,21688,6644,15044,31,26,20488,10586,9902
feae753730d4630bd681c7e1cca35c97,49,40,48747,19371,29376,45,37,49856,17849,32007
89aee9fefeae8e3d9aa3731d0a16151c,140,114,560902,129135,431767,184,123,595403,103913,491490
d7af79d287e71cf0f5da2c1639c35e80,75,60,117125,31614,85511,95,85,147625,32243,115382
54d073e88f684e632b7d1b76432d09b9,97,81,197492,51122,146370,119,101,292803,47128,245675
dee87065a0b2154cd347b6d3a45dfe7a,170,137,439566,94010,345556,165,116,453385,77409,375976
88f560592b5d0cb1b4d98a5f2757859c,22,23,8284,4234,4050,27,23,8077,5117,2960
e4b5d8457440dded63a89f9888667007,183,132,677125,88212,588913,140,113,395020,94705,300315
9550344b1f26f380d40d3d13a820371c,122,92,233268,58581,174687,129,103,265928,48274,217654
3425148a866dae6c00553aff1837ac05,17,9,4740,712,4028,16,11,4696,578,4118
b7e176d7a1ec383c8c9cf03a477509c9,72,64,121492,41731,79761,83,65,140139,39861,100278
bbc4724651343ee4f44574fcad689201,85,74,147000,24215,122785,58,57,55027,26363,28664
ebd992f91be70b8775be61956fe32d25,119,100,248580,72144,176436,113,80,242205,74473,167732
b46404d002966cc282617c7355564aa8,89,75,181380,55438,125942,80,64,147923,53314,94609
4dca00e5c8d33db196af8fd6cd3e0d7c,99,64,272500,41508,230992,84,56,169312,55413,113899
a34ef5ab9b37c58716491fe9aa1672ea,128,92,294297,87029,207268,135,116,295193,81324,213869
b106e9a090ecba191e71bc79f2875288,142,103,289411,59563,229848,115,96,280154,59738,220416
33fb3c6cee5a1cbc3da29d73873d02fc,160,125,429772,61695,368077,154,137,470527,83671,386856
1b00b399c314290487e3767b1ea5562d,137,105,341249,111417,229832,111,86,354392,97697,256695
fbbdc5495e6d156f791bd502105e6dc1,71,71,118216,63500,54716,124,96,244573,35753,208820
2d3d4ec98ac9fe73e68677656ec318a8,24,16,5280,1932,3348,21,16,3329,2634,695
0c7d723abb19b703bd6f5b4300eb17d4,138,109,459095,83136,375959,139,83,307149,75309,231840
cfceebc982d7ed4588ebf7b5c843fd51,166,120,804676,188842,615834,230,177,938354,187094,751260
0b1ece7df8e59374612d2d1caf622231,54,48,41247,18480,22767,69,49,60946,14668,46278
ffac4cf2717614ee0842f4f3d502cc0b,47,32,72633,12265,60368,41,29,38022,19363,18659
e6bf9a845e8f2717bdd5dfbcb7e051ac,193,149,693837,180992,512845,147,98,600938,125693,475245
2fc1b2d28842df1d100dc00976687b75,199,151,1226624,197217,1029407,217,150,968271,263529,704742
aa987b3aff6c4888c9c2cbd8d721246d,141,97,429077,89465,339612,190,145,648332,114757,533575
ad0b0dc44c90c248ee5935e02e59f37c,32,26,24965,11371,13594,28,21,19486,8430,11056
bb5c33c6f584061d972cf0aebcaf1375,151,114,523472,96415,427057,174,109,482076,88423,393653
a4eadcde9844da5e2ad6da4dd89ce196,39,34,35366,17230,18136,44,40,43722,13095,30627
f9beeaef8305e116afc8eb7e19219fbe,46,40,39442,20774,18668,44,34,37989,21741,16248
8167e2c35e6e2eb4ca7c6678345c4426,63,53,76143,31172,44971,76,62,81535,29371,52164
5d268385a6b8bb5554506d51784ed0e0,181,121,525599,95512,430087,150,127,461116,124172,336944
552421ee8e5c45057d0fc5ba66ff45a0,144,114,412136,77928,334208,169,130,443894,83075,360819
65cc440f1773543b4847b6b7cfdc1302,35,31,38468,18255,20213,52,41,63071,19923,43148
c3ad756e481b714fa11f9da4dbf1468f,192,125,709596,125903,583693,150,107,410151,110838,299313
4c130721c903c6c1c661055028eacc2f,19,16,3496,3152,344,26,16,8303,1474,6829
34ecc529bd9cb7b18a25f452380f13b1,122,92,276081,61988,214093,169,126,404631,71984,332647
deebed2a56cf6f15f564a9e0457b5e3b,138,109,287820,57315,230505,104,103,208314,66394,141920
9222460bec2e2c1c459d2c18a138bae7,124,93,235345,53909,181436,144,100,248035,41039,206996
4f7e81a7fc7be02a510789c6ffd1c8ce,84,61,131716,39472,92244,118,96,242899,37394,205505
2df001ac9e661c81a412402e1c5bec1d,78,58,157002,63552,93450,86,55,189698,54784,134914
b9d885139250cd2c6e17f56ab8990dce,116,94,262872,60997,201875,150,110,332487,29401,303086
f68761d15fb674b3d4ad1b8ef3ef6cfa,95,77,170884,57960,112924,72,59,150239,38803,111436
9f53b3c3a1e5920e8f0abd3e6c1b5c42,119,103,248795,45931,202864,102,75,159228,40777,118451
ae22e60b084cb83a0179d00e9f85f2da,236,166,2169737,360545,1809192,288,193,1478326,362891,1115435
0ad2b9dd043e72d9504c2eff83cb277f,106,82,179518,41140,138378,81,71,135839,34815,101024
d8da5f9b9ef045b3b431d826a92ed94e,158,108,521634,125057,396577,197,137,879838,100054,779784
397662d59875170f5e2e0a26ce821887,24,22,8917,3594,5323,26,20,9784,5403,4381
fe3e93c9d8dc36990c0b72546d902d89,130,110,321130,74607,246523,109,95,302891,72669,230222
035b68a0100be7475ab020c09a3bcb34,5,5,863,867,-4,5,5,867,863,4
41e66a6bb4c54c764fa1c7dc82e13115,89,72,149337,39751,109586,69,59,138671,35319,103352
e74b948165f892e439f6fabddf58558c,1,0,87,0,87,0,0,0,0,0
90c0445a30f2cb478861e563bd22c8bb,142,125,497933,123256,374677,182,117,517046,109164,407882
68a162f6231e17b6e50aecbb49261a3a,170,124,587743,96144,491599,195,172,799115,92969,706146
c51b09a2405ad35ab9deb6b30b01a4c1,96,75,210778,58521,152257,138,100,323592,57694,265898
0680f13ff9df5ac2cfbe412e8b23a328,29,17,14846,6236,8610,28,28,15282,6739,8543
deded7339bdafdae1e2f1aaf76c6b6a1,107,87,208207,54106,154101,105,79,229118,50475,178643
3e02eefd66e637d312d3266e0b92b450,215,136,789452,118214,671238,173,140,877910,166510,711400
2aea8b374e1106904816e8255ada7b4f,124,78,444859,95753,349106,161,134,498686,93200,405486
9fbed9a62c3d59b37e4de49789224163,50,47,93809,44873,48936,47,41,98593,34396,64197
4b4a20d11f2eacd2f43da9a5bfa553b8,23,18,6212,3651,2561,24,20,5614,4495,1119
45f932c0db1775f89d021a5f3416da88,87,70,174070,47175,126895,84,70,151310,49777,101533
6239b4879f903437618e5c2644f2475c,72,53,132306,40562,91744,83,73,146600,43396,103204
02ef32d372c1ff8a20d9af0a53ded673,145,100,295455,77608,217847,131,93,273073,85054,188019
595b20e4cf3ecb097372e2ea3dec70ef,147,119,416715,80840,335875,149,120,358292,81820,276472
6e92a797eb26ff1c6d45c0510193e739,78,61,111743,32078,79665,63,62,115105,35872,79233
423c45b51a82fafc6f08831d91e7c272,55,48,98292,30428,67864,49,40,61109,30500,30609
7742fde5176bc0ce1d08595905b8020b,91,77,142768,44797,97971,51,45,81280,37340,43940
d33b2a4ffedb388b11a797f0c50f546b,25,24,22022,9608,12414,44,34,43623,10567,33056
19139dada17fea5a42215978a41212ee,106,72,197566,31570,165996,65,48,107092,38734,68358
271acd2c16e3ad5d00e5edbf37572b9e,125,112,319394,86708,232686,79,59,247093,84607,162486
4bbb36746c72bccea4d92ca2cd27d545,179,143,724130,131266,592864,197,114,559679,93598,466081
39c13e030ab320fa1453c955e366449b,96,85,194848,67012,127836,96,81,209733,73542,136191
a04890e38c0e01c13309f0ebe14719b3,9,6,603,447,156,6,4,540,289,251
31527333867379487065a53f7d5dfdda,18,11,3227,1433,1794,17,14,3143,1148,1995
d53b466cdcc14671c41ecf0fbb0a8775,161,116,531044,110785,420259,158,120,528222,119545,408677
7301a971c00cf96c4da71e256bebc207,15,14,6359,2174,4185,21,14,5549,1981,3568
adb757f32d67c70b0f3b5d02abf3bbbe,49,41,77695,20693,57002,59,51,116026,26465,89561
34566340f18efbfe066809987e062fd8,44,30,44070,10043,34027,33,30,22721,13927,8794
f82eedfcdf499cb04de67b9e305de9ca,29,26,22419,12483,9936,43,22,41154,6110,35044
074faf40cac3b1805a6443cb8edafeb3,29,20,10614,6762,3852,26,23,13403,5838,7565
4bdc7a59d0a2ad1b201c93ba83a300b9,127,92,307071,85887,221184,134,102,329716,124336,205380
fd2268600ca021aa3da46165c07c7b46,31,26,22030,10983,11047,34,26,21158,11523,9635
b5004db26399fb65953ad4b1ea4ce212,43,29,48888,12387,36501,46,31,49556,16324,33232
a1d59aaff7ae920c500af561ec348c2e,21,15,4719,2288,2431,20,17,5459,1998,3461
c555fc5bd46be945951a80fbddd01782,178,120,528387,123217,405170,133,112,422347,130721,291626
dcbbeaab1ce8064a2e36dead58466ca9,69,47,101278,33483,67795,70,58,111018,38311,72707
c547c6c434d76e9ac7ad2d360bad0bcf,30,23,9216,6426,2790,29,20,12386,4873,7513
b9d37eeee2c8ae2397b98ea754273d79,77,46,82338,25042,57296,74,60,77717,31114,46603
9188f9dd1642fe46396cdd9ab56199d7,148,101,422677,98957,323720,146,104,425666,126040,299626
eeb318ae717e50f98477dd9a81d2c2f4,128,100,477853,73053,404800,134,107,338618,62824,275794
d5cbe9d66088e5d7027d9b53a48efe3e,115,83,301666,67342,234324,128,99,317782,77366,240416
13cdd3c7aa0dc240c44a41bf76a90798,105,87,210881,60568,150313,125,91,247601,55290,192311
2173c61ca9f59cbe6490b5597be4ddd1,47,33,112046,23604,88442,70,60,133356,33284,100072
598dacac8162d9bdf86628362dc10aa8,66,46,83692,23716,59976,56,43,57226,24437,32789
924d8c54e12d8c2ebf933bb200744825,42,34,43011,11438,31573,28,24,23741,9461,14280
4f73aae77d8c8fe6eddcd87fac5f014d,83,73,153283,58776,94507,174,91,287041,50606,236435
1b6bae44f1d4a94e4993bdc309e99408,50,35,58612,24597,34015,46,34,58594,18091,40503
19262977cc8f637aa1ad8f001a05bc4a,57,54,97769,37380,60389,61,51,98820,34883,63937
efaf83197911010ae167efffa036728a,84,63,128599,33665,94934,56,39,89823,38506,51317
49f1902ce8144badf359b8256f5fa99f,93,72,218106,49662,168444,115,92,248658,47372,201286
41585d0ab906bf9f6d07d8b7b8b43f9b,16,14,1985,1066,919,17,9,3008,658,2350
42c58b97f8cde4baf8a9672d4675fed5,94,65,118079,50699,67380,124,92,244905,47592,197313
4695d9e6b51346e8d7d48fa01d921343,93,63,131713,66702,65011,118,91,238140,49748,188392
95759a8191cfc738f949ef243f65d8ae,106,69,222729,37322,185407,113,83,171013,43541,127472
acba06f456db40102823de23e0c93d3f,67,48,131106,28066,103040,67,53,89087,39412,49675
01aee3764e2143342e4067ec45dda329,89,73,141396,32455,108941,68,54,118248,35087,83161
5947c5bca8327a0f6b562b59a33d795c,90,65,165987,57014,108973,106,73,180143,59569,120574
57eda44cc987206136f1814bbc91e6ea,111,100,202829,33920,168909,74,59,164798,40722,124076
9134c9fa8f2c938d55814b19150a9805,145,108,506505,143968,362537,161,91,587133,125245,461888
b063f8a23078f6f1f9453b9cc53f9908,26,19,10028,2728,7300,22,20,4328,4042,286
ab054782360409b265f7a01b54c6bae0,27,21,10545,3919,6626,25,20,10054,4893,5161
3dceaee5de101df0bbc975cba51d57da,70,54,113616,50422,63194,61,46,93497,37538,55959
986998d958e25d5c4a20cdc5d8c767bf,16,11,2604,995,1609,16,10,2036,1271,765
d8373e28237a04f383a21f63c4b05fb2,46,30,39607,15072,24535,46,41,44578,20262,24316
5308d30e3e1a48c1b00a38a4d96113b1,31,26,28081,7941,20140,31,21,16090,5223,10867
76a8f96f623028fa5704710778f80fe1,95,77,191926,55966,135960,119,86,202333,59192,143141
24f91f3de362f0d755c5c99f2102bc94,161,129,554064,128958,425106,193,154,823733,150803,672930
17b24173050ba2f6c957c5456d11af09,83,65,109874,26633,83241,61,44,75000,16988,58012
947e2418040ebc2f34e5dc61c8c12cad,167,131,676548,142435,534113,181,147,641289,107395,533894
d46e038632864314fca0bdface372d29,191,160,594686,107555,487131,195,159,615491,112473,503018
d5e2d4d60113d58d06b15696489dc724,132,99,284760,62965,221795,92,68,195856,66177,129679
e9f90763c8b22a5ecf4272cc82cf70dc,101,84,204746,67431,137315,133,89,255813,45491,210322
a0b1c010685e7c13efe977e4e630ebee,142,104,383764,95048,288716,175,147,615913,110757,505156
bc2fe5c2b752150455885be2c8d08aed,64,42,81877,21335,60542,57,50,52809,21481,31328
7e45755443aa039c9b59b9efd33a88d0,127,116,320419,77646,242773,118,98,365415,100557,264858
f93fe41a117f062d4200bc8b52898c47,34,24,27338,12201,15137,38,25,25538,9969,15569
c7918a98e1723c1920371ecf39c4045e,112,103,269432,80692,188740,120,103,312917,58748,254169
bbe414ac9a3830fec8d1a010ab929308,84,69,203306,47695,155611,69,53,155114,53865,101249
05ceffa3e4c898157d9c17e70c785e12,27,21,20758,3705,17053,37,34,27903,9151,18752
44b2575b3e490ea0f00cb785171c5e0f,129,110,270438,67096,203342,119,109,276072,62147,213925
3af2b34fac4d235b80826d3b8472ea60,78,63,159104,36463,122641,85,73,158291,49841,108450
cfb46bfa8c811d22d9cc4bfbf63f7b06,122,88,299337,97487,201850,155,124,391939,92493,299446
1029a6d11bc245184efb74126246c3ef,184,140,615777,100205,515572,160,114,450243,106498,343745
a015e498e601c0bac59deb344d915066,149,112,420415,81775,338640,177,114,361300,86423,274877
59b3cce44d534f4f9998a0203b8c4de5,21,13,2773,1008,1765,16,15,1394,1419,-25
ee32cfb90f2696442321ee4c6d9c16cf,142,105,285251,49600,235651,96,73,165132,61529,103603
1dd427d2ab71ade94e3e6a336260636e,153,105,384960,67144,317816,159,109,414900,74189,340711
6e427f4f63b1bab7112d85ddf0784261,83,63,118682,30789,87893,72,63,94726,30755,63971
4f1ab4dad17de8db7ee0265511fc4e11,6,8,845,566,279,11,10,751,679,72
42c8704911a9941c8eb8f735ccda1793,183,145,801109,147339,653770,209,145,776766,186838,589928
b38db05f4fd84ef672800a6fcfe18f2d,28,19,17747,6239,11508,29,23,21399,8021,13378
e753e053fce5f6f43a1dfd6bb06599c3,25,23,10919,4574,6345,25,19,12310,2988,9322
9939a85274ecaaeb253d0b3427da467c,92,77,192973,48616,144357,74,67,115138,33713,81425
6fe74f927453ea84a9ce4a561395018d,164,109,363869,81540,282329,135,104,335730,79161,256569
944e2bb176bca5a1d7340ea30b999b67,57,49,67502,22070,45432,65,54,87093,27061,60032
4d3276ad3736c56bc92008a8cd4a60fa,40,42,46133,23021,23112,74,46,78445,17536,60909
8b99c6d977275506518a45658db47180,160,109,460111,95793,364318,126,91,441672,112125,329547
cddf7279b2c58c0d554ef2220dfe8114,58,44,78039,31457,46582,54,48,69948,28790,41158
9776dbc804ed934e3e58ea2e0037e42c,171,133,575181,100545,474636,163,114,466443,113100,353343
a4a17dece850e20cd0d88d02b7522aae,186,135,498632,80593,418039,114,86,304373,76924,227449
4c2144f638155545de77c9d663b43f2f,51,32,102741,19455,83286,92,85,119706,37029,82677
831725c7db6edb0cea94a454bcba7393,10,7,1026,301,725,6,4,606,288,318
6c0346b0a6dc23df72ea0654b82cd500,195,127,704875,145967,558908,173,131,676353,166718,509635
bb5358657b60f357b6e72c934feb4b54,43,32,60839,18872,41967,44,32,34274,17549,16725
1d35f737783febcb6d1595b4105b17ad,56,46,102317,37805,64512,65,44,81887,28704,53183
37104517daa194ed2300547e4d4e4871,78,57,126580,31258,95322,64,48,63268,31241,32027
c23bcb9b8bc22a864fd5be834c58d940,21,16,4828,1267,3561,19,15,3326,1908,1418
3ca91daaec4c58a893ee53b7881b414f,141,85,239605,38277,201328,104,69,163464,38297,125167
1c68283e10a006aa8756a4e3b15a9f6b,120,107,337241,68077,269164,74,67,137060,62526,74534
d31ac8b2ff677ce624c180b1cced3c2c,19,15,4474,2066,2408,20,13,5074,2923,2151
42a1f135b92f7588d5c2aa2a9407e09f,142,99,273902,39862,234040,134,105,247762,45056,202706
96d77f65cd17cbd3e23a704179f871da,55,44,62223,22019,40204,47,39,65656,16017,49639
050a0efb929919e719d51be75e62c2bc,20,20,14796,4634,10162,28,24,17396,5051,12345
c4428a35a514732b04e07f94d9a7f747,171,118,453819,74838,378981,153,102,484544,100615,383929
fc43ba9ba1ac3defb0b7ec1e2e5cdd35,46,30,52179,14730,37449,42,32,42490,12147,30343
821dff71367ae64413efaf2f5ff23f44,39,27,23833,9317,14516,35,31,27777,8494,19283
50af406c4d0c9b2d88465ceb68f3db7f,32,25,22532,5707,16825,31,26,16646,6615,10031
cc52d7c1911a63991162d68cebc640bc,208,140,886395,177750,708645,236,185,949637,203166,746471
f8d0ee7919d3cde9adaa72bdf9c671af,27,17,7395,2342,5053,22,19,9025,3282,5743
07a590a164a00a178ca12348e6431345,106,80,286740,73363,213377,117,93,302633,53412,249221
709a2224ebce8302c10cf6f3778af3dc,108,64,200055,73903,126152,116,92,288301,67122,221179
0d2e71955738cd6f4b0a10b06cc91d72,136,106,379581,98185,281396,156,114,471802,100694,371108
62a23715c9216cfb14242278b111822e,66,61,113998,36918,77080,66,47,103312,35365,67947
7c1aa07e7653d661e40164c504338cc1,99,78,297017,104637,192380,141,128,435466,136141,299325
6ecbb835643a297701313a0603d9fd74,77,65,102061,25795,76266,93,74,107996,25124,82872
575fbf3698edc0a9f7346af8ee8c498a,68,47,63757,28686,35071,59,53,92209,23155,69054
148176a4a946be87a3e3d7d96e9ef8f2,168,127,500226,78678,421548,145,109,582259,112998,469261
727eec99f4936f1eabdc4443d1779631,34,24,27211,4197,23014,31,23,15878,7450,8428
89da95ff5f55c57da8eaaf1f58c26eeb,39,33,38489,10051,28438,36,33,30276,13143,17133
384760650ea4a92f88bdc6fbd03782f4,163,110,469882,93670,376212,200,149,709200,85912,623288
823bdbf417afe8c4e87e1ca71d724872,188,122,930568,137966,792602,170,135,660920,112051,548869
da56c3d853e33c715da8f96b20c8e787,133,109,543102,102304,440798,202,164,1014312,119350,894962
b1ff6a7354cc6dd054805f100f1a765f,39,33,51754,30821,20933,53,50,89051,27592,61459
4aa3ad181957c2bd9cd5e0094c0fdfdd,95,63,173265,47900,125365,115,80,238789,41979,196810
e3974f38aa11a3efb6ca49f062e94a19,144,100,286519,49442,237077,123,91,249355,59627,189728
82f758a1a6dcaf9005884fee74d103cb,159,124,597949,85224,512725,179,144,633372,110517,522855
c6882250f1c35eff8acb7aca16e24447,27,25,18840,8862,9978,40,36,37001,11607,25394
45fd707cc134567e4f219ee51eadb88b,154,111,547635,147684,399951,164,126,666469,122037,544432
270886fe9fb585d968324250ee9dab21,140,113,294537,54797,239740,116,93,199411,47603,151808
456281b5d2c59c6b292df30acf109ce8,19,12,5545,1659,3886,17,14,2715,1170,1545
c9ee78d902476c7f474164c98723a6d9,188,143,659300,165677,493623,225,164,1001190,206418,794772
61ad263b6d7624339376aa042eda34fc,61,43,56822,19443,37379,31,27,35902,12155,23747
f4ea322331bc363c039d8be14355c6e9,48,39,76773,23689,53084,45,40,60809,23182,37627
8c896b8002874f3b42bf646d0d43deec,23,23,19304,3278,16026,24,19,11443,4719,6724
d96b1e1646df2201a0081bed5e0f44c9,42,35,60503,22769,37734,62,44,105070,16735,88335
bc04c589052bebb3e419b58d94619672,0,2,0,126,-126,2,0,126,0,126
b15fa8d62eb1db2396edb416d6046844,46,43,48924,15319,33605,40,27,31752,10020,21732
8897cbcd31fc3f8056578fbacecb5aec,34,27,22156,15602,6554,44,32,57541,14003,43538
995bd5821d07b1e2f5b88e929fd9c492,64,51,79495,31773,47722,50,43,74293,31810,42483
a820623ff13169c7abd6955f39497d6b,129,116,367586,68200,299386,134,112,358417,67431,290986
b2ec90ad6ba6f235b70fb2fffb050b23,55,37,63197,23426,39771,57,47,75812,27640,48172
76387d69a53ab6c2e9fdc48ff21e4ee8,77,57,125019,27756,97263,83,70,138294,34437,103857
e225b2be198118109809be5e1dae1072,81,58,118249,62958,55291,85,69,244976,71941,173035
4f3459344578cb7c3696d3c965f41a41,172,106,548177,143825,404352,227,175,771908,165192,606716
d48af13ca3e281bb3f50b233ed30e609,180,139,474383,148914,325469,159,112,493619,96358,397261
98b49ba837df6e54c463fbdb94d23b5d,23,21,6615,2796,3819,27,19,11581,4199,7382
21c9a22be5d00f73a6dbecf2ac26b9df,69,66,69431,32662,36769,78,66,111591,25199,86392
eb69214b75ed094e6d4e0eb45332ca1f,111,71,200440,67697,132743,105,73,233385,70898,162487
08697de1424aa55bc39a7a4e3fde60bc,153,131,346301,67778,278523,149,113,321296,66730,254566
ee118936b9232b54b633d245d7080a6d,63,49,77394,26722,50672,61,51,77013,26949,50064
e3543497c26ad8637e1155fd63991501,33,24,25663,8831,16832,26,20,18525,8220,10305
663c1a65307b0889cc764551f0daa5c2,126,100,283167,60437,222730,99,68,208715,75475,133240
fc1b82998697ee3bdbbb91ee12ad2a0f,102,86,216041,53175,162866,115,68,186444,43376,143068
86dec10ba79bbd0a3c3fee4d6b865b53,4,6,974,966,8,6,4,966,974,-8
2e5cce08d6ad4a780f7a5a499ceb69e1,26,24,14331,8824,5507,34,25,17365,7788,9577
1ebdd81fb595b4ee57c552615373ca11,131,94,440677,59871,380806,126,93,354200,67299,286901
a764d831fed59f1f40c1d724c8dca864,61,44,89007,20855,68152,93,76,116971,30736,86235
59e82980d618d9cbef6015217d2392d6,28,20,8831,4328,4503,27,26,12129,3405,8724
36d747129915b58058ee3452cd6a5783,73,48,122989,30624,92365,87,69,143793,25750,118043
5872bff0929ea5615f5f6bbb8284d9b1,31,22,24046,7854,16192,35,21,28000,7526,20474
a4469216e465109a29f38467ae8983b5,138,90,292524,71236,221288,119,79,229331,57563,171768
25d2d7ff567d42acfd79db618c89b087,44,39,47561,20669,26892,38,38,62537,20128,42409
6b2dad2510bc08acc8437d1b76da01a1,113,75,195653,33119,162534,100,80,162669,59401,103268
d8d002c97e1eeb02c38355e4d86a2bdc,142,95,360819,80603,280216,100,90,287054,85006,202048
b5e47fc860b6d1064546f505dda66807,44,42,59930,25440,34490,62,47,77749,22191,55558
6eb68672a1cfc9b213e0093038338531,74,55,87946,27859,60087,82,48,117893,18572,99321
e3fae9b505f1cb7651530b90664fb418,95,76,146155,40356,105799,111,78,194552,28511,166041
9a642f1538da61ffece73fc83d8943a3,111,95,324456,76640,247816,123,106,414426,72802,341624
55af824e6a574c0e2d34526a8bb8db17,74,58,96656,26333,70323,89,62,146795,21674,125121
1ea2b6549e54059aac90be3506570721,5,7,261,560,-299,5,4,604,105,499
a3fc2f7d689fdbe9b634de508de95d56,91,59,143700,33192,110508,103,74,158392,38388,120004
bf21993a60794129e4e62ccd4fded027,77,53,99913,26005,73908,26,29,27742,17161,10581
0fb10898239783f3396c5f187f1b9129,95,66,223028,50427,172601,131,98,244702,58470,186232
2bdfed49f601de59064aa98e185e218e,2,3,208,275,-67,3,2,275,208,67
aeca89790c1610cc86a74d9d426a7832,131,95,406026,71373,334653,165,104,384796,75138,309658
67f8f3eec4c2de0ceb7bf71c80f5df95,87,62,165337,36928,128409,101,77,174147,49016,125131
73a70efb5536d16de18a3e477ac09825,172,127,477019,108609,368410,190,132,542169,98098,444071
e6edf17c33ed26d03731a42667330f8f,47,37,37723,13653,24070,49,43,46357,16793,29564
c825785a46a375b43cc5296206144b00,50,39,46027,36782,9245,59,45,81632,21198,60434
6ef4a3440696d9614073653bf932d5e6,30,24,23138,13937,9201,30,26,33203,12979,20224
37abf6c3b431bf44554f48cd20d7ff04,124,79,168211,33999,134212,118,83,229747,30258,199489
236073d6972f0a599e0f1596fcd33a7f,155,128,576883,103256,473627,198,165,707487,87742,619745
17b2873c17192317f072f9bb69e4a3c2,68,54,129031,25692,103339,88,74,155053,27274,127779
33ae938e519414c41a4e62f4f3819ea1,68,57,123350,32899,90451,51,53,62566,36504,26062
2828fe5f117c3883b99a36a757676855,55,43,73574,23575,49999,55,51,71671,29235,42436
255af8f371e97d79cbaeb08c2b9365ce,60,55,62079,44220,17859,81,56,146030,32962,113068
ce0e0129ea59c36d5b632c4c27b0fd08,129,103,336333,52397,283936,143,102,363203,60467,302736
d38c26138e48bdff9b3f258850470ec0,145,119,567969,128049,439920,157,132,564955,102672,462283
273fc9ba938535073c5cb25c4637046f,27,15,5381,2346,3035,21,14,4210,2876,1334
c1867fd2a1d5571c72d90142c750b1ac,14,14,3153,1463,1690,14,12,3232,1572,1660
556a5dfd6a3b256816b2529ceeebb5b8,48,35,48885,15890,32995,50,31,39761,14495,25266
ae6dc4a7e3e64e5b2e3c008cc23a2fb4,73,56,142079,42757,99322,82,72,217720,44906,172814
b401888c8ec66df1bed381553910fca9,79,54,167697,55093,112604,112,84,277433,46969,230464
eef8d8bd8b3f8299ec159da8caedde9b,67,49,101534,46484,55050,130,77,205343,34644,170699
fcbfd8df790693cc49b9b6b5055c496a,35,24,38317,10314,28003,36,23,25408,10367,15041
0ecf3f9f1ba714ddc8a1c6c8a0b1ea9a,158,118,477968,104891,373077,163,128,579763,85777,493986
f5976d1dd7cfb7190532989b6f64d693,45,37,24035,12603,11432,57,39,39797,9154,30643
7813cd44a09625578767a49e0e2cf608,153,111,426751,128711,298040,150,104,399078,99272,299806
5ab2ed82fda5f1060618d1a550e7ebe2,74,49,148132,42884,105248,63,47,103010,44786,58224
ca5390b76fe4ce1155484427015dce29,134,100,511260,135535,375725,170,136,671524,178159,493365
d5fd77f5facf5a488e6632571e9784ff,142,128,446223,80646,365577,124,99,372533,96443,276090
a3928fa302e233b8a5a84b0dc2baa4cd,50,47,85592,41104,44488,58,46,101037,29577,71460
4beae3ad669b4ebda74cf110b5b36faa,29,22,29319,12311,17008,41,33,51881,14680,37201
1b9c1363f53198260ade04277a2c999c,97,64,143558,35438,108120,67,47,103647,28182,75465
bcafc8c8f8b299ec3d23a094c1ac9c4c,137,86,332292,55283,277009,121,88,298940,83448,215492
5965e308fca6bdd55e2932c7bc4f3a1d,74,47,111874,34659,77215,79,64,134163,37397,96766
0c75d2624da054ebee5cc5f9a2920f0a,142,107,327992,58405,269587,129,102,315243,74517,240726
49e03700983964924a16a1271033094a,84,67,125406,29808,95598,68,52,84278,18918,65360
28754657c7fcdb50004ec3a7af81ae9e,40,36,28239,16568,11671,53,39,49618,16457,33161
dd04ed648385ee2186330d962ebd0c7f,38,28,37710,10875,26835,33,28,20843,9802,11041
12fb0cceb38acdcaa471962140af0a72,177,130,598640,115341,483299,199,168,635368,87470,547898
7efabcb32f54713b39394a89dbd22a97,126,111,272554,79573,192981,119,97,279363,46697,232666
58cb0762f31d3159a2652f65f9f057cf,52,39,76252,26589,49663,69,45,72691,25148,47543
dacfcdee30591422411a03c19dc6c65d,109,81,268844,64927,203917,105,94,247866,56991,190875
7ca099a5a869f539a2e17e8e272fefbc,38,32,33492,16085,17407,40,32,47392,11922,35470
e0aaf839de41853ab1a13d6d335d2f0e,36,32,36003,22706,13297,49,37,64055,19688,44367
9487ddc7401d19bb89a9cc079432050f,17,11,3978,1388,2590,16,14,3102,1960,1142
20a800fa3214bca3899cc100452ee5bf,79,59,118319,35678,82641,78,59,124519,41050,83469
65b51bc4d0b91b280a65e5255dcca6a3,39,28,38672,13323,25349,48,42,69365,16062,53303
57ddfe1b0ea75b0241246efcafaada10,48,40,65852,26749,39103,55,46,79638,21923,57715
96eeffe8a39a651a28832bc176b0a431,23,25,11593,7093,4500,31,22,14820,5817,9003
215dbd78eb3f3e980b5ba161e4ade11a,49,39,52998,15455,37543,49,36,48445,15998,32447
5fb998308aae801900ac69394e815c84,51,39,84025,19295,64730,62,43,70632,27139,43493
77f9ca4e43ae902da722526d73f6bcab,41,32,23117,14209,8908,35,28,38450,10694,27756
88d1cdacf54ed7b2596c4e41c952dd0e,42,32,44450,16568,27882,59,32,72284,10586,61698
bcc39d496164a6790f7918d3c4ec84e4,18,16,10494,5978,4516,31,22,24692,6349,18343
fc65d7eb5e0b62d0c5173134dc6153f7,22,19,15547,6000,9547,26,20,18422,7188,11234
5efba98e7e0d6b6597aebf388e615806,31,23,39650,12689,26961,28,23,36440,15632,20808
8064b08b611b74e3efea7be23cff15f9,146,109,661577,136031,525546,155,107,416874,119776,297098
a1db505f713528296af9e6c2f8a308f1,117,84,296451,64187,232264,174,141,415261,71494,343767
fcb2bb2c40b4a22775141336e68b5504,86,68,201898,44560,157338,142,93,288548,52904,235644
ee3b893afddfe0ceb2c14e1c19bb4366,125,99,270811,52936,217875,121,96,212173,57243,154930
85d0aea4bf27c4f92fddba46e9661ff7,9,2,958,344,614,4,4,672,631,41
17b48d33978d290410f4327b2b93943c,102,91,264393,66485,197908,120,103,278682,60138,218544
e3f6035a389936b3ff4624a095a131d9,118,87,260174,49687,210487,153,112,328939,54353,274586
0f2d90377df34ca13118945b893bbd2a,28,18,9342,6938,2404,30,29,17037,6011,11026
06c4ab9ff45fc80ad597633e0f09077b,26,25,23259,6397,16862,32,28,25262,9919,15343
4f05d3220f8b0babfed82f7b33af7a26,19,20,5667,3747,1920,24,18,5948,3575,2373
408091e2438f8363daef2daaed1a75ad,100,87,172225,31615,140610,90,80,246080,57074,189006
866980d8cc3ee8f84b64ff46a3bbcf66,178,145,1043050,271426,771624,216,169,991878,196274,795604
e253c343a4af70a7a246ec4ad1c53e08,42,40,37330,13861,23469,40,32,29464,15600,13864
4a4aa1e468bf3e38c6c7f1570bc1bef1,162,141,1053436,201684,851752,197,137,941565,205163,736402
f12b3134d9ce1466f9ae12d078d04c21,86,68,170780,73965,96815,111,82,204815,77135,127680
395a52936348ee26c51300c5834e67c6,36,33,46265,21550,24715,58,39,48100,17710,30390
9e09eab29090b51500a19adff606274a,94,78,138289,23527,114762,75,61,94860,36726,58134
eb413613f416f3187e74f6b9fd6ac9c2,6,9,804,1098,-294,18,5,2658,553,2105
053ddea8ebb079bec82df91b42225116,53,44,81695,30123,51572,58,48,97896,27733,70163
e61489e70bd0499fe042a327caf0b507,143,103,280580,62112,218468,128,92,259882,41596,218286
583dda324ff316255abb43053123ed17,91,78,153935,43546,110389,114,90,193976,44526,149450
83fcdef2b7fb81c02a5b9c9abd2674f8,34,28,18727,11124,7603,38,25,31025,8106,22919
0bc9069f4456cf76ac04d91260816518,102,82,200886,26704,174182,130,105,229538,53695,175843
cf8397a988fc1d3c8583e1c90a077fec,161,123,554329,151530,402799,190,131,630009,104019,525990
b30936cba17773504759f69eee967fe3,23,20,6064,4184,1880,23,22,8472,4017,4455
f52532d2505d427ac52ec790ac186006,96,85,186565,47200,139365,140,111,265595,54418,211177
4d7ab43ef81093df38dc1e8954c9122e,188,139,718448,132138,586310,169,127,799129,132918,666211
46504829fd737a81f1c5c53ceb805145,92,91,213222,62091,151131,89,78,180862,51106,129756
91feeb4f0eee554eda429796b12e0fb2,71,54,91268,28802,62466,59,49,77878,25863,52015
730802b925c093e55abfb19e9c008425,89,73,147812,47879,99933,86,65,119987,40951,79036
0e0477ea43883e20aad931a62b509531,117,101,273604,73947,199657,123,98,305913,50096,255817
1afcbd6982989858e8e0e025fa5b9a20,148,120,622625,113579,509046,172,144,546264,168835,377429
199a3c0eda855c71bfa38c3bd379f4e2,43,32,31417,16218,15199,63,50,77842,16485,61357
6f09ed80c5a5ebf611418a6f51b1730d,41,26,36420,11927,24493,32,26,25191,13172,12019
88d397cf2b9b8afb4c83e5fd60f25010,55,42,102589,26866,75723,45,39,60603,31745,28858
f479f8c03344ddeac41bf335a588ed9e,31,25,17929,2996,14933,24,22,9185,4520,4665
48bbf77f45ca605f2d739a55d1f77845,18,9,4475,1516,2959,16,15,2996,1940,1056
85d5188b78e693e3b45dc400bb207154,65,46,74449,16242,58207,58,49,73346,18264,55082
c071c514907adb9250c3817778610f13,81,71,141498,51832,89666,100,84,174737,49699,125038
cc1ed873eefd1cd93d3b42a680e36fa4,20,16,4749,1548,3201,18,15,4055,2571,1484
209b6ee985d35205764e41ab9d17c350,30,29,13254,6560,6694,36,26,13634,7919,5715
62e5cd58c80aad4a333625a40c2e2776,113,88,281655,89305,192350,126,106,442620,80158,362462
63dedf8b41170d0c1c7e34ee60d62195,87,71,189528,47901,141627,142,126,380566,73976,306590
af4e89d8f43c95fb4f5e9b0b7069c97e,27,22,25749,13371,12378,34,31,33056,10472,22584
0155f374365f47f8c19c00c5104cde60,123,94,229562,71219,158343,154,114,315820,56941,258879
1d71a58cf89d9ee25e4e076f7b2376bd,67,62,134716,38703,96013,86,55,163470,31966,131504
136a68f71469aa7b21375bbc4e9394d8,48,37,64409,20695,43714,43,42,57651,21011,36640
09141c085dd21a11d15baa83a2168394,30,29,17521,6930,10591,30,29,18995,6915,12080
2e903e2eb8638c050997462bcae0c27a,108,83,192376,41746,150630,75,53,105658,52809,52849
b24181f7dce8edda20e8ac3bf35ff4a4,18,13,3927,1689,2238,14,12,2531,2239,292
067cdea18503c61c317cded14fd6ae04,2,2,634,372,262,4,5,500,720,-220
4632e5bc2d8aad538a13db60dd6682c9,60,52,84045,30660,53385,60,37,94438,27138,67300
2d0a1c187ef2f6468d371a2b8ad9a3c0,166,131,438819,81648,357171,143,120,300943,74042,226901
c8c3a6db61a5867678526a0e0bf15ff6,53,38,75934,18731,57203,47,37,40346,21361,18985
847bcfcfd41e5580aa441cec2bdf3030,26,21,13177,6849,6328,29,25,18792,8952,9840
05425779d2bf5b46a59e6deded1d69fb,97,72,292160,43380,248780,159,119,434680,80808,353872
81f0c65fb9a20cad76a660e387340784,18,17,7275,2566,4709,23,15,12118,3617,8501
ece76b2d5414112beefcd52b35557283,158,125,519097,66230,452867,159,118,440793,76932,363861
732a7979cc9f9e108c8f0a69659c0267,24,20,21119,7153,13966,27,23,16862,7897,8965
d76ea21b1f32982dad2ffe2316fa4e1e,27,22,25805,7698,18107,31,23,17784,12508,5276
22377e57647bce7049df727b0fe5d4a9,19,14,5164,3073,2091,22,17,8514,2110,6404
9cd6f8198ee207ff087ca4eec60abe52,148,97,493924,138020,355904,207,166,839519,142985,696534
337268d02e840cdbd931d11230e8667e,71,43,100508,20886,79622,49,41,77542,19408,58134
e34c81a9a1789fdd25ae52e2a40464bf,54,42,74490,14876,59614,76,63,82216,25840,56376
5fbf3055226c62cd20beaf8835a1c285,118,81,205684,26652,179032,97,60,152548,40095,112453
9e8adf597ee8db5053f7bd57fa192c41,141,106,318338,63131,255207,100,78,224423,49279,175144
ee3512f2ce25beb07dedc6c8559696c6,149,111,323384,51728,271656,147,122,374594,51644,322950
a572caf859f979b752048218e0aa6470,73,62,110723,38388,72335,82,58,121361,30334,91027
77f47b8f53ea86442be9fbac8c990017,90,73,244547,34819,209728,122,98,271018,54625,216393
19c1306781e3cb602c9cf1eb512dfeab,171,130,441062,67873,373189,164,132,416813,98524,318289
24a2a75980ba92be45a7fae6b63bd772,20,18,7779,5938,1841,25,17,10553,4940,5613
bc90d4c82cb1e0921d1b8780c993b083,64,55,159929,50581,109348,95,81,168025,40638,127387
552282c356056bd443f72aa0962d0ff8,60,49,92793,19809,72984,55,42,57886,19836,38050
f7b48ef09d6da68466c626bcef43c49a,71,57,142401,46362,96039,75,61,161690,54160,107530
a922876a5b929b7170538c6c71ce6a63,58,51,75432,21008,54424,66,50,91783,22341,69442
88cd90b10f94a4ff50ab5d8cec514acd,147,105,301450,37774,263676,129,108,311693,63464,248229
055848d9d2fc771f84b5c8580a52e47a,150,123,451349,78845,372504,141,96,467352,57425,409927
efd4e1a35071673dda77999a77c1168e,132,80,503242,140128,363114,195,132,612697,139126,473571
699d0ad36b32cf4d4a6fb5eccfc4b719,18,14,3189,2369,820,17,12,3082,1894,1188
f165f4cb9b0d440a869993b6d72f78e0,58,42,75275,41831,33444,75,65,154970,43472,111498
d18bae3bd1143decbad6c64399d69b5c,80,56,87902,24965,62937,94,81,103698,24127,79571
224960eb5b9aad1ef9a4e6679fa94acb,23,18,12557,3202,9355,25,16,7093,4498,2595
11038e527c5e3aff2e96fea2eade9163,165,131,619542,137662,481880,189,126,666352,106794,559558
877f371e9f4bb84d86f0aa3ffcc00a93,22,20,10478,4622,5856,33,26,18673,5507,13166
945a0cde319328a7fe1376b36f64603d,83,71,124254,43756,80498,115,95,173424,46049,127375
ee33f660338ad85693fc196b79987a7c,61,36,87523,15959,71564,55,47,68417,20272,48145
855a648bcd6276038d318217d63d0613,116,91,222426,47913,174513,124,103,238797,68176,170621
5382b2f44e391e648d89dd4bb06c453d,36,29,27020,7941,19079,41,34,29790,7430,22360
711312edc08c6022f1e9225a542418a1,30,23,46832,7366,39466,22,20,21705,15649,6056
45cec2816135d0cc93a0a415800a30a2,40,33,21879,9402,12477,41,31,24187,9139,15048
de525765126660a5521c1b25405b2e18,25,23,17212,6686,10526,40,31,26672,8417,18255
1557ad27e478ba356cebcf738862e89a,44,34,34003,6596,27407,34,29,27725,6986,20739
951db5258d8954c2e11dad5983d06850,2,1,311,397,-86,1,3,397,392,5
5108f9d3e4270908f0e63af37cf86ccb,103,76,200875,51474,149401,133,98,296867,47268,249599
4999b30a392c9b7108fa04de9ee51501,55,36,63962,24789,39173,63,54,92712,25625,67087
ddfb3c06172d18f486450b97c4570d40,53,49,52264,18654,33610,61,51,61281,16000,45281
f0a73bb8b91fb02236acdec28f3468e7,174,136,463060,85592,377468,137,117,283239,87120,196119
1b472f81e3258c55d61308c8cdc3a086,128,91,305379,52807,252572,157,136,439208,71165,368043
0aec8b6e5f77059823b665ebccea25db,40,35,74723,25044,49679,53,38,72890,29210,43680
abc2209c53892ea1f129e2cebeb4ee69,38,32,32975,18530,14445,62,53,87006,21816,65190
7223604f30c37a0421f95b736ccd311d,66,48,115095,32616,82479,100,79,144412,38138,106274
9fdf374c28347b3451b5e86ef3834436,2,3,166,463,-297,3,2,463,166,297
82c011750c8736b134365709cb498c4e,59,48,93618,38586,55032,58,49,87920,33428,54492
380e5b0e0f7670d9a2e1025a56010d14,211,158,727403,141273,586130,161,116,580212,113825,466387
32e4b3011793e4f53a0060b106955784,73,59,126179,32753,93426,59,55,79336,47604,31732
484a06ddc85c8a8fa50af316befa3273,145,123,541133,101780,439353,149,115,489330,121665,367665
9486887cc5ab40803667caa79f14aec9,68,53,81881,19668,62213,61,46,73922,16910,57012
411ca9c50e8b4ca9b2ce9c983f0badca,53,44,87200,28298,58902,58,42,81028,19947,61081
b775d0bac4e007163c063e9e09d2cf7a,32,30,33871,9897,23974,43,32,43505,10663,32842
9721bc0887187df3fc4ad9b3ddba4b6d,59,41,67876,13690,54186,66,56,89282,15810,73472
7f9bbfd06e1f8e05f663504d9a63163d,111,89,257210,74797,182413,111,93,192813,49289,143524
eb92e2e54443bbb7a97fce0b05d82f0c,48,34,87384,37149,50235,62,48,93832,25658,68174
894c6d81093a8e00e2b1614615d0d805,132,107,320622,50663,269959,119,87,285452,43337,242115
6c183e445f9d065511b35f92a4d416be,20,15,9494,4114,5380,21,17,10505,3823,6682
36fb4969a94d0b333036d46a582363b2,107,81,212126,69530,142596,95,59,164319,71517,92802
8a31f7b66134886e9401f3d988324706,81,64,81482,18186,63296,74,65,99519,26471,73048
09f0a54090fbf749125c210455939070,30,24,23469,7104,16365,37,35,30483,9624,20859
f1a6b74726edc5b18fbd1e1ceef669b7,107,81,224391,64226,160165,145,114,294479,67398,227081
3ad18b77bf7be8ad7aa4be4904eadef6,19,17,7264,2417,4847,21,11,8930,3020,5910
141256f6c854ddea2b721d80af480bf1,139,93,260926,102665,158261,78,65,183090,80790,102300
c049f6bc3c66c9c4d29bfd57fd89bf8a,96,86,228625,61605,167020,110,87,203225,74473,128752
d8c1152fda55aa01d452dbd8f6db52c3,23,12,8894,2850,6044,23,18,7121,4034,3087
4a6d02132e726a085a9f0067e05627d5,37,21,25664,6914,18750,33,28,25128,8042,17086
654a854fe2444d98c9f7b0ea6cb94f89,185,113,562482,87586,474896,158,120,458169,100355,357814
de0c0fc45d1c4186cf46b9c3b672ccce,108,86,118426,45785,72641,91,84,150723,36067,114656
216510c7770f53c9b85384f14725ba06,170,111,413155,56519,356636,158,110,444027,69228,374799
cbfcbffa10ede2199a95daab090d088f,56,52,60620,22111,38509,70,45,75619,18478,57141
82f827b9bafac0370f4517d997a16913,60,39,72511,30529,41982,66,63,101299,28815,72484
8abfff99f10f39ff8cc1f42c91567694,80,58,152461,34442,118019,75,67,110201,53331,56870
b5a58a7920dfe849bd04464dd588e7cb,182,120,609897,115609,494288,194,145,703198,160935,542263
7244b155d071525e2bf19ee2461a850d,111,94,235938,56919,179019,85,69,167809,68172,99637
6b92dd6a6f20196e61761c5260248188,120,82,265974,74747,191227,142,112,314642,83238,231404
190d85eeb7ed8b9f412e52c0f29f4342,207,147,886208,215579,670629,175,134,769137,252346,516791
d3403c81e0f7d2d7fce78f14ec064020,71,58,107527,25608,81919,76,60,88284,30117,58167
b785c1f71bc30b4971fd69802ed9b512,58,61,86152,37138,49014,56,35,91792,21492,70300
163114c49b097598aaea7779267c90d1,150,113,549406,136628,412778,187,143,591219,133317,457902
a20bdbdfc4e05d7217b8cd87973da11a,96,74,167774,35349,132425,72,51,90979,43525,47454
2263c9fab0cc330092a1caf1e8c7ea95,39,34,50364,14700,35664,47,40,40192,19044,21148
bd12ee49960b5fb1374259d8dc995271,148,114,460405,97353,363052,153,113,411984,123789,288195
a41dec26e5452f3e2a077b279bce9200,71,60,99589,26233,73356,49,41,58731,19302,39429
008dcdac7228b3a7a55c352027a067b1,85,59,88752,27394,61358,65,47,97713,33982,63731
c86c9e0104ebe53032c37cc08017844a,94,65,178246,39601,138645,90,65,117693,40582,77111
fef7df422d295f20ffb4bb84f41f78b6,114,95,220965,44629,176336,141,104,349360,48767,300593
f748b07204e9161f799c93935c9c27ff,82,72,116999,36129,80870,74,58,75702,33924,41778
3cd1930cf87f2ca50f40435f2e308501,212,119,496135,89746,406389,126,80,315658,97063,218595
64eca1bd54b9425a4bce6edd41c2d54e,97,72,156538,37704,118834,88,70,163673,38818,124855
7983de1d081927234126ca516a22e415,64,52,90488,29638,60850,76,64,140951,35751,105200
dbef300a0410c71031b3bd30fc9f5179,50,44,58775,21634,37141,56,48,78440,17552,60888
16a11e2fa806a24af47b410b17c2beaa,148,114,262721,56565,206156,117,89,289828,69635,220193
30ec0880fda5db2b8f3e1c01726caa36,1,0,148,0,148,0,1,0,148,-148
ee4de5d88f5b1fc5a3d9448d77ad8e63,172,130,585449,122049,463400,174,137,615041,138357,476684
aa23165f53a7942dbd5b8e2d4ecfc83d,84,63,116844,40833,76011,134,100,205858,25821,180037
f11395b49cc96fccc089ce23e6c6de0b,102,82,263531,87233,176298,114,100,298410,94721,203689
4e5790ae050f31bc7b9ea117434b40d9,59,39,108299,29453,78846,64,45,103615,29992,73623
817b600fe02feacefd81e28ec3440a5d,131,116,417090,120242,296848,144,117,534732,99508,435224
58facd3a6ed4550a7db47344a71e963f,84,59,127716,28729,98987,103,76,182586,40679,141907
82cd3f3e119b327e429a56b038718dd3,90,72,191814,52633,139181,118,91,294644,55752,238892
272349a94064a7a1818b5c7ec70de035,60,46,61952,17291,44661,55,37,49210,12077,37133
3c440d7418c95c062765dc0a6ae1857b,58,44,72654,18963,53691,54,44,61593,23235,38358
9d1c50516919aabbcf6e2a1f628f30af,160,106,393317,116141,277176,147,111,469208,120642,348566
595fc654afd39ff50b546699ec4fb750,174,137,436103,95068,341035,136,114,337470,111060,226410
e1d579f5dc45c515a3825db27305ffcf,155,110,360133,55741,304392,114,92,258212,50113,208099
03fb83abe724371485474bda397d8f1a,72,67,148278,39248,109030,94,71,196422,47817,148605
c8a7eb3ec7884a936dc01233805aa11b,3,2,105,350,-245,3,4,422,177,245
a87e5d2191a38fab4cded568a63e0b8a,50,40,52371,14811,37560,53,35,43633,13252,30381
269b8857963673a51b1f281dc7d0f5eb,144,94,357448,100133,257315,103,80,255684,70602,185082
7d5f9c59f67681b27f8106ad64ada524,58,37,71248,16784,54464,48,39,45153,24822,20331
0e7a31f7b821138003b43a97c8312d79,68,54,133716,42206,91510,71,55,134118,36686,97432
9bcc32fea6be0f41ec625527a01e0f10,73,68,104936,24214,80722,73,56,87913,26954,60959
33d3b0611e9434a422230f82592fc040,118,93,330258,73922,256336,177,130,565768,51613,514155
8d36724b3df0be28c6279b0bf71a64b0,92,78,149863,49019,100844,76,64,132142,31344,100798
92ac8a5e947445b85546a5c65befd307,96,76,225090,79427,145663,132,121,341009,68705,272304
a29d5252d6f0e34c1266706644a6d46c,92,67,164734,34432,130302,108,86,192074,40226,151848
88780e5ce33a3c715215360a796118b1,150,115,414704,72673,342031,131,105,340177,73365,266812
9e4d64c26c63aadc3ccf4025d69aeabd,84,53,125848,27229,98619,110,84,155041,46158,108883
a0dc99aefb7122adf92d6c8e928205fb,30,27,22575,8075,14500,26,18,15485,6052,9433
ab53e4ed838ca88d1ace066ff33748a2,51,47,38730,20563,18167,48,40,44661,14210,30451
9e1ba239b93b4ed57d811a1a0894c74d,112,99,211211,68027,143184,130,109,238752,67368,171384
e1223ab586be187a384022d066f6f693,82,58,149599,31849,117750,70,47,104159,36244,67915
886d8c423feca0fad32ceb32e821d96a,124,93,243539,81781,161758,174,128,371154,70869,300285
4fb4f8d042c362494cf0d2a079ea36e1,27,24,20166,9085,11081,27,23,19185,7181,12004
a9f43f5aa8977b0167a664ffd41c7aba,32,22,31404,4057,27347,32,31,25725,7851,17874
0bb7318118adef384e9f8e4d5c735548,16,11,4008,1518,2490,19,14,4681,2023,2658
d19f0471c00138c044ea46aef73af9f4,103,81,314118,81547,232571,182,134,624809,66066,558743
2f39ece03db5d9937b3a1c6d7153fae3,33,26,24616,11322,13294,35,25,21212,7899,13313
8213c5d14eca97f29c7de43e15f33ef2,50,37,46443,10978,35465,41,35,31633,13210,18423
a6f8da0a81d726ecf9f214022d4d4994,106,87,239969,84547,155422,146,106,413298,58663,354635
da782bec9279f8c6acdd1220b220c050,132,108,235233,50958,184275,87,69,133146,43735,89411
2c05d27e50e67909ea5af46e0b5e1e92,168,112,533585,112259,421326,225,158,720042,156339,563703
b0acd295539a07f3c9810fb784cd44b9,133,83,438242,56863,381379,164,137,416873,94350,322523
1cc171d27e8937699223a66d69e965ff,43,29,47949,11715,36234,34,36,27863,10096,17767
df7ad6c0ecc1e99b6285369d3bd16bc4,145,109,484807,126434,358373,140,106,449864,150517,299347
a53370edbddf70a8839a8c9b5d5c9968,69,46,129938,38851,91087,99,83,216491,46204,170287
ec58cf1206a70f27943aeda5a5b74957,168,125,586528,128301,458227,221,154,856099,173325,682774
9570ebeb2023a0f199a76cd8b6626a3c,11,6,1453,1167,286,9,9,1561,1175,386
a774c7b1b1fd55bc6b93e6f93ef382a1,24,17,7939,3515,4424,22,18,5779,4118,1661
6fe1da9bf075cf220516aa27f0f9996c,73,60,151579,46320,105259,79,72,196413,62763,133650
c55d44aab54ee8f4e1722c7cfa1ea7a9,69,45,106194,25945,80249,63,40,86636,23410,63226
edbbd5cb0a6d46ab8b4c5d7b7900527f,135,101,286515,54733,231782,105,88,227780,66937,160843
41a8dd4301e915bf73a46a4de04e4d01,180,116,539658,111515,428143,136,106,460221,83384,376837
71ecfa49f4bb3960d182a920eec877cd,58,46,42065,14131,27934,47,39,46072,15726,30346
931b94740e6e5c6ce58aa715a4ff2eaa,97,70,324740,120162,204578,172,169,487718,156072,331646
3048a1e87debf51615927464e57a8b8b,58,40,56513,19353,37160,62,50,69002,19048,49954
e28fa0c3aa792455bd17bb6d7becbc67,56,50,86885,28298,58587,49,42,78179,23731,54448
2ec30fa9413ce0e69d52fe66a69e9f33,85,80,136031,72933,63098,108,88,259400,54069,205331
037d357705f1922f8849fc6f51b38634,126,103,457092,155056,302036,161,116,438120,122723,315397
1846b35f036dfbf27c943da32d173ea3,62,48,99723,27962,71761,65,57,82503,28062,54441
f1cb37e7e22262ba6d79b6f58ce8aae6,91,81,153213,41030,112183,64,54,98289,44461,53828
b6bb7613543d6c74d1030736c5602cb4,188,99,417043,99637,317406,155,101,335766,111558,224208
94604bf46c75baf12b1d0c84a99ceb11,105,80,167740,40455,127285,107,81,201019,40362,160657
157407ad26c89532cfee8bfe2ad9d69c,131,98,289881,78632,211249,116,112,272815,98660,174155
798035ee0a9939d2309ac2630080a9e5,152,123,384377,116251,268126,118,85,295796,133660,162136
7ce775233d3fbc2db2594d7f7dadfbb2,62,54,66497,20441,46056,56,39,48422,19527,28895
ed1217069e6a26f08b4d114a47958125,140,111,338378,54895,283483,128,107,341575,51373,290202
1b95073c21b823321cb5114f4bb40650,221,157,831105,180854,650251,177,134,705742,116791,588951
d286772eb932fdbb288420067da9a75f,112,61,202735,53856,148879,124,85,221439,87407,134032
c1f32f8e3447c6e2f75a514d59b65eeb,155,127,435479,68855,366624,126,93,323060,63976,259084
c53a9237265e30078a36294b7097cd77,46,36,49706,24750,24956,68,45,87339,22019,65320
7cec6b589abaea372afc8ae90f4d6a9b,87,77,179521,44331,135190,136,108,340683,59837,280846
c7d8941a5518ffe708fa0925bd1080ee,139,114,403415,80178,323237,102,86,262923,63774,199149
2b669f0edd658642114035e1e37907aa,159,106,394230,80008,314222,146,122,363615,64792,298823
a9e468d891b328f7eacd5ac52cb7955f,30,23,10899,4405,6494,24,20,10706,4326,6380
bd220517714eaa6b63ef4e087cb3828f,27,20,12751,5788,6963,27,19,21713,4997,16716
072239189af751721557e24f475a87fd,145,131,541782,109222,432560,193,140,557079,112950,444129
9115c629eb94a658f2e066bd6caae1c0,50,41,80976,20222,60754,63,46,126516,26975,99541
383b3f8d254e028f7af4a9bf52a109ac,129,89,421880,83055,338825,127,101,352770,88633,264137
ea0eb61cacff8fc33b1729d6efc5260e,25,27,9183,3217,5966,24,15,10512,2311,8201
1cb692624daa67befa684deb55a4a7c8,179,111,327501,102770,224731,201,106,384032,83303,300729
966b9311e5f4ddc28de563e5707eaaeb,144,136,351863,69254,282609,131,118,324483,83833,240650
666ce31d975ece0415e72c021f6122b9,43,38,51473,21477,29996,47,34,52123,15123,37000
15e6208a2aed40db716f1b1a1cbc0d21,199,131,596968,127332,469636,225,121,571285,125530,445755
5a0da22a1305a798550bd0cff384ec6f,121,92,286473,59790,226683,136,103,401280,80200,321080
a783eb83136bd79a4316346436834cf5,148,104,408929,78816,330113,170,144,470801,101018,369783
5f0ae9c03a4cacb895cbf83d52d02b33,101,81,180603,43545,137058,111,96,218085,33513,184572
08b5409b83f84068e4abfc1b7a29cc24,114,81,235404,95476,139928,165,107,410984,81607,329377
9c438ff8486d8fce2525f151f081230e,33,23,14571,8491,6080,32,28,14441,7290,7151
c31d59dbe8977753eb089ab28eb1f121,179,125,565020,118370,446650,170,127,748271,133632,614639
2c79ee324fb904d5d2c571126199a6e6,124,86,327218,52994,274224,120,101,302247,61532,240715
a9dca8665596160a6ae965718e4e5375,58,41,69021,27950,41071,79,57,98442,32842,65600
8c46fc731f480d3e33fbb6cce60399c2,162,106,365454,86374,279080,127,100,303345,71026,232319
37f24f9b82249b9f428e7a5ec60239a1,63,45,70749,23081,47668,80,65,110539,24131,86408
c01bb22d170fc7674ed289104715722d,96,63,176711,31864,144847,94,85,129175,55027,74148
7794122e01374c8c118fc62ec07c8621,156,124,544031,113737,430294,164,108,472851,134641,338210
767875e05edc5f3ccd0231cf81b81583,57,36,76748,17939,58809,41,38,43313,17624,25689
86f8df40342d30cbacfa72982c2744df,55,48,80450,22919,57531,64,59,92066,27272,64794
c95c0986ff71aeeb61b80d3fa662373f,156,112,670043,124648,545395,216,152,676168,182760,493408
90279a738dcd27f37e17a7cbbc57746a,85,61,116528,41656,74872,72,62,119275,26989,92286
0fccb928b50ae58d077ec20829d05a8b,85,57,139639,34233,105406,109,80,174301,34952,139349
96c64f5abc8e2edf3e1e0d168006af76,53,56,55212,24434,30778,47,41,43149,15641,27508
c23c84ff5a9efa25a293122d53882d20,162,97,506935,95406,411529,195,154,628900,137026,491874
5a83e8ad52febab76eee3ccdf8b256ea,100,80,199804,48219,151585,143,105,327552,47872,279680
9c4da7a8e2e7a8acaff10699a924fdf9,25,22,9625,5820,3805,26,28,12698,6211,6487
b1399173dbcdf6fb80ff68f7c68aedb9,77,53,102879,19802,83077,91,75,122494,46293,76201
031cfdf8f0dfc8e5d0940b780f480e12,44,33,43415,20853,22562,59,43,79644,25932,53712
26eaf490bcbdd57e34106af8570faccd,88,65,142281,43411,98870,101,62,138572,32699,105873
8e2f617cf9ade99c90cbdccde0bc7b3c,110,86,273602,95287,178315,155,122,414703,82959,331744
d1cef82120917e1824ae7669d53b73ee,4,1,168,73,95,4,5,150,111,39
c42bf725e436f5eedf4f7ee4d111f06b,226,151,1003853,162561,841292,212,153,781313,122957,658356
4081d3f67c56af72e3798983bebaf99f,79,72,119273,42312,76961,91,62,160920,25122,135798
8372a8e8ec35b48eab56cc3228677ba2,96,105,181794,52673,129121,114,101,258971,51154,207817
fa4d8096034fdc62a72a3184d1bf6b77,68,51,78143,24322,53821,58,57,68440,20638,47802
9d8d18fe41c258edee3c42457b7f5257,18,13,5950,2110,3840,17,15,4784,2926,1858
db7ac281b47d906a3178acc9d75fe18e,24,14,8439,1754,6685,24,18,6866,3428,3438
9e6303183db2f228b852be06c324c88e,36,22,35407,12528,22879,33,27,42022,14549,27473
8e17f962dec971c2513596cf75ced2b7,111,95,481258,156350,324908,193,153,670666,101134,569532
75ebb0e9c31ceb5198e9414d7608c91b,98,73,210934,37785,173149,132,101,276471,40758,235713
80e1fc7cd05e0361bec9a26f38ebaea5,13,9,2083,950,1133,14,14,2288,818,1470
f21183f88a8fd6a8a66f78176bfad3e3,196,117,607171,76837,530334,164,105,450562,115982,334580
e1df8aec387ed60afb16a09e35399f0e,107,91,196574,43484,153090,116,91,187961,45429,142532
24df90a6bb90f8c918763947b0d7623d,117,96,336863,84285,252578,115,96,291892,90721,201171
50dc5415c3977f54d610671114875223,105,84,217257,47946,169311,62,55,82311,68178,14133
7bcbe2fb8b91f5401068e34fa1791d15,114,78,326240,73461,252779,164,115,400451,72623,327828
196e60078fffd769814311b35db0d13b,31,28,10741,6037,4704,30,22,7847,4717,3130
1d3dbfd2269df6b7590e2d13d326facb,105,86,190712,57804,132908,111,92,251152,59274,191878
debfb6b14cfe946abf67c900175af5e3,193,116,488479,114047,374432,219,173,600677,141413,459264
4dd2c710ace81a0218065d8d781b7889,160,122,489584,96815,392769,215,175,800271,93340,706931
3d6b51273a7fa2988d82eb1f6c6a2b8e,92,82,117577,33747,83830,75,64,95318,27501,67817
1f8918eb7c0bc107407d1882c44926b8,47,37,67899,28117,39782,62,46,115328,27103,88225
0a5bea90fbdde4c1c1a2f8e17237ec7e,51,44,47336,13430,33906,36,33,33081,13580,19501
2de771ffaef7b10e49da4a3adf110d42,84,58,143677,47081,96596,78,77,141429,49133,92296
07902563868734be932187dc90b915ba,193,140,657918,84512,573406,171,132,652174,118766,533408
457bd5d33d22919c36f6ba6d1c79e0b7,33,21,34093,11024,23069,40,31,33402,15566,17836
a377c5394d183fd29945fc47edb7d2a9,143,103,368786,71250,297536,128,114,324282,71909,252373
3c7ff6059668582da4b8bb88c777c8c2,38,22,25212,5794,19418,26,34,18332,8787,9545
4f0c69dd65712bdca9785eba9f91c700,69,67,113559,38143,75416,77,59,89515,20026,69489
c5fdb0593af2c1b2eebe43c2bf53a329,122,100,270513,83398,187115,149,107,327815,69690,258125
287d5e61907fc955e2f769d38670cd79,84,64,132905,51229,81676,109,73,168831,58353,110478
e43e4db3133aa23eb1ccfb265bb7d616,124,94,354544,89360,265184,128,95,389319,71675,317644
c65648d930300d98ae88456bac2b3d69,161,115,596458,145401,451057,234,162,912033,129939,782094
9ce24d1fb58ff86fbd6338c7fea056ea,89,59,126380,40620,85760,108,86,164549,39205,125344
c8014d2aa56e3df55a8019af9b5099be,61,50,78531,22529,56002,89,84,113158,41685,71473
e0ac088a7b0245d167a6d80a000f2639,77,60,172180,64277,107903,104,91,286597,67497,219100
2e33af94cab4f60786980fb8725ed8f5,71,65,117779,34752,83027,56,47,85908,27972,57936
a479e49c2d93ac2d89a1336690848978,103,85,191357,39987,151370,71,63,111634,41597,70037
10767100a6a7721a824a55784f6f0284,132,96,258727,69765,188962,102,82,266996,57845,209151
83e0826aa7f7020d8cb2da0437de4265,63,47,92380,22310,70070,59,44,83758,26619,57139
191dd102b559b94d1a1ea756594ebf53,98,76,211590,80042,131548,160,146,401841,88801,313040
121342c452f2c4ae434c30995cc6033f,114,89,189247,56976,132271,121,84,228099,46446,181653
025706cb5a8832c3cbdf0abec101aea5,43,30,52452,14629,37823,38,26,46039,16143,29896
2375c44d20b9adff0248a4a6d76d852c,90,87,140928,45484,95444,90,71,147646,40660,106986
d3917b94b6f20c88a3994a104993886d,24,20,9088,5156,3932,21,16,8861,2873,5988
0b7663d633e870ea8143a26cd5c363ed,93,80,112167,33224,78943,112,85,167622,31891,135731
1f7316271b3c2bb594b2fa6289d2d376,38,30,31991,15205,16786,35,36,38438,14899,23539
e7dd92b8a29b76858cee6c268a91f3d1,81,62,120359,30141,90218,76,51,89181,32849,56332
39612b13f1e78310ed4e751307f7975e,177,127,521961,132130,389831,112,78,404720,78660,326060
cd38dd320b88971f02246272aff4aad9,35,30,29672,12073,17599,38,29,30185,11534,18651
2ed21277bab79f1af66a04e7f60d51f9,15,12,2327,856,1471,10,9,2076,1098,978
7e930d8c6fe0a58e7bda9581c26784a6,5,3,932,104,828,3,3,850,48,802
0455a739194c7ae2b0b0f529a90c5d72,22,18,12991,6591,6400,24,16,14881,4104,10777
46db72184507a1bbbb399ba7e769ae64,7,6,773,285,488,12,4,1034,471,563
fe72c91951ff8a135d3e19b35c1583b5,177,119,521887,87594,434293,134,83,310915,89651,221264
aced12747566ad17e0681f09b5e6c56e,47,34,64905,19313,45592,71,55,85470,22846,62624
98ec6bf8474aa9ac84caad7e4c6ad19c,49,40,86750,26469,60281,55,45,69595,27564,42031
62a05540c21123ee199b29b0c092a8ed,71,47,98662,20268,78394,43,28,53010,17422,35588
90808b84fdb380eb440021fe501521f4,26,25,13999,6237,7762,26,21,14538,5947,8591
c37b42042845b3fcedf2cbf825f17a56,47,42,91700,37133,54567,98,71,155462,33880,121582
bcd053eb460d4ae0bbf20e9f2f23d936,190,120,685941,118704,567237,146,100,666612,93196,573416
6018c10d53f7c0517fe478f5cfb55077,140,86,358263,63905,294358,152,112,399513,84185,315328
fe435e5a638c3a028315084286228e1a,134,115,276983,60688,216295,125,107,313433,60842,252591
0ddea6a915d74296f133f7ff6f7856ee,121,84,263621,49352,214269,101,69,199359,62972,136387
230d533c8ee184949b0cd41a1d0ddd03,175,146,547190,115705,431485,166,127,764224,107701,656523
b3f75ad02f3db01f04cb51a91179039a,90,74,122397,30941,91456,77,54,86307,30084,56223
9a325a38ec3c30690fad6f690d9e854d,66,53,92405,21771,70634,41,31,55174,18074,37100
3ed9a0ecd93336382cda92f55af86c89,104,86,173661,80972,92689,128,106,287654,72251,215403
e845765a05c2f450cbb5999a8acbd708,157,106,464612,119985,344627,168,124,524177,134835,389342
88919d4554cfdfdc200e3fd17662069b,119,88,322371,67299,255072,136,107,342163,85159,257004
68dbb7c1e12555c2f7c8e72bb5945538,58,37,60066,14301,45765,80,56,87815,19545,68270
ddea7c8b1737ba53cf00243ed3d2ea80,78,66,173208,45462,127746,111,98,222361,52341,170020
bfc54f6aefc36275aa45d3f9d8e740f8,111,88,198076,49795,148281,107,88,207464,51194,156270
4264dc59f0770b0bb6a9daa04b3284b8,42,28,48298,9383,38915,35,28,20997,15355,5642
e6610ce7f73248a9dc66e4242c551aa9,155,127,483040,160332,322708,155,112,733630,129925,603705
a5a18b55f685ff6de445f6207e4a459c,121,86,296719,65356,231363,141,123,369267,66450,302817
2a86832711f16f8aa2acb7b7376e11f9,47,27,49793,9267,40526,41,25,28814,12456,16358
37f286558bcf4f76aeb81b0a2160e018,151,126,437367,76371,360996,157,111,566286,85353,480933
af4051a2b3fcec65e46f61073f092377,21,14,6566,3234,3332,20,19,5248,3742,1506
eea5775ac4922d22cc25321296fd220d,175,123,520632,68576,452056,178,133,435781,91870,343911
365704d8c91f82b93f1d49817dc9c260,55,41,38171,13759,24412,64,53,84608,15675,68933
65b355b2a1ae6597200cccd4411f9dc0,15,13,3630,1628,2002,16,12,3280,1926,1354
1e68ed80460607364a9cf74751c6df09,59,56,103009,29859,73150,70,54,96757,27553,69204
d34c82c268ed8f465aa4048559a42358,74,57,98719,32934,65785,88,59,121973,30239,91734
0388cef8e3bac092332bd654d43fde07,112,84,240627,40033,200594,125,90,254094,42691,211403
6fd0a47cde835dfa724edc492d20e767,65,53,118358,49426,68932,95,62,188815,35273,153542
6240478bfef365d8af1453f0cbef5123,109,71,175290,39919,135371,102,72,194757,49447,145310
fcb6cebf048b563a40d6ae6065e87c2d,183,142,797227,137363,659864,190,151,759056,109403,649653
18af4eae84ee036a523b4671cf1f31d2,49,40,60204,25483,34721,46,41,68912,20258,48654
6e45e29384631f29494ad61d660c16d7,51,43,63719,16606,47113,58,50,65998,27007,38991
7b759812807922a89445fa223fff65d6,24,18,10630,4601,6029,24,18,15002,3454,11548
939d9ae09683503c82d21a4eb345233f,111,75,358837,80355,278482,193,153,408705,104402,304303
0c164114e3902d8178f612bbe06296fb,107,85,272876,93174,179702,120,98,319351,96524,222827
ee4b6e792134c98791057219eb749f1a,47,29,50612,21861,28751,54,42,75883,27674,48209
47d7bf123d8158a3c50a85dbd74c5775,54,31,69984,22059,47925,42,36,71228,28629,42599
ca9eeeb37027e327591f14621cece813,26,21,17408,8515,8893,45,34,41007,8410,32597
21b60f032564ee7485ecb8060da38c20,41,30,36819,14319,22500,40,29,32923,14172,18751
aafe6b289cf01bcc93b5892ae5c003a8,183,136,739835,139128,600707,191,137,752762,156576,596186
179e741de2e14ad5b93825418d9dce64,77,63,97883,35099,62784,86,62,138868,27632,111236
f74ad19e51d1c4746b848abf69aad638,97,87,188389,44333,144056,100,69,144331,29399,114932
b293ad8d050309705de0eb6f1938ca7c,11,11,3014,1549,1465,19,10,3010,955,2055
8d3cc41c3ecdfa28b8efbc067e712052,37,32,25298,7475,17823,37,28,26371,8290,18081
59bbbeff52f63ef06c61a55a01cbe55b,110,83,201389,48522,152867,81,67,156235,50381,105854
fffad4da0ea8e162664175bb7219254d,61,47,86187,24482,61705,48,40,60993,16792,44201
9f752bca3b07e1864a933b5961d775cf,164,122,581790,112919,468871,192,137,652021,115548,536473
c7e7f7e9edd3b963b1dc616858ab46ad,12,13,3727,1110,2617,14,11,2570,2939,-369
802a66ddce7303e70657a48101121e56,21,19,14902,7031,7871,26,21,20002,7600,12402
50eb056aa9fe8174988523930e31c851,157,114,643946,148534,495412,171,141,752387,140519,611868
ed3537e406345e9fb1f3f1915bfb14fb,153,115,582450,152383,430067,197,175,656496,144056,512440
49b2c210d9bb0da10fab94eb515c5e70,26,22,8024,3689,4335,25,21,6643,3571,3072
ac9f451673c847107e0e859721a5aa7a,53,47,71962,36032,35930,82,69,118540,39168,79372
8b224626d00d71937c9b206e26ee28c4,126,108,259688,53425,206263,105,78,227431,58128,169303
596a17ccce351cc92dff0322d5933fc0,89,71,162948,25182,137766,80,62,84763,29177,55586
c8b6babff48ed95f860455f3feadeb5b,204,132,1060146,153422,906724,253,155,915648,204639,711009
3fc781f64ce0f5be9277e60f2bdbefc1,125,96,465125,168863,296262,212,154,805395,165743,639652
9f01594d7b00b67705aa6a4536d6d71b,114,97,246952,34859,212093,105,73,154058,43916,110142
72f6ddba984207a3f4cf6017c66b3234,102,76,198395,55575,142820,77,56,164967,44956,120011
1b5195fc631168ec5291afcd8fe7b5ab,57,38,90363,24338,66025,62,44,106187,24701,81486
3fc2619030ef8859dcff04c97946b294,121,98,251856,56092,195764,104,75,203588,44117,159471
223c491a0ff169717358070c4a3b6cc9,116,87,340634,88586,252048,149,107,392748,94545,298203
0a257213c9ec6e3a97a632731c36c619,11,13,2550,711,1839,21,13,3743,846,2897
070fdebeecbb0cf5494dbc867ffb10e7,27,24,8754,6589,2165,26,24,11660,5252,6408
1aa594541649e557eb2f3678f7f73bd8,89,72,207932,48904,159028,99,92,216761,65262,151499
b8d131f133025b719cb6e0b353bc9497,66,53,106841,25640,81201,51,40,71029,22530,48499
152b562df9a464867d4932dc16465f70,76,57,163885,44045,119840,59,53,96134,51297,44837
47212223f718a6a56f581b73207126fe,62,49,79264,41364,37900,95,55,162869,41768,121101
b04ec88c0538eb80423cb893dbc48ca9,90,85,149803,58871,90932,77,61,171909,28364,143545
6526736d410151426c23062af5751fd4,61,36,98592,23583,75009,50,43,83354,19279,64075
2cb487a291ad67e9d7f4352d8249d9b1,34,24,19475,7707,11768,42,32,26299,6195,20104
223553333495600af385ce8eb3855a70,108,103,191266,45201,146065,102,78,171507,26901,144606
f6b80b3a924a76b3eabb8d2863207f82,90,78,159094,48065,111029,115,90,183585,42308,141277
ccae6dadb2760efcbe1963678f7fe519,78,62,130379,25220,105159,72,55,117524,29706,87818
9cdb636b89d6e1962ebd8a1ab17d62d1,37,35,34120,12104,22016,42,37,37473,11889,25584
23cb173f653f1297fcb23f71f0f91325,73,48,119026,29866,89160,75,66,125283,39793,85490
1883a3a6b0ea160fa5075c9faf8e538a,94,77,232499,39881,192618,85,70,158034,32487,125547
9aeddeaa43806a4273ae0e6845fb9a5a,132,96,262257,80024,182233,116,76,258042,47461,210581
725ff9328ce4fdfc48d380adafa31762,75,59,151023,42973,108050,73,52,101403,37397,64006
3b406bba357f15d347be2c546c570a43,49,41,49264,16453,32811,62,47,58016,15329,42687
5444a37d949ab4deb2d561fe24031e1d,91,87,170960,91456,79504,93,84,239065,56721,182344
6a9aa188f16cfcca96a03931548d8911,124,96,472610,182243,290367,146,91,489002,193604,295398
3bebcadb1d1a73d3324bfad6d88c9024,72,64,146655,53574,93081,101,72,172635,50310,122325
9117aa857a85a4cc947bebc3348d7e15,154,102,702513,138157,564356,205,117,992525,139340,853185
d02e18cf1dc8a2a365c2b123a99497f0,172,112,595660,107757,487903,154,99,641994,89551,552443
ec384294eca2196fe063f542ba01ad77,153,97,377397,96809,280588,135,92,306396,74766,231630
e61f689d7cf46ad22c988106d7458401,55,38,82001,20098,61903,54,45,72940,17706,55234
af479f65fdf6d4dab05a21af54e5247e,197,138,820111,111638,708473,213,169,755448,138537,616911
1ca31d0810baf3e373b02209c82bc903,178,121,630944,115948,514996,233,160,669322,115423,553899
80e046504792b93cbf4d143246b5a7ff,35,29,35628,6488,29140,31,27,29064,9145,19919
9836a46de099aa50292a4c00e3026cdb,119,94,274707,50080,224627,94,81,165360,66972,98388
bbcd55073e84ff2f32c2eb3219b742b0,65,50,102937,46869,56068,108,75,190912,41216,149696
83df4fb8eda9eedc32ea47c86a1e90ac,49,46,59199,21736,37463,60,43,66291,18593,47698
cac90251237f2f324c454edcf819a2ce,63,56,80510,26430,54080,91,72,134683,27304,107379
f4b18d9cfcc36dc3ca186e3fd1dd33b9,161,140,380223,75481,304742,80,68,154935,62773,92162
5a1b737c40f19bec6ba0d4c8baf9fc91,111,95,257517,55333,202184,105,78,185215,57533,127682
bed3e636607ac786216659c955b683e2,116,84,250650,37543,213107,153,117,326255,52767,273488
be9d0f0cbd7e381f2d1b2c069e073d62,130,106,295415,56195,239220,118,82,205187,44178,161009
899d4e7c4c3ea376f121c7d2141a71ad,65,60,89445,29871,59574,74,58,103508,28781,74727
7a8419b5af93bee11814085a27a78eb6,115,99,229407,63216,166191,104,86,248308,56972,191336
38ece3f67b742a2027c7b67b36a71270,35,26,31736,10012,21724,41,29,24613,9575,15038
9645f09890c135ce69273008f21deca6,145,102,316620,71598,245022,117,92,260790,55592,205198
9e2cbc30ddc5482900dc79d7a7c3d343,0,0,0,0,0,0,0,0,0,0
7f2740b80831bb794722fe5b2d446f09,59,37,71429,16005,55424,58,48,80051,17926,62125
7f3e8846a5fa275f86a2f9546c2086d0,29,26,29919,8438,21481,45,27,37666,9164,28502
7f524f5f603de7ab402b70c2b72584a8,158,118,427330,104992,322338,158,107,403758,90757,313001
b8c2ac8716939769b126007cad06c900,24,20,9032,6878,2154,27,22,18510,5770,12740
8675e28d45d7546199bcf57999c30b71,26,20,11052,3632,7420,25,20,6931,3970,2961
17d076139d6e2769343182af50543f11,114,85,237752,50679,187073,113,92,255383,50466,204917
86e74ed2edc9a7d3083a0df7c2c5f344,43,32,41390,18032,23358,67,41,69143,17685,51458
480db4187efaf93f738b54e2f45c8de3,103,87,179151,40732,138419,85,62,189307,41275,148032
f0a8cbcaac387abcb4a6cef469be9871,138,89,270816,77991,192825,151,116,459874,79121,380753
65b790bb33d87fb49b246b5f0c63a45c,127,101,265551,59202,206349,123,102,233256,51614,181642
dc05a4a76e93971410e1f8c5df734532,113,76,194359,66828,127531,117,97,194998,57309,137689
290375621491cb04558ede45fcb60513,118,95,206509,34524,171985,130,110,205243,38112,167131
cd32a3a4852d09b5ec3a684a5e204983,124,83,232919,51709,181210,126,109,313440,58667,254773
11d37ef3537d0824ef3eab3208a49f1e,160,92,368835,53281,315554,111,82,279952,85294,194658
11574005e9aac2f02815dcc808ca01c0,121,88,181801,46143,135658,84,55,141915,38671,103244
f6f71dfd00ee7569f181c01117236661,138,108,419401,150390,269011,204,165,759777,110712,649065
48bb1c62364e84eb08cb77662af2c29b,96,71,138019,44818,93201,98,66,137223,49442,87781
2ea241a66307212b894ef9e37496a068,108,77,178635,40179,138456,85,69,147507,42885,104622
6b43e22af6ea513a4f1156a240e01005,178,138,717209,86346,630863,167,114,452110,111837,340273
b0d68b4578de8d83d79dd7a14e73adcd,65,57,88547,29158,59389,58,48,82281,22806,59475
6280868839079511e33436ef094e602c,58,51,66638,16185,50453,65,53,60487,16500,43987
a9a74da5a73899aa18342cbaa9074f3d,144,120,616693,81424,535269,146,114,509249,112203,397046
46f05fa1876189ac07cf20353ad65078,28,22,28060,6439,21621,27,20,13526,9094,4432
b3b703bfd66870b5db79dba888342fa1,43,29,36085,9284,26801,41,32,23347,9886,13461
90c31a4ca0257ca69b0c8e4f87468657,26,23,10706,4107,6599,27,19,9636,5406,4230
c1a0bf9ec3f08c686c35144a34ea4499,63,53,72059,26742,45317,55,37,58668,23442,35226
76e77e3aebad222c5d11e82a005da35c,3,1,286,253,33,1,3,253,286,-33
09521211ed7667c74c01d3acc6582628,97,70,178860,96049,82811,106,58,217595,74920,142675
fda5212aa50795304c6f95593ec9143d,36,27,38111,11745,26366,40,38,29925,14725,15200
60ab3418e7e05477e16581c4668447db,121,104,265642,44899,220743,82,71,125455,55746,69709
ad9d1137084d741292b8d1e8706a605e,94,57,147411,33115,114296,92,85,173509,54950,118559
6381d89a8f779cb2e40a17887cc5ae53,45,31,26514,10215,16299,40,40,33568,12802,20766
22f092e788f0024201a6d7c40ce56a57,11,10,2106,1370,736,14,12,1952,1965,-13
bb4b9db971e4e8fa10162a6750df7398,60,43,82145,19751,62394,62,49,88085,19968,68117
33b65a4b193d4cb0dc039640b1bedd62,102,62,263522,72405,191117,115,100,274261,93611,180650
61f28bf5ce9996538c34de152185a5fa,160,128,490711,135904,354807,148,118,436171,140127,296044
8c71c03ba1ccb47abfd82b5ebe0ff1e8,130,108,383939,67832,316107,147,129,378883,99614,279269
2cfd061564bb0b9540d7d88f94ffe048,135,108,269710,71459,198251,145,115,340484,73737,266747
bc8fce597c4b07a8d2d0710d6d69cbf8,58,41,66776,21537,45239,73,60,84068,27707,56361
ac1888451252cf1c796118efa8312296,159,119,522871,124241,398630,169,145,579771,133493,446278
0b3f90f8da63b360db694da91caf3974,108,62,183140,34820,148320,130,93,250130,50668,199462
b26423b43c3ceb0467b5288fbf689483,18,19,6091,2175,3916,24,16,8666,2348,6318
aab24e5de389aad1e0796addf4bd2743,20,25,11086,6904,4182,28,17,14145,5426,8719
9b71661c3c4806b035bdc631267333e2,195,135,759213,104530,654683,172,125,758898,99329,659569
d3f63e8b559b73c4de9943c019adfc6e,160,101,360676,82317,278359,120,79,295975,78937,217038
a134258525cea3947aed176e22cf8d77,22,19,8181,6455,1726,23,17,12967,3867,9100
e076e94306ea03e0410c439410499102,36,35,35858,10923,24935,35,28,23350,10642,12708
3f5ed5342f6c5e98a164b1c286f5bbdb,59,57,114533,25885,88648,55,33,73836,30628,43208
7dc329dc98998414973aacd81767cf3a,97,78,167354,39920,127434,110,96,222865,52115,170750
5da1056a9978247e94ac335578764d6a,43,37,58313,18995,39318,44,34,46485,20082,26403
7addb6fe592c22b24b56be340680b824,95,65,160901,39572,121329,112,76,129611,35324,94287
5b46554893e6f8523517fba7025637eb,177,140,643587,137819,505768,213,136,655216,143132,512084
96f30f11af8915f870251ed1b259bbaf,20,13,4406,2117,2289,16,8,5003,1456,3547
d2ec16b0bcbbeb1885591fa988624d36,13,12,3366,1162,2204,12,11,2218,1280,938
042d28ed907afa3f9cfa146f368cdf4c,71,54,103392,24108,79284,50,36,66551,29481,37070
d9a3e3f01dea709142934e97e0110e5b,118,102,297355,70293,227062,125,98,340852,96473,244379
3e85f055902e1fd3bcb0085102932f3a,72,58,97371,32069,65302,68,40,112638,20331,92307
08da859383722de2c41ce45a5c49a2da,38,32,21711,9984,11727,35,33,22666,8341,14325
b54741cee15c120d6ca7f3295ce11132,37,27,26680,10986,15694,33,27,34147,10628,23519
587ba8be9106a03efa28ba01d1cd6562,117,105,346311,135630,210681,140,114,466216,124909,341307
bacfabd03b63c84926cb7ec9ed7bbe00,175,136,663874,139522,524352,197,128,672055,197895,474160
7bfffb7156dfe9afd395af6a954cbbdf,0,0,0,0,0,0,0,0,0,0
d060fe256fd8abcec9a8317ccd53d2f3,112,97,425531,153897,271634,158,129,574508,151213,423295
365ac5fee165338d500f6d3cf960e8f3,67,54,102619,42162,60457,76,56,125809,39529,86280
194cb95f9f8e9b07889ad78575dcc061,173,139,659399,88422,570977,161,139,527491,114395,413096
57a40869405305b3e2ba4e1c556f1af8,153,107,381438,82051,299387,154,119,398257,70534,327723
0ca38d0a36a61cc3c9b62295ad141320,42,36,56399,14452,41947,46,39,47103,14414,32689
1d2703dfe3d3dd96403ca07052be0df5,115,72,194330,32068,162262,99,78,203791,39480,164311
6c67db3230e5a1096b317b04a0c5fe8a,101,79,188990,43168,145822,114,98,240140,73146,166994
09bd0cea8b2501193f948b4862dd8b9d,70,56,111376,39490,71886,79,56,100872,32925,67947
37d606c4a0e95f2431b3fede255ff5e9,72,56,125906,27251,98655,63,48,89490,30018,59472
ddaa481e8e5ea4870fe769473d79ee9c,52,44,54695,23503,31192,49,46,61119,20061,41058
d917c7e6dc49c472687286e9dd048f90,61,46,97997,37452,60545,55,40,89474,30237,59237
f249106ca6d23650fdeed581591bccfb,43,33,39010,18312,20698,51,49,68424,21304,47120
a05699593d51c8789d240a891a84a560,70,53,81024,21483,59541,70,50,75216,19930,55286
2dbc5e7aa01a848864608ae8eb81f212,133,116,443448,105609,337839,132,101,418823,112711,306112
4e6cf647697eb9e4e95594e8aaba2b4c,113,90,266255,49249,217006,90,73,209806,50806,159000
92e75b874d9493e71f1b3d08b1c6e090,85,73,195822,48799,147023,75,62,146911,48753,98158
a2d440bc58657965abc6c93bcaee8a73,13,8,3071,2350,721,17,14,3562,2681,881
67f0922f671132b44f5aaffcf035a13e,211,165,956404,135584,820820,176,137,593955,180916,413039
68e029341df6b19398a46c693062990a,177,115,455802,88570,367232,111,76,278633,70220,208413
2f01c1608caa12e02389e8e7b61d5fa3,96,70,187231,64208,123023,107,77,195658,52151,143507
406148614e17183e89343c525938ef0d,69,57,105668,33726,71942,87,69,135727,34185,101542
fa2c11135790669f07b5c601d709a89f,60,46,210193,37964,172229,152,98,357333,60876,296457
5f8ac79fbf0fca702b02458e83981924,105,57,167878,49592,118286,121,80,301683,56775,244908
a44e954d3e7c12442f2d96d4c4e4f5bd,37,26,57227,16045,41182,46,40,47763,19829,27934
2cdaba89d853f56d388ec0f76520ef81,154,124,446012,66262,379750,141,100,354729,53366,301363
3357c656ee32e923d1977cf546bf7313,116,96,259580,57828,201752,100,61,160920,65487,95433
ac0a36ce939813411ae2d5d619173d10,44,33,43276,11805,31471,56,46,66519,16135,50384
a5d45be95f245b02ce7009c920935c47,72,62,118026,49094,68932,96,62,165394,30519,134875
8d1ce7c2c5f0d41eb40e5e3d5cc6f99f,73,52,92812,26084,66728,95,79,176273,52059,124214
28d9ff1caead4f1dfef922f70c3bee73,77,70,104268,48288,55980,66,53,139444,36069,103375
0795fdc9e67d1e79c4f556a929a6342a,62,53,106837,39265,67572,110,91,253101,38296,214805
463c46857974ed624ae44cee4be5f300,60,34,75893,30475,45418,62,53,93084,46910,46174
6076d0a6c8d5c6ebcb3952a8b2473008,58,47,77564,20228,57336,51,35,45101,20547,24554
c9d0cb687ad74569f8f67ef11a1f6b2b,76,70,128116,39974,88142,102,68,162430,30174,132256
80803045dc871e9a5f8db72a9fc86d7c,41,25,33347,8389,24958,33,22,18786,9954,8832
f323a4c8bfdf2fa396df2453d1d41f77,103,73,210881,49567,161314,120,88,218048,68462,149586
5a335a8d5755abe855ec1051f12dbaee,68,45,91406,19996,71410,60,50,74785,24667,50118
aef1d40dcdf0d20c72d3fb01b1380f50,0,0,0,0,0,0,0,0,0,0
8e11ea4518af4bae3b8d4368ebe9acb2,146,97,486621,107579,379042,189,153,541856,121424,420432
9fdc7f96535c5d471a7bf7e90822687b,175,130,515555,97320,418235,128,110,453689,105783,347906
e62cac252daa478b78b2e4ef0b130693,122,86,257138,31448,225690,103,84,244769,52646,192123
d9d2c9422b46065f0687ff6aa438f570,165,129,391022,86984,304038,134,101,448617,91477,357140
018b0f7607c862d6c0cb4bb93d45134d,19,18,3892,3196,696,21,16,4576,1903,2673
7470c7034301a58e8b9c1df5468b03f6,26,23,16972,4473,12499,23,15,10651,4508,6143
cf4df1bb89229e3b9c339851dcd0deda,64,45,112559,20456,92103,51,40,86417,20569,65848
e04b7aa57a5cee915a4f1ba6e7f644ab,106,81,187861,34128,153733,100,77,126592,51566,75026
f0d9ac6a749e8a956512c2c290f53de4,57,43,52547,15894,36653,41,31,41348,17992,23356
70a59769acf708f0e74eee3ece0b4121,35,26,27108,10731,16377,38,28,37005,9226,27779
a41e35004e95186f641a7e6a5ab8450c,73,64,102956,27652,75304,95,57,102947,36961,65986
c36c7ea6897c7ff55abcf9c3dc271b71,90,77,194084,44264,149820,82,75,160160,56543,103617
7817d15408160addde826d0b011d4bf9,111,95,201582,36541,165041,86,67,144349,42486,101863
d26e1c6bcb3e7f42ec70ec870b6cfa39,129,82,337090,110573,226517,154,128,573525,94114,479411
cd6ac00128f7b038a2932956206ed1cc,208,115,661852,160480,501372,162,118,529760,160605,369155
8e88d582136175e9c10dc9db52ea535a,89,79,196416,65742,130674,91,73,179795,41556,138239
6887327f083ca6ad6f8543e68334bcf6,65,46,65603,20650,44953,40,31,49102,18736,30366
1de151e202534493cc78970ba8084adc,143,102,358695,42955,315740,104,70,178563,47524,131039
a4f7f48165bc1b915f2d62bb4a6a35ed,69,51,73024,20506,52518,63,37,64765,26021,38744
a5ee142f327a6b0ffb505658a6e202df,57,48,105080,43960,61120,96,79,168693,52696,115997
25ba8fec8b077ccc557315a92558b173,128,83,208666,60254,148412,126,80,188939,57164,131775
b0ebc37d491e0f52e120219e68677f36,51,43,66421,23245,43176,46,36,42071,14588,27483
189864d459079271388afffdf60df205,122,107,321374,63458,257916,125,99,237309,54095,183214
4dcafcc6a0852e1066a9377816278db5,32,27,24934,11306,13628,39,25,23777,11137,12640
b2e0e5cbec1bfe262889575728e109fe,55,50,75103,20630,54473,45,37,52611,13368,39243
05e283b7349acd4354b96c10b5c30b13,56,38,59160,18644,40516,48,32,45220,14126,31094
2e9c1371aeb7eddda2b125140f33d738,214,167,797185,158116,639069,222,144,748055,141840,606215
243289bf45f6cd0e48595c5c29ef28a7,100,76,156941,36648,120293,98,72,154033,21008,133025
7b146bb79d3d34411300a1574ab00686,96,67,193463,47712,145751,79,65,108498,36377,72121
78f420cc3b8036c66d1c082a1585ba19,126,84,218565,48255,170310,127,104,213006,53495,159511
bd046cd8decf98f18c1a3c21aaeffedf,22,21,14395,4770,9625,23,17,10966,6076,4890
fbbf95023f82a068e87f4ee3fe29ee73,93,75,171134,46103,125031,84,64,139340,37945,101395
35f89f5c73766a85e88716a275d52294,113,93,316736,84332,232404,130,113,292305,65327,226978
1c2afafb516064faa4ce9b67b79691e2,105,83,205437,54977,150460,142,100,240111,55829,184282
71ed0b9006e41dd803b978bb0db9a112,95,77,164715,31918,132797,76,59,103505,49056,54449
62464320e06203502a5009be883a73f1,163,115,459402,90856,368546,123,90,424562,118760,305802
9596b7e77e0c63f446b39be423bffcee,127,92,217738,45951,171787,100,67,148853,54273,94580
d348aeed4cfe4c833c936d50c570ba6f,44,35,60793,21671,39122,57,48,58207,22762,35445
6515a242e91eaddf43da6b4c975f17ea,120,105,299157,49905,249252,123,98,261472,70357,191115
bf5863266bb285c42a7d30449f19f343,42,31,76325,34294,42031,47,30,107389,27779,79610
e8a4a3f2e3ddcd5791dfc5a013431d86,34,22,21779,8016,13763,30,27,22862,7690,15172
c7a8a2af320adfd58f8071ca0f9c6c40,62,49,81363,16158,65205,44,36,41938,13694,28244
0e6bc9fb830eb8d49a94107a2cf8d398,0,0,0,0,0,0,0,0,0,0
0604e0e6f28c6bdb13efbde9eeafc992,19,19,10506,3817,6689,28,18,9395,4634,4761
b9c4ee9ccef78a7e35cc3e8f52012413,173,104,486029,64622,421407,171,136,449680,85483,364197
e4f437d422657c6937205a9485a91738,21,12,5822,1966,3856,18,17,11427,2897,8530
db9664707e880d1ad0d2007aeaedd2e9,48,35,78413,20612,57801,64,52,70774,25021,45753
931f737084338f0094ef7a7ec297cccf,63,45,44180,21454,22726,57,45,57023,20583,36440
5fe09d8fbfc143401eeec01262d5b929,128,96,335219,70073,265146,118,84,293001,73381,219620
c54fc2dedf61b164dea17eabd1813cdb,117,102,407559,149677,257882,178,135,548447,106547,441900
7c985787998fa6a8dc5f9a4f812743f0,145,122,393707,84851,308856,158,128,465989,92117,373872
5bae5692849031abcb7c85a64130ca6b,20,17,5077,2971,2106,17,18,5162,3518,1644
f53f3ec5d617d3675042b5fb609a7fef,79,68,142832,40624,102208,64,55,112133,28822,83311
d25da40e67addae62b3a16a0286ce524,103,77,179479,54936,124543,140,99,227496,47386,180110
8e88ea2eaef7f717c00ec2de9366362c,55,49,77267,24953,52314,64,46,76454,24157,52297
194edefffd2a81736661a303213be554,30,26,19346,7307,12039,28,22,15216,5460,9756
2d3492970996434f8ef878c6b0c1cda2,193,129,581264,80947,500317,162,132,496196,124474,371722
618a713906d4010d1f4947e1be201991,99,77,210239,63199,147040,66,61,91022,58549,32473
38ccbd8db5164c0733c3294025da3491,53,44,76778,29162,47616,70,51,94537,31468,63069
89d9cc3950a748173a4650f91b2581a2,127,68,323898,71166,252732,153,115,361477,69920,291557
fd64d8f7b801eeecc7526e7542f91d09,136,97,293236,59254,233982,138,98,297012,55382,241630
52b1aa45775024a44c901f41af18b795,156,121,356359,75127,281232,104,72,248883,83824,165059
92a0dd7dbc5a8735007a74cb590cd501,105,71,178232,35712,142520,126,90,218758,37445,181313
ea0b457eb7697ad983d9b487bb58e47d,119,96,337352,101895,235457,160,130,560924,86355,474569
2b5a85d4a93af448644a98d8d33d1061,23,22,7025,4221,2804,23,20,12279,2695,9584
4ae6d0d3e70b10d9e1a80738ed05f649,70,45,134566,20110,114456,71,60,65360,37521,27839
e8e24be68c848894599d8378870ae618,149,110,624886,142690,482196,183,135,662200,161972,500228
c5cc58b7b4f5785076aa3f5bfc0d1da7,43,38,54369,10922,43447,33,27,18532,11110,7422
871c0e30bc1dea8a6a9906e3594e3839,65,52,96778,30806,65972,53,42,71010,24707,46303
859fd313ff7b65b222d595e805290cfc,120,109,312070,72933,239137,91,70,153022,79178,73844
550494a80b2cb5c0ffa238fc0138ea7e,38,27,27108,14566,12542,39,27,25123,8355,16768
bef3537929247486eec0c4eefa8de1f0,28,23,21667,7968,13699,45,30,32574,5893,26681
acdefb3cd96395533e3b814cd5635e83,25,21,20810,6041,14769,23,19,11764,6759,5005
f8927ce53453ce016ea1cc1611fb3633,36,29,33921,18213,15708,46,33,53373,18086,35287
9ef8a8a2f44c2a8e1e89eaec1bfd9312,60,53,74879,29046,45833,51,34,80154,21424,58730
16e8732254bd8534631f29b7323ea923,107,68,145071,30157,114914,94,68,166089,26715,139374
4abc59bdd28ab362e5d1c5ef1aaf6036,28,20,10345,4513,5832,26,20,11927,3704,8223
8f81d768da266a095c75a5852111ee29,55,39,64061,16555,47506,63,48,59766,19986,39780
110edbaee0b58b24783596e8b9212541,101,73,174537,57611,116926,98,81,212083,46303,165780
e38992def6a91216224f435a0afc66cf,59,31,82663,28292,54371,57,39,107859,32959,74900
597712d314c026f8051a690de06dcbab,189,147,833747,157906,675841,157,137,639212,91486,547726
73922b93dc560b330dde298160bb43eb,20,13,8954,3029,5925,23,16,11519,3060,8459
7c040116f74e0c9e58f1d580f0121d17,56,38,54790,14907,39883,40,34,51081,17448,33633
f776dd7db85165798300f8874df34194,45,34,66366,25385,40981,77,62,104691,29868,74823
d50d7716c5453722d11b098e963f508c,90,70,174606,40688,133918,95,68,183563,34845,148718
f60de2c849f61eb892cb425ea3249859,55,46,63366,25149,38217,45,41,52890,18284,34606
a2f68a353decf0584adc7e89fa8fc991,139,84,304341,111960,192381,163,89,377269,80738,296531
311b4e9c491bf8e1eba6fe34bd4ccff0,144,130,437792,137625,300167,120,80,371392,100878,270514
d43ca7cc3f4d82aec38348aa04adcb64,118,88,263616,49877,213739,127,99,264466,56984,207482
f9fddaf9d5a50c0069fc8173b78ed71d,72,61,111911,30453,81458,87,64,166449,35055,131394
ac3df0ac0b0d7f1171867cfff54d7d0b,149,120,374681,69131,305550,145,109,492727,70130,422597
b24f81d303fd7850964350af9adbcc58,27,19,13610,5949,7661,29,26,18456,6797,11659
9768edd3db82fd5824a9fe3252bea3dc,58,42,81102,16028,65074,43,45,46592,28095,18497
bde6e949c6d2e19e44d542b0a787eb5d,15,8,2629,1129,1500,11,9,2370,1048,1322
2071f44ac01af4bef4b22443bc12b4cb,18,17,4019,3078,941,22,17,7832,1815,6017
71e8f64c91ff4c5e22452736ed954785,172,125,555142,163701,391441,172,128,639467,123141,516326
119e863d1fbe223b95faf3d4c5059dac,13,14,1526,2145,-619,18,15,3071,1018,2053
7ef82965c9a6e323f30c857ad84cb61f,18,18,6128,3044,3084,19,12,7970,2445,5525
38a8c1dc0658a515255df68d3466dae6,164,143,567538,99600,467938,169,111,526234,71108,455126
d3770d573ea3f0a29e1e42a47be7ab02,146,104,356620,69972,286648,144,119,366230,105270,260960
2d0ada18dc40f25ad42a8abfd2beb327,43,32,45399,16289,29110,39,29,64591,16351,48240
37418139046a3f5bd044383a4c16f343,165,131,620553,163044,457509,199,145,708586,149236,559350
e9e70edb0c823f1bb0f7ce2db6d8d2a0,25,19,11436,2762,8674,22,16,6652,3989,2663
d1f7001395eeb8dd6372cb2dae22d2b4,34,22,24739,5284,19455,39,28,34526,7573,26953
701309aab1ee5482d6a2611d5c7376a9,79,60,143608,30906,112702,108,77,166253,34851,131402
25a0be6d7c920793e582a66a0096cc2b,46,34,35416,15394,20022,51,45,53888,13757,40131
106e9b622de339c462693a8f0472a942,41,33,90848,25183,65665,41,24,47567,26403,21164
f4be2f86f50139732274538ad2a86c1f,117,100,318931,97245,221686,150,113,537409,124245,413164
199c4772a3c805455c6609f66b2d8a1a,71,46,93755,22265,71490,52,47,99313,29911,69402
35b18791798f3aab4f73f8d343900216,2,0,248,0,248,0,2,0,248,-248
aa096812d6d9c4db7ef3e05b775233c0,155,117,505384,123546,381838,142,113,453742,122456,331286
33151ef36ecb105973dc88cf5102b238,71,54,117860,35238,82622,95,68,148992,38967,110025
ddf190a0a2b088e9042c01963d74b712,9,3,2300,36,2264,9,5,734,398,336
9934857f8f52ff1825884f81eaf052f7,40,35,41670,14955,26715,58,41,47995,15599,32396
e957c6ad2fa5598c75666594ad932e1d,92,65,117014,48954,68060,94,80,186899,40998,145901
f702f72908d5fc488c41d17d516d53d9,122,103,278749,65563,213186,92,82,163811,49655,114156
8dfc47624011e3bc4292787b352d1ef1,59,41,68963,34133,34830,54,47,99867,31309,68558
c682721fa4a485512034e13c0d574209,114,82,248805,48537,200268,113,74,226279,39697,186582
526ea0cbc1e7dad4fe8179760413497b,29,22,24484,12775,11709,31,22,25122,11038,14084
f9b8a3dec534789f48433e7fbfc93d0f,26,23,11186,4617,6569,25,20,10564,5284,5280
7b7c45d4b52a0657bab8617494c6a706,23,18,6243,2907,3336,16,12,4744,2439,2305
2ccf6ed30df166d3359f4976c35fc5f7,12,10,18853,4913,13940,35,27,40560,6722,33838
4f16302ff4824c3af4b5d928fb4b1d7e,93,73,188879,49275,139604,106,90,253687,60176,193511
f133d22542b6d6dd0751dc4303008733,143,108,385587,97612,287975,160,104,376366,65183,311183
d665a6b53db969ca7944e44f7be5e9df,168,107,456557,70535,386022,159,129,509697,101661,408036
8b1b1c21544b6b6d72d73114c0f52a50,121,99,305740,93680,212060,125,92,342579,83152,259427
9486c44835e2f8d326ca370aa1152ab9,51,33,47477,11241,36236,49,39,38286,11373,26913
e8ff5e5b167eef8f9f36cfdcb06d68d5,125,87,265074,48281,216793,147,116,329452,52984,276468
0e7051b51df74c6283cd9b1c659359c9,34,25,15483,5809,9674,32,25,14940,7973,6967
e76024edd96a3150e6b660c8de9730a8,25,20,21651,8939,12712,26,16,19297,5829,13468
41348662a6332f4270aeb07ceec41843,73,58,95138,14095,81043,58,51,57727,20843,36884
a66f1c38b183f8df7407c7aab1853940,39,33,36259,16504,19755,49,40,41347,15652,25695
c02562653d5f8730c9bba9c16e7c892b,141,108,284059,48826,235233,147,114,348333,52041,296292
e056cbe4dada7be00b3d2eb04bf9f851,140,111,469733,69331,400402,154,118,376659,74358,302301
a56862449892cd89646e867e1e29e3a0,83,66,123712,21174,102538,68,47,67151,20161,46990
ddd94185395a0909cc4260d41f5cf9e1,39,31,32951,6999,25952,27,26,12752,12248,504
589fe5dbde6db5ccafd38d625b373150,108,93,172354,46277,126077,105,87,170082,49015,121067
a8ee32c05a0571f94683874c35150c6d,56,45,75475,22760,52715,56,50,65122,22354,42768
2380d938ace7dedbd39485ce9c3f8bac,149,103,321348,64268,257080,147,93,333397,67225,266172
0735fd835758eb868afb000ccf2634f0,69,53,94002,19703,74299,60,41,90947,17642,73305
7f572bc73860e31e15a6287c11e6ff8e,78,68,166692,54537,112155,127,100,263054,66561,196493
9f11bda96640b949f0e6496592a8a22c,97,71,165011,33294,131717,130,104,217975,46134,171841
6498e1b158e71caf014c2c299c028054,107,71,176392,34077,142315,97,76,166378,40223,126155
b3cdd195d9c644e0fe6f5d3409346032,28,25,22763,5927,16836,27,20,12618,6171,6447
6989193923422a9f150c236f2e2b981b,116,94,220166,62418,157748,119,96,245082,82567,162515
abd8a8aebb8b28c6d357f157874eba3d,8,7,1412,987,425,12,9,3110,707,2403
da11dd01e6f3fdde42f8b5b21b505d4f,39,28,20398,9604,10794,33,31,25211,6895,18316
271dca0a2d841d22b7aa1689c66e8ef1,28,21,22821,6249,16572,35,34,24741,9378,15363
93292e8d4a088c1cf1591666868c0a98,67,57,77008,19811,57197,70,55,59369,19920,39449
55718c79c1111cb21b739304f28b029f,103,83,189839,35909,153930,87,79,156354,47556,108798
f7d7a1e5c22003f30b21930535f5c770,96,78,184351,46813,137538,97,78,183655,44436,139219
58233064afaa6aaebda42657b33bd3ad,162,125,320828,69964,250864,128,96,313674,45142,268532
9636a78064f1ebcbab75bb5426d5e526,168,120,368819,79912,288907,108,93,248022,69126,178896
654a129ab1574a0009f3c4e817b63c8d,189,154,509382,87153,422229,137,105,691537,83403,608134
08d099411b26e233d1fccff7b041051a,140,108,471612,150434,321178,154,127,454213,111977,342236
15d81247bcb7898bdec72a4acc5fd9e7,48,40,85768,20831,64937,41,29,51567,22046,29521
7adbd179868853d2b34fdee79742fcf6,157,108,347887,95715,252172,139,115,297745,96121,201624
772678aff96fe2e1d2c343347f8a6c2f,23,19,10705,5281,5424,26,21,10617,4746,5871
85e4712023214d59c7443d2a27db8268,30,26,16192,8323,7869,29,23,16221,6870,9351
7f2b663c4fa0e78ae79b03a7a1a3d2c7,88,62,139776,33996,105780,65,51,111438,39868,71570
e91b7828199f546eae929c89a500e9c6,66,52,115362,30768,84594,68,53,113920,32027,81893
1220794eddf77f3bea88b89efd7e706d,88,67,202870,71488,131382,120,92,277387,79982,197405
aa94e43d80c223b66ff54a93efa1a2ad,132,104,286754,34109,252645,85,78,175796,56179,119617
64fa6454c581e4234f5009d39878c33b,197,126,566737,78336,488401,184,153,632435,79340,553095
efdcbdd807b47da12299e229ace4b57e,84,72,95646,36749,58897,99,76,147169,29406,117763
6c26395a57bb9437217ebea8f193276b,128,90,329137,70858,258279,148,118,396223,92656,303567
806dcf753090ddabce9fa5a7d6155a45,82,70,198922,47318,151604,93,87,203002,50626,152376
5d013e7b21648385dfe6639c8e5e9c79,92,74,147229,28420,118809,81,59,98989,30969,68020
79d6ee2e14d0883f509a9a4c6c1d4475,69,52,105092,43891,61201,90,73,154977,33680,121297
d57b29ae84f3a5da20c82705e166ae8c,46,49,75177,27027,48150,55,47,66213,22461,43752
9f78216192e159379a7c0c5c99b31d82,85,70,115697,41647,74050,111,83,171736,37249,134487
8457e0f09e9f7bcc280709c2e4916b2e,24,16,5992,2025,3967,23,19,6123,2901,3222
3e1bc39ca6d819702d021e720a4f450b,155,114,658075,135914,522161,160,110,662406,107328,555078
a8d3a35baf8c5c64952296e53ebe6941,136,107,376345,80550,295795,133,94,319032,74345,244687
1bc737046017cfaa0c6122a142428d8e,37,29,32909,14367,18542,38,30,29269,16017,13252
22988d83c6aa93561e1ef6140a2eaf63,161,111,711568,155749,555819,190,154,595509,118325,477184
9d55f7d83ef9c44b08be3bd7374f4f6b,116,87,275235,70781,204454,125,102,292621,70519,222102
ad8b86d6b9752951c476d9f9e90601ec,114,90,261285,74842,186443,135,110,336226,61054,275172
01643def8f3a39f81b31015ffa106c49,26,21,27561,6659,20902,26,20,14234,10729,3505
d3737c9ff514bf4ae9040c6b315b4cbc,152,106,329302,60730,268572,123,84,305565,62829,242736
fc813296d4c89d3446208eb1b40ec951,18,10,4759,1623,3136,15,11,3239,2644,595
f77eb35e5d56ae56ab70884694c88b89,19,14,5381,1660,3721,20,17,6217,2128,4089
022324c8bc6528ee6bf6c6aa00c94d6f,129,90,494921,169643,325278,176,126,815779,130227,685552
1280b8ea794161b5a6d253bd18004485,127,100,306876,72707,234169,157,131,510133,100139,409994
732d4101fd0452e663a18b1f3cf68609,139,93,292357,77548,214809,183,91,263265,60838,202427
892d3d2b05704ff6a0e5a5ad666db65f,193,142,707420,166566,540854,195,153,605619,194676,410943
0971a77a89d142885389553cec89b281,36,34,40199,19267,20932,55,51,63589,18198,45391
b6abfd82111c4b1efff4f94810ec6171,43,37,31896,14012,17884,39,34,39679,12107,27572
f871c65f761fdbfc91d820e0ab111b1b,55,41,47831,28270,19561,48,42,86796,22735,64061
d22de85cd56fb1d45d06c8b257727532,140,113,417601,75576,342025,160,101,385367,60620,324747
a66bb4a2a30053a3761b7be034369bf6,22,21,8919,4798,4121,22,16,10429,4590,5839
4eeb0c012b1a0e4bc72a4bf9a1c2d274,27,17,9792,2604,7188,28,23,13982,4148,9834
f228c7c3e20474aa34f2ad2d0fc8c8be,50,34,33290,10777,22513,40,31,37066,11089,25977
e3ef50c7b0cd915be3820c26c9113fe1,125,62,283623,85021,198602,105,79,325642,78881,246761
a6f0859d5ac975f14b9d6a229b76c265,132,98,405681,103313,302368,168,116,509618,95422,414196
b50701b239488b83f38326c876349659,29,22,7554,5104,2450,27,22,9987,4492,5495
787dd088994340451e88c7d8d08c95a8,186,149,755451,200834,554617,211,155,754047,111566,642481
daec9ef35f45699c0df7210b197f9183,24,20,13809,5986,7823,35,24,25376,7164,18212
5ee3085fba25b791c8ad97293118d82f,24,20,20949,8022,12927,35,24,36681,9533,27148
88b5c36140e4e23e421db98c4e4f2192,43,33,37090,10855,26235,34,30,25061,12746,12315
7b1e3babb273c09564f283d564497fef,163,139,611902,99089,512813,163,119,658584,96979,561605
61a322e9ee469b681428615dd94fe7f1,39,28,48204,10979,37225,35,26,23472,17525,5947
55ba322ae3781c2692057bc685338726,59,40,94920,20961,73959,84,61,131608,25855,105753
bbe5753dd065372aa4e9d9c56ff73300,3,2,550,301,249,2,3,301,550,-249
b1a78eb3d2ae7b1e8d8c36e0d0cb3fe8,77,67,154329,50815,103514,72,47,113341,36771,76570
398b93f7573c8605803493a5e53c2781,118,85,338126,78425,259701,158,113,433578,81136,352442
1cf58a375699b65a0aed3e1eaa892efe,58,36,46614,16480,30134,36,31,35621,14497,21124
144ec2e04c5f6be806357cfb0d04c4c0,142,124,541687,135235,406452,175,147,766151,124638,641513
a580ea0fc84b8cba6807cd2111aa1ca2,122,94,362854,68603,294251,112,67,241086,74938,166148
05f8010b1b1a1a8c132a9a60e676b877,22,18,11820,3213,8607,26,20,9533,4690,4843
d970cd3de2c14c13918012de112bd4bb,36,32,24051,9787,14264,38,34,26625,12172,14453
bd0f4c21991bf840e3211dd7a307d129,50,32,56580,15225,41355,41,25,32536,17141,15395
7062cc98c3ceb1e70dee545542587477,167,124,508394,88322,420072,149,130,452555,68995,383560
447efe064b43ee2ed2a357112c6f96c2,194,138,827213,123713,703500,211,117,716276,121933,594343
2dcfd0d52a1a029f232b539b2de31764,22,22,9608,5522,4086,26,19,11367,4235,7132
eccf217f1ce91a8babfa4e459deca694,100,72,172615,43310,129305,94,77,199761,56815,142946
f326deb2b4d194e2a0bd7074d63f1a2d,71,53,80260,32066,48194,69,43,96765,24708,72057
707912203308f7ba6e0c69d7f665d930,153,120,467602,55462,412140,119,90,293498,79775,213723
8d3f53ffdd6ff598e98c513df90da7b9,230,187,1590286,327627,1262659,292,205,1742191,296841,1445350
a6c33e181e48cf335d7abbeb503b9940,133,101,332559,66036,266523,117,105,268865,77642,191223
5da2540850cf737609c501416fd9d39d,31,24,31921,9007,22914,36,22,31507,11957,19550
b15abc2f6d41e36b0d403b07377f4dce,47,39,56139,15999,40140,59,44,50537,22355,28182
5ac3800fd01f06156ce6fb15ce7ae0b1,97,72,154742,52867,101875,103,78,206587,43341,163246
b27680bc065af59ceb41f00bff76ece7,165,106,436117,74067,362050,198,128,482371,104286,378085
e1dae0c576d2317f88e3203985d8f4ad,109,79,188193,47185,141008,93,70,135620,45679,89941
1404531ed534ff555febde1d1729bb5e,109,79,217078,42202,174876,111,92,189600,46704,142896
1c04009a17db725fc7c5c57810c3e1d8,61,58,82417,35034,47383,57,45,84852,31222,53630
b27377d9afa1cf480b953613ccc32f7a,18,10,5060,1370,3690,13,14,3103,1421,1682
50dfd78c5b1a64441fb2f1a37db7f2b4,152,124,418324,61338,356986,131,90,377111,61218,315893
1df548ee60b655b9c97b080dcf5c86a4,187,140,552504,86486,466018,149,118,408777,96458,312319
894d81416101cd03d0ad602b428ad4de,70,48,152684,30942,121742,68,60,103234,30934,72300
aad2d8284018c44751544840f4056ccc,81,54,142158,51146,91012,106,74,184827,40783,144044
c96367aa99e054686ee485ff68ed7575,71,54,98514,32874,65640,93,68,110102,41734,68368
1eec060b9f1905f99afd51e845737d53,102,83,245818,39351,206467,104,75,159582,36760,122822
740f786f51304291689de1c68f7efbb0,153,108,416283,76513,339770,192,134,482363,79983,402380
be7a77d5ad1c028c76090f69d1fe1241,62,56,75007,18090,56917,56,43,64402,20397,44005
5225ba7e498492a5c838e102fe08889b,0,0,0,0,0,0,0,0,0,0
76a0601a462706a155728634b8c4f3fa,175,139,497193,66624,430569,174,114,390616,69380,321236
bb5836e44ad14c97a77ff800de17cbed,107,84,400795,113577,287218,146,124,442271,132143,310128
9c846b2f69f023bf6698521acd75f675,39,27,92651,34289,58362,86,79,189014,39183,149831
058e6927564b04aa2df17f25ed40d463,26,21,17679,4521,13158,34,23,17276,9237,8039
1bd37d8009db5c24ce82699b87e938de,156,131,398997,60623,338374,129,97,342725,60182,282543
469e6d30be18ac9c6d592daae3b74557,99,72,156557,40907,115650,72,57,129984,41719,88265
2b4f871b18bc6b003d230de024258702,113,98,207640,81352,126288,120,85,213309,54035,159274
b89df272f383c3f45e8302599c4ed998,11,11,2480,1572,908,13,6,2649,1414,1235
cb5c85a6300f19f149dad9f8a0c6c21d,39,32,36558,21777,14781,40,28,54555,16279,38276
b7e1a45d0580db7a14820580cbfd5863,148,114,306227,57636,248591,119,89,254072,46777,207295
482eaedd3a3887255363eb355ca3f377,131,106,278719,52301,226418,134,92,293338,40027,253311
634ea73a02f7dd983a5db3b5e9c12872,41,33,26842,13585,13257,31,24,22764,9095,13669
9aba7d8b83af15b94fb7d8ee4d8ae6ac,110,76,222335,40167,182168,86,62,150285,35719,114566
70b8c998fac61d5c1d56ba2612b3f975,20,11,13258,2697,10561,21,17,6382,2598,3784
6df64d56c8fd77b5599ede25852e3d29,52,36,59364,18994,40370,63,56,62669,26137,36532
1cf2a6837f1eb3396b0da4bdec0288ea,79,61,131854,33885,97969,51,50,82182,29621,52561
bc8a92192e7f06924a8640a9d019a86d,30,24,15814,6294,9520,27,21,13448,6895,6553
8f7f2de1c9443af5752a74a887dd5c64,83,69,154762,45852,108910,102,87,228872,55319,173553
24af6cd3c128a389735a7443a86bc9ed,35,27,31357,12716,18641,35,30,42046,15001,27045
9ff48edcdcc43b36b9e235e89655ee1c,39,32,43120,12903,30217,40,31,35210,9587,25623
4f526e4ba118cd4aa64e203dc20b2394,51,31,38051,11984,26067,55,38,48559,15266,33293
d54e921a92261004042dabdbcb30ea53,39,40,59909,18200,41709,43,26,51068,21683,29385
8909ab1449b495bbfe5728638bf0da86,135,100,370693,135288,235405,168,127,412524,98946,313578
abae517733ea0f60914ca91b5b961a87,139,105,305274,76919,228355,124,94,301970,75787,226183
2454ab97ae54f068c951381c5bb9a471,21,18,7144,2633,4511,15,16,5566,3195,2371
7252cadfedee5e2ca053914ec3f91602,102,74,158665,33217,125448,89,84,141440,39492,101948
d80f2b31c45c012b7787816f5510590b,140,105,455687,105184,350503,160,105,409259,128853,280406
2abd9575bda0323588fe702dbca2d48c,53,48,51330,18945,32385,32,30,34417,18466,15951
4128c314374d4ebb9ba6dc26da91640e,36,28,31627,12772,18855,40,28,28399,14344,14055
1c3fdca8836e355fd4b3d65007792640,73,56,165302,57436,107866,72,54,141837,53010,88827
eddf3c4a6239ea76ce9c511eddc7e2b0,126,94,267864,65409,202455,110,90,231907,53956,177951
601bedfe1936836911aacf2199a8b49f,130,101,300222,53117,247105,146,81,262972,47780,215192
927b0632eb0b7fe841f6884af859a641,17,17,13489,7996,5493,23,21,18804,7581,11223
57833ff770029565639149800eb02901,60,53,62964,31361,31603,86,72,145073,36539,108534
83ea64bd060a72e06d3eada901cf4d49,60,52,83316,20690,62626,44,33,38136,24406,13730
572f7007d77900b0060a4fdfdd8f641f,72,59,121299,34194,87105,79,50,136060,28353,107707
cc2f3df7e13e14ac0e097894b18bd820,46,29,33975,12910,21065,39,34,26745,16356,10389
2760f13afaa1f369178a7508f8919631,82,67,147522,43184,104338,79,52,175633,37392,138241
15e40db32b9c862be415a1b5e2f7a11a,125,98,261001,53488,207513,155,106,265271,48250,217021
1c00d9cd21906ca76e2b4aa0293cf09f,188,113,494021,89400,404621,196,162,530702,106794,423908
1250d8e3fa9070bd43ad3e6ca7a949ce,32,26,25959,7326,18633,27,22,18325,7609,10716
d8c05f21dd31761722ff181b29f60772,59,46,75684,18730,56954,50,41,56918,23244,33674
ee01d7664dcdcf11f245b33b25ee71db,196,138,750205,109278,640927,170,132,542784,85961,456823
a70c696cae2a360c494f0370fee85185,54,55,110652,36647,74005,81,54,108663,42231,66432
7d9f712f2d834c2642276c2b57aebdf4,125,86,282798,48309,234489,126,90,231573,62368,169205
243daf8a736dc08a6167043f571e58a5,128,85,331543,72480,259063,130,93,361587,66702,294885
204b34f47dc9408a793eea71758cdca2,95,61,119294,25527,93767,83,65,120493,38326,82167
07b8ed43bb1e6b2bac8acaec5520fe7b,161,131,651043,106762,544281,139,106,386463,109267,277196
5083fd3a9a0ecba2ff7655f06ea41f6e,60,44,84379,19533,64846,46,42,45308,21076,24232
6297ab703233541cc953aca1d440d9fa,154,132,730526,153080,577446,194,153,948310,116393,831917
2c9a3fdee182b8f6a9944f0e0ed85477,204,134,491509,119790,371719,167,150,449436,92412,357024
f346f533f080bcfd207bce7919d72f8d,164,125,495733,85367,410366,161,120,339587,95794,243793
9922f8c35289fa28803743a182c21ec5,173,132,505669,81362,424307,154,106,435760,108168,327592
3afa8853beeda0ade7a1646c80f09cde,27,19,18524,5595,12929,25,21,12488,6696,5792
e684aa0b5b759887c427494396cbfdcc,24,22,9505,4214,5291,37,24,17320,6631,10689
6f19df662729f4f6ea1f0e73737edf27,111,88,302094,45427,256667,108,71,168503,48292,120211
fc9e3c3c31b9f87842d64cd831427562,49,34,62090,17390,44700,42,33,49665,18515,31150
86c67d3be6d4c84602c6ba6859710a7d,150,106,471389,163351,308038,213,144,639930,123250,516680
93954c862d5ec2ef52110add3655119a,68,44,95309,24076,71233,87,72,157538,32133,125405
c331671e7382a5bfa54f3b46bde5c459,42,33,44666,17598,27068,47,32,51972,14999,36973
e9142746e61f6ff4dc6ab6bd0b0dfe48,40,31,34383,14137,20246,54,44,63504,16957,46547
7e59da16ceba53efdc97c9b9932ddd07,25,21,5580,4232,1348,21,21,7380,4665,2715
c34040f399bd6b30a5526bff3a0a7056,122,91,254689,61397,193292,130,104,238475,71713,166762
94cc732221dd449cfbea5c60bf51d102,125,115,304507,62881,241626,110,102,342173,72178,269995
679943e9efbb533e6a9403535d0a99bc,115,97,355996,132608,223388,198,158,462026,157091,304935
cb12d46bc08c34e0ff4499c4bc759f42,92,75,161798,41617,120181,126,65,160956,26008,134948
5178e23a496b7a51db8522fe6a4f9e94,35,26,18332,6730,11602,35,20,14078,8326,5752
71a798042f9068381d271cfc64bdddfb,118,98,303718,60169,243549,118,102,312989,60251,252738
359bd9f9af1ddfc7bed8918802c771c1,120,91,272615,63512,209103,123,98,316789,56027,260762
1eb4e6dc0cd3f03229bf19f47294598b,50,35,54933,15946,38987,73,43,79466,20028,59438
f5782188e823a9c2f6e2685c69c04e6b,172,119,456651,65866,390785,124,81,268770,73563,195207
320671f467a0e47c36ca7478b9047ea2,28,28,14825,5584,9241,32,23,12897,7045,5852
3240bd94962812f4ea668a6df508c58c,168,125,646870,103404,543466,151,107,475887,96275,379612
e0285651bfddd8e9ffb75d09ad95380f,127,100,262952,49026,213926,102,87,253841,56032,197809
9caa020ce9ad314e3c4d599d54b360a0,160,112,350007,85653,264354,142,113,345572,108526,237046
4f185aa3784ead3d4c2cdf6d361fc8d8,149,132,369717,53533,316184,120,92,232459,38602,193857
8e93b9da5390a01b7005bf36fc8ab98f,55,43,73616,27068,46548,54,47,71553,29687,41866
88134588beec1417b7664d99722ef6fa,11,10,1281,1110,171,16,15,2046,1403,643
4eecac3ab6f7182b9baf716f6c9c145e,72,64,98965,37665,61300,101,83,141506,22477,119029
64ae4f8227d23fc779fa68aaecd44e46,50,37,45750,20619,25131,50,33,45274,14649,30625
32c5a9eb961cea33ed95b771c2f59053,125,103,212273,42928,169345,106,89,185746,35531,150215
c87b0f00ffd1990df6ecc436b2ba1daa,99,70,159414,37140,122274,83,68,108411,43775,64636
cff2d552e0d15b1b04d4377fdc7c205d,136,102,301626,83634,217992,118,80,258327,54471,203856
346a625940829544ab84670f6ee60e64,113,93,205533,66192,139341,130,111,274245,47092,227153
358fdff84d9aaff561ca367bc1d256d2,128,88,503329,106562,396767,218,154,628734,88394,540340
bc17e71e4a0d7e6d7d0286437652b3f6,52,46,66689,23852,42837,50,37,68528,23180,45348
cc72a2b6d26e10944b014c1bf14b838e,19,20,5439,4741,698,19,16,7312,2376,4936
186eaede665a7809db560024210e6fd1,25,22,9954,4642,5312,28,16,20706,3331,17375
bfd19a1a572f3f1e76e9eb10c74ea789,66,45,136655,55462,81193,124,103,277715,64601,213114
91d64d4beaaf79ca3144fa8c2c4edd7c,26,21,17001,7506,9495,28,20,14034,5935,8099
6b9776737464b9df40c88e77080b795e,174,128,1033903,204017,829886,222,163,1736718,148915,1587803
110394bc91bf13271549189e878fa043,137,127,358896,97071,261825,99,76,262580,88406,174174
334704e67106d586c069bfb407241a2c,101,87,153808,47578,106230,82,71,129823,41558,88265
d84ffbe026ff4d5b2bfb2713eda3ee09,24,20,17535,7402,10133,22,22,19994,6057,13937
9029c15db15a669bb86e0b36cadb384f,45,40,36289,18809,17480,48,38,48585,17968,30617
6f8bbb07d26e310e8ca5ab1988b4d7ce,63,40,74925,13561,61364,30,27,41117,12572,28545
0094f56cb27346c947404f609bb04b81,8,3,856,313,543,6,7,952,665,287
37564d5ec4d2474e669bcbffc2fc0b1a,75,62,151512,41323,110189,90,65,148792,39887,108905
84146d453d094189ed8c569ddb9f6bda,29,19,18470,5677,12793,25,19,13385,6263,7122
0db1a4c38a8ffda2b0d1662c4b78b416,134,114,405592,64237,341355,163,135,399336,89625,309711
8a9f567738616bebbdd3a2bd01b71560,39,24,50220,17662,32558,45,25,47830,11869,35961
5a1d5a2037a3f848bf986e48eb3ccc91,110,83,255254,58511,196743,140,98,310564,65225,245339
c7df33016245163e0b1c7a3680cc5b32,95,76,197428,78432,118996,105,86,225418,82361,143057
bb5e756fe0a1559db42e5038e7d4153b,45,31,41102,15370,25732,42,29,46602,14198,32404
402f865985d9ef9319a3b230c0e319ca,181,122,925366,124285,801081,196,139,794949,198545,596404
5b27aa5f943c04b204fe5f98fff82756,59,42,94622,23972,70650,54,45,77354,25347,52007
9ad9b4a9728722ae5d749c705f50d86f,100,76,184366,40956,143410,134,103,286318,53201,233117
1fbe04080b5bfe890843a0c57acedf6b,76,47,129006,67012,61994,106,90,223362,64726,158636
9be50b9fed16927d957b47f88c21dddf,24,19,17267,6287,10980,35,27,30559,7735,22824
5d3f14970635c6acaf27432b8bb13918,57,34,70213,21532,48681,57,37,73415,27932,45483
41628d699d67cd2cb365b9722276b8a5,92,90,155438,55196,100242,101,72,173992,45777,128215
dcc4050522ddd128c9ad8b32cf41c8a2,136,89,270486,50406,220080,125,100,308524,57357,251167
6305ac26d0fc4e405221c92ae813ac0d,110,91,208952,34304,174648,95,80,151971,34680,117291
2a2a789188074c88d8b3fdf071545b26,135,107,411084,125632,285452,156,133,518942,106731,412211
a7ddebbd05e46184b11f8e69a773ab14,20,14,7908,2049,5859,18,12,6008,2488,3520
5b2e4d1fd4f812cbc856c08d92c9ee77,98,89,191756,50303,141453,136,110,265579,51332,214247
2a7750ec7e0a95ea96a761bc9cb63b77,81,70,233976,58436,175540,101,82,178507,35058,143449
3a7ec7526368a81d4d437ac9f80765e0,30,28,20756,12455,8301,38,28,24709,11123,13586
c81e9ecc73db38d76a63ef050a4ddf49,26,23,16838,6409,10429,30,24,12724,7241,5483
3b1611c7851741885cda63a4ccac6e28,53,41,53817,20621,33196,73,56,94658,19170,75488
6deca05f6d94d15f32fbca2043a95650,2,0,100,0,100,0,2,0,100,-100
6692b61512062ff63413c5132b048346,240,175,1439924,211795,1228129,197,150,1307657,260998,1046659
8a64aeb4e9de55f9c8fa8d9b66a20f36,28,18,11147,3536,7611,20,17,8327,3404,4923
c8ebba87d0fe91f84feb93b09402d381,57,49,71163,25460,45703,68,48,96730,19625,77105
0431a153e31a1db00caa72431a12d831,107,71,212271,42381,169890,102,86,197045,45156,151889
f402db8cb1b39ef6b7a2a95c9c8ef9f8,136,105,232847,47647,185200,102,90,224717,70843,153874
374a3f98d1d883352086118c2efb2082,90,73,133415,54377,79038,112,80,208308,33449,174859
60aecc284b9e2cda8910b069fdfdc7ed,122,86,241190,81576,159614,148,104,298553,53339,245214
3341cefbfaaa47cdcd7fa1b4ef66c678,107,80,162995,34182,128813,61,51,90690,42878,47812
fff8117e45340af82a45a9902461626c,74,61,102182,28737,73445,81,68,126610,32723,93887
ee021c1f4a4862d0b1640ce88b478c0e,71,51,106655,33857,72798,79,55,104859,28416,76443
f201205dbcef5557669d441e1950bf9c,170,122,487258,128565,358693,204,128,566205,102190,464015
7a753d0559505f45538092bd7c9c3d8d,71,38,118427,26577,91850,82,68,96527,19039,77488
6fd3674a9c0b0ac825c2f39d91ceccbb,42,29,50914,15490,35424,50,39,64712,17672,47040
b197539cf74ca36e734e06d76b62a889,18,13,2858,1372,1486,16,14,3587,1388,2199
d330fd7818b126cc9945bcd9d65bc4f2,110,92,337774,152444,185330,189,115,589928,116610,473318
36ec38d5a5010b93d1d388b61a4cd997,206,141,661307,140808,520499,136,99,442022,156916,285106
4b44f51b97a9ba97c509afec1fc71c45,222,152,855337,135777,719560,219,146,994036,190885,803151
8b503b6aeefdd5925bf3ab106295d15e,137,88,281270,54769,226501,131,109,269689,40345,229344
60e317e6ba4e01e6f53731b14f044370,103,80,226289,50617,175672,113,96,294140,68679,225461
1042f49c4b46402819fdd7ae94a7d04d,62,61,91224,35313,55911,63,47,84834,26246,58588
8922eb8e3c066bded9de197e913af171,214,159,728892,150827,578065,182,128,695092,164240,530852
e23464cfa39837d18ce3c31f8eaedff9,109,79,227892,60791,167101,153,100,279734,39535,240199
1ab8751baaee019ef3612500b469802b,27,24,14152,8412,5740,27,25,16361,7086,9275
76ddddbeb8c8ba5a4eb1d752f0c1c362,50,35,87404,24878,62526,48,46,77960,36026,41934
3544a8722eaa6151b2c7a46f948d6054,156,129,281709,58761,222948,123,98,264937,45133,219804
abb3c21f7c517d5ffafe390c52e2d79c,92,78,229618,78280,151338,123,85,226095,73414,152681
fac65d53295e00d9d49c3a6054baeb0e,120,89,259597,35759,223838,105,57,196811,27710,169101
a74db9448cf0f53c1624a90df5b569b6,90,75,169741,64996,104745,130,104,262212,59583,202629
9bedde4613e905a6e1c14d50f4ddf10c,37,34,26887,10942,15945,39,28,33669,10004,23665
0b674599170f6112789a91d932ade5e1,139,122,387841,86079,301762,108,81,280795,52215,228580
0c90713b5b9dfa7484a5b847890ff609,0,0,0,0,0,0,0,0,0,0
b3e03bd08665fb0d3e0b8d9edef310f9,34,32,24986,18943,6043,37,32,44885,10771,34114
f32c1ee85ee8b45023e2b79f66982bf0,201,142,608237,114271,493966,141,105,507924,94649,413275
7c000ac8817cc5fa9377234ca69c5d18,103,81,213467,60384,153083,118,84,308836,44397,264439
37468662b27f784aa8071840f87d0aea,31,23,19030,6576,12454,33,28,14155,9567,4588
ed3b4421bbd9bfc1faf5b1036adbfabc,136,105,345811,82751,263060,130,100,374801,64116,310685
ecb91ad3a8d6ff34d259821d6ed52a18,123,90,436508,81622,354886,168,110,442823,134190,308633
ab33117937a6ba82eeb2890021140efa,48,32,74111,23273,50838,50,41,64744,26897,37847
88359a9017de7f575af344940bfc3398,120,85,319661,92951,226710,145,106,306497,104769,201728
f1443f046a40861480bbdb4e953fd9ea,10,7,1251,783,468,13,7,1654,587,1067
f4a15a105cf2d742f64ad8f35d971293,77,56,93729,19825,73904,69,50,71324,19064,52260
9a073510160b2f1fe426f0a6f97357da,158,135,514114,139288,374826,159,129,430439,124543,305896
51e1bff13fd2674d7e7b671b81d462c2,153,109,341647,97147,244500,148,114,427822,96924,330898
77c679c19c4f986484f1d4dfd28e1347,89,70,125714,31465,94249,82,67,160027,33992,126035
762f6d2329dfc2954ad862550b1cbff3,50,29,52718,12366,40352,50,45,46264,13555,32709
ab8027a962b59e0fb1bd5c0337ba49a8,117,81,224619,41417,183202,130,81,267520,44874,222646
b3eccc1bb24b1e4143d26540646f4482,148,118,347830,102199,245631,178,135,458463,89839,368624
825028fe957585d8aac7e6b4b36d3fda,1,0,55,0,55,2,0,93,0,93
62ed534a7108986143bec4f086de049b,136,107,349582,85448,264134,173,144,480550,100898,379652
062f227a74086a4aee9f0ea69873a7d1,52,42,60019,23857,36162,51,51,57640,26351,31289
e540e0a407aab9b11df82a634a0c5322,14,12,3803,2810,993,25,13,5264,2921,2343
de2eaf16de8cc6c64741dcece9c757fb,123,71,248863,66515,182348,150,114,355889,73697,282192
c02c84b0301a1bc0be922da670b49838,64,54,133289,28907,104382,68,59,105520,48859,56661
23acbf0e3aab2b3356f3854448b553e1,126,74,228906,48890,180016,111,80,346889,71951,274938
a2467fd37c7baba55f02752892b3010d,16,11,1994,1698,296,14,11,3892,1587,2305
5a008fd49716e393d840edddb7b37246,133,89,369455,97818,271637,130,97,470847,106261,364586
45875abc7f106deeea20bf8aa8bc8f50,222,163,711927,184365,527562,213,146,937533,196436,741097
75295670cf68d4ef4a7dc377bf9a2a3b,157,118,456040,113542,342498,153,124,458919,103488,355431
8cce601ebdb8651754c0987a7e84393a,134,101,398472,96744,301728,134,107,383186,110645,272541
fea7faee98fb7376d8ae25cca7f7955e,39,33,35432,13787,21645,47,41,39713,11963,27750
e54f35656c22d0248d1402bc5bd177ce,51,37,55695,14270,41425,69,60,81543,15419,66124
37cc73f5ff369653bfed87e622e7d938,123,72,207714,31962,175752,91,80,143553,52469,91084
41aad6d97f4cc631222f3efbd572a32b,78,71,201044,64156,136888,90,59,249397,47775,201622
248d9b37531aba293e7a4ab7fd1fa10c,69,57,130711,69286,61425,85,70,201812,48574,153238
56d9d54c78a2bb38a5f4807c2904ba4a,34,25,15128,5286,9842,27,19,13553,4715,8838
8c197a82ee4bdbb5f4f5b16f116d5150,17,9,5854,1021,4833,11,10,3851,1367,2484
8da045035efde177bfcb2fe9cd631715,62,41,85982,30874,55108,48,39,65979,36154,29825
55e284fb3d637ab0eb21c1aee9b1e341,89,59,153127,71622,81505,189,138,360438,73075,287363
d9a81ccfd1c9b7eb70e41235b2ffb3c4,181,125,599545,124233,475312,163,128,493117,117823,375294
679ad0c8e39b27c024cb1bbf5bc20f63,118,105,332275,63386,268889,63,53,160892,90107,70785
b660b98311ffc8327298ddcfdd9fbf37,219,153,675249,166802,508447,144,98,376634,107833,268801
da0b02e11a23210fdee66ad203d91f71,109,84,245276,80354,164922,189,118,364346,69055,295291
ae7f1f44e9d76ac74156ba6a7af7518a,37,35,40055,14833,25222,44,34,37574,14154,23420
9eac9efd833c50c020136f17df932c9c,172,123,503201,67397,435804,171,116,607714,98349,509365
65cbd10b925b1b51bbe33dcc3e0eecd5,170,128,476606,89120,387486,141,121,449748,127053,322695
6ad2a36b57bb7f4d91c4c2b9f3ff80fe,33,31,27615,10406,17209,28,28,27585,9916,17669
8bf3145637447511f8e95e88648640f8,137,113,352394,74403,277991,188,140,451863,91364,360499
acd3ea3b24e717cc5a11ee6880eab203,187,127,571772,113273,458499,141,107,384956,103427,281529
736ebb21bd60d5a89dff18eade61c725,38,36,24412,16380,8032,34,31,33975,12996,20979
0c912d2d471ef4de5fa01ad98f59b31f,92,82,154015,32292,121723,113,89,186494,41091,145403
f426466cfcc5097a91aab4e0207eea96,28,22,11177,4747,6430,27,20,13982,3517,10465
5fa8b5fa9a55015d4da871e80e45c4ca,75,55,112772,31066,81706,60,53,82752,30931,51821
56012e19e7e662fc51202c294b1b02bb,61,58,88177,37287,50890,82,61,123578,42982,80596
66fdc269438ae8805fb0eb3a509244a5,66,54,112572,21430,91142,58,48,68472,32600,35872
f7908590eab044258a24eddddd5a73a2,22,18,7415,4178,3237,18,18,5607,5570,37
d71075ec8d3a068bd9e8c6f870c5cfa0,20,16,10492,4295,6197,30,23,16976,5371,11605
11f8ab7c2485ee52e6231cb1e60463b7,35,17,29970,5936,24034,25,20,20833,5584,15249
421857cc9682acdff56743f2529d34bc,18,10,4663,1479,3184,18,15,4084,1263,2821
c236f926bd9706aacb6eb6124f6618a3,47,33,51371,21855,29516,46,32,69695,18804,50891
c54ed355fe3f64564c0edc124cc33ff6,30,25,15217,7132,8085,33,17,18456,6364,12092
b0498f33737ad355b8b9036d037b7bb3,116,94,271614,64161,207453,150,117,311953,81205,230748
471a6022cf5278a8b7015da0973ba578,52,49,96144,36970,59174,80,68,140730,36353,104377
434e5c199b1bfef46b354d1a7adbecad,114,94,245559,78178,167381,126,104,284259,60060,224199
7620b04421b0232cb6f5f96584e234ab,166,125,605510,118103,487407,190,129,869696,94383,775313
3b01b255c9c72b618992b63288436e39,132,91,235423,76736,158687,141,92,255295,65467,189828
9e31312d3fb51ea1f26490c4f4a7ed90,138,101,359739,129732,230007,128,104,433311,91066,342245
ae0f4344aa77f3e279949892e4f0559b,170,134,556909,85229,471680,153,125,443752,82547,361205
326ce322f354de8907799449d7d9614c,28,25,24666,11472,13194,35,26,31697,12429,19268
1012b41b5f08ae3e7325d8603cc55081,83,69,217296,61723,155573,74,60,166460,70662,95798
7b1b44160d9c81e88f8910d93f0cb62f,175,127,414121,84307,329814,150,131,344999,108550,236449
08e1e7a50d45e61552c01eba31a4bc63,171,107,392172,76739,315433,158,129,407160,88884,318276
3b094e29d2ca77ccb322e1512b088a28,40,30,28435,13075,15360,61,48,53685,13918,39767
2b91b3c392b08c62b0a0ed30cd077191,49,43,50722,17226,33496,56,49,56976,18045,38931
24f77ac07054c11828a2e907e84ed035,74,62,145760,38805,106955,48,40,90120,45758,44362
84f9fb0d3efa3a32dc96231d7ffd0b35,42,25,39957,13001,26956,36,29,48617,15615,33002
18498737e3c0b87d5c3674cb9cffec8e,92,69,168386,34363,134023,144,116,253036,47171,205865
be02b2eea00c4757f90b8ddd4e95c06d,131,97,192734,30613,162121,84,72,130887,34869,96018
62852637a2a75ea9b5b2acf0a55d12b5,104,83,195496,37821,157675,148,105,282777,38333,244444
ac7c46b92b4fd7f2022c83870a3d705f,159,106,265216,50385,214831,90,72,146856,41226,105630
fc4712f1b569634ac7ae4b314dab27a1,33,26,29945,17826,12119,32,26,28478,14913,13565
be75ca7b0f9a59ebe83d7c7dc853730b,24,17,3543,2116,1427,21,20,5495,2208,3287
3ad4100b7fcda18375217c9573a9c0d9,86,55,192381,47428,144953,87,74,163238,50356,112882
ed26d37c3c0421ced45c186b2332dc00,133,96,566458,145721,420737,187,160,647836,137728,510108
23498535d45371748802009cdea88735,125,90,332405,76904,255501,152,98,430122,75672,354450
0bf2ffa13a4dfeb4b0330c67af39b7bf,79,69,144967,29133,115834,67,55,95921,35952,59969
900f26948b704cf5c624c42b362ef87e,195,136,719136,156896,562240,211,145,869390,157950,711440
aa1baf07c6a7787a0c8f0b8d23950eb9,39,34,48129,14116,34013,36,26,40578,17661,22917
d7dd5777628ab6473d08fe923975aa09,72,65,99372,28700,70672,50,44,72082,27905,44177
8c96ffd5a780ad35c95b4d11cba6d87b,82,52,146339,40571,105768,78,61,141772,41633,100139
6ccca1dd0ffae93d2bd152695e67068d,82,64,103009,37633,65376,108,82,185827,45686,140141
1e0b52058c26d1427ce80b90bbeeb3d1,33,32,48212,17495,30717,40,29,45556,15188,30368
1c34a8420916f64314e32110f260c7a2,39,33,24237,9751,14486,38,34,23599,12403,11196
0703e1b088ea87304808976401db0955,152,106,330113,76785,253328,135,112,320120,90917,229203
aefbfe3ce97904c5b527d8c71338ed0f,133,120,271639,58613,213026,112,88,213196,50136,163060
6b1443f080fcf9d1d8831c3afed08136,43,34,71201,26233,44968,67,51,62720,35635,27085
6a00e6968173f58b78ede59c180e02e2,106,81,167317,45428,121889,80,63,117350,48699,68651
1551ea88324bf790c4f86d1e0b02a0df,121,108,256290,83054,173236,106,80,227189,64551,162638
e1b26b985612fecff74310d8325bfe9a,67,51,99905,36714,63191,68,61,101114,40587,60527
f7c764e1cf233030644c02c92051288a,102,74,256812,46505,210307,91,73,178325,54846,123479
da715e4c0d0f82601ff270e721e14f08,50,39,60219,24129,36090,81,66,96029,28905,67124
768a9e536a1984c600e59cecabf2fece,28,19,16725,6777,9948,28,20,17903,7094,10809
6e8259a173f58a9b1135d7c413470965,47,37,52094,16510,35584,38,37,35957,19014,16943
11c507b0ad2db826088e7674ebbc058c,45,33,61002,21157,39845,51,38,50853,27104,23749
b3a8521db5fefbda51d2ab81e7a7efc8,199,139,1266866,217446,1049420,227,164,1379072,234020,1145052
5fffb527516724f4802af03a8cde8d6f,40,37,64949,31270,33679,77,52,109585,25996,83589
38fe9a2424e976928e9562382210ed9a,105,83,197228,59741,137487,76,64,106071,41793,64278
66126bfbec88190adc17276f0780c8f1,48,30,49947,19651,30296,39,35,44394,16020,28374
d96af2372a1db62c85769835eb05ebba,122,100,287748,51806,235942,116,104,233017,53435,179582
2027d3f984d085f098e9b6bcaf7629b9,157,136,452041,135318,316723,186,134,544294,120996,423298
84d35e0d555f296ae8a9435fe1073457,1,1,161,106,55,2,1,108,161,-53
87df97360193b327e830743c4d148feb,93,66,156534,30257,126277,91,73,159234,51984,107250
f613f9f69e5aabe44658a5270ad05590,83,71,158548,62478,96070,81,65,162094,53637,108457
49d3c308af8dd2cf6ee0ea6bedde9fcb,138,112,387753,71443,316310,144,118,374891,60167,314724
2f39aeb77639f49187a92682078312c4,108,86,241296,66607,174689,123,88,210072,58200,151872
3271d3fa12f71168fffd2a72487a4f0b,189,155,820152,190191,629961,166,124,736437,116403,620034
ca7ba8801083b68aca43072e276090a3,87,71,215250,87843,127407,155,124,311821,73225,238596
eb7f75a38a352cfae5d4aaedfcfcca34,66,55,101377,25641,75736,73,57,88622,23584,65038
c56c066de9a755dedd57a19617573ae1,57,44,89990,18365,71625,44,37,46246,21190,25056
3ae9f8909207dbe47845a5b7bf3c3c10,77,60,116408,26579,89829,60,49,68284,33249,35035
8eaf7169439ead49525d26411fa70905,83,67,112528,27205,85323,81,65,105517,23547,81970
02cb4341ad1f536a8b16050f5aad69ae,30,18,19928,6961,12967,40,36,37496,10672,26824
5bff7b7269b6f3819ff016d8b6a8ffce,193,158,664612,120968,543644,117,88,315154,96902,218252
23b5eb4a53f81244343a19629559f42e,106,79,282334,91101,191233,143,115,311792,87047,224745
554eae852afb9c157dfae204a4fe9e4c,133,100,248799,60308,188491,124,89,202590,59230,143360
f97fa0294a0b3e107cc88e6317a8a3fe,103,74,146728,26400,120328,80,59,129309,35791,93518
1133f39ca423ae08efdba7c38f1bbcd7,67,52,94167,34347,59820,124,92,200097,40187,159910
02531f66a3442a9d117ab1ee995ddb3a,139,105,410225,54600,355625,171,133,496235,77895,418340
1a0872f20a449fce45d8ec3108b26aa3,138,112,370383,65735,304648,109,84,214298,75619,138679
19c8d7bb9bfbcfe6c2b8b125a461ed27,145,117,290250,88881,201369,109,86,292391,72179,220212
3511d0da0cb99a2c7b3b6b0b03b1ab81,111,86,165232,69042,96190,128,79,256670,39301,217369
ea63afd57b930df17b07ea5a2accb032,164,117,420189,65763,354426,133,111,303758,81913,221845
aa943a7e1ba85d7ef7231d1925b7bbe3,157,106,375605,80477,295128,157,121,317715,99175,218540
795381c86af03ff68dbda78a6b5ddcf2,113,70,249907,104811,145096,160,122,432615,82635,349980
4eba2397a500d8c873d5172409277122,84,87,202373,88593,113780,126,100,279942,51204,228738
8a8b070411c8d6475adfd6ff76ff3031,43,37,29027,16708,12319,35,32,31502,12919,18583
e287d04b85a06fcb68bf0a17dad64311,55,39,47631,24059,23572,51,53,64135,21387,42748
f0a63bc635f6153d4e6a70156009ee77,24,22,21604,7165,14439,25,21,18715,6564,12151
0e60704e9a84a12f0c12c283b95625ba,89,76,134253,34299,99954,69,62,79247,44157,35090
9eda5a592324aaba51e8317d741c49c6,178,126,622380,141907,480473,169,147,870802,112185,758617
072289d3a52d080304cc28c477151345,44,38,41013,17326,23687,43,25,29438,15541,13897
92feadf3604719dae97993da8d74f932,124,95,288141,90875,197266,133,103,400008,77592,322416
2547f8b2eca082de2b140bff8a6c595d,25,25,30682,11596,19086,29,22,27056,8149,18907
d51949d0f76d9aadeea0fc28d76f4369,39,25,24703,11030,13673,43,31,23291,8138,15153
b57cf9f952e557659e81c77e454a49a5,80,71,146520,45377,101143,92,82,156985,31007,125978
a44b207460aec9d4b6ed27bc5faad3af,106,92,441670,83116,358554,151,118,505457,79592,425865
42da70c71804a6b16f0ca9279544a6d2,46,30,64476,22381,42095,63,47,93939,17267,76672
01dab91f387305787331c5e6c300521c,41,35,45166,13473,31693,35,22,28404,10238,18166
a12d166155c499b1ca9e6f09335e6f06,9,9,1483,825,658,10,6,1146,983,163
54c7f34eebb98c184081cd8de91a0492,189,137,728773,119273,609500,166,137,516041,158303,357738
89f2783777a8850f1dcfebe0e9019241,128,92,299445,53735,245710,122,104,266903,75337,191566
bb89348a82fa0cc5f3f3d2db593b24d7,49,44,75021,14679,60342,46,27,39613,16972,22641
8f0d25c11b7b36abf2684796c6678c9e,188,128,515261,74315,440946,136,118,486016,90723,395293
250f46ccea6a489ff06a0f8b724c1389,139,114,296904,45286,251618,132,110,319880,31351,288529
3772dee9111ffae78065e018d1d44848,130,105,296960,79595,217365,134,115,357112,91009,266103
bcc75f9c16cee67ea285c33a11332500,125,81,296484,65089,231395,129,87,345329,84865,260464
aa87bbe4ddf64efd5d744d26f1714a67,147,120,467031,109703,357328,182,134,585892,94077,491815
3f1f28ab94a014ff6198d5b2ce3ca69d,66,58,96506,23978,72528,51,45,58235,23248,34987
8a399fca4ccc3c2bb4689017c812d9b3,75,59,113677,39301,74376,114,85,224148,41179,182969
c2c344ae9c3f8edcae41de2371586355,28,22,25471,8959,16512,33,29,31040,12196,18844
1b8a748a09385bb7b3648fff95114913,50,38,54112,16043,38069,73,65,79917,26192,53725
dac9c2ceea69857a2d4a58dd42aa747b,113,86,267662,68457,199205,106,97,259789,86039,173750
3dcee36da501d4f2c9e566624c3e0a88,31,23,18342,5777,12565,27,25,15950,7189,8761
e5c054e0d4b3e829cd5d8083b30ff1a6,89,67,166483,39217,127266,69,49,97443,40749,56694
61dfd2c8916c18c9bd8190520877b453,66,52,125496,52682,72814,102,88,226366,68262,158104
01fd828417c200399f0aeebcdf60c408,161,122,583079,139498,443581,164,129,607503,198988,408515
5e6441c8407c9d0bd8f74f337182bef0,29,22,17921,5227,12694,40,27,39897,6594,33303
c33458ec59aa0cf7006f4b7856f4d7db,29,21,14765,6476,8289,24,19,9590,7731,1859
fd8e6ffe440c9467d10482a79fc25b52,57,33,74947,27888,47059,70,51,111761,25772,85989
691af299cdeb71eca35995c54e2578d3,87,61,169584,35225,134359,75,50,120418,38267,82151
7dd5b6a878a67ec31ba0438bfda04b4b,79,63,70846,19571,51275,62,60,42745,22826,19919
83aae9029da9c91ecd1c7a71777e029f,132,76,285947,73313,212634,132,93,266065,87285,178780
96d8bb1f31fe39366cae983c2c75d0ef,120,87,272369,62005,210364,118,84,349431,63243,286188
e7cfa80692da6032de7337d1a45cdb3e,19,17,10358,3052,7306,22,14,7092,3429,3663
59139c26b0627b1c89db83025c52e443,128,94,337217,92849,244368,74,59,239583,82113,157470
2eb0ca69f4eac8086fb281e6de26de85,65,40,61123,15187,45936,55,48,74036,18249,55787
15b694186330753576277677a20af699,100,80,205502,43495,162007,73,65,142046,45548,96498
8a34490403d24a53e876d964dcc3a709,39,30,30251,9102,21149,37,30,30465,8958,21507
aed3dc98bcb3c24671131693e8c4518c,144,120,285323,47258,238065,123,101,244401,49908,194493
0d5399f97beadd1b79ba77ae856874db,138,105,409353,111160,298193,161,119,540390,102654,437736
e77e1145067c5670aa19c7cd1ae2543a,36,31,22877,7626,15251,38,30,23190,7149,16041
22527a6946af13caa3c0d522b857e017,82,61,151200,37962,113238,64,50,104600,40582,64018
f026f9f72bc2255f5ef3317f92a06c3e,138,104,353999,92395,261604,200,157,617557,82882,534675
47f186950cbbc3cfa6f7da12f6a160f9,60,40,84518,13949,70569,36,29,52230,17110,35120
a2cd34cbf1e3996ddf651192d68015f5,84,60,215986,87827,128159,157,127,352177,70141,282036
6291464579beb0be031a9bd8dd0eca21,40,29,43824,15175,28649,39,30,37691,15300,22391
3f77f9c4d8cb63dab4a25391a893fc87,113,71,394391,92948,301443,159,137,452335,136430,315905
b462acca640cadde6094edecc2024103,75,56,157684,36437,121247,110,97,237511,51099,186412
74ab4a729eeb91d13ab24910df788d42,149,109,330557,61232,269325,156,133,354929,48808,306121
96034c79d77c2c7aaa013cb2c782a311,30,24,22084,10287,11797,29,24,23729,10496,13233
fe8e85bc1887c80656cbbbbbb20849b9,73,60,140811,35320,105491,101,79,194399,37751,156648
43f8331484efc90a2c1f9c014a0565b1,63,47,77558,25686,51872,56,46,63151,30059,33092
1bfac36df8c5c2c266cd9613a0cb93f0,94,69,147219,42604,104615,91,85,194723,56973,137750
c7ef65c03fce279515eb4a62cb7a3ab2,113,102,219147,46675,172472,117,97,171133,33021,138112
e9953fbd852c2fd0643c562314c3004f,46,41,32953,10579,22374,32,30,26952,9117,17835
7868646bb7baf6739a026ffc9bcb02fb,62,43,91072,26131,64941,57,50,69316,33530,35786
49fd987f9bcb463431f3fa541b3fa541,162,104,506578,97600,408978,167,124,710707,121700,589007
8979d9649040e565012c3cba588ca537,138,112,446418,133572,312846,168,131,619806,141735,478071
e193f6aeb3bf097e725f4c9ce759d9cc,77,62,122161,50047,72114,103,76,165662,40749,124913
7fdbb07a55a012988df90db5bc9449dc,133,89,424652,47897,376755,180,118,623866,67514,556352
d699b5345dcab7bf46e8c5cf10ebbe72,36,27,40294,14658,25636,49,43,35876,18502,17374
a5b83ddcc5e5b1d916eb3b6a9f416979,61,57,82433,39889,42544,62,39,115931,19980,95951
daa92d5986afa75a46f9d006e8b13107,150,112,424890,66446,358444,142,112,434792,90831,343961
9c5ecdf8846bd99f36c956f315769b1f,30,20,22060,5887,16173,40,25,25646,6027,19619
bb2d26d9abc721e541d6c93b648231e9,132,108,458139,142440,315699,166,138,546608,111967,434641
c245c83338ffcb8176238b1de89d5de6,35,25,19117,9947,9170,32,26,26023,8628,17395
d9498cfee490eaa451eef7e99d95c267,22,26,14173,3707,10466,36,24,9848,5841,4007
e369f0ad6dbb17b5985faa1689e7cd13,106,83,215571,32865,182706,116,92,201212,40132,161080
5af9c9b147e4b5ad7612aba4afc6229f,106,75,193303,44072,149231,140,117,233106,51406,181700
71d7d77c8e94a88bb4f67bacf4a76b5f,156,122,550358,111157,439201,142,114,441120,78322,362798
e5340208b73a7374cdd0683658553bf3,144,113,317493,74662,242831,112,90,324594,82736,241858
ff095225683ce946edbb55a7db80e7b0,68,44,120730,31339,89391,47,40,84064,45921,38143
4bc6d6a0db37c32f5516acbe1b736074,104,86,185416,39460,145956,107,93,193927,49563,144364
70fd8b8b0a360bc6135858a4960d45ec,26,19,9675,4658,5017,21,20,8220,5160,3060
0d54cc58cbe88917c0b15d23225d97b9,104,81,239395,66261,173134,134,96,328120,79557,248563
f708bccc4dbba264baef6ea2850218af,59,50,50994,17574,33420,51,41,58110,17839,40271
3791050ccb5fb86bdb4671f5b6b2bba7,195,139,537917,98740,439177,168,132,479245,94585,384660
87c1822f8f567b792584175e8ae8c5b4,17,19,4319,2389,1930,26,18,5760,2294,3466
1fb613269ee842986940bdb78dcfbea1,62,45,57295,22809,34486,82,65,115906,18891,97015
5ca109bd0dcecb63ca59115907644a0d,138,108,379035,72515,306520,184,129,517471,68837,448634
029fb50a630974555e2ff53e610bbd7a,135,111,286743,49233,237510,138,103,335681,44294,291387
d22859600e8e85ff45d1df68998752e7,84,41,91142,25544,65598,80,49,112174,30368,81806
cb2fdce811396f32a9809664a8e7865e,116,90,211714,47489,164225,94,81,173810,48299,125511
0be961adc7f801546bd90bc1eb6a703e,43,31,34128,15651,18477,45,29,45868,13406,32462
5e9cb7351057c21e17ba598a6e046ef9,77,55,69386,25133,44253,44,38,64618,18630,45988
d0f7f1a500ada904292ece01a1c3aa8b,129,107,323117,101741,221376,132,108,261422,102764,158658
50e7613bb131f41e8923cb002bbf34d7,131,108,275661,98592,177069,117,96,269169,87497,181672
a94d858cf3e1ceeb3ba6f739391491ff,31,24,22343,7882,14461,32,24,21982,7661,14321
a243141f29f7d4dd480d7384292c3bc1,96,66,141281,45762,95519,92,68,135529,32092,103437
dd9b789f3f46e044c3a298d742babf58,36,37,39279,20617,18662,35,27,28422,10497,17925
ae8debaa4454ca1457ec19fc1e0b670c,98,80,161398,51105,110293,115,76,243134,49090,194044
b40697bb5b8553ecfcb2f82f181b661b,145,100,271241,53820,217421,120,74,229341,45995,183346
5bde3fac8c93730ad1f4c660989d24e2,126,91,445351,85741,359610,161,134,527332,85995,441337
3c31214033c697e78c40331d9de395bb,92,79,182431,37418,145013,109,87,180569,44015,136554
f2a1725c8b1a8ada0c291b912e748a40,108,79,207098,56550,150548,132,97,273683,61577,212106
93ba4df7ce97c8f754d5e3a4c7af2021,147,125,401764,73850,327914,140,111,350799,66325,284474
07f4429ace8ade2dfc90bfff9826d91b,215,133,1065733,168822,896911,188,141,876076,157269,718807
4312d1039213e81bab6ab9a0f4446af0,52,44,102043,33420,68623,48,45,62540,36993,25547
292e7fb2c607c037b9ed213be5a6ebe8,99,73,134728,25655,109073,49,42,49774,28426,21348
b3fe455574455b187f1e5f3dfc4b2af1,190,146,1081177,180656,900521,184,130,797014,119339,677675
293ff70c87993a5785a50ebf43e6d565,146,125,441189,71048,370141,117,100,313652,69632,244020
1542ebba56a7ba99a27431fb03a0c993,80,60,157285,29847,127438,67,49,110954,39300,71654
7d6a02e910fd983768bb8d8b18181f04,146,109,368996,107311,261685,129,104,358296,130589,227707
5c854be825441a661b0d67ce363f73af,99,93,223155,61709,161446,117,84,197296,49233,148063
32b64c13247c28382af52cc516ef3e28,117,86,166527,47645,118882,87,67,146566,39543,107023
d7906ed33aae82a59de3bce3b7751956,91,79,201167,69230,131937,88,74,183498,51778,131720
be7a5836dfca9647b630256acdd8fb85,111,90,226265,53000,173265,121,95,256076,58711,197365
192ed043b4b9b1312780ee8a51eac7e3,73,54,120263,21259,99004,75,60,85426,28823,56603
b4e02fb3abc0bc2f747075693876a5c0,67,49,62351,17921,44430,46,44,54343,21318,33025
51c4eeef4f62d702714a9634085fbf7d,114,102,279188,66058,213130,102,77,247716,67593,180123
a9bef10d6af71202dcb93c1aa3989877,84,51,127421,31457,95964,62,52,87553,31147,56406
2c56bdff9a7061f12cc5ff7b49c04030,203,150,897721,215205,682516,162,116,719788,170045,549743
1e42003ecc4c987058e9cc94b8d56f41,95,73,147875,31405,116470,87,61,112163,23542,88621
df38cce0e1daa796c1131e3534f85e9c,93,64,190305,53156,137149,149,106,300630,73309,227321
82dd07f3234cf31ee228536db9e692d5,20,12,10880,1594,9286,17,16,5904,2633,3271
b5ea4b32bba00ccc7a1615ab4aeeb67e,29,25,22360,15235,7125,35,23,33596,11013,22583
8118c2a2308f9b1baef3c3f1e5fbb2f3,82,63,147204,55669,91535,102,64,258209,48590,209619
5a8abb34b6ba1aab233fdbec12ef70fd,96,78,162273,70310,91963,140,110,336456,48645,287811
8b046d4fd0e70d564719fd7e7a06a058,15,14,6770,1992,4778,15,15,3424,5097,-1673
9bca0d0337b7a4e2497430ff6275c68f,100,79,151323,35049,116274,96,84,183284,40288,142996
9ca0946699b88a9bfa5bb4d394d366a4,57,43,65931,30004,35927,51,35,69983,27835,42148
18113895be19e82edf2940b781354f6a,92,73,117674,36431,81243,104,77,182949,30343,152606
9d521b1dc3b8c69ff2b101dd51d031f8,64,46,105516,17785,87731,56,35,63345,25951,37394
2c19ab4b55f0039b4f930ed6f07c8bf4,185,122,990916,102543,888373,197,134,834130,90921,743209
1d1d96d121d6d04719589ba6f52079d4,216,137,805507,162225,643282,198,150,714726,168672,546054
2b381b384b7e354245a80c3d883cad5a,100,52,151648,28156,123492,56,50,67408,46665,20743
d1fb0cb06b7745ffc13c573ff6fe8ca4,38,34,67605,22307,45298,39,30,56390,25847,30543
c30da17b81712d1381e25f66febc6334,94,82,202174,60777,141397,129,98,323733,61264,262469
cc6502ab06063c1843d18e8dd7170202,147,122,479233,99491,379742,133,95,401720,111458,290262
d58ec9d5b8fadf82f43a6fc024886699,53,33,39252,11565,27687,45,37,37100,13757,23343
1e95e9d1b118272b284ac98f0da09e94,249,154,1602236,335678,1266558,214,172,1377359,305601,1071758
73021f8200cbeb4edeccc9d03352beb9,65,53,89709,24371,65338,84,59,152109,20913,131196
6ffcd892e886daf6ad76878e992c735e,131,92,224982,53829,171153,100,88,232766,67142,165624
9e73c16f7de1942f56abd6c693952454,232,179,1708610,205767,1502843,219,142,1224233,227169,997064
92464a0becc0bd3d0f371c89ac1aadc4,168,118,493246,112686,380560,147,114,573456,111595,461861
6fd2e80a57f4a76c283cd4d33d43c1fb,89,65,145135,33355,111780,73,66,143544,41482,102062
0cd9b4ab73a7e053375e4b1aa2141e03,106,84,153466,34741,118725,77,67,120015,48494,71521
571be2d9c2405212ac109a9be1a16058,117,87,212603,42509,170094,80,60,156143,48017,108126
2f687004c20d260fa7a1066052070030,116,100,328214,80775,247439,86,64,178205,71399,106806
002559e19a608c49af726eefc3a5189d,155,108,623618,195534,428084,199,156,843997,145783,698214
a556520616a5ee3c12d641264c41d228,31,23,27197,7519,19678,31,23,22364,5939,16425
6fe938a48647b51312f401b729e9a6e1,147,91,414704,88984,325720,177,147,634280,145010,489270
92a8dca12272d9ae9c33a1257553109a,110,83,245683,64433,181250,116,102,345193,54248,290945
56b36352e4b336383be6554d5fe24b67,186,134,500632,61121,439511,166,111,388288,56518,331770
04ec2af86d50e305c0f1103d2e66c33b,31,22,12654,4366,8288,24,23,8716,5964,2752
372386bf884fc4fca686a21060bcab1c,35,29,43786,15059,28727,36,25,35064,17326,17738
7a4ac9bd64af714bcb39cf6b98f248ba,106,62,200707,47080,153627,87,67,134917,46703,88214
d8a616ac52cb2e5787d964b61fe9a991,66,50,130658,26686,103972,57,45,97048,23669,73379
cd2cf10e3c5a0c9f0b68391944b3dccb,55,38,60154,23533,36621,63,46,73527,22480,51047
d94b05cd33e91ebabeb610941aa6af29,36,26,23896,13572,10324,45,32,32617,9596,23021
d206dce984e56a9941f61bc4190c3a17,34,21,15115,7900,7215,29,23,21248,6440,14808
230bb321eedacc501728e48ad4ded026,39,35,43446,23403,20043,41,36,53634,18796,34838
e0fac7080df129e01465484797faff6d,60,53,96885,35096,61789,85,69,93060,43986,49074
f4da6b45a4678f1c8668ddde2f4f3d03,138,109,428784,80481,348303,155,110,431342,85306,346036
aaa17a4ed2fa65ab38e2d8e6a923cdc8,99,82,207002,49343,157659,124,113,255164,41040,214124
abfd4cb7cefd4e117c41d722bd3c1594,74,62,135909,44944,90965,82,63,164347,48043,116304
c3c08e0ecd5d44847da3e1d38e96e318,38,35,26177,11524,14653,42,29,20610,11917,8693
f94bd0f3c1204d4f788f51ca57fe49f8,116,77,272832,80329,192503,89,67,240622,62046,178576
97e7f628dd0a878a6fc7fe5dc4a72bcb,28,20,14719,5722,8997,26,24,11430,6039,5391
2b565f39ea4fadc3b3e7e5834e439ab9,70,56,116339,30172,86167,64,53,129659,23123,106536
908f559e4871816852060c105f642b60,72,62,133923,40180,93743,96,69,150455,48029,102426
0c2df1c51c82bf31dd4c06d6d6bc62e2,121,97,366296,79238,287058,123,95,330848,80699,250149
f5931cfbbc56a3ff0e31e2c55665ec8d,38,23,23294,6500,16794,28,22,16961,4880,12081
8f3b79d232c1a48120f404bb2bc5250e,40,32,50492,20439,30053,53,41,62066,22829,39237
2185489e232b306dc51d47653ad3a465,218,172,1034390,232916,801474,192,128,842125,246599,595526
07f36c38bd0e84bd25f64ea310f11579,97,83,159422,44327,115095,94,74,156200,27174,129026
1e0b59ec9c9c1a2e2f1f1ae65d934c86,170,121,408993,68417,340576,114,79,309536,77766,231770
e8bfac6fc8455c87ff4bd5f5e0f56694,19,15,2779,1429,1350,11,9,1921,1500,421
484a3835f178a938d67be3df4069d985,19,10,8659,2195,6464,14,12,4621,2697,1924
6defe4cc5650f7560805a020fab3f6b7,153,120,413469,51962,361507,118,75,331194,70326,260868
f94cfb38e18426c052cb096cce1c0835,16,17,3704,1551,2153,17,12,2697,1489,1208
4645b1c855f51159003b4c806703901e,137,98,610929,184984,425945,150,118,616444,136623,479821
326209bc6148dc11f88dd52457301610,219,153,633282,82752,550530,179,96,501255,71255,430000
8ac72557e8d3988052fa4e276b3f4e41,33,22,9725,3898,5827,26,24,9754,4464,5290
8d16b10ff7171f009eabbdecc393884a,116,94,236134,50937,185197,132,101,313800,55411,258389
258370ee9eaba929063ee89a1b3dea38,191,132,504749,89853,414896,138,104,441579,87879,353700
f126a5ebbda78104756a2d00a8291968,97,94,288789,63017,225772,145,117,496326,66426,429900
96d8cd6655eae6f72b3fd94d254d9156,0,0,0,0,0,0,0,0,0,0
16bcca06ce3682ee463995908468073b,12,13,2358,1911,447,15,12,3193,1811,1382
0aff3cde2fb29434bce6c37ec80b8b08,123,99,318591,57956,260635,153,96,330069,54707,275362
b3cb63b98db7160344fcced248cf8809,126,101,290662,60074,230588,133,107,320806,58928,261878
f6c363c834be6490194402cc44480103,156,109,532729,81999,450730,140,110,407175,126646,280529
b0832473bd8c8e727e0993fbf3ffa234,94,79,186959,33237,153722,117,89,233043,38160,194883
15a03bf75caa5eb78dce111052b29baa,167,113,598901,106526,492375,220,141,688418,99507,588911
1a64d4570b12ee4c3bb548c32f5d25ba,53,38,124255,42149,82106,48,43,99635,43971,55664
ae2bb09289d5a75745c290c8e4b01e17,157,120,644449,145494,498955,182,151,679189,146898,532291
08dc59e3a2b59b52774632eeea28d278,68,39,84326,14996,69330,80,63,88631,24172,64459
4021e6f4b37539fed6e58894b7139626,70,55,89817,47054,42763,77,57,115253,49451,65802
8c566a45fbac8784ea59144ca9c3e065,154,120,432127,64850,367277,133,112,359285,68276,291009
2c6ab62b08f821109fe44894cc74cdc2,34,20,13488,4658,8830,28,27,9872,6564,3308
0bd78739a18363b74559700ec641799c,69,60,132803,19351,113452,74,61,100217,29238,70979
a5f20871c875ce07f3f3fdce6463e39f,230,179,1349844,257942,1091902,200,159,989649,336820,652829
f785b854ee2e0a34305e2d5dea71fb2a,21,18,5719,3994,1725,24,19,8444,3251,5193
e8f0f31bdad5f48df28696dacc16efff,167,133,635393,152918,482475,141,122,570931,190024,380907
9b818ea2f597d3237bd101066e744afa,101,78,173548,41186,132362,73,64,134454,37870,96584
5f4286bb0e0e751b64ccd5223f6b63ee,176,135,915124,194652,720472,183,134,921754,125266,796488
f7bfd5fcf6ebf1461af48309a746bfb3,95,71,205196,74144,131052,145,122,265028,87269,177759
43608341027efc6f663988c26208c0ae,151,103,487584,101050,386534,171,110,390396,92686,297710
44bb3be9f9c442da08f8b014cc47b514,80,71,185019,94496,90523,184,112,337464,76257,261207
3826d01cedbac775092cf1dbf23d1137,45,38,89506,29031,60475,74,65,151311,35842,115469
4bb1b6c7f38154b2613331aa3bf71203,19,14,6074,3577,2497,21,18,7595,3218,4377
30d443e722aacd81030e122fa35c62c9,137,109,703438,129149,574289,158,136,606980,150484,456496
c110628d09a9c30dd4c6f78560daa1e9,48,34,41074,19363,21711,49,38,58794,18796,39998
f34f3b91929f82270250ddbeaa3ca5a7,157,124,512304,106368,405936,191,147,766041,103607,662434
3552eb2cd018ad4f31e2e854df5784d6,68,50,110151,33825,76326,79,73,139787,33301,106486
65ef093eacbc233781a95a8ca0f30389,40,32,39632,18365,21267,43,35,43883,18285,25598
bb32156751cd29d38c74e7ec50e418c9,130,90,311727,70687,241040,135,89,309585,47668,261917
4a0aadadfe3b9da26395413ae6cf2403,60,49,108115,22537,85578,62,53,74914,23731,51183
dc79ed0ef412d87bc4a0bcd279ff862b,183,135,589375,120766,468609,141,117,562219,97553,464666
dbac5bb8909307a7aa72500bfafa32fb,185,119,681531,220247,461284,174,140,610519,176223,434296
d11a8fa22b517b398b0db4cd4d3a42d0,30,24,11795,5680,6115,18,15,10324,2786,7538
1542e237acad585dae364427b12d1dde,80,61,208757,45080,163677,91,86,207793,63621,144172
da98d7b60273771e0ccc196425dfa9a5,90,57,176579,46598,129981,133,106,329026,39578,289448
43852bd8ea474dfe3141a1ac00f355b2,159,138,949139,184471,764668,221,176,1164369,179324,985045
bfe430bf826956a29c7453add1e680f8,106,83,275337,73180,202157,118,102,294398,79173,215225
074c5bdbdeecad15e19f1453d4eb88f3,29,19,11698,5382,6316,30,22,9791,6210,3581
0a88c9eaa2f798c0171905fbecffd120,85,69,145459,47018,98441,103,76,207085,56835,150250
f75c58ff18a8733590cb28bf9f056348,179,159,718561,193780,524781,179,127,777801,129140,648661
fc4c575bf3293d131142a8917e9fd461,26,19,9029,2869,6160,21,19,12207,3815,8392
d2c49640facc5da7236b77fd7eafd032,74,60,108778,40082,68696,83,66,116931,35152,81779
397b3c578db492f66f0cba2079cc3254,90,69,172598,42335,130263,92,86,163961,58756,105205
52f01898eba899f09c6339e162322e38,97,75,168334,33508,134826,79,64,120405,38064,82341
50baea4e7be13d0f2c4b139b7bcda37f,35,25,24130,6726,17404,26,29,14753,8484,6269
1db6f074ba0ac04404362ed6e1982340,68,50,107648,41593,66055,94,62,213618,42661,170957
39d7f30b826c5c765fe305eb66bae12d,106,74,132104,44232,87872,118,79,142918,47021,95897
e3ec9316e9048bc6046c41688dce6b2f,22,15,6732,2404,4328,16,13,3788,2776,1012
97d8fc4a06370e7dbf31383ed204119f,156,131,377492,96924,280568,142,114,448830,73522,375308
061f3758ccb84ab8daac3649ce1784e3,55,43,81863,32470,49393,61,44,104748,18408,86340
1f43839c9e8c9bd2183c7dd94e03b699,50,33,60230,14843,45387,38,23,44651,13666,30985
cb84520d63dcb6488e6bf27defdcc035,76,53,105032,25870,79162,85,57,125793,29467,96326
e18b31fc9a6837777e3efbe5856e104e,132,94,580913,127825,453088,198,141,769505,134869,634636
dd2570bf4f885ed45b725008b07c9563,11,7,1471,965,506,16,12,2626,1282,1344
fd2162cc6af4becddbb217e1d6ed121c,133,106,354954,93703,261251,147,109,353367,70361,283006
95ab2e9e0a17234b672698c289c69c5f,117,110,292335,72993,219342,94,77,242027,101902,140125
1530bb0be3133c001758de6882ff4514,54,44,81689,31884,49805,55,38,78281,26547,51734
c02fb85deb0f4788db5f7cf23fc6080e,88,69,140191,28779,111412,67,52,75557,24792,50765
1c2299d420a5e6dfc020ee818a70dda5,114,94,267985,58607,209378,81,68,181675,59701,121974
3f80b2df4a7505fc5a31d20b2de85c17,176,125,671438,132826,538612,165,142,683811,169988,513823
36149a733d465e7cf835a6bafdb1c13b,36,35,29916,8334,21582,33,20,22115,8836,13279
9b34bdee943a63b141cd6beb933cce04,67,57,90517,26913,63604,57,40,82177,27481,54696
8f08625ef8d0791d799aa44d3b3106dc,113,96,218068,67887,150181,143,117,341783,60646,281137
8e2995d7d59af5d6a1b210c7da82e9e6,56,53,63162,32668,30494,90,79,137684,28604,109080
19fdd835873140dd14af0e97483dd5b1,51,44,62348,27885,34463,85,62,113908,28347,85561
fd3a26b6d9d166b9034d4710f8fa717f,130,89,290573,50524,240049,179,112,452257,64605,387652
b21667b709c17246de378d078937e3c5,4,3,596,329,267,3,4,329,596,-267
721766f3e499f003798f186728970fa7,96,77,151873,46887,104986,109,82,193369,49613,143756
2975173671155b020b2e325370ca0356,143,104,330685,78715,251970,115,96,263241,84064,179177
c4b63abb4d630f146bc59b1a41b59c94,62,37,98109,19647,78462,69,49,98413,17486,80927
e994b14e25f1e226713af8d41e12c4de,79,73,102120,26101,76019,63,47,76850,18379,58471
88ac1e49d66b00d383c82392ff92b9e3,43,30,30550,5696,24854,29,21,13330,5968,7362
09d6ff363024b88e03cbbc3305844ebf,93,56,216529,91241,125288,86,72,160107,92315,67792
5c5158368ce6d87efaf162a56884cbab,118,95,333373,91495,241878,143,115,390566,79410,311156
17e4578b076fb9a79512be419b6ecb33,99,82,311936,87258,224678,152,128,348434,85069,263365
57a090f33e59cb730af7c68fef6168d3,24,19,17778,8508,9270,31,24,21492,7515,13977
4986cb8e857b4754b25e4aec482a5262,66,54,79149,32755,46394,71,52,98056,23597,74459
d0b282931212b58d4721ee947d034b07,136,71,158800,39693,119107,92,78,139790,27546,112244
75f1ad96b23d5e51ac7aa2ce6c907bfa,145,127,416486,139872,276614,156,100,452677,96309,356368
a2f16a5b1db94f3a6c5c6bd60c70cc95,16,14,3423,1499,1924,18,11,3878,931,2947
19434ebc4e26f5021643cc39182e0a04,32,23,25361,6492,18869,39,32,35369,12365,23004
f6fad68ca4967dd69988a9a57914fc52,42,30,61038,11579,49459,37,27,52530,17145,35385
35065d79d6ee1fe0b4fcc788e979e21b,55,46,88122,19783,68339,70,47,80379,20052,60327
87bf841de1fcaa165ae7d6be91ebcbcd,150,101,550695,87625,463070,179,129,475324,116458,358866
b073dd07f77b6f7546d072019b7635ba,20,17,7332,3250,4082,22,21,11640,3893,7747
a44946f39eab8c8bedf65a53beb90202,74,63,149576,45651,103925,93,77,183849,32039,151810
7f933e4a058bfcd73e7eac78e79586e3,74,44,75806,18012,57794,63,59,68472,25908,42564
a0b451dbb09cafd2f3b60e2de6d5a773,100,77,122098,32911,89187,91,70,165462,39540,125922
3b92c3c4286abdac52de76646803e6ad,35,22,27930,6059,21871,24,21,14946,8073,6873
b76d71771a57b1f8a6526e166e6e913f,142,106,223837,46874,176963,99,86,181764,56180,125584
8e84997ced5cd4239b4009a23cd1fd37,20,20,11699,4225,7474,20,19,8829,3968,4861
602a94c527e24b1709439e6ebb11b1e4,138,84,436095,112734,323361,143,116,447602,133890,313712
1cc7803b7dfda4e287fcec141c416c74,158,127,592298,92472,499826,156,130,528547,139901,388646
17e48ab1b19931ed26b973815f7c376b,80,68,98269,32160,66109,67,55,88735,29955,58780
a053b13e922b5d0512442604193074dc,138,112,486667,100692,385975,141,123,432631,105485,327146
b6c924b5c175add9b785869ffb6b7c57,26,16,15105,4272,10833,23,20,10189,6793,3396
72f95a53c9294444df42504252574379,147,116,382182,81851,300331,128,80,311669,95812,215857
8461b2203268e0c2c99f671cacb2e231,144,109,605525,129859,475666,212,168,850694,162182,688512
ccdb3e6eed6ac2e2ca678f9dc339c942,70,53,92914,29220,63694,52,40,68974,20330,48644
1506722b14c273bf18cb7c306de86183,60,46,71566,29024,42542,47,38,57793,22802,34991
24f73eec1f2bc5464c200c2ecb01a92b,76,53,138068,78018,60050,117,92,244082,61759,182323
e988e0ebddd9f52f6cb0c7c1bda8b467,14,12,4212,2074,2138,20,14,6104,1157,4947
d1a1c5b97f7103fec3b53ced6bf6d4fb,53,35,68651,16629,52022,50,38,47468,25223,22245
4f1ffa22c66f6ff94d59c28f1d646178,151,114,506074,166771,339303,212,125,712980,112961,600019
ffb44c2e5bdd9c7ff3306b95a53f3cf7,103,78,235224,66991,168233,129,102,323212,57594,265618
f028a01387ba06d150951670eb51e73c,90,82,250114,54628,195486,107,92,232804,59252,173552
cc2e23a21a46479cc00a9362dd2ff749,176,123,580716,149392,431324,197,138,1248896,149564,1099332
4acd1923f2b1a73e5eff0019abf5e610,15,13,6248,3780,2468,23,15,14639,3269,11370
4128940c515ee41439bd28ead42d3501,123,79,269708,47900,221808,121,91,261288,47137,214151
7383fa0684721ef26191c0a98007fc94,53,45,71177,20880,50297,48,37,53779,18195,35584
42a2ed48736a62bfb32fc80cc4887423,27,17,16993,4913,12080,20,20,7732,6203,1529
98f95fdb86f17549e362523af47e43f0,2,8,284,936,-652,5,3,677,256,421
280cf83d5b50cd645739b81052c17878,116,74,275492,60894,214598,151,89,325784,45504,280280
7c51d091ab1d6a9973ebda04d8d6370a,164,122,611984,163909,448075,175,128,657505,161226,496279
752412dc395d8f6bd8a1dc333a29fe6f,27,17,15955,3162,12793,36,32,24972,7666,17306
74071554e850a8e14ba9285e9a59c0ad,76,57,151454,37088,114366,79,66,105724,46376,59348
2408aacbd688836d72c202820a3870b2,98,70,158441,37154,121287,71,65,108858,51640,57218
db6b61da6a2fac6504a2f5a6fc6e8765,0,1,0,52,-52,1,0,52,0,52
8c0efa554221f843344a0263b1536d39,25,14,8218,3122,5096,20,13,5542,3895,1647
e8c689724e9a530e386e6bd28f360578,52,37,46652,25412,21240,57,41,59970,19944,40026
61f67639e7eb6b7ebe158e42fc2bcbce,67,56,91478,26783,64695,49,34,67438,20010,47428
44fd99a5148ec7bdc08799e2d6d4e448,41,32,35883,15632,20251,35,28,31659,12130,19529
2d052089de5622e55e2e48c47921d3a2,37,27,43150,10263,32887,33,25,18531,11131,7400
c985e547180d9d8505fc246e2da4afba,169,122,413952,89566,324386,134,112,347142,82452,264690
6911352f4bf3bc594ee5df066db1aaac,22,14,5198,1810,3388,18,15,4046,1511,2535
2929589a3464e62b82ef070e3bfa156b,61,43,79675,22185,57490,56,41,56967,22804,34163
fa371cc3e88a3dbac1cf1a80b8f8d11b,69,49,127772,18461,109311,53,38,81338,15721,65617
65214a453c45b43e3282ded0525c6855,58,50,65508,20660,44848,54,44,64665,31124,33541
35b703b019bc3e7a0b4aaed77478d70e,131,97,273018,97945,175073,173,156,397163,102167,294996
d2791d71347e145c41546b58af14ab02,105,81,257813,45819,211994,92,71,168800,57011,111789
019a497af1b2a214cab08aa24241b100,137,94,388256,61917,326339,125,88,342597,70362,272235
96c13531ec80582172e0c72d8f1bdea3,53,41,61378,25994,35384,74,58,128305,22481,105824
571a4df2797bfb7564e0904965675fb4,73,55,124284,36784,87500,73,64,105314,45712,59602
44d5ef54c61b37177c1f5137919ce9ba,46,37,38758,12170,26588,40,33,34136,9079,25057
277c6b151cd3511a7d9b826769c6445c,143,109,384253,97203,287050,141,100,366300,83751,282549
44eb826af717ea727f7a66ab8cca66df,50,48,54762,17459,37303,46,34,35184,15860,19324
f6f359b437dd94463c5aa09540e99faa,105,90,181762,48924,132838,92,66,164070,33320,130750
e3d06c0fd3ac56c53812de8ef420c292,111,63,160072,31220,128852,97,76,152939,35197,117742
63adb3eb5e3b616732361e90bb28569b,56,43,68818,40640,28178,84,66,143635,30112,113523
b9798f70af7ebe574af7a4f240dc546e,166,130,406517,80271,326246,124,100,367522,69329,298193
cd6123331d4402bcea7323c68b3130ac,84,74,157510,47851,109659,73,66,122969,38923,84046
9b039b27c552a116033d74a6836bcc61,90,62,149708,47598,102110,125,84,245647,34028,211619
8879b2afe8b6dd8c8b0564efbf15ba00,4,3,587,141,446,4,5,169,615,-446
727c15ab3f056a4a781aa82fa91d4020,17,12,4568,1931,2637,15,11,4703,2528,2175
895a2c6d80263644fec715892f1dc3d0,17,15,6983,4202,2781,20,14,6406,4017,2389
ad59e03b5b021255f01e23472039d3ce,31,24,22675,7410,15265,32,25,23859,9457,14402
138b8d12a75f8241341f7a4498a4372e,138,104,327589,66595,260994,125,97,277994,61705,216289
b38998e67ffc818a7f46ed6490ee01fc,169,121,533412,93590,439822,172,123,625675,78442,547233
864742e3e1b765688c5af9d55feed3fa,154,92,464471,79713,384758,216,171,830371,105242,725129
2415f89d68fbd549bf13bc6d1bec4723,0,0,0,0,0,0,0,0,0,0
a4bc12049282c3d839176d1b8255b945,34,27,32741,15424,17317,40,31,33850,15893,17957
1fa9c3991ff20936b0db6bdfbef55016,117,89,280120,50975,229145,143,104,325491,72471,253020
e034938f5644a13f584376a41fc4dbae,86,48,109486,22711,86775,76,57,110020,27084,82936
75626ac28a09fefb05df0f84955c71b0,137,103,294613,80716,213897,159,103,345540,69192,276348
a4b776c5a8993c66a7ce535d653e4e89,72,63,94529,31697,62832,66,43,82875,32409,50466
b3be104b5451e8dfbf6ee32e055f0d4a,151,119,590431,115450,474981,159,115,540312,139745,400567
f2b2af28de1ad94d2a9b49aa33d016e8,93,80,153232,40957,112275,89,75,131755,34885,96870
531c6ec189895b53af08192bdb8e5321,108,95,199914,55628,144286,97,71,189741,36462,153279
b5275009fde10a83c957ac2d743ac80a,81,70,207602,53141,154461,88,79,196107,50035,146072
d04508a8cebaa3f7188e8e4a1c5f120f,115,82,182529,37546,144983,92,76,186279,40204,146075
98215980a71d07a67bb7bbdfda92de9d,35,28,20810,8313,12497,31,24,21009,7984,13025
f5f3b04c2a3b74ef3bebd5cddb1ee16c,141,101,416241,113582,302659,170,112,519772,124173,395599
f136e3d7c292ba1d7780e1f088a48815,49,41,51404,13776,37628,40,32,38721,9823,28898
e3e30109d862c650999dcd01a759e5c7,131,106,482730,115011,367719,181,115,500180,88377,411803
34f41ff25fde8b422d4fe2082abc172b,86,63,195508,71624,123884,100,73,174249,57971,116278
dde02010c2da768039bc2b46bcb1335c,118,84,234949,50974,183975,73,64,137989,47090,90899
51702f471f430e69324cbc86ee81ce46,20,16,7992,2079,5913,26,14,12435,2470,9965
f7b1b1dab97348e2c1ddbfb3b450d5eb,16,13,3429,2353,1076,17,11,3712,2460,1252
2b660305280e4c47587c3a6f273163d4,108,70,248977,34353,214624,104,90,187307,46945,140362
963743379a40428aa86cdb08b6e8cea4,75,51,81952,21830,60122,65,47,63773,21619,42154
2e2e41d4123163ab6f635c968d0448b6,82,46,98765,30864,67901,59,48,84235,31391,52844
c8a6e57d8375738cba54b49c09aa742c,22,16,10775,2535,8240,26,22,10888,3742,7146
6029faf8ea8784f4f010ab085da2b394,77,53,106654,21580,85074,78,69,108085,34780,73305
83c752f8b7c890c2a835531c2e88527f,23,19,12338,3005,9333,26,20,5719,4169,1550
1ac2436c16822837d9e927de62bbbf41,172,143,721392,194657,526735,183,133,1018418,106885,911533
00bcbc31280615e69956e6adf62d06c1,24,23,17244,6723,10521,28,18,16510,6423,10087
10db7fc22616ea9cb8302d8c78e84cb8,178,135,756381,212291,544090,195,131,643299,133858,509441
185b666bb3fd4c937467281d90f629d3,70,57,76742,28533,48209,68,47,89326,26366,62960
4b4350a48f3ddcdda0447c488cc70c38,55,38,46496,11744,34752,46,35,23705,16260,7445
1d7c888e14b0e97c15f1daa37bfe2afe,91,83,165971,56523,109448,106,92,165732,51937,113795
abeac9a4cfd701e7efcc05d1ae744a92,72,65,138927,32848,106079,79,68,155089,33039,122050
b6d0e1f62ceb038dbbd49cf2ab950f7d,90,67,122722,42646,80076,111,86,210815,36674,174141
df411d30e1fcf4fb8e6c6b393faa92bf,24,19,8350,3288,5062,28,19,13870,3915,9955
3e2af226d91fb4cf1afaa3fe37468ed8,187,108,631333,115134,516199,166,121,612671,114725,497946
3323150ed61d9d481febd083612cc2fa,189,140,851326,163363,687963,219,162,942520,152238,790282
f06e0f9142c2ca6e443fd2ad8917d298,92,58,119735,34643,85092,105,75,194402,24788,169614
e9308d2e4e51a6a1e0fb17148f3fcbc7,16,12,1991,905,1086,19,13,2261,1286,975
764928344c9e3cf72aaa4428ed1b323f,24,20,8089,3704,4385,25,18,6751,4469,2282
cb81611e4faf484a0809b728fc3bddbb,90,61,155329,60926,94403,110,81,192841,77106,115735
6f2c079ee9264da57eefb7186c9fbe36,27,15,8966,3042,5924,25,14,11489,2539,8950
d907b06f5b2472a874a9770cf82c893c,31,27,30836,12656,18180,41,38,34522,11797,22725
8b2fd5913683ee8bd3026b7d6d1a6a7f,77,57,194034,49250,144784,115,101,294218,60347,233871
09843073499144010db688aa72c30782,25,20,10447,4282,6165,26,19,10941,4480,6461
5d4281d0835c66c037113ca974f9a4ad,31,24,17159,5950,11209,38,31,35129,7289,27840
0bde2509d76c549aaabb464d39c04348,35,26,27110,7096,20014,45,41,34811,10969,23842
795e7a4948e8ee871c56509d4bbd83e2,80,62,122848,25826,97022,63,49,85765,27907,57858
e36451f5f4389b798371ba42b0a22063,58,48,68698,28605,40093,74,64,104775,24440,80335
926e861794e73aca79bc987f446eda49,126,83,317105,64622,252483,155,100,417967,76232,341735
6661df9fd0f1aeaa20b96d63df95da52,46,39,56055,22385,33670,42,34,56483,15977,40506
533e75ea76784f13e20f0f61a2131888,79,62,165736,48505,117231,97,81,176339,49778,126561
a6ad67c99c0afc3fd5e183e101998a3a,65,52,88372,23814,64558,79,59,90499,23089,67410
f11001ae5e4081ea7ab024621f89347b,139,91,303087,82062,221025,136,91,338629,88080,250549
88224c59e2c63dc7e44c16a556715031,51,38,54427,15296,39131,37,31,32825,22678,10147
be1d1ebd5af093df8dbc9d9874e3244c,96,87,230253,76467,153786,155,125,372244,70991,301253
00a5d238dc57de3a806f47488350ab42,100,80,156588,39065,117523,111,85,239106,43551,195555
7207cc43f36ecea3fe6ca83a6236be80,42,27,35851,14037,21814,62,53,52984,17181,35803
4d5c3f367e542a7dfaf6eef1b81f0be0,189,118,500715,112308,388407,160,135,521664,123339,398325
4342a98471f8da8367e03537f52a4867,96,92,261499,48866,212633,57,44,98074,57422,40652
9d94908c6907ead128acbc7f8b5ea2a8,40,29,43167,16933,26234,59,46,65077,18931,46146
40fa8874254af66d7c471ad932d2955b,163,121,404970,117229,287741,160,125,502258,89580,412678
b6bf38aeeb72bd71dbc907fca3656a1d,96,55,114007,13353,100654,71,45,56869,20249,36620
15d68a4a62a696a1dc35e7fa573d7739,142,115,301923,76981,224942,132,93,403812,55077,348735
b458cddc0a9a65ec5696348764c99f78,44,38,76798,37293,39505,66,63,107231,45883,61348
6aebf5d68878638a7912c77910c46521,34,26,45725,18258,27467,39,26,42071,18664,23407
f9b190dbbaaaf956b186ee1e64b6f496,9,8,3171,867,2304,14,10,2307,942,1365
a47b4944cf0b7047cf7240d7a2ab80d5,26,21,9099,4024,5075,20,21,9082,4003,5079
31cd91cdf4de7ed6efc3d68e96084cee,28,26,24436,9276,15160,31,24,22428,7725,14703
17b8d80abd3d466cabd2a8bb00a96c3c,19,13,6139,2717,3422,19,16,8361,2424,5937
8308d889eb4bc7431e757dc8e4460ec5,116,91,268687,68182,200505,69,69,170796,60518,110278
8c1db6143189717354dc850279780b5f,15,15,4728,3104,1624,22,17,5838,3364,2474
48efa8e02ae052c253550908cabb6765,29,24,16696,5850,10846,30,21,16501,7737,8764
ac84f4772cb5b409f4e1e4800534e03b,1,0,103,0,103,0,0,0,0,0
c10886304733d99e6c709d2575537a41,161,108,339595,90740,248855,166,122,517209,128230,388979
7a650cc8719ac0850fb3aa3b8b80d9e7,86,60,158031,31068,126963,84,54,115661,20990,94671
e2465fbeefa77b4067e6c95698fcb834,39,31,29428,10217,19211,40,32,25308,11885,13423
c32a0a6d884b2084ef06274b700a0ad1,111,81,172308,42614,129694,128,85,232718,47773,184945
46337c091ecc6ca2c19fc0ed7216b29d,159,120,395053,66634,328419,131,97,292300,67889,224411
cd8ad52242898e42d2566e50c58b292a,120,98,277107,79416,197691,159,106,323979,90568,233411
49e83cdadf9cb9e53e3d1a10367fb1ea,29,21,17549,5270,12279,42,30,25716,6157,19559
f24d43d117e2caf03d3c4ab5a3ea51b0,89,72,124032,36268,87764,79,63,104795,24172,80623
fbc1a2e712c4235e57261426d1ad7809,141,112,414024,87772,326252,110,91,237412,96958,140454
5b10f1edfd3c716a3f8c7584f9591171,157,101,354435,91241,263194,153,106,427296,81586,345710
83be8710ba13f533f682d687372ebc2d,45,34,37878,15553,22325,61,51,111399,21475,89924
c2b7940cfceaa3bd4c9842df520fb123,32,26,24540,6902,17638,28,31,18986,9440,9546
fcd4cda9301d9b8a39fef00a2854ebba,102,84,283520,89187,194333,138,105,339007,56104,282903
c6ad1162b1f15b5ec0a9a38569f3a6ff,189,141,586648,96706,489942,138,98,455781,98141,357640
4c852db1af1c839d47655fe46999de3e,105,72,161008,42427,118581,97,85,194263,36989,157274
92af6c6b4e27254af035ba9152c53a76,44,38,50411,21918,28493,48,40,50935,21341,29594
d539b9cf8500c7aa12a0394c3d94fc81,105,78,226868,61574,165294,135,79,368876,56920,311956
33611f17151f90338f701edc22520a23,65,52,77561,22040,55521,60,50,90485,19938,70547
0d97e00cf09e02f3590886a6b26ef071,25,18,5720,3769,1951,29,21,11986,4591,7395
2ac9a903f77fc8911726a6d2558840a7,90,74,148858,45776,103082,98,72,162729,33708,129021
c9726817e9ba929d679589bb1a2334b9,97,84,256165,59437,196728,124,99,270131,62300,207831
4478b868cb11544059a42c19bd26226c,99,80,160589,38240,122349,116,80,182428,36867,145561
2aa8d2e62389c9694a3793b5605d9786,109,62,243985,35794,208191,125,104,273169,56330,216839
75ae9c6ed1165b8ced4acf6c3699949f,109,86,275858,85693,190165,124,113,340963,101327,239636
c82866214e410b407afb6d744aec4f1f,72,54,138074,43705,94369,78,67,156126,49735,106391
f29b4487e46d945ea5a57abe36b7b797,39,21,31191,11385,19806,43,28,32783,16752,16031
b67cb4c76b89a5f7085184f436f71121,34,22,21376,9207,12169,36,24,24113,10662,13451
5497cf2b662b8f6bbcb616d4540d7377,103,71,177611,27556,150055,86,76,211227,41008,170219
8c44e74beeae42b249252f365414db26,161,103,438887,70844,368043,113,78,249247,94413,154834
c977026d59c47032a927aa59df037517,161,110,320486,78187,242299,126,89,404321,57198,347123
0d2fc535eeb3958399427d7b9b64c6e6,45,36,35035,11338,23697,37,40,20454,14411,6043
ba926cc106c62446b570f3e57e975b50,140,111,532027,106895,425132,170,124,926647,161449,765198
dd9be26caead2d6ea92869055a68544d,41,33,49199,18874,30325,61,50,75368,25809,49559
37576ffab0f0fb4b7c84a9f1a0d7081a,134,87,242610,47786,194824,84,71,166316,67792,98524
086c05b424521aad812510bc1e66208b,164,134,433628,84837,348791,93,73,199752,83290,116462
f6756daaaa2e7472155d494870e1e57a,71,64,133878,40843,93035,86,76,153357,45085,108272
35f6be87c42d2d271f2a3341b115368d,165,125,457492,93350,364142,152,107,349432,113908,235524
f8f49af7b00e2cd65a0ae247416e5bda,3,3,434,242,192,4,4,246,404,-158
dc1e7054b9c3789c296d446a8565cff5,26,21,15789,8066,7723,29,20,18650,6055,12595
ec2854395fb065ce68babb9ca0b67ff3,140,81,416487,80223,336264,126,102,300476,88675,211801
940ec2ad7b2f975d4cfdd745dbeaa57c,38,29,48427,14888,33539,50,47,71015,21361,49654
497794757ec84da96ca176dfbc21b82a,47,33,39975,13620,26355,38,31,45832,12133,33699
2e65e1bb68623f90ceb302ca1e0f342f,56,40,75400,16935,58465,55,47,77920,25018,52902
6b5bcf0ab80216ecbb6830cfe9b1362f,104,82,162192,36980,125212,96,80,153346,30468,122878
0c9157f459a9292d43507a2f58bbd8db,72,57,118088,25667,92421,57,47,62958,30484,32474
eb1f3fe062fe226c6c5e5011ce6b6920,34,26,22196,9510,12686,48,38,52748,10708,42040
b899326b4a70cdb67a6aa5e06c3efc55,155,117,352535,54639,297896,81,49,163109,54491,108618
cb39154a8c05ddc3ff24a9e14e308d77,32,22,18925,7198,11727,27,23,15397,5434,9963
bcd53675f7f442c7351686e5d068b328,113,88,177823,33594,144229,78,60,107344,31923,75421
a7714eacef1649462d94a1b57fc99653,40,32,39169,11390,27779,40,37,28019,12555,15464
a6c7af0aa2c5628c2e756034361047fb,79,69,130850,52150,78700,111,74,186503,45745,140758
d910ad8793e12ef0d68b741f9bf62373,57,42,72240,19792,52448,60,57,63340,27262,36078
7020063b33ef4b6ae747332e9d783ab8,132,94,310161,97789,212372,155,128,405545,104381,301164
77f9a76486e5b9a187eb76fc1f8884cd,44,34,52594,19886,32708,50,31,45723,12256,33467
3b1bf2bf4d9f3a12afca0eaa11cbcbe3,79,62,119289,44743,74546,93,77,155588,33740,121848
d5bbc848dd48f27eac20909079bc1491,100,67,276511,59092,217419,80,63,200484,65682,134802
bed53d54a8efc1292f51d9b09aef6b0b,159,127,580607,131862,448745,186,147,770402,148028,622374
bf48a419f474f5648448ad6389787f6f,37,26,38323,6792,31531,38,23,22049,7934,14115
9b9add811b55707dc594448332ea670b,197,147,730327,151704,578623,185,145,709242,173882,535360
1f9f0cc7e81138bd01ce048cafe3ff49,73,58,93280,32959,60321,76,60,105742,28761,76981
b6261506ff608a66708005cfe9693b35,45,34,31745,16179,15566,39,30,37177,15366,21811
d8e19426aaa4876456a33ef96334101a,20,15,6357,2412,3945,15,13,4015,3042,973
5411dc4b9d3ada7263b103e97f2265b2,96,65,167984,26025,141959,75,65,119702,33629,86073
6939fb5b00cf361a84553e8c43a91317,67,46,68560,20880,47680,70,54,56962,14631,42331
f7caef5789c4d53e7b5c186a67c0a8c7,68,54,116868,34806,82062,99,81,176538,39970,136568
4a851da9b7e961baf2dfda52a8af9d35,187,123,696115,124651,571464,166,129,481942,140438,341504
437b2000c6f74a2246250cca5326a1bf,12,12,2392,1326,1066,14,8,3086,1286,1800
a4e7a9ecc6915785606ef34f334ff8c5,123,83,248768,82390,166378,97,69,166010,61470,104540
356ea707369bde93b0cb68daa1f14b61,133,118,339503,107048,232455,154,136,447549,74693,372856
f6977e8dfca3b8da803226dbbb90f98d,130,96,322078,52359,269719,110,97,247531,83252,164279
70c53fb303d38e4a4c6bb0e63b161702,201,125,938089,154231,783858,249,171,1191830,156023,1035807
ffe459c5bbf1ab9eb53a02247438685f,53,38,72245,15558,56687,59,38,86585,18032,68553
e92ad4136b1eab958a378e838034a88b,166,98,366917,94581,272336,158,125,382092,102712,279380
22c32436f3349c973b9931041a347200,6,7,1003,354,649,7,6,354,1003,-649
3251825fc959829dccd90e4b0ea97310,146,118,348296,75125,273171,159,126,410664,62369,348295
a45f78b1da66fd17d7ed0e9f86eaff97,160,111,410007,89050,320957,168,119,496908,94878,402030
a416496bdad5f79276bbf58b5a5aebfa,27,15,8660,3708,4952,21,19,5967,4231,1736
56580e3d75168b4d724fe7e837e4d133,106,83,186162,34255,151907,108,94,160366,38639,121727
e11900565f77ebe69f803e92816393a9,122,97,216642,56116,160526,104,76,184089,51314,132775
ad633b975d192ce3a28cafe0b4f568dc,59,47,74870,24930,49940,63,60,73170,25696,47474
df9300526748207609475dbadd91222e,87,57,111705,36944,74761,103,75,151912,33286,118626
955ee8996cb09f59843458ec3919e389,70,59,98968,30366,68602,86,61,86362,38615,47747
33f92ecdc3cefedbbcdf0fec0258b614,106,84,247502,38355,209147,100,67,181719,41653,140066
ad68034639e3694debb67e5ba96129f0,87,66,169580,52940,116640,115,91,235485,51020,184465
d46d0c82287bb3ab5881fd19eac97e94,192,142,639741,152402,487339,131,114,577627,153152,424475
f28aeda28c078f84ae2fddce83a4fcef,100,67,156073,29059,127014,81,65,103204,42831,60373
4b61f06fe4b8f0001ca50c4c2af8e1d5,100,81,288569,55685,232884,125,111,205811,54614,151197
75e42d6a4a4402b86fdded1325255a60,46,42,47609,15573,32036,58,39,48023,16724,31299
c61b414cc73cbf71febddf9cb44fc713,89,78,118718,41386,77332,81,55,156446,17796,138650
6f42bbb4aea24f5b417e213a80fc3744,123,104,314732,65235,249497,184,132,424169,53110,371059
6bf73c8a6bb14fde52ddf71dd540179a,55,44,44999,16004,28995,57,44,44913,15260,29653
467c6109f5ae847d6b76fd9e40337a6f,142,97,358114,123705,234409,130,66,303990,97289,206701
8a36f81fa014cbb1683b85747bb10079,163,110,218776,34871,183905,87,76,147123,37917,109206
05dd3ecb9f9479441c58cbde34604855,137,99,518599,134545,384054,207,155,673889,139027,534862
146630737b3caae8376d6cb47944ea0d,106,81,202078,64709,137369,103,79,222120,62852,159268
767d2232c7ec07abe71ecdc6123cd836,21,16,9438,3342,6096,20,13,7401,3640,3761
70f997105645e832c57b5819eb52a0bb,129,96,324500,55685,268815,115,93,270786,51512,219274
3372b49f4cc2b1eeea7ecfeb446e5b07,24,23,20764,8829,11935,28,24,16315,8648,7667
694042ab2d2f1e2acfe302af04222454,108,94,226768,63945,162823,111,101,252073,61816,190257
f553e36f26c935f9e0d59c8394b487c3,76,56,131240,31403,99837,56,45,82239,39989,42250
4f49e1997c74f1e3d42b20b3fc26cba8,104,76,199397,79116,120281,81,70,197846,67821,130025
1f674e3b4435e22affdb99d502614329,100,74,200880,39418,161462,85,67,117916,62403,55513
372c15034d000205307cb2c251f0518e,45,32,48306,22702,25604,44,31,53520,19910,33610
94f7afb65fc64f2920e90edd19e1208c,33,27,28601,9721,18880,40,32,33174,12163,21011
ba08dad7b8880a5dd367119b91bbdaba,26,16,7971,3325,4646,18,15,5821,3354,2467
c15e27ea0f8c275833b5a8a9b56b0574,166,135,525714,71426,454288,119,110,270234,68319,201915
ab2dcc64eb6878b07bd8ae7b698e131f,100,71,220326,42660,177666,66,52,110411,46358,64053
e54ee1059b3f7fc95273e22d95b9fbf9,190,146,1011615,156858,854757,206,140,792174,133076,659098
6e2eb7757dfb2e9a6e5d1f99cdb7af2a,42,38,41137,19891,21246,44,33,49039,19177,29862
63d88cad7cf9fb8e8812777154550aad,96,69,173884,36077,137807,99,83,144876,35849,109027
0c073239dc81797e88e2f30231e1e4e1,111,81,238753,59287,179466,136,114,321918,55956,265962
af534fd22b7dceeb230370b7db9209aa,109,79,240579,61482,179097,161,99,321758,73663,248095
9bce2432ab8c6a3277b5d8cfc4700d06,91,74,153955,44112,109843,97,82,182721,49137,133584
2edbb158a656a1c08809bc095ca69d6a,47,31,46137,23123,23014,41,33,58839,22357,36482
7d86a473345011147f384d946ebe7644,130,100,202564,42966,159598,99,85,152505,40389,112116
ff84e243c5dd96a02b2749e045eb9f14,84,67,322089,70402,251687,124,90,376661,97210,279451
f1db0ae9f9e15a74a995eb7f120cf653,174,90,594150,108489,485661,172,120,547806,134329,413477
1504c106d57dd66888a327f5e12500cc,121,90,182208,41844,140364,103,72,189818,38544,151274
ea398cdf8bd0ebeec342195608ecbd22,124,76,239967,52567,187400,112,78,209432,50082,159350
e65f5fcd07dd493f303567180e93c5a6,237,150,918506,127459,791047,249,165,1185733,128594,1057139
189cf7ed1d2e5d2a52968b78ec1c9dd6,28,22,26880,6325,20555,44,37,35314,12807,22507
5e525b7ebac8ba82de10cca020462bf3,106,80,292297,63718,228579,151,125,466154,73486,392668
aed5b7577dc1a96779447f7f556eb2d2,98,84,223575,72543,151032,127,99,305937,89848,216089
b036701a828fadf2fdb5b8d955902da9,110,78,207749,36999,170750,160,100,396959,66040,330919
7422116416609aba7aca0455ac092bb9,139,106,332776,61625,271151,117,83,232119,64861,167258
385412294b57bf7270ebd2f3b0c1ccef,38,32,25451,9926,15525,31,30,18225,11983,6242
9bd2276c955e36ac4edd9cd397bb5dbf,138,111,314961,97436,217525,170,127,474667,84505,390162
78cf2a6082e8f4c2bee530fa85c87ef0,33,23,21379,7246,14133,26,19,13890,3524,10366
2b00c506b77ce2a2da1b11d7fe6f3c59,145,111,497580,67809,429771,166,110,397709,100723,296986
3245bc0554304b554ef6ef573b04d348,46,37,66334,34369,31965,80,58,139123,32631,106492
b11b4a1e4866567fc22fff479e284b61,161,125,589523,139264,450259,176,138,683640,168456,515184
5b9db6389f492dc85b41d89a7273978a,41,28,32550,8212,24338,43,34,28694,12751,15943
c265e356b238bae3ccc5a23f5753fede,111,84,269912,65231,204681,119,91,230529,68955,161574
dd013dd0718a398995b34c74a41d30d8,29,26,19149,7549,11600,23,16,11105,6336,4769
576ceda48e3f47617c3e17036b14c460,99,69,202556,41442,161114,85,68,179670,53026,126644
3b8ca337cb12084ce69fadccfb20f4d6,134,91,335168,107613,227555,113,90,294427,105715,188712
ec81766745568f8110b312b84c528bc7,165,109,547868,117090,430778,176,120,483596,92298,391298
9155d324904bd80dc9a4f535750b1f57,194,163,689794,116050,573744,208,156,701924,95644,606280
92b5f578f2700c29f5cfac7539bb8167,93,83,175271,40648,134623,91,79,207720,31768,175952
38414819b6786d20d7a7036e702e9928,45,28,40851,10595,30256,52,29,51119,9428,41691
d3f6aa102e39f7f23343d8518fe7085d,21,18,6144,2866,3278,18,19,6522,4384,2138
661bab1e8aa65be3eccd8f99defc28e0,63,53,97077,53370,43707,97,75,211968,57418,154550
ff31ff71410d78c0192e15aedbe6f31a,69,63,157659,46870,110789,94,82,146994,57345,89649
1bf389b0162af9942edf547a3c56a9af,95,77,145303,51615,93688,112,77,186329,40371,145958
713f577cb1dc3fbcb2653e0db8c72e6b,5,5,564,559,5,6,5,693,547,146
4694b59de19fbc6b9039d173da0258d2,21,18,8656,3163,5493,26,21,9720,2787,6933
c8fa25fa757601275b56df0e6aed4fc5,42,27,30850,4520,26330,22,17,7255,4727,2528
e21040f5bfb055654be5934546ed0943,29,21,18734,8532,10202,31,26,18808,7841,10967
ef0fc807fe9c838e6d857560ac5d9ba5,128,94,284010,62585,221425,109,97,315403,86440,228963
23783e3e35ce236a181ffb68a9309c95,22,16,7605,1947,5658,22,16,6019,2842,3177
d05ef9c8ab7c43204aeec56df5479b46,60,46,85584,27671,57913,66,53,115085,28524,86561
6e15d855430a775c9522614939876333,130,104,347177,115742,231435,127,104,312537,101173,211364
dcd5f822df0431b36f622ec5bb8c3270,25,19,6997,4547,2450,26,16,9327,3970,5357
7b6ae9e72747e5805a25d2af2421fc41,87,76,247518,126022,121496,136,96,452618,85566,367052
f771863390cf158544f7cbcc5d80282a,123,108,381201,63125,318076,141,107,323470,68114,255356
cf951abf360ec91f4c90a3d98d1cc71e,165,138,452191,121603,330588,132,115,383365,103351,280014
35011e2f31ab4e51540f5b6e2a3f3a52,82,66,154014,42735,111279,82,71,121361,52460,68901
d25daa8b875c3e05e0df5f8bd96aa87a,25,22,19307,9759,9548,24,24,20264,9669,10595
7a1f74085b532bef3ebff4c7a1b72afc,30,21,18780,9365,9415,35,25,22396,7138,15258
884c681132f56089ab432fa43494057b,157,109,417369,77856,339513,143,101,353727,77519,276208
f15bf445906932388a9cd89a99e5d8c5,108,100,196776,34092,162684,112,92,160890,50026,110864
7d20b907352777afac7944b4170d5808,34,30,34999,12283,22716,39,23,32146,10016,22130
268cd5d32e5765bda2e3f6b3aee5edf9,76,65,102697,45896,56801,96,73,135202,39600,95602
9a43b1304d560e4f36981b4d2d3d3826,197,151,728510,100347,628163,188,156,607425,139801,467624
08eaba4c14aa361c67030618582ca10a,158,121,342241,97291,244950,150,117,365713,68968,296745
a590378de9f12b3ffe82a029f028be95,201,144,751251,138051,613200,174,153,586596,154666,431930
b228b29e9cd89437576fe8723749b8d1,143,116,420423,94794,325629,148,128,499322,126636,372686
532b3f3cfacfb55f70f2ec352a54f5ed,104,79,132758,40718,92040,128,96,213471,32822,180649
f4b2e55c9e29a13b34163645ea078bde,25,23,10196,6403,3793,31,27,21132,5800,15332
adcd1a73324a20d5945f31764a3027bd,31,28,26051,8527,17524,35,23,17211,8706,8505
246b402da18acc46ab95e97b17cd22de,165,116,558103,140724,417379,171,120,482751,136539,346212
156cf5156e9ea24bda5aadc01425ffe5,129,115,341442,98461,242981,149,133,404362,113775,290587
a9e1385915f4f7950bb8624d29dc03c2,162,85,323641,45668,277973,141,99,242544,62151,180393
72075950694414106b925f3943794b37,52,48,59318,22103,37215,49,35,42964,20827,22137
64f9ed0879f0747e68cabaad4e5810b6,130,108,327279,103714,223565,148,109,267692,67585,200107
b572c97199ec294720944304d0d313d7,96,80,174118,53119,120999,126,101,258449,37005,221444
721e45b15fb0ce84577510712f5cdea9,2,0,74,0,74,2,3,93,44,49
88793720286c08d94eae5d40481e9385,160,111,472126,102947,369179,172,115,465582,115875,349707
5b0639559f4226c975241ea58e71f5a2,58,45,136505,35052,101453,71,63,108364,44791,63573
e278552e6d18ade128796cd2e4b66c85,48,47,41800,20961,20839,43,40,52770,21304,31466
416d50353db5b8c30485cb7dcd0b62c8,146,112,503600,202599,301001,174,123,514620,116315,398305
f6c1244383aa09034e85cc919d0f35f7,75,51,89393,23115,66278,60,53,93433,19920,73513
55b7e6f2b332cf0aa5d04a09cd6290b8,5,5,781,980,-199,4,4,848,649,199
446cdf7471a9b7ab7e8b43d13b93cfb3,96,74,158610,37783,120827,85,65,122388,34983,87405
bd7843e2e648f3355136dc9a18e71fc7,42,29,40563,13923,26640,36,28,32512,17996,14516
ea86b2e2ec167871602fedcad4a95f71,54,45,72263,29747,42516,75,60,122248,35138,87110
b64f9330e48d94912c5ef86fb89cafaf,84,57,252385,68129,184256,90,57,286713,56230,230483
c60be6d34bebcdacc007b055c7470ac2,49,31,66330,13340,52990,77,71,99184,28235,70949
5922950d2d4090b5fd2fcd9f6b0b6762,182,147,751188,175467,575721,153,127,756211,158495,597716
4b5ad994b5b12dfabe207d2fd7295dc4,116,111,296314,110139,186175,114,95,307110,128202,178908
72579f5b066edc2abc0bc07d084979a5,69,58,170971,67857,103114,169,132,401633,95987,305646
e69bf38b70b3e47d031abd0224dfc632,104,91,268858,51382,217476,89,57,180770,58425,122345
fd8d62a7fc30bdba5ce6b67588ac207f,179,131,592859,115087,477772,167,138,461141,110775,350366
b945a04ec7dc1f653b9e69b52ff782b5,100,75,154488,25899,128589,79,58,84670,35718,48952
db51b2ec3f1a9f55f8c24c4b5937f973,122,99,263033,84593,178440,110,104,220521,71314,149207
485bae46d62f5e397c679bd9734a5351,193,151,676246,122889,553357,218,175,911952,143292,768660
c37d26e06036af6386c31e865471a963,105,75,149302,23277,126025,77,53,72695,20136,52559
412461b22d9446c46bb4a8b075c32f10,9,3,1120,129,991,4,7,258,549,-291
e53e6491304cd3ae747cbf0d91fb0e12,107,95,232767,82827,149940,144,111,362770,85854,276916
a9fc5d467e996b3549ce4f02c8f565d5,95,71,103024,33443,69581,69,52,82989,22275,60714
2e786f52ee80b5104dca4117621fe9a4,38,34,53505,12164,41341,42,25,38646,10129,28517
8020477c3ffe668aa5ba41e2f17ebeb0,12,6,1503,157,1346,6,5,379,610,-231
6452444680b560b6b64375fda0c73f40,106,65,214290,59344,154946,159,107,338729,53764,284965
8816ad74ad0661def76d79f5a8305b4f,53,37,127478,50325,77153,59,39,137339,39794,97545
094f43cae8e29dd6ea7c71cfce984b18,47,35,44156,10012,34144,57,41,38537,15256,23281
65df73207c039fc5d8b5f5e2802feae3,164,106,472355,100032,372323,135,103,482241,98174,384067
cd8afd8580746833452f5259d13b6834,118,100,303766,58803,244963,125,103,250310,65958,184352
dc74ddfe332908ce0c76e8eaf8d6da6e,107,83,162284,34091,128193,92,77,146118,33484,112634
8da3a923dfd5a26623aa7a986ef19156,124,81,304514,53706,250808,141,111,235631,62170,173461
53ed536f5fa4e34ac06a0c819a1fc6fc,135,112,303248,63447,239801,90,74,250645,76820,173825
dc4e417057cc4c5e0ba9d52f4e3d56b9,75,56,111698,50225,61473,70,66,99843,45737,54106
ae7de4de622a98f4f626ed1def479326,4,4,594,436,158,4,4,436,594,-158
c1735f017e6b03576668f904443ba5b3,71,60,123558,28090,95468,56,49,82766,29756,53010
1fc47e37725e163d6e599daaca5c041d,42,25,50655,8138,42517,39,35,43211,11956,31255
860a72aae24a1d77afdaef426f90c124,99,85,178218,46226,131992,116,93,265970,49645,216325
75b470ee5004a6c0502586d6396d0615,187,137,457206,101315,355891,177,145,522078,133117,388961
3f3ceada8c1248d12d0b0f888824d768,104,88,241403,39759,201644,104,89,138882,37619,101263
95b5bf8442e9f72a9f16abdf351084bd,69,61,125764,43129,82635,99,76,164553,39437,125116
5229a639010241284178171094868d6d,155,113,416148,85262,330886,139,101,355808,85593,270215
a0b8aed2c8bf865bbf413592b8a3c04f,226,168,1048115,268719,779396,217,156,1088520,173599,914921
36582568f4448894ec977e67a464fd98,47,46,68119,16994,51125,60,38,82117,20871,61246
e97366d2b0f46c024a5e774015deb7cd,50,42,95905,18118,77787,33,23,40193,16669,23524
1fb61c8056d277c6d38d04b2409b5ed0,127,110,281917,64948,216969,91,81,237769,54292,183477
d13f0f5fff8001facce8cfd5e20e9bfb,0,0,0,0,0,0,0,0,0,0
81c80cb2c48813666a9dd9c70b93cc33,42,32,34238,12104,22134,47,32,32885,13290,19595
d48067c421f9d14e77b32e447904616b,41,26,33437,8684,24753,25,26,17588,12126,5462
b9985393d94a877ef6613947bf7a337e,146,118,353771,95803,257968,162,139,443724,93089,350635
2d234d16c15e5ef62be646c164e04de3,33,21,18820,6809,12011,32,21,24196,8123,16073
f19f632ffa3bdf50bbc14e8078d0aaba,158,112,599139,129614,469525,174,135,822814,152279,670535
d513ca0dca0e4687bcc329bc0c2fd314,132,96,239162,63177,175985,99,70,157020,46148,110872
1dab6fdb92fe475c297326f7df4c9b59,93,71,194614,45087,149527,92,73,143114,50038,93076
ab8bd27e20a99129a36a28418e61ace3,88,70,164800,37965,126835,87,77,174230,48219,126011
9fa68a37401306d40eef1195bd302c64,185,153,664695,89336,575359,191,140,561174,82060,479114
be639318abb405ccf0b85226fcb43f23,14,12,2175,1806,369,16,11,3470,1323,2147
bbce30e26baedec82e37f183ac8b8044,190,120,667989,146358,521631,219,150,703787,140334,563453
00680b1ea7e6066b0a2bf4ed6057a032,144,110,645845,124796,521049,199,138,825080,140846,684234
1c0cd09b3a48dc944967091f48edbb00,29,22,29462,6013,23449,24,24,14723,14050,673
46d2aeefddba8cbcba83baf6b5ad227f,135,114,311455,98814,212641,80,68,187813,100354,87459
c2cb5feadba0d6d43ba9f4bb735f6b0d,168,137,462077,138123,323954,211,128,560106,84212,475894
6ae4de98776429b9b5e7cc6310e0c813,147,99,404399,86113,318286,129,112,311416,88133,223283
c5836f96e1f757bc304407ae473f3a85,43,36,60082,29469,30613,47,42,96678,27587,69091
efe56358d615ef0a7aee127bf36651bb,205,127,776214,159048,617166,194,152,759496,151483,608013
1d7f0d05f9976fce5241dc33d022f061,44,30,54928,13979,40949,50,48,50595,17843,32752
48a8fb39baa6bfd8ca494a4c52977a44,166,121,368362,90116,278246,137,92,391216,58242,332974
3e8f59f80237c3aa9a502e94bb9721b4,11,8,1557,1876,-319,13,12,2359,1653,706
4d7d00b0c14ea8f65f64fa75f8481967,169,109,323317,69615,253702,153,89,266619,71717,194902
b39abcbf32e7c98500bed62646cd494d,69,48,84346,20547,63799,54,38,56029,17603,38426
43179752d1ee75baeaea97750c507162,109,95,327087,89096,237991,104,88,343153,67357,275796
bc0a469adb8d569e3295c7dc8e4f33b9,94,86,191582,50634,140948,127,117,295268,60671,234597
c1bb85a28d2eaf919b47d6e9a15391a2,37,28,27452,8880,18572,31,25,25606,8270,17336
ed6dd4d1f0616cb1cb76b10052690f7b,101,82,196884,32543,164341,93,67,147355,47129,100226
b172fd9da1fe3b7ffcc3a8ee5a8cc57f,15,9,2646,538,2108,10,6,1703,298,1405
13c82cc6993717e1b6e8fe1ca35ab65a,49,46,65409,19974,45435,40,30,69358,12411,56947
2ce77ece91a35d324f7ba31702684e34,71,58,120703,36989,83714,59,39,88631,36067,52564
620ae1af9bad27736b079f8141c55200,115,101,312195,87306,224889,161,125,481846,73027,408819
51f34fc73f55456df94ef04a0247cf2f,12,13,2305,1531,774,19,12,4091,1021,3070
b99f310ca9090cecfd3e779750364be4,153,115,435816,116513,319303,116,89,448858,105242,343616
49b03a51108bb4ea7887d9370ac6881f,86,67,172906,53279,119627,96,82,195875,55931,139944
63757a1731c28c1a719ac1c82c487ba4,113,90,307887,116040,191847,139,107,428435,76853,351582
7c2acabcde82cbc65b74067612758f96,76,56,83509,24305,59204,51,42,61602,25574,36028
c41f51e1e88a8312e9fb61d734ba75a0,20,11,4819,1495,3324,17,14,4064,2001,2063
2061f6865ed64154b42c57b81850b2bd,158,116,412552,104896,307656,161,104,534188,87526,446662
eca093f818321d001165754cbf7ca803,95,79,185475,49514,135961,73,62,143609,49916,93693
fd9ed5a3396a209412a6d947b6692dc8,7,5,972,177,795,4,7,372,851,-479
ff20926d98c44a8edba459e5a45328e5,33,25,33000,11332,21668,47,35,51503,10616,40887
6b261b252c4e3b1038db6a6b29a580f2,149,113,366377,90459,275918,184,145,594703,104438,490265
2021f16d39739309480b15505e412647,42,29,80658,20785,59873,61,46,82736,25981,56755
c2db567a20c0cb8c44828947c49134d8,169,109,396575,99178,297397,140,100,443205,98952,344253
eb44b221791fee835563614381e9b0e1,94,79,184487,41961,142526,74,48,114300,37290,77010
423f6b9ce1ba723ec461d5c546ac4d4d,3,3,286,366,-80,4,3,437,286,151
772810e03c088bd2f84c4160893b9719,39,34,39908,11660,28248,49,29,32390,11423,20967
82e1b94b8bb9bcfab8835ee5126045ff,29,20,18196,5133,13063,45,33,39341,7596,31745
7798ebcef4db9d23cf48f1745ec25728,106,91,238645,40079,198566,88,58,175882,62207,113675
9537a803f82c7dd6a2f283ccb202e5c2,55,39,53357,21119,32238,59,38,72182,16238,55944
f1f0542ab550a80754a669e902a3c61f,130,99,259241,63498,195743,166,114,354534,67049,287485
d855228f841cb14bee8bce3c285daf0c,93,63,159339,45618,113721,95,71,188962,46152,142810
976da620ef686b492d407f57c7e071f5,50,38,36296,24636,11660,55,39,50374,16309,34065
6e2eee01eb3df09fd567d88a7d45dc5b,100,88,266974,53918,213056,109,78,230295,45334,184961
02387481cfd68e80287eef448905f4bb,123,87,237264,46335,190929,96,78,236277,52136,184141
b111285a03052a45ead9ca16b58b3bf3,105,76,252901,50503,202398,110,94,237948,61222,176726
c767d285420403524ee24b4ea6aee483,177,124,777825,134840,642985,177,146,549856,167410,382446
c101eefc34dfbc6b64e2cd4b0f127969,150,122,442980,125671,317309,165,131,589449,129530,459919
052245b2c002691b45506ed360bfb1db,76,45,107911,32758,75153,73,62,88851,36164,52687
85a99060eedceb34dbf191fe4b0bd6d4,94,80,257398,56232,201166,99,87,212981,75695,137286
16f951dacc055b1b41da3b4c7f41f96e,54,33,62253,32493,29760,67,47,94202,24659,69543
162270cd969e41f6b252e9d159128996,140,106,423563,77777,345786,110,73,184842,73326,111516
f2afd79f3ba9b02f7ab3c65f56627c37,104,78,240931,72227,168704,109,77,222425,111380,111045
d4bfedbe77026ae8b624df8dee3e516f,19,15,8143,3572,4571,21,21,8842,5052,3790
faa13c17b140e95f8e6b3a9d4a692b0e,163,124,854944,195610,659334,218,142,852191,155105,697086
e8ded7aa23188cf6f62a21ed69198452,191,151,802481,206765,595716,155,121,609850,185193,424657
def53c42e76d3da0ef71e8a9b91a7e33,163,119,478946,90608,388338,144,118,456054,117611,338443
05439d2abe4a7b05d6f1dfd9e6759aed,160,99,290153,68570,221583,162,109,307011,71482,235529
b0992bdb135f82f96a9132fdd3dbdde9,29,24,16147,5362,10785,26,20,8885,3742,5143
51ed31e0a6f3b1d06beaa5aa00a4a47b,207,152,965370,200181,765189,215,131,1260688,166741,1093947
2a61cc0a32fd7ac812965cb10fc8a435,67,60,98222,30618,67604,53,45,80881,23558,57323
69fae3a7da110540667ef9425e8cd3ef,65,42,104658,24279,80379,94,75,146600,35150,111450
3e07c362e5e1afd3da26d08adfcbb301,27,20,17941,8534,9407,27,28,19771,9348,10423
dd28c4a50ab154bac4057c06f9235e92,29,25,20354,6175,14179,24,21,13729,5860,7869
b39ad60894f1c26a0b99c01768a4d4c0,51,34,55051,12701,42350,39,29,30873,12072,18801
24adce2c937075b1a44d4adc629c30b8,137,114,372628,66854,305774,118,91,288340,60477,227863
cf87c4067d4a1e3c97a363b8d953166c,49,42,49053,15489,33564,41,36,37985,15923,22062
5a4755e3a39b80fc509729c8ffcfc057,80,70,137640,37478,100162,86,74,122846,27652,95194
77588646d089f575348055b3ccc2b39c,6,4,1220,477,743,4,5,477,1164,-687
03a32fd01fa5e642c468572152443a36,195,120,599333,147707,451626,229,132,829030,116523,712507
f24b55176c6b1356a95f2b79b5180522,139,111,470991,121482,349509,145,121,443498,125204,318294
8ee7f3d375f07fa4e4d21dd4aa512478,20,15,6371,2445,3926,18,19,4966,2843,2123
5574a83032fa35fc06312d988e38f930,129,96,213990,45065,168925,99,89,182516,60286,122230
c024ecc478615f0e5629520dfa6a71ba,11,4,1497,387,1110,8,6,1167,1031,136
ef9c2155f8f50c8fee245a2e4eb8e7a4,128,101,325357,51955,273402,174,144,345422,83052,262370
249b997bbb07f6f137e7dd768cf2ed5e,75,41,93975,34240,59735,128,103,222326,46871,175455
daae676e5c642a77f8a30e56d6d56f70,76,54,129502,47349,82153,98,78,195432,41201,154231
48e29d3767cea228e371cc24e147acd8,68,49,114991,29495,85496,86,77,124094,40756,83338
e989db02be3105babf16e7f7bc7ab4f0,80,68,127795,27048,100747,60,37,67326,21509,45817
80e3af6ea66338597d1456d4156fae42,101,75,166538,40518,126020,97,83,191519,47983,143536
73b0a8904ac6dbfd73b318bddfec8391,92,79,164619,57219,107400,119,84,222950,59627,163323
1698fc1a1f15dda015b12838624a33e6,131,121,441613,94655,346958,150,130,558103,88605,469498
06726e4117db39b5126069741a331ac6,231,161,801257,154698,646559,187,106,652635,160836,491799
a8fb01b8356625c90e8ba5c9c83f0826,43,36,38835,18343,20492,45,38,51420,14263,37157
4f63f5920ba92fc9e4462f98df686e5b,1,1,75,10,65,0,1,0,75,-75
9ee412768f339aabfe4f7126f4e9d3b5,127,103,273355,60817,212538,122,99,219232,46023,173209
524abc4708f4afa2d4b3139de2f921aa,4,4,148,847,-699,7,4,1793,190,1603
9d05c238e5141d7df2b4beacba7047e2,133,99,294402,52069,242333,137,99,288787,50904,237883
504e6f8664bd1a701db1c0ac20e6380d,98,88,178859,38707,140152,106,83,242902,33239,209663
d01514a8c1e11ece3b53f2d41eef829e,27,19,20119,5145,14974,25,21,16853,6663,10190
348ebae120d149ed9a9a55cedd550676,23,15,9172,2056,7116,25,16,9737,2352,7385
2bdf751b8c06564a7fbe45b5b694ec2f,35,28,26461,9579,16882,38,28,28560,10267,18293
14d035203686094496eb3774e84d4751,81,67,137998,43043,94955,88,71,174280,31988,142292
bcd3d7d86c16cd0a4aed6714e4225fa7,98,86,139960,38585,101375,93,66,105278,25278,80000
a6e92d1369e8ea0d54f0d13fc658b6bb,58,49,70749,34181,36568,49,45,66385,24710,41675
91ed9b6313bf83b1eb7692660a42ef1e,188,140,523045,74995,448050,130,111,333686,76987,256699
cc60c7e762939f49a1e3599a5d1ad64c,31,24,25193,18961,6232,44,31,52009,14172,37837
e5b49a815f84a1daff61a620e89ffe54,26,24,24571,5548,19023,32,24,17387,9478,7909
30be9c03be5f345b9df60881b935bbc1,28,22,22814,7564,15250,22,19,18173,7167,11006
e59dae7b0935259e109e26335988d55c,170,127,383760,57520,326240,177,131,554261,77525,476736
bc3f8d1d8f02bb6417d7b169aebc3af3,125,88,219076,54643,164433,92,64,163623,43933,119690
dd1640dca46132510c4fab8ce98e5f10,90,75,116417,36308,80109,86,70,138479,36330,102149
563069d32a63ee55244bce4dfca8c72a,170,142,568480,130978,437502,192,144,552855,105825,447030
a6fd33008d16dc05749ce81e330462b6,134,84,299366,61962,237404,165,125,386052,69891,316161
d25da39f1389eda8a941febcc7c0263e,26,21,11898,5324,6574,22,21,14612,5138,9474
568e57432109668912b877c8f6be2825,94,71,213185,46975,166210,136,103,291039,71113,219926
00f577362256effaeefdf09d741be7a9,9,5,569,945,-376,7,7,1133,444,689
65b6b9f670ae72ee93480ead1ad14f97,34,26,36440,15895,20545,42,28,35953,10822,25131
f3b1f2cbc57a4c72fe779ed3da3f0367,60,40,100718,31907,68811,39,33,73295,25893,47402
08db9a277ccd58b39bca68af6bc17de3,72,56,68863,30254,38609,48,41,71854,18225,53629
085a7f2e5afd73797b812f927a3ce6fa,81,61,131038,42631,88407,116,88,203416,44426,158990
41fcb19c06a0b6d1265b145c74b5f024,137,85,250297,104654,145643,148,98,294756,91975,202781
1e81697283c46b809547610827e696f4,24,15,16946,5515,11431,34,27,30008,11793,18215
6d336fbf2f945f0a47b0cae5b27b9445,108,65,153363,39834,113529,103,54,135107,28213,106894
7f1663a45d192a962d3bae8f7e4b4559,113,89,252532,48812,203720,146,113,292442,60068,232374
5d68db1544258c23c299f8dc2fbf5326,53,49,92592,27622,64970,84,58,111835,34485,77350
ba32ea7a0b61abb01ddda35dd5e7c4c8,165,101,352635,60834,291801,122,83,239375,60015,179360
d123749f15db7eee9861eebbbd3a156e,91,67,143977,40996,102981,72,49,123129,41625,81504
6f0cdb127954d36075f49a6d0c7aaf4c,34,29,21727,8575,13152,38,26,25030,9892,15138
680b742f7b1a398802404d8571c9ba70,59,31,58668,20132,38536,65,65,67747,23965,43782
bfd07073c645857d47f0501d4aeb63bb,86,67,200058,67537,132521,89,71,191302,47603,143699
d9a9d40e4100af7184651f53b6262023,120,95,201287,52638,148649,120,107,282284,58890,223394
4e9be1d0a4a36959d3b0c1ed4ea07b69,85,63,141277,29709,111568,82,68,116936,29498,87438
7e7e97f130875f092f5266aff36309e2,28,20,12281,4979,7302,27,25,12545,5272,7273
23427068fbcb553b8ee1975c86fc593d,49,36,69366,33538,35828,54,38,109040,24245,84795
92c787fc67bcbbcd5aeb7cc07abd1a61,142,109,644833,156969,487864,208,162,704274,186941,517333
3dc82f95d10f791b7e90320b0cabbef0,20,18,6094,6253,-159,28,19,11514,3377,8137
03f1c076b4ac6690a7dc0c0a0d26f454,138,85,221190,58936,162254,150,95,291034,49888,241146
44a4f0a5552def3811b8f162e2eb3cd2,139,114,406343,81671,324672,162,120,534482,82611,451871
03a565c39e3339b4f626a359b7b902d7,132,95,243876,52847,191029,119,88,222246,42151,180095
e919cd23d14ff169258c6140732d1b22,34,30,22101,7775,14326,22,20,18882,6327,12555
a4604ffad34c7d3abd113a527c47a1ce,178,119,523975,75212,448763,197,137,578965,91506,487459
0c07709e37cccfdce93a77a5eb018037,82,67,130910,38987,91923,68,59,112173,39739,72434
6a38dfbb87f46e3db36e09823c21a805,47,33,35252,13285,21967,42,38,35667,9932,25735
6af4190391c19bcd504224d884f1ce21,52,41,66700,16445,50255,57,39,50051,14094,35957
e12c3f0a1d698ba85b9f786672cb1425,22,23,19576,10647,8929,41,29,47372,9755,37617
8fe8871d368785c641729af0407a60ca,28,24,16135,4852,11283,25,22,11707,8245,3462
b627f8c24ce06090cbc9c9228c0e881c,32,22,21508,11057,10451,35,23,34190,7931,26259
43d3c618e405764ab5b4bde02f4d3fd2,151,119,346480,74223,272257,88,70,187044,64118,122926
b124d263c46dfe250c4854887639063c,178,116,587116,91113,496003,180,131,538905,87209,451696
22d00e44f09c2f822e28eb0432a05719,40,24,29126,6275,22851,35,22,34220,5600,28620
fd4a9d7162a52ee5ffb5417302ecd071,111,68,124663,30361,94302,90,65,132984,32809,100175
8e3aee4a494def0a3117156bc812b0e6,187,136,1002462,219990,782472,209,137,975964,147202,828762
f7e5b11d7144aebaa6a4881d9feb3938,193,135,984908,139727,845181,228,144,1019465,153967,865498
b0d99d50571dbc995651230d1f01c610,98,83,329352,114887,214465,177,145,540268,123155,417113
a5a970289614767b52210dfb76b8015f,24,19,11674,3589,8085,25,27,13590,5248,8342
237787e9079c1d8555b269302761ab5a,159,132,466481,105501,360980,143,119,469848,144089,325759
c9ce6b1ced19d2438e9e2806d6aff163,172,99,434635,100560,334075,164,126,540026,128449,411577
3435c2fed4d0c1a5bec1f50b186d7ae3,91,76,220038,59857,160181,107,79,280730,71516,209214
02d82982570e5f598b11e41af04862a5,61,36,69117,16272,52845,35,32,39440,20678,18762
5f3d8d93dbec0c324ccf10f87bcbfcb6,74,68,107163,39021,68142,76,44,123136,24823,98313
f443b4143ec912b30b9223b022c5fcf1,137,77,195796,75858,119938,135,87,202039,57171,144868
214520a0a1692030f474db26868fe7d7,24,17,9111,2261,6850,25,19,6539,3502,3037
4dc840dd2ca9f5fc0c7ff8ec26a562a2,171,131,524894,119918,404976,166,133,481046,116252,364794
8ea35c56b8d97fb5517c849aa3398ee0,80,60,88068,26154,61914,72,42,118864,16857,102007
39c66512ba579c0b5b9308219bbad3cc,33,22,24178,11013,13165,29,26,23315,11403,11912
e655a2363dec3b2c0e177b702d73d0ef,78,69,110257,31953,78304,54,46,87375,27854,59521
d278973fd86e7c485ecc191b6c260585,16,19,5208,3834,1374,22,10,7534,2203,5331
79e3a556170d660698d05c57d77ed3ec,58,45,82751,26476,56275,65,46,73012,19491,53521
2e63d1c85e68304e6a97d303014a8b59,146,116,304575,109183,195392,112,86,238970,64789,174181
8ea30abc0983ba92890f8fef50dd7df3,33,30,20418,10406,10012,30,24,17971,7084,10887
f44d82bc113b4400b2276fbf6f42efaf,127,101,288656,90737,197919,144,110,359175,67213,291962
0470b9e05f1de7aef5d39f244b713a59,193,136,904631,153705,750926,192,103,588819,184502,404317
89a3ce8bcd896e3d43c2f96b8292fe6f,121,85,201286,55538,145748,128,94,221286,69431,151855
9f4abae81f7fa297217ef86f18ab5825,93,73,273394,86982,186412,108,79,326943,97851,229092
a218f621523b6ab6df1505418e6b04f1,191,134,413888,130658,283230,142,94,409262,78832,330430
0e4b18c0cbe404c6d13815a3f542677d,121,82,356560,84523,272037,106,92,297539,118728,178811
04e2623cb0af7b24d6b2f8f79f21f4e4,32,22,19987,5973,14014,38,29,19436,7995,11441
13a5f81ba3dac72e7585d9e747c6e3b1,84,66,135693,24118,111575,72,55,79191,38155,41036
a403e3acde06822c0190aa923c7bdc43,128,88,374627,91731,282896,149,109,451778,107153,344625
3ce43945c5286397c4603c37698dc933,25,18,13231,5825,7406,24,21,14326,7282,7044
4906881f6a83b31015eb1a973a765dba,19,14,6086,2324,3762,18,18,5290,3297,1993
eab7dddb680f241fc6491437af45551f,117,86,307014,87698,219316,134,104,355144,97134,258010
b7e38aa4e68c26086001efab2b66f26e,21,16,3857,2371,1486,18,18,3355,1999,1356
26deb0eef1db9176d752d1542448274a,168,139,577677,98732,478945,117,102,396929,82297,314632
eb2dc423aa2fa21f6be767d9921cb27f,128,99,222068,50808,171260,135,83,244858,44019,200839
cfd4baa78c37ccff71becc9d1c8bada2,53,35,84612,15742,68870,52,52,42987,23635,19352
0e68dfdd1d37db586263e23c0c489176,190,143,914377,137977,776400,146,87,393519,122587,270932
53c108f90c6da57a75b8ec0fa27f4cdd,225,163,1214168,174306,1039862,164,133,855154,133184,721970
63e6af95286d09db35973ad1abaf4bbe,61,37,66571,20468,46103,70,50,61078,19978,41100
bef79055c8b595c72d155be44639a20d,129,107,307812,94010,213802,154,110,299925,58354,241571
370cde50887e600d3c23a092d6959c79,148,119,350799,67945,282854,122,95,288458,62678,225780
2e8d4df0ceac5057ece7ca8984e417f1,97,83,184924,109263,75661,176,146,418925,94066,324859
6ecac0da57a19d275c2198d32237eb4c,73,54,116818,27292,89526,55,49,76279,32668,43611
ddb3e0b5588d8d14721a96dd2c01e475,64,43,90757,26939,63818,78,58,117724,25369,92355
4b387c7859933f559191dcefd40ac6fb,106,78,234814,77908,156906,109,94,249392,64984,184408
eee717a87a968014dca43713b393f587,64,60,96898,31151,65747,71,58,106042,25085,80957
4073458d2f5b9d93408de36d2023fb71,132,84,236295,41482,194813,103,85,196483,47359,149124
18d7e6d205fa6be4b4d82ebe52487cef,146,112,484005,121102,362903,140,101,530347,93486,436861
a59fde49c361d8503cea6ac729ae5d8e,112,93,580787,164010,416777,165,112,596831,148611,448220
85ffe79cda2b5a91c831a0805fc2d59f,72,59,120426,27658,92768,93,77,148251,34271,113980
1a719a7c661be4b56250a44426b43a09,96,82,164773,67544,97229,146,99,286312,52879,233433
b956ee8136c5667589a6f16bb9755566,35,31,24110,7402,16708,29,20,15053,5540,9513
155c863a2a871fa81539b3d7efb9e97f,151,113,367836,88511,279325,122,100,289030,90702,198328
6fc877c0de3d0c1c4b18378817291e03,157,101,389783,76535,313248,129,81,309370,120931,188439
23d72ed889c840761c9f33fdf8f5a2aa,38,32,48871,17446,31425,39,25,35294,14574,20720
e5257034294b0bc591f24877dd67a5ea,62,53,176995,46484,130511,72,68,154258,42743,111515
3c5cd24603dfdcd2d4f3cb2d3f56fb11,82,67,115989,37558,78431,67,48,81561,24870,56691
e085aca7ba8ad4983d4598d048de5332,28,28,28414,12865,15549,33,24,36565,10780,25785
81da076c1885cf4ff47e74038a53cf63,158,131,507059,98458,408601,174,119,554993,147718,407275
f3fce7f553985c721fdb15a2e66eb889,200,117,565833,80897,484936,173,107,337726,106837,230889
30e6075ca816a8c1219f042c350a9151,166,141,492788,118058,374730,158,113,508228,85872,422356
ba26466625aa50ed60ac6c06bd8fdb2b,89,62,146620,39808,106812,105,77,190769,59631,131138
10325eae0a5a92bbec7e296c98fc9b00,119,95,275137,113393,161744,126,97,368758,86244,282514
5ecca4320c22bceff82e654c648cd852,161,142,420361,97664,322697,180,111,406191,64655,341536
4d6031750285e3d71f8b03f23fdce7ba,35,30,33996,14144,19852,37,31,30554,15747,14807
c65c2a3d8fadab2d757e5439040e06a2,70,46,77597,24899,52698,48,43,54463,24780,29683
3f534b953fce81dfe520c099111eeb14,108,93,249708,78214,171494,138,114,335787,74661,261126
141f01ca3b01dd0979b2b0d7c1ae5838,109,85,188395,28169,160226,86,81,166710,39450,127260
d0fd27b48eac44113631c8ab3ce6f815,137,103,371834,62111,309723,152,131,381373,73199,308174
711aefef279284331c97ddc1690ed200,54,42,80511,26302,54209,80,60,100171,27450,72721
e39d415727a37c450d264bd275762da0,49,31,29233,12579,16654,39,32,29838,13953,15885
fda45a2710f8804fdbe24a3900e9b37c,61,44,66251,21292,44959,71,60,95987,27171,68816
4cfcd843acb9b79384260d3ae7832190,88,70,173349,32230,141119,83,58,93351,43498,49853
a2b44949354d828250b425c6242601ec,175,132,828282,193501,634781,193,153,1061314,146434,914880
66b035c70e37a757d96c7358924a032a,139,92,251885,54730,197155,115,100,207550,71378,136172
0ca90b6e76e07dec39a73b6f37dc0c12,104,74,252975,73875,179100,113,102,271671,64191,207480
5d697e7c2874f78a40e3e19641bbb726,41,24,30505,9554,20951,40,28,28086,9856,18230
114012eba83438bfbac4f5f33d72c0ac,243,181,1556401,163393,1393008,179,136,1061362,175483,885879
cfa954f4f924ef43dbdebc3c37e03bee,83,67,166337,57913,108424,87,81,186632,65465,121167
3a259debdf67ecbdab5e7b7b68fa4162,149,115,329589,78790,250799,96,64,186582,86115,100467
3c27e84db7e445a1776af4377a4fb947,37,32,23953,8126,15827,38,31,27062,8729,18333
45fcd404929a3ce2106920c2346d5ece,159,119,483492,150167,333325,210,134,523538,92670,430868
8fae5fa6a6278289e7a58ef52f58599c,25,23,17963,7159,10804,26,19,17528,5526,12002
8faba225ac797dbfa659887fb0077e01,77,50,75747,15077,60670,68,57,67137,19543,47594
24b380f05eb0ccdaf88348ce089da670,49,30,46212,15609,30603,35,26,37290,13383,23907
e73c522479e7b810929e8e0de46a1444,96,79,110697,27411,83286,124,97,182997,23927,159070
84e841b9d686691e6eb40c9cca58a0a5,215,134,975745,196345,779400,190,150,1043741,161977,881764
5c5b9cff390a3bec46f67b52eaec48a3,23,16,16154,3648,12506,25,19,18629,4372,14257
1c405a3fc2dfc73e8e8e5c07dc9226e8,20,18,5279,3325,1954,15,12,4052,2972,1080
567c915796b6ef640ac924079d326a77,65,46,83361,20377,62984,54,51,45652,17231,28421
804b1df1de1abb5abe1c139137e463ab,107,66,199851,68396,131455,108,86,321574,74662,246912
f512f4d54d3caf0ced5b17f082150796,68,56,92973,27017,65956,70,68,97525,29783,67742
20f770fda2f5a821c3bfaac3949dd385,26,21,10449,6294,4155,24,19,13509,5277,8232
402c989be906d636dd3593b9ae44b030,29,20,23508,9786,13722,32,31,31664,13598,18066
9d53049d39f63312504bb4738971a7bc,53,51,67317,26623,40694,52,43,45529,25876,19653
c489fdf8f19953a12db5e3b1a5cb5074,129,94,299326,106200,193126,109,79,266982,111796,155186
1a8640691bea943aba8f690d2ee32e10,16,19,9549,4610,4939,17,13,2549,1132,1417
97c578663ca181b2ad994ca4975ab91e,226,148,963932,187877,776055,235,171,813144,253421,559723
f3fdfbc2728a684ab17434a6d69a6174,85,83,133436,34327,99109,53,38,74214,26836,47378
b6bdc9cfabc65efeddb7c7d38d7cef9a,62,59,98492,49251,49241,91,73,169649,33384,136265
901f9878d1e1eb2af78fd3cbff040330,193,145,602330,166586,435744,208,153,959479,164534,794945
d047a20646eb3802cc96c01199a38ada,46,39,48778,24939,23839,46,33,38707,20992,17715
34c9728aa214c7c11d872463c324af00,25,23,10865,3038,7827,31,24,14372,5196,9176
812c85c442f40e1d11f8735f46362165,169,122,491044,92978,398066,146,112,463223,98367,364856
95b28478c3c1336e98f9187a2444a51c,137,93,354051,89259,264792,117,68,294618,73632,220986
8f0f9c3b3e33239c5abce9780a52734d,31,20,14315,4082,10233,33,18,11439,5050,6389
6e31f6f68b964660a2c0cc5269bf05f0,50,43,58686,19823,38863,72,61,105780,28444,77336
1dac462ed6cbd3ed0797225d5d986e94,74,58,91872,31448,60424,65,51,80756,33736,47020
b0f9958b7522cb2606fc1df09f9d85a2,80,60,136145,48431,87714,89,76,178450,45985,132465
f5818c5e5b5943fa0bd8ab1641ec2c15,48,34,51960,16541,35419,34,28,35141,17492,17649
9308503c3f5affdbc11d71b057e9dc49,68,58,146856,47500,99356,63,50,122530,40966,81564
4ee977395549ee0ded26b345fe0123b7,117,96,245760,65734,180026,100,77,185603,55655,129948
a801fd015fe7079abeb635d56a6b19de,162,119,390789,58765,332024,143,114,358776,60334,298442
0ab61a4833a54341ebd4169b7d603000,133,98,220630,65921,154709,127,87,289077,49769,239308
115104222870e4f0c37a453ef61271fd,32,23,26569,11906,14663,35,21,30966,8953,22013
d9415fb3ff2dc000c2c350ff8b190800,56,46,71469,23260,48209,58,46,73616,21463,52153
53aa1978e499e7022442cf37ce791c2b,56,40,64575,18690,45885,55,41,72980,18343,54637
e4a14c672820e2f61f85c7eb1031a2ed,61,48,78229,34804,43425,61,59,77418,34900,42518
17fdcd3a4ec58a80ac10d60cd2b31998,77,56,79294,26348,52946,54,57,79366,20329,59037
ee1b8c7376d2dd4d44ac936beac00923,167,130,514282,108243,406039,138,122,400542,88164,312378
69efe1ed3f43e875c56b5f3ec6bb7126,149,123,587939,131138,456801,163,122,477948,111792,366156
b8a51465705740b1851d159fb28c9871,77,50,130781,31501,99280,73,50,90044,33130,56914
1e79f633b845897ecabdc9c8d19adfc9,150,111,457073,152763,304310,161,144,456577,128397,328180
bba42e1c4c2e0b8f81fd8e591f831f2e,62,34,62713,10335,52378,36,36,38034,12902,25132
456c8ed1e08363b289b1020d8e812bff,61,46,66589,18753,47836,59,44,81342,23607,57735
57ade8d66b1ae183516d760a9c058729,93,71,137277,33638,103639,88,64,120913,33027,87886
32b1343d946fc3d94570f673eed79392,22,18,7359,3446,3913,19,20,6097,4097,2000
7ac320b279ff500e0d7dd02025d780ed,62,50,119318,35016,84302,88,69,145965,39074,106891
22fda769feffbb67d85165fd7a8a7be7,82,63,157122,31541,125581,91,87,138821,44883,93938
58c615a41bcd3ce26ebed91c3c0afacf,185,125,728459,124771,603688,143,99,539421,168067,371354
7035d390e79fc19d20c29195ab29b1aa,18,19,12212,5482,6730,33,24,23767,7782,15985
9e96343ee1ad252fe83ba36f6c9a3781,214,180,648890,132396,516494,155,115,451135,82424,368711
a54add612d66a74a0628ba949d6e397d,191,144,471324,85346,385978,153,124,484525,107577,376948
dcc2544e6959b139d3e1fa54e7516d0a,184,110,442389,74999,367390,115,89,341567,77387,264180
5b13fe5c6cd173fbb1d733cb3ab4bc3e,149,115,315958,63239,252719,145,113,403230,58114,345116
e1e2fd2720a840481ba27bcbc2d77a15,72,62,83386,28631,54755,73,52,90932,25930,65002
ee6e3970ea134ba0a87556ed5e06dea0,63,39,147865,25070,122795,84,64,127774,34434,93340
4fd5a1bdc3e7405aca43985a4fae2832,186,134,676994,146524,530470,229,147,838859,90114,748745
d8b0e93baa38356cd35233fdcb6591fc,198,166,869303,161851,707452,199,139,757625,184742,572883
c88b4c033741b55b8b85b5352c4c400c,174,138,426023,71111,354912,140,98,333701,66067,267634
530106b7eb4b20bac91b48fadbf5cfdb,51,46,46383,10931,35452,49,32,42452,11301,31151
c90153baeecdaef0dcc89f31537c550c,134,97,444531,111371,333160,138,121,599644,123642,476002
cd4cbc8c276dc8eede21f9413d7078c8,88,64,168133,36076,132057,81,57,138300,41061,97239
12aaa908d28cf3301570f9028172f1ee,44,37,43856,18046,25810,52,40,49366,13215,36151
3394cb2e578cb06cf66125417391adfb,17,6,3413,987,2426,13,8,3163,828,2335
8d07adb93e0aa5e19bb9240fecbc10fd,24,17,11544,3576,7968,22,20,6970,5434,1536
5cb2aaacc97b1b5f5eaabd27203f138c,119,105,263956,43122,220834,148,116,279622,46509,233113
84a6ff7d7c00e0df382dce7543122a51,34,26,24749,11496,13253,48,33,34209,8224,25985
dbe21e48854244bcc28858ac3138136e,28,25,15740,5742,9998,26,18,15394,4967,10427
bf370333b2769e73d731491a0b3c3008,112,89,281359,67288,214071,127,93,283640,60936,222704
4b2b77a5bc70b3599e8b3f04fd844445,38,33,39993,15286,24707,46,32,50259,20093,30166
1d3c7d281d81da5d9d2b71ab56a0f9af,103,77,200554,46487,154067,105,76,174320,48200,126120
0e9b567afc1b74ab760b8392a95a90a4,103,79,221526,61773,159753,124,102,281495,68495,213000
58819b2ddc5fb1d429c5fe1c19ec54dc,199,123,471667,118171,353496,201,124,558692,159277,399415
c426083d13e1c30583aa1fb214107e6f,198,153,838763,176085,662678,187,142,918073,157989,760084
c4fa4632a715b7e3594eee5f5125bcee,75,58,114400,36850,77550,70,54,91404,34401,57003
e7cda68cdd01f2872174a5aa5a86c5c9,109,64,154580,38490,116090,87,71,147763,53416,94347
2006db1aac6dd325bede5d107c87f3b3,86,71,73764,23511,50253,77,57,82612,16315,66297
dd80d108a348160c8e1bd1a6d8e600d4,33,27,24410,8739,15671,34,25,20308,9328,10980
14b9992a1c9d839ab2f71573af7de67c,107,97,372602,122358,250244,104,64,382927,140450,242477
e13273b29878c58edc7f8473056fb92c,210,128,686589,138894,547695,191,158,736077,146129,589948
b493694920b43e71f06ab8ccacd6370f,139,109,441340,95111,346229,211,157,663109,105469,557640
bd8cffc73e06abb615b4611f60c75b5a,26,15,7079,2694,4385,24,19,7016,2364,4652
8cc9e664094b7cffb42f17806090eb96,22,16,6018,3197,2821,23,19,8844,3303,5541
309b2b2f7ed62841cee4a14211a971a8,84,71,162839,36464,126375,85,60,150868,29491,121377
fddcfede3ce7f7249f8bffd7f6315cc7,48,38,33478,16825,16653,42,33,42262,17277,24985
2638854408593fb042c7b56bef17fa7c,1,0,30,0,30,0,1,0,30,-30
7333f63801e949fc658a80975416d2cc,31,28,18871,5360,13511,32,22,14139,6426,7713
0459c7ec66edf6f02dd62b0b61e3609e,134,100,430055,116035,314020,120,101,370697,127987,242710
b501d185cc480ccb62b8a2579592e30e,132,103,411084,127531,283553,179,131,475998,133953,342045
aab9c4fedc51d1db4c1abd16d9fbbbb7,30,23,13121,6218,6903,32,26,20716,7196,13520
a6d900de5cc56ff7b8796d70700d63b7,44,38,47757,15979,31778,39,28,47799,13423,34376
1d1891859235faf31cd777d75b04984e,85,64,209719,37422,172297,119,88,225145,42080,183065
365317661abfefa1af665d0fe4a676bf,20,19,5972,2798,3174,24,17,7773,2381,5392
336f667a7f248b45f3d47862263918fd,37,35,54535,22481,32054,66,36,67703,13236,54467
1e5d130d483fbdc7d9b6c3f2db80811a,43,34,36566,13255,23311,30,30,27079,12084,14995
f6b48c8ec8cd893557931ec0cca4b708,66,47,68507,23012,45495,76,54,83049,27982,55067
52ce7d5f8b95bb7e1233a80647f21c99,148,92,439672,91194,348478,138,108,351091,97303,253788
02674ef5b6e3156c777491a09a4e5348,166,140,403175,91447,311728,85,76,245213,108572,136641
eae602297a4ca9385ae031cc59df9478,1,2,62,170,-108,2,0,170,0,170
65fc1fd5e2a21ebc6180fc9697552aa3,26,19,19883,5138,14745,37,27,25733,6929,18804
b8fa7fc3e003aa9e8d79f171feef87fb,21,19,8655,2897,5758,21,13,12288,3607,8681
d1519f7e825b3201779b6d63e20d1664,131,113,266191,66682,199509,127,117,295050,98181,196869
9753feb6c6b5594111d12567608647f9,91,64,195129,37627,157502,107,99,211359,61624,149735
e22f8e5dba1badc2d66593156a676e83,38,30,60158,18333,41825,48,37,59595,22613,36982
5dfedb02ceed4c4b3c3c271179316ea4,26,16,7310,2074,5236,30,19,7071,3405,3666
e2c276f6a211d7a7a634e4435f7ffd95,79,68,111148,36716,74432,73,64,97194,28843,68351
896fc2b64a7cff8548d8d365aea148a6,30,23,13239,7078,6161,36,23,23574,6230,17344
c3ee845fa39c935edbbda6ef81d87d84,71,53,115242,34876,80366,77,66,107339,36972,70367
61290c84e88423eac4d0ed879cb8750b,120,67,166501,34168,132333,135,118,309198,45297,263901
562de5bce40fd0c194bc739d41f6c172,139,91,307837,119375,188462,118,76,259550,104869,154681
abdc34f126c362a7b5685e5b6f466024,124,92,279923,95115,184808,144,98,360462,56385,304077
1ae97c0006a2d62305cd31527f49ce60,39,27,31381,10052,21329,48,37,64313,13463,50850
a722b0adcdff8a32ba0ce8be4b6ce6a5,47,34,31637,11251,20386,60,49,34592,13126,21466
1bcc43d55d1a087db713d80b635436f0,57,37,91418,38781,52637,79,58,145874,45893,99981
91fb332be2420e79feb78084d2b5ef98,26,28,41257,16040,25217,31,24,39230,20594,18636
52a77ae9b5d94d7fb58828be363e63d3,76,57,73412,28387,45025,91,61,99984,26062,73922
104cfdf6f4d815b218d7e9e9583dd330,49,34,40613,23175,17438,54,43,63274,21620,41654
4798de840a628537a46c0df4a18a08f7,58,49,142189,37934,104255,62,48,124200,33263,90937
533f1a96f12506db71b05f37eb97fa9b,187,127,502250,91719,410531,175,147,511722,97871,413851
67596d26e9e84252403f8e43457709e4,131,102,346141,61242,284899,137,113,429471,94890,334581
b9518a7b942bcdd03f820e9de3b84653,36,40,36689,16332,20357,36,27,27360,13331,14029
91548306019629be45749a922c3ccad3,46,47,55178,20184,34994,53,39,44131,18380,25751
0380a7808a8770d39003f8261b98068f,96,70,228820,94153,134667,173,96,418681,70899,347782
bb520bde4039333e1c4c9fbc4d9edb45,108,85,262715,47452,215263,107,97,189673,51911,137762
c735731b2964f7090727e81b4775e4de,89,58,106218,30339,75879,75,63,123861,28589,95272
cda86cd71c8c30b5456dafa713e815f6,165,124,704410,265012,439398,192,150,839879,191569,648310
758bba13a979a5602636cb97d4ddfca8,69,51,123207,49551,73656,105,94,237144,55133,182011
c02cc68d9d7fbe8e70c580d8dd3b3a13,63,42,94411,30082,64329,100,59,144517,37630,106887
b79cdfe0d4d0afc88f9f417d671f9566,204,133,685995,138039,547956,181,156,800861,178490,622371
4b604d5ffdb5d3056f3b1ae7a728fa2a,57,41,88963,26443,62520,52,38,73908,32299,41609
7c8a28254ad5e2cb884856c1462ed467,159,105,471255,95554,375701,185,133,605990,123157,482833
f447c2f8b6afb1b472d570a52dfbee52,124,98,357282,85581,271701,122,109,431888,59031,372857
bcbafd39aedc8c67681c1cb904938fb6,36,28,35699,11978,23721,38,26,34076,14197,19879
803c323dbeb312fadc23d4f1f9b806b3,86,54,138111,26654,111457,40,31,59540,14176,45364
bd490c7e2757b83195fab1b4687d86af,124,96,329354,78549,250805,103,85,269549,83090,186459
613a2f7a2f5008114f39ad1fa5750138,178,128,838620,209699,628921,184,153,710598,170498,540100
e3ea170f950dc6955bc55ec06ae2187c,162,102,475799,96093,379706,212,135,550471,140526,409945
b56f58e14d798e641a57fad172654ea0,27,22,15421,7775,7646,32,28,30121,8882,21239
af51ced0e990e9d65e643202870a41ce,125,99,290558,67170,223388,94,65,196857,64722,132135
9a99a946217eb2b255bf6d4c56934767,95,80,222569,49898,172671,88,75,209438,45282,164156
7589f5047e4561ceb2c456455f6477b5,128,89,272670,47721,224949,116,82,271548,59181,212367
f1816a99e11ae8ae16c3996ac793c9bf,75,63,137387,69113,68274,101,85,214363,65007,149356
ef49269f33ad57c4000a927f213b3260,175,127,643832,161820,482012,178,131,726331,154863,571468
ce5ddb4684146364bd48da0ca120ebc9,90,55,131174,31942,99232,90,61,97187,32619,64568
4393ba9b17808c04d31555df97ef5890,9,8,876,1084,-208,14,7,1826,774,1052
7d8c21d3817a44a9ff1869d13422449a,141,97,469808,176769,293039,155,106,553182,135926,417256
7697e2db3164cb5185faa28cdf92b9ab,111,83,232062,49462,182600,133,100,329051,60283,268768
ae7982222084b3154bf12c0d42517495,166,118,413381,79203,334178,122,97,213566,71816,141750
d7b31fff015ecb70f6108817cca82ba6,89,61,184193,42111,142082,80,70,148008,43262,104746
f3a1c5831685592e6370caae6775a72f,145,105,531015,84988,446027,169,118,385758,95635,290123
43807b554a9eb4e74d13d5d63d7c79cc,21,19,7436,4226,3210,19,17,5715,3250,2465
6d4c5871beaaaaf30043fffecda55eae,193,141,851750,136989,714761,167,120,777385,118871,658514
3edae868203aaf218f8c9bfe3ae4bd9a,28,28,23441,11611,11830,29,21,20131,8292,11839
921917ff66b25096a6dcdc8111cae46d,128,92,305026,87239,217787,185,106,399293,71322,327971
82bf74b818665239c213758f44a45831,91,69,144682,33691,110991,100,91,136350,49118,87232
19503ce849941ed5972de736ab0a5d49,91,72,144701,34760,109941,91,67,167864,23992,143872
455895d25000511f5524723e38cd3d4a,107,89,188418,52383,136035,61,49,108874,42783,66091
5f75af1c8975fa75ffa30a7c3338399e,170,130,517185,80350,436835,135,111,351794,89867,261927
539f00a004437ff574b07f96379392cc,25,20,7076,3127,3949,24,15,5671,3970,1701
501464a1c5edba56cc27bbbdef899e66,54,34,65300,18981,46319,64,47,87726,20783,66943
9c82391cae8f3be819fbbd347033b435,55,43,67263,17151,50112,53,45,47581,20938,26643
d4f34659fda2f8821900402bad8a8a9a,88,60,121329,31871,89458,72,58,117799,25162,92637
6f914bd4c53ddcb0467ffe1b8b927ea9,150,98,260992,46114,214878,146,104,293983,35974,258009
9555801ecd25ebbc06955d446af94d71,49,37,34410,11405,23005,41,25,32466,7222,25244
a5b18af49fa5937cb74c186b42e0183c,22,18,19790,6136,13654,33,27,27719,8640,19079
2896c6b859454bbc6a92b30c3e49e7a8,123,116,265438,61633,203805,128,97,277942,54313,223629
d41cd93e7b643b5a5660d247a181332e,54,46,109634,29563,80071,43,34,69316,22175,47141
792f21947972ccedccd855900b9430c2,156,105,578145,119153,458992,158,106,412611,127289,285322
faa0585691f181bcb37a73af216e8c79,154,113,741329,134252,607077,168,117,554203,120378,433825
c9c1ce5852fae92c004c5b88080e8b5b,145,117,325493,57521,267972,93,64,183762,48542,135220
52fe874e1cd7a46b819c3fcd7800ce4f,91,74,200669,43802,156867,105,93,235118,49385,185733
b171867ffbb34724c7b2c3a3c8d06379,42,34,34493,18567,15926,40,32,31629,13605,18024
8291e8e7bb5a6e51326dfacc232fdc3a,107,101,242313,53313,189000,92,67,178216,48467,129749
b4cbf911628572daac32d9e184fd1f98,33,23,16225,8464,7761,27,23,22614,7602,15012
62f070bdc8d21c8ddffed1b646aa98af,165,90,343075,75774,267301,202,115,388829,101884,286945
162fbe44180a7388559a0c337179b7a4,30,21,10045,5578,4467,27,15,12823,4630,8193
039a5821a83784073ef53bab06b29959,106,86,176008,67704,108304,85,49,181349,52498,128851
260251f68b80b3f3ca48ac442dae18de,25,22,13275,4559,8716,19,12,10988,1654,9334
044b7f44e56ad5cb3813b5cccee2998f,94,88,189361,54054,135307,75,50,108758,48863,59895
c5b3f35c5f02da4c264fce2a032ae59b,81,56,83403,15126,68277,44,32,63771,12291,51480
23c4fe1672109450309d226aa53816ac,76,53,109803,25930,83873,67,51,96558,31268,65290
f0ea74e3ba175bf273258a4e98ab96eb,55,48,116982,59925,57057,111,82,251099,83123,167976
3b13dd1f80efc64ae2f51318e88584e7,4,7,521,996,-475,4,4,647,457,190
79af7376b67c2cbe4ce3063b9fa61bb4,62,47,109892,27018,82874,65,42,67650,20670,46980
05da446d383c4b72b428162aae684347,86,66,138420,40992,97428,104,80,174261,36577,137684
667eaa5e15e99a437fe3a2388bc7a315,61,54,76784,17914,58870,65,51,91121,25285,65836
b7d4f11a4494d875fc8bbd3a2949f0af,144,100,333842,55320,278522,126,111,298824,83016,215808
4b3ab3c3b2ee0caa084a5dd6e8947d9a,169,106,479386,94534,384852,177,120,473988,126296,347692
632c3cb8f43bb9ab9e59ff0a45c61ceb,162,124,405605,75640,329965,128,111,324890,97615,227275
3a2e5de1610a93d1c65798706829640f,169,114,546963,135826,411137,157,125,491291,149156,342135
cf90c68db5cb8aa059f14ef084047385,78,49,53443,26174,27269,67,39,88094,11539,76555
5479a3a67ade4c6adec2a99fe9d73209,85,72,118559,38251,80308,50,40,110729,33719,77010
eaaea70aaa0168593f2988492d3068bd,52,46,63013,26923,36090,62,47,56748,17142,39606
21d44dde0f92a07bddf70aa9f204fbcb,76,57,136113,23237,112876,50,39,60749,23801,36948
0da15336c521aefcf35aee9ac4406560,99,68,130139,35063,95076,88,71,114368,40419,73949
61b818056eba864c7aafdc2cbd2a92ca,24,18,24888,7594,17294,34,28,38957,9962,28995
5d8a2b5c5a577dc4341cb348ebb1f2e6,59,49,65162,34508,30654,70,53,80219,28794,51425
10b2e539f8f1b5b66a5782ffde2e9c01,78,53,115389,30876,84513,103,78,140178,47682,92496
83819b9f28ebbff759c8e0810cc2d937,53,44,84761,23662,61099,69,56,85654,38921,46733
681cace9e3db798267a7d5e8328f01b4,118,92,246026,61885,184141,152,110,368188,59222,308966
2cadff0dbb727aab976b0f0d697f5cdb,130,92,602978,117357,485621,158,134,466508,121706,344802
0073902fbfe26fd1e2bade7252f6fcb8,110,83,228743,35081,193662,145,85,238842,43134,195708
e0f29e4723f04390a6d0bf7204d125da,115,100,327803,86803,241000,168,128,383229,85835,297394
1e9e7a575ea5ebf194366e45df28efeb,102,85,188490,57128,131362,90,66,200083,50275,149808
d65f3b77cc23ca9ae09a6d59bb7f1f83,139,113,391257,79307,311950,166,117,355727,57867,297860
eb6e54aadfa5a701905ad087485b96fe,75,69,118015,42430,75585,82,64,121113,35258,85855
f2d7b87da815ad18634f0f438b389931,94,61,177023,38893,138130,85,55,255763,46461,209302
b322010ec10e4a54865c13a01b882cab,155,104,502760,99706,403054,165,109,505062,123023,382039
4d9979f5c91ab45e0a713910ecf42bbc,97,81,150807,67162,83645,117,96,225987,49935,176052
a12035a658c31d534286fb4960e15131,82,63,170213,57114,113099,106,80,248756,48560,200196
2e2ebcefed202c0856738fc45aa07b3b,157,118,571115,132190,438925,159,125,611642,124963,486679
eeafec5d9767265a834aafe021cac714,162,112,541338,56009,485329,136,107,413313,77752,335561
7b45403678ca34ce48dc86a4f7d45693,84,72,138495,42920,95575,100,78,196343,48492,147851
a5f3c742100ca29e6abc40826403982d,32,29,14515,8480,6035,35,27,18029,5981,12048
df3f0678324d0401a49ac66b1a14165e,93,63,189835,43386,146449,62,45,111570,44106,67464
db5a056272f9c88d66d13345e67d426c,188,146,729109,191986,537123,222,173,1098349,137796,960553
282b847117b1dc5109338fa04e247fa7,176,134,859871,137372,722499,175,141,1283222,145674,1137548
5ccaae53646d7ab20c2e140712907583,52,43,65572,35470,30102,59,44,68699,23702,44997
ae9ab682c90ba619125a806b09fe8769,41,40,43603,14120,29483,40,33,38151,16190,21961
dcb8090e838007d1b51971d55fbe81b1,104,73,139470,51670,87800,74,59,155041,35391,119650
32f21c5baf4752ee575496a888483287,62,45,60337,20481,39856,66,55,113294,24536,88758
d8af7090ef22eb21fb0ed60ae06e2b4d,12,11,1534,802,732,9,7,1344,817,527
3d82dc01361875ecf345c46c4b6c4313,134,104,559893,108102,451791,182,118,719550,137764,581786
e6dd8b50f71cff2ff722bd5090759ffe,23,16,9926,4070,5856,21,18,6347,3901,2446
4a842d6f23f9ff158825b9a945f7a411,33,23,27650,10311,17339,38,27,36573,13529,23044
f3544ff7b52d7b926f924a39f26721a8,103,87,198046,43299,154747,104,98,234346,56736,177610
d3eb5785405b0ccbc3a39afdbb8ef15f,39,24,35299,7603,27696,33,20,23787,7098,16689
bd1421d0e7d037ce96e488202042a480,49,38,62464,26419,36045,54,42,66738,22029,44709
60e7d9bf0023cdaf19ee2e60bddcb36f,203,152,864103,212535,651568,214,174,933581,220374,713207
9c2861b336a28db0605318d9d59bb51e,136,106,308027,84589,223438,179,114,462412,67076,395336
105b4f4225acff6cfc9a329097703b3d,53,47,63943,30652,33291,73,54,86880,29932,56948
1a9577de661ddd15b82e40d146e7ff9a,29,28,24558,9618,14940,37,21,28797,8120,20677
cd655743de0364e5f3b61255c593b188,140,113,454093,174867,279226,162,117,585184,135583,449601
753a549f6c8191dd8b9adbab4d521a8a,60,45,61469,18317,43152,38,32,45324,22413,22911
7cae45ee278043072629d90e94754b52,37,25,34347,5535,28812,40,35,28307,9920,18387
26ddcbf7b13dba3f89301c7e611358f9,38,29,41751,9886,31865,43,36,34251,11448,22803
bd06adb94de57283d803799046320d31,41,28,45818,16378,29440,46,41,58221,18898,39323
69adaeb0d9af4667bc9a64767628bb20,81,67,129241,41003,88238,85,70,144772,45237,99535
489b123b5eaad4987d3c7540c566d830,90,69,149817,40479,109338,96,69,188602,31813,156789
5fa261ff6aca5dab09c9cc09a9c6ee8e,29,27,17682,5560,12122,29,25,10274,7987,2287
0fe98a11fc02dc43a33012f90a52d048,105,86,214827,38540,176287,82,68,128606,47648,80958
c65f2fdd054f2b2be5fdde4b8e1bf4f4,167,121,600756,94793,505963,170,152,626634,170688,455946
6a50f868ba9d315c4ff2b4e132c823ae,23,18,6312,3615,2697,19,17,6773,2880,3893
a22a0c49df3bf88e84854484f843f7ba,76,47,113287,24108,89179,109,87,144317,34444,109873
e3e7d83e6c2a8d4f1992afae1240b2ab,113,102,198852,47240,151612,105,74,158700,38956,119744
cb1804ad2b7768cf1d182eb0c2bba5b2,96,72,137256,31864,105392,85,70,178328,26420,151908
701bb0b9fe3521297d2041875f4cbc54,144,114,512512,93870,418642,161,139,496652,117816,378836
d76a1a7df6d797b728ac77b5b1e8c3c3,110,90,196289,51850,144439,81,57,131698,46065,85633
82e939882b454222329b92dcae7a18f0,6,0,392,0,392,6,5,840,71,769
ab6cf8eef6a30d4fca042a44de701696,122,104,295167,74091,221076,127,98,331616,61968,269648
c40b733b2bcbafd42dd8ba219872a19a,190,137,711999,101311,610688,183,148,518132,126108,392024
77e490001116530ba3e231752eade11e,31,22,21356,6645,14711,35,33,29375,7636,21739
53a2ff1203e23435c0bb0b8bd3573d20,20,15,8563,4001,4562,24,17,7855,3391,4464
274e9f342e66bef8959fe8e95c65f7d6,55,39,78175,23736,54439,90,70,107609,29277,78332
afe97ebee0a3c9541e4cfb773b955940,20,13,3945,846,3099,19,11,3446,1125,2321
a9a04f72916868cc7a1dacb49d3c3cb9,58,38,90959,28600,62359,66,46,108576,29750,78826
e6344935602fc665b338677aa7218c86,121,89,315308,64891,250417,122,101,237987,66447,171540
9fdb5e939df944faa4bd7484f8cd8cd7,150,116,324479,97839,226640,164,116,412455,62070,350385
085021b5c7983f4babe100c8d0d0041f,81,50,98809,22569,76240,76,75,115507,37729,77778
14934f371eabc2f1acd6816e27253156,153,118,351864,92336,259528,175,118,575249,104418,470831
f3434f265bc5a30342513870ecc05f39,59,51,56590,16010,40580,49,38,68607,14305,54302
1da9883c138979b51606977493057b1f,49,49,79188,31102,48086,53,54,79461,34997,44464
aaf71e52988b94c95e1eee6277952438,40,30,29646,7820,21826,34,36,22098,11052,11046
3dd4a097981835a9b95b19e40b915bb6,160,126,421256,96931,324325,118,113,396348,132351,263997
815edbebc3bb6f6169e84df75edd9ffb,177,138,755789,129978,625811,161,103,531705,105425,426280
c464f23644651e3bb19aca83e6ef15c2,143,118,330503,49645,280858,120,96,242118,55336,186782
90ec7ee3dc803a48106d8fa0280ec05c,148,105,336917,66633,270284,140,112,374218,76259,297959
d525e2ce19c921550cab14288ca7df8b,21,15,6932,4274,2658,25,19,9579,5106,4473
da4444e880d58b20480fb72227eb09b8,128,99,383747,89504,294243,134,117,451173,77468,373705
1529d0b959d3339b04ef8c4fbf719fc8,87,80,147342,31068,116274,83,64,105834,26680,79154
fbd88563a8e4de023136db51f2344db6,20,14,7000,2865,4135,15,16,4997,2790,2207
50e6602c94443fd45b329de8735b4181,129,103,330100,45540,284560,117,94,274303,71521,202782
692184d3438addc2782c5d056fc4e4a9,93,74,159638,45223,114415,67,57,116916,51173,65743
c35f783a6b847e54258f86c8883c3357,112,87,286688,86774,199914,125,98,312293,53072,259221
56519d0928631b45ea7436e09c2d2fe5,88,66,166899,45107,121792,75,69,146334,48865,97469
6008bd3efd83b860c102a28cd46a6f06,158,93,517949,109378,408571,256,154,921219,112511,808708
4cb419860f06b33fa8f41904295431b2,166,131,654059,125425,528634,127,91,384703,120398,264305
7e35233605559d8a112cd2a624be2275,138,113,462570,91781,370789,129,87,283069,83954,199115
7a5cd6369e5640acd8225f606f3b071f,0,0,0,0,0,0,0,0,0,0
02b7f7fe1977e207b77cbf02f0017bc6,26,27,15470,5782,9688,32,27,16074,7377,8697
81b8b88b541634232ed82e53b7c2857b,105,85,182193,32437,149756,102,87,149104,50453,98651
94fecf3c8478a0a84797eb5caa8da72a,109,86,221273,70557,150716,125,89,214766,50438,164328
4cf9f50021992d6567c2198bfb9c8896,90,75,211147,71238,139909,165,112,338014,63303,274711
22f77f6f15fa2d64d7f054a91f9a5fc8,61,45,80486,17963,62523,61,48,75611,17128,58483
a8a775e84ebcf9d5dbc674a3c0c43f4b,175,147,638660,162001,476659,198,123,629251,152150,477101
907c534eeb7d0a385b990ec58b557402,65,54,89120,29630,59490,60,51,87656,30482,57174
ea070659e5a596b63954145ac8d15bd3,211,175,804444,124259,680185,164,122,583538,134984,448554
59cf1b53a774221d0237d230d840e29e,5,5,1050,1057,-7,4,4,608,850,-242
eb418181824d74b9bffcc6eeceef0acc,114,95,213967,65043,148924,114,99,255527,52525,203002
4b20b6ec50cab21123392d0673bcf4db,140,120,378950,82428,296522,100,94,250278,55638,194640
0538e107cb429313e16e549041b55364,102,83,233712,69823,163889,96,83,212841,71122,141719
7ad2b76f487f82a288d2cf6a10f52877,69,63,203706,76086,127620,135,118,346368,71154,275214
3a5f967ccef768c9a6207693de4dfaef,145,107,336916,84122,252794,133,99,279248,97198,182050
e7b92b3004ff525386751c1e0ed0f3cf,143,106,340212,63090,277122,140,108,327420,60203,267217
53baa4e00b73aeaf4079b98c9c9996c2,91,67,163096,48409,114687,97,82,196914,47045,149869
a5d333912ac2b9978bdd288faa9b4f0b,74,62,185952,37430,148522,73,53,105224,50133,55091
5a4c61fa445b4317f9892c82751b920f,28,21,16457,7172,9285,30,26,17178,7111,10067
029d4203a020f1d14c2beb2dcf02076a,40,29,26400,10403,15997,50,46,57139,14506,42633
067dedd3725ed99ad47c00897d13df17,126,89,233569,67173,166396,103,81,254569,63864,190705
f8edeb8dee13165d5757fc361e1b09b8,51,34,41075,12877,28198,52,44,49513,17193,32320
deab00df785f927db9191861b922a772,42,34,69199,20160,49039,43,31,60360,22384,37976
5fcb2282332413e626063adba13765a9,217,113,617599,64023,553576,183,157,801861,104377,697484
897be2137c6fcdc7042bc3b36b7e6d04,13,10,2621,1280,1341,15,8,3001,1566,1435
4479879ce1b3106df29d0fbc48e8d226,198,150,830698,128948,701750,185,153,682614,177984,504630
0a1844bea233c43c382985b14ea7ef5c,159,132,656322,108122,548200,147,114,484540,131662,352878
6acd5b1f170a5bae50566f773631a4c9,120,79,221022,40509,180513,121,98,245514,67432,178082
37a65a094c190100cbfc4ed916528199,51,35,68200,14436,53764,50,47,51610,29348,22262
b9ebe9a667645de39b54da2e3a4848bb,61,45,106326,42306,64020,66,62,118370,53503,64867
03bb4ea61645820fb3bafaa68dd2f90a,140,108,404619,88362,316257,171,128,472216,101248,370968
3ede34b1cd355c7ecffe21a171993eff,180,135,504609,87341,417268,165,124,520312,141902,378410
b1e51b0cff3be79726b87b9a1ce37c13,136,118,432799,115474,317325,209,133,606915,69246,537669
c5e4790c8fb2351a2f7a6b73cc991798,11,10,1591,1002,589,11,9,1729,833,896
b9dc60bcc6b4d4fd90aa1189b3934f8a,46,29,53008,12549,40459,37,46,34290,15768,18522
b7bc0108993de8144ffae0e2378e4c7b,43,32,59326,15482,43844,36,27,27946,15628,12318
9f9b2aa9d765a80f18c4b1b2af55a825,71,55,120455,15480,104975,66,47,71354,23236,48118
29b1de9d20aa01e03bb246069fcf247a,102,83,181495,30068,151427,110,82,154388,35114,119274
a46e517857e04e42735efcbe2d23be8c,21,19,12910,5735,7175,31,21,15855,3933,11922
6c056415527228b95ec6a5fd189cb6df,52,42,46170,17892,28278,54,40,54352,16503,37849
8d796f9b82f844aa24f8daa12d016bf5,184,140,581110,100277,480833,191,136,741621,97895,643726
ebe55cd41684d885c57d23f9cacf56c2,31,29,29799,10328,19471,40,25,29906,8912,20994
68784974ac8a1d07e164facbab169c5c,104,78,175586,45820,129766,126,102,302608,49965,252643
6cbdc71910102b406f75c80d6c86cb0e,83,65,123012,35125,87887,88,64,161842,50252,111590
f2c92964ef24359faf4880bda23cd9f9,59,49,79607,30509,49098,47,38,81424,26813,54611
baa3e58f24826e286730b5f31bee97b6,55,39,48262,13710,34552,33,30,26291,11761,14530
bc1a41a7bf6ea7dcf939c9eeaaa49aef,136,111,430066,165474,264592,175,131,517243,110625,406618
dbd4722d672dc648114b0da0480ca6b4,26,23,15583,5438,10145,32,25,15243,6139,9104
fd2c01444d5abe82352b905ebaebbbe5,94,74,252773,59852,192921,181,140,443465,71611,371854
859529b2bf0085433c5749a94516e305,119,86,309426,58286,251140,107,89,252913,57406,195507
79d04022191199026a7baa6a636ef9df,81,65,154025,28706,125319,76,51,93852,32564,61288
da45948421a1302b425debcd89bd8a36,73,69,108769,28385,80384,74,50,65848,25018,40830
3e35e98934151ca96e9bce2490c0946a,0,0,0,0,0,0,0,0,0,0
e616272edbae583eb06173e22f706ca6,38,30,32884,12856,20028,40,30,28273,11123,17150
68e5e31819c9409d00800708038a1038,65,43,91628,18636,72992,43,29,47554,20253,27301
ea7ce3707098c9849386101dfc2a9fa3,42,29,26085,8742,17343,30,26,16204,10654,5550
22324a2542af5806001e36a332305fd5,54,43,66651,27026,39625,53,41,106658,26256,80402
c7511b730409fdcfb3132a0f2f3b6f73,148,123,534909,100905,434004,120,108,346110,108607,237503
0906d9fe97698ed7ac0e6b033d15a439,36,34,33721,14824,18897,36,27,36558,14003,22555
cb0072b4c4b6682afda257493f1abd7d,85,62,141019,38134,102885,96,61,132703,41836,90867
a50b8729ee4896707a619e8664e26db0,36,29,24226,6335,17891,34,28,14685,5364,9321
2318296ac8508c7747bed5fa4336b39b,28,21,11492,4251,7241,27,21,10750,5994,4756
06ee94795510c175637c22e6c13b4d05,110,93,211666,38617,173049,118,106,193356,37051,156305
8a46f3b2635a891a3b9b7b376b7e57aa,28,21,18070,5692,12378,35,27,30112,5555,24557
70a5c22abfc8ebcf2d7a6ba02a5188f8,113,81,214898,61144,153754,122,102,279467,50733,228734
afad682a06ec01d6d84842c6c5606a2b,45,27,42650,14134,28516,37,41,56695,17841,38854
70f1858cf1889cbada545773cd0b885e,96,84,153704,37099,116605,96,83,150152,40485,109667
b07e108d1e71d395f26d7051ce32bb3e,58,38,60226,15661,44565,64,60,76230,20200,56030
8ce88971bb7c969cb67a8cdf81b4f5fc,67,40,78916,20670,58246,54,43,78451,23141,55310
e6c9800cb4b1b72ba26b703c3999794b,146,88,237843,47271,190572,145,112,247274,53677,193597
2fedea057a1a92584918d478d101b594,170,125,457799,73712,384087,162,110,399970,95076,304894
5b1c865d7df8fc1762eb420d966c2377,46,36,38481,19313,19168,69,54,64092,16313,47779
746eab1d13481c6b5c5ee61814ecf879,17,20,8014,4249,3765,22,20,6769,5266,1503
ee21599fcd0e211ebc244104bd52d12f,63,45,53311,15879,37432,61,56,92979,21299,71680
32eb15f37ce4b91ef6f7f93c6cf7e060,8,9,1667,999,668,10,7,1221,1469,-248
eba569905b88d47f673bac8946115644,49,32,57838,18064,39774,45,35,53168,20291,32877
48bdb0c43c37367b4b9ae9813c01cb83,106,72,183410,77791,105619,172,140,386295,71915,314380
ff50eeafc1c8dc32193c619e6d887af4,168,105,421263,60012,361251,153,110,296145,91724,204421
cc8af980c24c4f150ac357172c6d9d0b,76,53,85382,27258,58124,68,44,59998,25916,34082
5f1a680dec32bb2072604e498d6c3473,126,109,287778,63360,224418,155,108,482850,47435,435415
0b53a3f50245a01d1ca1d5f47ce172d3,25,21,9215,4144,5071,31,25,16246,5223,11023
89d608f19f14f694a4051034f9d2e805,184,127,651473,153306,498167,228,161,1023093,165144,857949
027c73804359d14e1546c87ef92da23f,205,169,1223656,246282,977374,206,160,1207683,326239,881444
e9cecda9a0c69ee5e0563b1f7d84deb4,65,48,105057,26048,79009,57,50,77730,31471,46259
f0591f01d5da8ec68e42a3b58cc598bf,194,146,918637,148357,770280,180,154,793527,145395,648132
142dda58571c9397539d29d2b3400cea,138,109,381592,80228,301364,137,105,320028,100977,219051
26c22762aa48e0127b8f9e3c2d25673f,143,103,377591,46221,331370,154,113,346973,48210,298763
97207d7c4a863b6c356a89a8eaa07940,82,46,145901,33459,112442,85,48,109407,31162,78245
63a45932e4ed526c61bc0acd288e98c5,117,91,245486,59193,186293,124,106,316552,62482,254070
9b94fbb55365d523c735318d9692ecf0,140,111,337810,79219,258591,159,139,489836,132011,357825
bc51671e3384b363ecc38918259bb150,122,98,298591,65962,232629,140,97,303614,69260,234354
ad207fd5455eb7d2fde9d86e20286531,51,31,45813,15268,30545,42,37,31316,21482,9834
38eb7412949c3fe9444bc47c16e22950,111,83,271948,66816,205132,100,76,231144,55928,175216
b5af64368b6714fc60ba92a33b32b7e2,69,52,161239,30558,130681,83,65,132832,35875,96957
540d98b1a5fc0ffa535bcf275f7b7b21,188,138,777142,121478,655664,185,131,755600,135596,620004
363a8b95fbb638e143341e9ee1c3d6ac,26,23,6473,4439,2034,29,22,11811,3871,7940
61e35f4b435c2b9373f8541633826f21,70,62,115679,32456,83223,64,59,100120,28793,71327
24d31e59e50f84ccc943c0b4eddf972b,159,115,385924,68541,317383,112,93,271942,95519,176423
b4fd5b95b9b278259a6111c06fdb5fe3,61,46,97321,29566,67755,57,40,69100,24104,44996
96d5f1a8cf61df0ed974f231c5188c85,106,86,262645,65684,196961,122,88,278833,65406,213427
9dcf8213c2d7c564dd1859de390ac39a,124,86,282779,55523,227256,129,106,250446,39533,210913
58ea83696eaa414d07b7ca5049a075de,93,71,150240,31174,119066,90,56,112000,30578,81422
d62407d162d611e01ab92174b4d88b61,27,25,18819,7195,11624,28,22,15363,7819,7544
902a3209a046800f2f2a30dff2bec30f,142,108,370923,66871,304052,114,106,268929,63470,205459
950baf3249dd76064d2d4e82102b4114,148,111,320865,54727,266138,132,115,288900,72987,215913
0e81e1db4e2858d2a0fdcb10417ef58f,138,106,336855,82607,254248,190,145,506150,78373,427777
dc29cf0603398b428143c9f0d231e401,77,61,182751,60449,122302,138,105,300971,74068,226903
5dbaf1c40a6d4e2a74917a802c528e6d,112,92,296833,115411,181422,117,90,303935,69524,234411
102ab5ef7ef0ae41724c02e994b00248,19,14,3788,2384,1404,20,16,4181,2859,1322
222e459c061dd7eeeb888674b33fae36,26,21,8784,3841,4943,28,19,10007,4829,5178
876ef6f45917a02a1e03e8b0ece90a89,32,28,20749,11258,9491,32,24,29601,9480,20121
58b6949c870bfe4f8cdb13ba0136d8c1,164,130,544797,170160,374637,153,107,473139,121623,351516
3a6e0c338e280d691376fa466aa0f95d,122,104,257629,63733,193896,140,109,384332,74572,309760
654532b5bf7b73335619b96c9a2f8905,91,64,159897,44438,115459,83,68,163688,40326,123362
8f439d6deccaa537cd9e2d9940ef2874,32,25,22585,6952,15633,34,30,20125,8796,11329
76b4d5f8cbb9438d62ed3abce9b8c562,97,88,181252,50389,130863,95,78,151925,51472,100453
0b21f8e657e0d6f190840e91e7310e4f,136,97,337023,64580,272443,132,88,271954,89896,182058
f024cb8d2b1dedc92bbed77176dca88e,126,94,320628,46775,273853,94,73,182514,43733,138781
13862c96465f2486ef6fe4ef5bdc3e23,30,23,26161,9985,16176,27,28,20721,13544,7177
d2c334036cde5c81c4139be1d78ae51e,120,88,293510,75024,218486,159,123,360958,67233,293725
7fdbcb1344b7b9835acdba21d21c4fd5,32,20,14053,5322,8731,29,26,17979,5251,12728
bec2966e6da663e3118fd9a1df5527c8,126,107,259310,47977,211333,145,117,287812,63941,223871
c64d81080e44010c2072abc3e4f668dc,108,87,266968,47035,219933,109,79,172650,45587,127063
33d59b3105d143dc8e534171987cc90a,79,52,103993,29670,74323,62,52,78691,41749,36942
257ad8aeb772966f9e3bd79e1b55ae3f,132,103,367551,55818,311733,150,135,428517,76633,351884
24af6729e7fa189f10c92c6165cff784,93,73,96206,27067,69139,112,69,162387,18411,143976
1158db1c2fdb22a54920545bd4d8554b,121,79,233859,57159,176700,122,98,254719,79740,174979
1eb0f1c1d363a4b6fe9005e2639d90dc,47,37,43011,15455,27556,45,39,55651,16839,38812
7761d46b2460bf4972ee4a3e8a871fd1,87,72,126480,43490,82990,91,70,132663,30177,102486
7ea730ed1fc6f43d68dbb2f0b9113aa5,41,36,40028,22132,17896,57,44,85988,20798,65190
b77c5948255cf606b2057091ad6f9983,74,61,106566,31549,75017,67,54,104386,32701,71685
576bb5b4dfa64bd476d64ed7a40c14a7,85,58,140522,32273,108249,97,77,193629,43976,149653
3410a7b2ac10afb2bf8afc33f3e48381,28,19,11392,4059,7333,26,20,10627,4013,6614
fd229eb5482cddc48afe757ca6f06dc5,49,40,75051,21069,53982,50,37,74676,25814,48862
0517aadd4b57a0ea39e339d72b66fac3,134,99,351640,48551,303089,114,91,255578,73731,181847
bda827ae0acd0f0abcbaf2d37c141683,65,47,73238,16950,56288,57,43,42884,12804,30080
a1daf4febca9f0bcc078a267e0369833,84,62,131208,42045,89163,96,77,127059,36889,90170
91eec650961e21b2a10393ffe635dce8,147,121,364982,82802,282180,114,97,286130,72408,213722
46dd78e453a6f6323b68349844a27435,52,47,67398,26943,40455,57,42,67418,23599,43819
3cea49cdf843dfcb32859fa12bb47a22,91,65,161861,38574,123287,80,78,148412,40356,108056
d6fb08a230f9e31933bdccf8ca521330,171,129,581510,123236,458274,133,107,399553,124620,274933
9247f3889226b576d09651328def48c4,121,91,287765,59131,228634,140,120,391598,83449,308149
2253146a2ffba499348563da039524b9,81,75,115762,29761,86001,99,77,174963,37811,137152
6e570b8f633f622eeaebd3cc8d1039de,64,50,65827,24151,41676,69,45,92800,15869,76931
c9c5263de378a393b979f68e2ef0e52f,147,122,555914,94093,461821,134,95,359179,63180,295999
6182bbb2aa3455ba032090d85d7d0238,72,48,92644,25349,67295,59,41,51187,23893,27294
17215ada146a127d603a634c4e6632c0,34,22,15075,8310,6765,32,24,28909,8239,20670
ecca8ca55e72ae7c578ae7cf9865b14f,107,74,265516,82028,183488,192,142,527863,75845,452018
55ebdea5e494fceab43ef66de3755078,176,133,579262,124163,455099,181,151,607530,123482,484048
4ce2dd79db3ccf22ad3d459d78e2f3b6,185,149,712165,169661,542504,164,118,959513,141543,817970
faf7a44c1d311821919ba5b65bd68195,178,124,436610,85519,351091,151,120,508810,98535,410275
cc72fd8d4acd2b0052b1f03082feb544,150,122,354217,61172,293045,162,113,308017,54820,253197
4dd39e89d96bf14778c09305dd1ec39e,38,27,25889,6688,19201,28,24,14732,6593,8139
eb14303143f31b9c8e665c0ad7ac7297,97,74,153310,53752,99558,118,77,174821,27453,147368
a1ed2dd0f4f7be7ff53bc0db0c889376,28,27,19850,9011,10839,34,26,26049,8235,17814
55cd428afe659c3a2eab954ea41c4eed,103,95,225144,83471,141673,129,89,269204,59238,209966
09e0cbc1495cca92bcbc447652ffb2c9,143,99,364644,68866,295778,132,109,284156,84685,199471
20673eacfa44952e40f60b3edc77cd1a,171,137,683606,166207,517399,206,150,1168029,115813,1052216
c4c02af9088e5cf01770437e0c62f9be,135,120,401162,136266,264896,134,103,375096,81435,293661
4c303b5006e88775a9331fcd71743e50,1,1,38,156,-118,1,1,156,38,118
6745e6f98aaca904747ed1e1d25bfb2b,172,139,667463,139579,527884,216,157,1006715,99980,906735
857f4bf53bc59e54a7370b6abda00eb3,15,12,4101,947,3154,14,9,4457,1812,2645
2bea554d57a19b1cfac92728f581cbb9,49,49,67437,18547,48890,48,41,49713,20428,29285
3788b186522a391351c21a80a1cf3aeb,50,33,47036,12634,34402,39,31,43409,12330,31079
6925b703696bddafef186a0dff0b33c0,121,75,203887,33314,170573,143,94,237102,43732,193370
fa35a322611f8b68acc180d6e71f413a,28,26,22096,12943,9153,29,24,20318,11154,9164
f90339db613908f709d7a6744dfefe31,55,47,92498,32447,60051,63,50,99043,28057,70986
0574312a5804db82e98fbfaf2e40e5b5,55,35,60605,15844,44761,45,38,47121,16398,30723
c8ea4b88e5a4d3ab7763815c8927d50f,136,98,273318,64171,209147,133,89,316697,75127,241570
3645e6d7a169e4dd1f29de941738977a,110,85,293513,48149,245364,116,91,238502,59373,179129
5e3c0ef9b3b7f71824add2f662ff256b,99,71,144584,38547,106037,79,58,111997,37873,74124
45201798a994ccd637074f6ac1f01f82,101,81,225028,43629,181399,90,79,155856,48033,107823
dd618b300d3a4d24a7bf27672334b5b8,141,123,316755,78184,238571,124,102,321650,76856,244794
12543b6d52f23a9e32594e7814bf5f7b,91,80,148556,23757,124799,70,51,80415,27200,53215
b50c5b2b58a7db861b8e12c67d71b84b,71,52,143801,36418,107383,104,90,181483,45100,136383
a24233c82332312a1bcd010bc2ef458e,161,102,535634,88332,447302,194,144,605055,126398,478657
d15d3bf31f6c1c0c1620bc156f7c58d2,219,164,752545,135531,617014,163,134,467098,79388,387710
88fff32b3191a1d8174f16feef58037b,61,39,75968,23345,52623,65,53,95874,29429,66445
7945653ae166590310a3156dfe0d8d77,78,63,147689,42645,105044,72,64,123518,39035,84483
c8737f74da28e8dd48b7d91e232e6479,165,108,583295,156224,427071,195,160,859533,131638,727895
5e18903d1e94806f6b66e1c77c62b65e,24,20,8009,3233,4776,29,20,8544,4342,4202
79d9cdc6851247199306ae01e5288435,100,80,200019,74960,125059,124,91,268989,76034,192955
943bae53b2d55b213aad13a0e251c4cd,130,90,329657,70210,259447,134,107,344462,73327,271135
c1da74f9a98a937d29b43098975b3b09,35,27,30822,6972,23850,32,23,19688,9074,10614
70cecdff92f97fe95212fdd81e192c14,223,146,568235,124876,443359,194,144,706898,106306,600592
839a96667c8a2b44ae5cf485aa134a3d,81,63,173681,28228,145453,50,37,76951,24055,52896
44ba793f6f961814308ce370f236aee6,60,46,74540,21410,53130,77,63,76965,28370,48595
1cca347d6e01043314f96d264685d3ce,47,26,50067,15276,34791,61,52,87430,24221,63209
85e15a974d8cae15ed1f8af37b87e1bd,40,28,38356,8833,29523,32,25,21081,7106,13975
9e214a3149031ff0099349593ca23c68,174,120,590217,141170,449047,182,119,557765,161226,396539
9617d3932eb491feeb508dcdd165d047,123,88,332039,83236,248803,114,93,238962,72664,166298
e188c2000aa0b60d1ea5e10525e6b76c,139,119,618014,127308,490706,177,121,561392,111388,450004
9d8771304e52d7d51621519ecc49e5a2,16,12,3499,939,2560,11,9,1463,1242,221
b7bdd1ae49e5a0d3326c86f37081db84,165,107,645728,118671,527057,130,101,461336,139701,321635
3faa1d788e5ec9c6cbdcbe42d15d8f8c,166,137,900323,225651,674672,219,151,838340,160066,678274
d310ee53d67a21ec19b5f22535363af2,145,106,397646,67374,330272,135,119,358579,112878,245701
5fd5e2e2f69ee1ad3bf77ad4e283ac4f,23,16,8543,4530,4013,19,18,7185,4114,3071
0a537f9bf8bc45dc0dbd9d72ea3983d3,13,13,1754,2300,-546,17,9,2557,1272,1285
f8b27702ccbbed3cf20702515678c18c,40,34,51205,18390,32815,49,33,51061,17173,33888
c2af171b956a960b71d039bd6c08954d,87,74,281640,73643,207997,116,90,373070,77581,295489
9310717e5bc2cf2ea2fc0364dc769001,29,26,22475,8436,14039,46,40,43985,10876,33109
9b805cbf1eb9df05917f90cd393f5a1d,122,84,237965,55883,182082,103,82,204237,58344,145893
261489523357b35ed205249050a944f1,106,78,197114,39629,157485,87,65,106805,46152,60653
2b1fe1ea09caec5d65a9c74b34b2d820,109,87,259914,80893,179021,150,119,376896,53819,323077
22ddca23a84994ba044afb7022d1a554,100,75,278167,69728,208439,149,124,417056,81179,335877
9c4d61af5816af2c20ada76922129fc1,109,95,167404,43208,124196,95,82,158482,37851,120631
2af5582d9c517ae0ddf266b01e4f2691,162,93,342036,80093,261943,127,90,301377,96439,204938
2f4c43326793fd1eb94cb121382e19c3,203,133,577965,82885,495080,170,134,547323,103389,443934
0cde142d4c2a69ffe508bf37394ac759,91,72,229824,57830,171994,117,92,313079,74340,238739
967cec6f7b9f080fce4400dfa0501e1e,95,78,126392,43934,82458,82,59,140825,32057,108768
3a6dd64f7b8f12f8cc0bfe8e314d104b,216,154,979625,119073,860552,197,136,766985,196508,570477
d5c3eedc1130cccb6c36d52578856759,75,61,104403,24213,80190,54,37,81414,15314,66100
c409ddf285bc9dec3605af98cc05b41b,219,145,687571,135785,551786,228,156,801817,149776,652041
79ba011cc1e64c9570550e9df024a4ae,126,107,334753,75119,259634,128,101,338749,64334,274415
0597bf7a5b7961dac3e87958e9c3f714,57,41,83261,21905,61356,62,52,77874,26862,51012
835f379c93321b48eee5cd5212d21dfc,128,87,294000,83955,210045,105,77,241329,85768,155561
d35fc398cee58e9789817e91ac9a1778,100,85,241429,89226,152203,137,115,401467,70052,331415
6911307fe2e1a2be558cc190d105b539,84,69,179586,43858,135728,70,57,133923,36609,97314
17b248582bdbbe6258e3d26fc03c3470,164,135,750686,218430,532256,184,123,782134,195981,586153
99bc57850b42b6ef07fcbb658c35bb3f,55,42,58116,27957,30159,66,60,85076,27127,57949
7c4239505f8b81c1cae1678c3dd1b530,2,4,165,357,-192,4,3,357,389,-32
da20edb521566efb5ff8925ec042a268,35,26,35956,12820,23136,38,30,40602,16676,23926
0d0e452a793791048623a4e765e3a738,22,21,26996,10462,16534,25,20,21703,8222,13481
a044c9364e864fd13d8423f19d0f8447,93,75,173075,42873,130202,74,54,136328,29052,107276
90ad33eb610b860948439e44b2187c5c,51,43,100826,29051,71775,55,41,82196,30761,51435
19f7633d8c27f128b4f6a552673386e0,13,8,2633,1459,1174,17,16,2694,1903,791
58ef69af78fb1f9de91226ee7ffbef66,164,132,625810,148316,477494,200,145,938433,151430,787003
6358ac5b6cc887e3da71040373d293b8,1,1,49,81,-32,4,0,245,0,245
47b1de3b76215b47af1761a19bec4127,161,115,482568,89072,393496,195,131,477043,99823,377220
7407d00117654a2ea0e1672286d45b6a,67,49,101640,23418,78222,59,49,62600,31942,30658
9c161f350222f58a594f83e72d2aa8de,32,27,27149,10051,17098,32,28,23420,7217,16203
4d3461ae0f1f98d1503beae5cb91cac5,27,20,6920,4555,2365,29,24,13518,5147,8371
0b0c2dd7cef3eb679a72351813dfe820,125,87,259510,74836,184674,155,118,347599,77585,270014
38ada47371b3dac120bfc76f262b76b3,65,60,104989,33980,71009,103,88,147104,43553,103551
24ceaa33e80c2bc2616cb3a5f60752f5,98,73,137620,42932,94688,129,100,222709,34210,188499
a557aa3a39fe602ae15e4f92fbdf58ac,135,100,367307,53481,313826,138,93,349474,50481,298993
2dffc0c4f270c400f230076ed7e8ba91,29,21,14817,9466,5351,28,24,26844,6087,20757
d12db1d0e408652eb01c74489e72647a,162,135,841233,169143,672090,183,122,1013781,158074,855707
91f54451a3237d518a003afefc9e42b1,97,85,205379,44900,160479,92,62,130878,40677,90201
3867945cf2d638f305b99a80c4cfb6c6,84,68,165153,34454,130699,107,84,186006,41384,144622
86f03506af9d18237f2240621211e421,150,99,274260,51186,223074,107,70,236028,75996,160032
22bff81563696a58e5b7c0befcd139f9,129,99,362475,86150,276325,137,94,431118,75187,355931
1a2f42471789e9108d053be623ee41cd,24,21,8738,3659,5079,20,17,12464,3011,9453
ecffec4476ef1aa3709be7083e314ed8,202,133,863706,157820,705886,193,149,923378,174999,748379
98cd09aa47fdf2a62a5aa83824c82358,83,69,105420,27293,78127,83,44,111815,22926,88889
35d1e2a70cb558f2a56b70161d1e2a3c,11,9,2438,683,1755,11,6,1988,1061,927
96d99188c8d2056fdbf9a90c514c96da,102,79,260234,71887,188347,101,79,223390,59470,163920
f1a9b80b5c20734fb0ee0cac0d21c54c,170,120,630610,147122,483488,194,146,652764,164634,488130
1aad8dff9420fd045c5d6e94caf560cf,57,42,118453,42479,75974,74,54,123422,40848,82574
73dd48d11fc496d3d803df7b63622fd4,162,133,693322,161212,532110,169,115,533884,176527,357357
19349f64a5ac62be9952035c900c791f,53,38,56441,18997,37444,47,40,79334,23461,55873
c9c4022f270a4cd9b6ade4afaa3e3aff,15,13,2501,1736,765,16,11,3218,1431,1787
01c4ead8286a877cc7105452840349ce,115,75,198429,44610,153819,126,86,215867,35987,179880
469876d4df32148b074d1f3155fba93c,78,66,126872,38747,88125,67,46,159802,21992,137810
ee99d2f0bd93efa5bab232e507f3d919,73,55,88724,30809,57915,87,61,88639,31275,57364
88f356e50381b486b6197e857174eb7c,3,4,329,596,-267,5,4,600,333,267
3be82b30b6cb0bf6ec50785205e7de7b,142,108,362471,59412,303059,95,78,239691,68083,171608
6253c84824c6ebf39860a5cdde08172f,20,12,5557,1502,4055,18,14,3544,1460,2084
d4b28c61d125f44d8c5b7fdee5ffae34,98,75,249000,47514,201486,128,86,237556,52243,185313
a2534db3dcbd87d1d1e7b5a4d2b5d6d2,82,71,157758,55609,102149,112,81,255671,41993,213678
71351ef7b5b66d3a757ff6dcf787ed33,132,115,406239,94852,311387,149,99,473420,72960,400460
a7065c4ffc838fb94364903568b6af84,98,79,187512,63978,123534,101,83,205815,46713,159102
e9687164841a6f449b8e8e6c50b4cdf0,80,56,118979,45881,73098,79,50,118455,43008,75447
1a774ac3973e549cb985211b303cbb78,146,107,297804,79651,218153,106,78,234757,72068,162689
744ae23c63258b9be2747bb9a864355c,3,1,255,108,147,1,3,108,255,-147
152507554800244b10a9082ef4dd0158,150,131,494641,93765,400876,149,106,490558,74954,415604
8bc635764eae6dfa5fa08a3d97d1d30a,84,54,143994,33408,110586,80,71,177739,43432,134307
a5563e8362a6c01a4505814c2e7eb3a0,160,121,598384,113423,484961,194,153,501209,101037,400172
3edfdb6a47efe457223ed6d40b72a3b6,122,70,277212,99449,177763,113,81,257972,108554,149418
c08cc285b037bb6f889454dc2ae612e0,117,88,353490,109598,243892,136,89,347160,107996,239164
508e82e1aafa15d27116954c0e3717d8,108,89,237080,43811,193269,84,72,182051,67129,114922
dc639f4473f1665e01d984047bd3b0ec,65,50,80942,27918,53024,48,40,69637,21825,47812
0917350550a2df73d049d0c133608740,122,71,328475,65310,263165,107,96,283095,60443,222652
88d6c8f7076cbe01756cb0718615eb6c,109,91,251522,53083,198439,131,79,287480,45875,241605
a357e403b3af99757de44178c5d1ccf4,70,58,103767,39217,64550,89,67,161534,32612,128922
49a42d9166b59714094d2038a45d43a6,178,149,478854,103629,375225,118,99,249963,67371,182592
caff5730044c0e51795a0b1226c288d0,98,84,218728,65772,152956,130,113,368348,77127,291221
bf66d2b416d99449e5e37d9bbed29c67,180,113,532989,153067,379922,205,147,598606,115866,482740
3890f3ecc97240cba3fea52e0fa5efff,39,31,29205,17881,11324,39,29,38097,10391,27706
2bc4958c0e941469c6feb00cd13ff96b,109,94,279658,46094,233564,134,122,308803,81146,227657
7fc9394cee9d4da62599060e4cffe45e,11,8,2072,526,1546,14,9,2295,697,1598
789a97c46a8aee4c93f3ec3ed4feee06,53,46,75498,24486,51012,64,51,115942,30877,85065
cffa1ca76d769905ab3a833a7ea11e10,46,29,35878,9254,26624,47,36,36733,9506,27227
15ab5201f90407d4d1fd4db65127ba2c,30,25,23505,7915,15590,32,28,14285,9565,4720
170242ee7c50191ede19806e32b5149a,207,153,833530,198546,634984,225,133,695912,125120,570792
29f6c41addb0fdff4ae42f151507f20f,48,34,49887,13755,36132,57,44,54820,17706,37114
8b4ea9a5c8b1c35338300e2f469c1fbb,166,135,862079,187946,674133,203,155,744277,160773,583504
a78bda043c2cf0f8654e63856009abe4,180,108,880645,180790,699855,209,137,768151,147474,620677
98e4eecc0f0fd123b4f239c68c8cf5f5,104,83,260136,76974,183162,170,120,348136,66771,281365
6555d1b961bfdb88caeac70dd65798b8,96,78,180090,44151,135939,98,81,197329,39963,157366
1ebf2db4c2ea916e740fb6718cabfc38,114,86,262137,59142,202995,95,67,199603,60823,138780
da6fd1a383443d491d61721401e6ae18,192,153,1030715,192522,838193,206,139,783220,112741,670479
66421da552b54fe27dc15e59fcee5204,64,43,68151,15582,52569,56,39,50611,16240,34371
e6e250286d38bf6fc84d9096a7949917,55,42,96290,25845,70445,72,63,100012,36634,63378
cc7ecb299413999689007f47ce5fb43f,134,89,369337,72647,296690,169,104,349367,66540,282827
c8c8d30839c9c39e5605233dd1444f61,138,90,372890,130718,242172,153,131,507739,157825,349914
a269c0b4bc45ff3aa25e4d5b02f655ac,168,137,519249,105751,413498,184,150,608338,138600,469738
2c10b17fc2d45a406fd10cd30ffbac39,130,113,307481,76796,230685,129,114,299314,87293,212021
b9280889dd8ac84f5c0f18f31aece5dc,187,145,673100,103302,569798,181,129,529553,142618,386935
b4183df031f58df47e27506a7b0a0066,49,42,51253,21098,30155,67,66,84912,22257,62655
2cd269977119c4507d84ab5ad1e3a0e2,144,84,349723,54748,294975,116,107,277303,95750,181553
427937693ab7702b47ff1b0c64f6a978,54,45,52385,20969,31416,57,44,51104,18543,32561
6dbd9bc7c3b76960cce31ec1456169f5,90,79,132604,34796,97808,65,69,87172,45973,41199
ec9490e88c3e791a2e9a9d250b7c0512,124,105,302748,87823,214925,88,77,186120,74856,111264
a191ed73fc1072fd835e3d51b544395c,68,45,92237,21376,70861,69,57,62015,24321,37694
ab0b2a0d071a25f2ad1c42e425a31f2a,114,99,226503,89721,136782,124,100,315642,46502,269140
b988ab352e7dfbe6d2d2c9fb08a60835,44,22,33988,6806,27182,47,31,56681,9097,47584
fc0eb070fd3184d98aa6356d8b265c49,101,70,163611,25277,138334,73,62,86341,35444,50897
dc395f793257872b601ccc5f1c56cfec,8,8,1256,527,729,7,4,563,228,335
1917cac58a96b23618d75721af7923c0,137,100,280598,43520,237078,81,62,164291,44759,119532
5d961476988d4b3b8bd3d2dd22019215,114,85,282042,105651,176391,153,98,479988,69330,410658
5ffd4771580df709b1337312b9eebbeb,54,40,57330,19937,37393,57,47,64195,28370,35825
bb25bff8b2806fc7a563e313aeed8506,155,108,430632,118265,312367,139,114,314574,87032,227542
61d3c46a47f001a2dbf85745da654509,198,161,616351,89678,526673,133,101,426111,73095,353016
0350bd2612c0aab1a2ffebc8b1380438,68,53,90565,21855,68710,62,53,76968,24266,52702
32cf3f9d06f87374f666a3afea5e9cd0,83,61,167373,50170,117203,89,83,175208,50266,124942
0430fd2f5d6ec312ef95931f7767de3a,86,72,172460,48436,124024,106,90,207238,58069,149169
3daffdc5fd60ec5ec08b656b90a87419,13,13,2601,1338,1263,18,15,2426,1781,645
dd7eb5018098ea06a29a69dc9b53b3d8,109,100,209327,66069,143258,76,64,152522,55099,97423
5d351389018272441cdac8df5cd2e7c5,166,128,847315,150149,697166,210,138,822744,132067,690677
0738b30039cd2e015a2b8df565091387,153,128,299792,47054,252738,134,105,210191,59540,150651
4eef467f201c9ab9f2713ddf62dd23de,195,140,479641,89953,389688,167,117,426221,140523,285698
9eb7e19ae047df3be736910d6d809995,32,22,20844,7163,13681,31,26,21010,7174,13836
9a9c143d95c60188b3b8c2d586e89f3c,22,16,4673,2386,2287,25,20,6340,1850,4490
33cf6ecae93c1177426c8fbe685c271d,95,73,186767,34920,151847,82,61,120500,41387,79113
c80c3a22213fe0668e3479dda574d61b,78,64,179673,45784,133889,71,54,85752,52745,33007
9d756df459bc541f8ec65345dc3d40ee,130,87,249519,80784,168735,108,94,349141,68105,281036
1fe2117e4eec987659b87a78d4702428,102,77,213410,51094,162316,92,72,167209,62842,104367
00d85020cc137fee9614afd0ea0a766c,103,82,186389,42891,143498,132,127,218725,46607,172118
e651d78d0e5cc534cbbd8c264929b8f6,225,141,1156971,130648,1026323,167,121,918096,207514,710582
a68dc05ab39bd4dd085ae6582cdedc7f,40,30,33813,15759,18054,42,33,34515,11066,23449
9228abb127f682359a27987f3b5f3ebf,109,90,260239,70940,189299,90,65,179179,41202,137977
3865282d334082cbacadf5b92d940254,87,58,209877,36385,173492,90,69,198216,43794,154422
cc8b20dcaea43ca8adeeb47246143653,107,91,236284,50882,185402,116,77,222983,35052,187931
38c82e34e8c5a0022a19470f72d75fdd,19,18,6154,2641,3513,19,16,7386,2285,5101
3e0a0f836d57cfda71c5d3911ef620ca,110,85,309148,94338,214810,124,118,312557,92331,220226
1463f53a1197c692e96979352877fb4c,40,27,34787,13394,21393,40,27,39164,11545,27619
943e3b4ba67ff4a93874b27efbe1b169,72,58,137647,45427,92220,69,55,140054,57526,82528
45d07014443ff16c1a14c87c374afdf9,184,149,595291,117683,477608,174,120,543057,90696,452361
a596fba70034c7ada5d8ac93e47d4ba9,93,67,145658,35302,110356,74,61,130500,36702,93798
62b50361c8ff9e25c897b1ccb3653349,23,21,10382,5575,4807,23,14,9688,5488,4200
cf869be4f210341de4e2cbe5303246ce,25,20,10274,8039,2235,26,21,11135,6373,4762
efcb1bb850f268f24bd5757a39e3dc9e,152,121,438233,78176,360057,145,114,430989,77071,353918
4c5f2e8a9fc55d7035ea4ae8d53f9278,105,72,220431,40078,180353,127,97,264938,62555,202383
8a3ab1098465fdb4f46b74260f40d5fd,135,105,359100,73328,285772,120,84,307733,72387,235346
511281a09cf3b59c29c81c7f22c0ccf9,79,66,100665,32724,67941,78,58,90988,19894,71094
84dd7d003c2137e58fd6276f5013b68e,261,170,2152494,171792,1980702,205,144,1930869,195300,1735569
0f1f84e2085958198ed78c2329587244,88,71,195760,34023,161737,91,62,139505,29859,109646
7cefbba30c826fd71b7e2d5fb1ae0e76,114,88,451363,90883,360480,155,134,375372,120096,255276
6b1daf7ca51ba03a092040779f383b4e,114,72,307161,67125,240036,152,113,349087,72998,276089
3db955ad13ff37dd2763f6f9c1bf2dbd,129,108,230690,52790,177900,122,106,267218,65605,201613
921250f4a2bad97d9e7de2d9dcdb6402,115,97,269928,56691,213237,136,108,215417,44352,171065
280eb59233b50d83951e2f898bb596ce,85,73,150095,47463,102632,99,79,168162,47050,121112
4bdefc38ba759bbabded9b34c1273b1b,24,20,7331,3900,3431,21,19,7401,3686,3715
072bd5878ef5fe8e413d7b8c41afd198,95,81,135621,54096,81525,117,97,128048,43083,84965
9799575e0f6eb1bb2c8cc04759117164,116,74,244666,68460,176206,134,84,345115,59923,285192
515ccbb6cea7bac4d734a23408293b82,111,89,344865,77737,267128,140,115,422372,64907,357465
722598d23b47f2428230291c398340fe,64,51,54787,19944,34843,51,48,62408,21174,41234
6f94d5b1fdbabe4334caf20756436bbd,93,78,160263,37342,122921,110,81,166057,33874,132183
4a631a82b16b4cfbb6b6d622f594578c,25,24,21219,8054,13165,31,20,16511,8168,8343
138e5998d12499729cb53cd2d58e278f,37,28,33030,18232,14798,45,34,44730,16074,28656
a7282ac6aa87cfecb39354296bf2e7f4,127,90,263304,48858,214446,91,57,159218,40100,119118
030a266d0b70a35f9b9d7568c84bb456,37,25,49756,8618,41138,37,33,32263,17135,15128
bcc12a965e4d50bf33040953a8199698,139,110,304943,70412,234531,123,104,333571,80559,253012
c1674cfaeeb4932813d824d9995160a4,107,85,207833,50467,157366,101,74,153039,44710,108329
af62d4b485e2b841dfe3b9d74cf321d0,139,111,281128,65882,215246,122,92,264743,50154,214589
5a1ab142abb96db3a6d808cbe7983635,72,60,110147,34919,75228,103,79,185804,50077,135727
5ce8111e137a3bfcf81d2ea2a05c1275,181,130,716018,131316,584702,168,117,547670,85480,462190
6f3d304d39aebc474560fe567b8362bf,56,38,73764,20253,53511,58,45,71445,28709,42736
ef8c87d4060f753e75e62268514af301,150,120,550270,107855,442415,171,115,458368,124794,333574
91becb7bab6759953e96e14b989c4b1a,8,5,419,345,74,11,5,964,268,696
37da8d97cef37bda7f2c32a114bdaecd,37,32,39922,27040,12882,42,33,60728,13681,47047
21438795018b960a77c66a39a3fc95f0,100,81,290840,59797,231043,130,106,277853,85030,192823
4c49a700a53a07c31f6dc391a147db43,115,95,308035,74968,233067,105,90,309038,57352,251686
8340f7abfdc483ff32c33fb668814ea6,123,99,222713,55785,166928,123,82,208847,37034,171813
aa0261c35a535f0dd0a258372d4d9526,94,64,128761,39281,89480,95,80,170350,40203,130147
0a4fee911d6497a708461e4d7bc70862,201,129,877024,111477,765547,201,146,676790,169137,507653
79ee912cc163a2d3a7492e1243afd1bb,155,140,443497,99952,343545,152,112,352733,66955,285778
6d886984963bff9343774f06bd5082d2,165,86,504890,94952,409938,162,105,619000,75762,543238
9ef28c6657eed15f43794b265dd8950e,191,116,889391,148116,741275,213,149,995788,182642,813146
2a9e0007984f14b7ecb62b4ec5cc2906,83,58,169865,35863,134002,81,73,129298,54966,74332
11b68e8d9163408c5e33dd86361bef2b,72,45,149536,33579,115957,79,62,127005,46483,80522
8750de08a63f0216b895b690b0023494,93,81,172842,33697,139145,82,65,164111,35276,128835
fc3213184bb42235e5bab87d5218a6dc,85,73,182785,44396,138389,76,66,161277,50444,110833
4131445a3213ebba29f6b84b51468ef8,93,77,163635,59843,103792,79,66,180851,45173,135678
9b62332c4633ab6bb7316af7d69e57a4,63,47,95380,25749,69631,77,52,116780,25477,91303
4537ecca7624e3a6219f00db769d2d6f,105,78,250738,90477,160261,134,90,213639,76349,137290
3e72bd906dd1562e2189a6dfe90808cf,33,29,11020,5818,5202,27,24,12442,6688,5754
3837538ed3af78bd5f8b5dc47884ecc4,118,94,359915,81650,278265,159,116,467754,72695,395059
ef6b9afc7c92478ed1f9ef13f7186346,31,22,14132,2789,11343,26,20,11225,3195,8030
d67244deeff5c1308418ed697f069cfe,144,82,296409,54326,242083,137,98,387161,60306,326855
f19d3319a9f75a63e9cf358f8c4949e8,76,70,184305,61469,122836,123,101,249496,56657,192839
387392708f3de469eaaa1a2c115efc2f,82,70,130608,39262,91346,111,86,186033,32864,153169
f9209efdb1591427e627a770256e183a,178,116,400998,63773,337225,160,123,386715,77782,308933
7ff7c3942ef77491bc589d3fa5affb0a,53,32,49675,11738,37937,54,47,64192,9142,55050
47b57151b1a52d6bdc58f3e1f1d99d25,56,47,75154,39664,35490,63,48,74904,36128,38776
3dd580bdcaff83e04f06509351857d02,51,46,51060,28060,23000,86,60,133052,22954,110098
3fe8b39f3ec8eaf1d0a6f4a5c6a04064,61,52,76569,32192,44377,69,62,90179,29879,60300
1fb935677905491be1ca1922d8185cca,184,127,637892,104795,533097,151,119,462300,80071,382229
b985cb6805f18ccf8e07c57d556158f9,198,130,2081863,209292,1872571,286,154,1328114,218735,1109379
31b1e00af67a845a34a89181a59ab469,158,118,413338,80939,332399,131,113,363229,68382,294847
26d9f9948b5423f00824cbf97f11c7f4,32,28,18281,10464,7817,29,33,16446,10261,6185
3e805c2d703dae620ae950b1a93ff336,132,96,387202,111686,275516,166,140,430544,132103,298441
7b4f3fc563a25a6d4587b31e9900cf52,33,26,39904,9006,30898,33,24,21977,14223,7754
4723c823401902ee3b1f07625d4d54e2,138,114,324762,71486,253276,143,121,463044,74531,388513
2a2d3cf5acef41a21160cd313c81870f,30,22,14879,4324,10555,26,24,11533,6363,5170
5ab6a534116352c808ccc0ae70db3445,110,77,218518,54472,164046,107,82,191218,50097,141121
d9ec768574d19770ea7d2a6744e283ba,4,2,533,177,356,1,2,45,190,-145
d1b3a102d62d26e6b7d558ea1940db48,93,76,190640,36188,154452,109,91,228461,42776,185685
7f47b16c22b1a70008eeef6f51b129d5,83,66,182511,47419,135092,103,85,222293,69892,152401
46e2f7588fcaf6ecfd395f58f46b96ca,139,125,292896,63289,229607,98,83,215997,65303,150694
2c57acdc868a7d736beeba2dee2a3a40,17,20,5839,3403,2436,24,13,6196,2633,3563
59c76d370f65e2cf577e079a3f5bf8c8,56,43,65555,11071,54484,63,56,64022,21875,42147
73b16ed1e72613c3b44b1115f8630764,82,67,158030,38494,119536,91,64,131397,37139,94258
dba85fa2fe1e6bc0c036c600003bd4f9,155,93,432818,84685,348133,136,96,296461,92657,203804
c7d4813b3babf713b9a1e17755cb31f5,137,101,444954,113714,331240,146,120,523683,127020,396663
88a4febc0120a5695e359def2944156b,64,41,54897,13341,41556,42,31,32762,11995,20767
b80f6b63eb40491144cf8c65053ad9df,33,23,25470,13818,11652,36,32,39621,12837,26784
9bc44d0968ae8efc4c95f5deb43c38c5,138,100,443193,100530,342663,225,146,493258,111067,382191
d2a1c9ca33bea4e734fbd81574ee4b51,82,63,154218,45587,108631,83,69,171851,47792,124059
c41db3a1bb90e2be12ae394dc2a0fcca,86,75,106587,39596,66991,81,55,132348,34541,97807
d12767767498541ab3742ccbcdb1e257,92,74,203590,53908,149682,125,106,312979,56658,256321
aeb92cb1835b39bcc799d5f2e20a5374,104,81,277270,80385,196885,136,115,433433,88211,345222
82f9b99f41144674eaa958487c9d711a,116,96,291276,84409,206867,119,87,344747,62680,282067
582b32db24fa09c0a17c8c686c33ec7f,17,9,4128,859,3269,20,17,2712,2047,665
57af25d442604071e10bb25767e8cad9,57,42,66099,17226,48873,56,40,87679,12848,74831
f9d551135cdb3171ce2e3a90f9e0ad7c,38,31,32275,12659,19616,42,27,34698,9167,25531
25dbb406613320b438de5bf914de08d5,216,142,1327033,161388,1165645,194,148,1001270,145829,855441
c46680cf7bb0b91e4b4589a021d86488,43,30,35926,14985,20941,53,37,40508,14190,26318
a10f2f8b2bd1709fd47d4cb748fde8fc,46,35,36687,17121,19566,29,22,23692,11618,12074
c9d2af4c63e7559931c69ebc21079fe4,30,26,24755,12858,11897,33,24,27367,9767,17600
5c8c00b54c2c6d801a8ec3f414c5415d,43,32,48520,13240,35280,26,21,30096,13386,16710
e239a8c03ab117a620f8c645f3ded3f7,125,93,229533,45221,184312,132,88,195690,59708,135982
314037b832b70593811cf254f2665c31,81,54,176508,74870,101638,113,93,320380,61516,258864
59678a80c3238403b0c4ae82a18553de,86,70,162914,38822,124092,74,61,113418,40169,73249
2a299817bbd6ce4a4f8d9065b599beca,72,65,91978,34967,57011,56,44,85333,27314,58019
c7bfeadccdc951453e81f55216f4367d,193,145,740451,122285,618166,182,126,783481,101291,682190
261bb6487fff5d0aa0b1d705b6f08b28,46,39,42369,12691,29678,59,42,58041,12507,45534
b07b7b0122485374f529c8f901648bba,201,144,939648,162924,776724,242,185,851400,197512,653888
5da8664e651d739ea06778556cb6d199,117,83,232089,35820,196269,95,70,167661,36060,131601
e73bb7d47dd122e4442e91c3c7caab98,20,17,4804,1830,2974,17,16,3843,2640,1203
1e438038446b3ba07e189bd3f3284071,185,142,700832,120544,580288,170,123,535659,146989,388670
2a2f23ede0a219bfef924ed3bf7e2abd,107,72,127689,33700,93989,111,75,173903,28416,145487
04552ef7dd0db83427365e97b5a987fb,68,57,94048,29478,64570,59,54,95227,31992,63235
574d11ca9208c56593ad257b274e03c9,142,125,442076,76430,365646,176,114,402539,69715,332824
63cad567a3ecf2b98e0974e07b4316d4,26,21,20133,6615,13518,28,25,17487,9190,8297
6375e1754f1a76be4ab95ca53690a6c4,109,96,216617,42759,173858,73,73,96562,41566,54996
cba943cbe35ade5d9f07b462c8813d1b,176,129,788370,176232,612138,177,134,680862,188123,492739
54e38d8d16d32511aad1198b35702e4f,208,156,926496,166951,759545,175,132,777605,149897,627708
a4058eaa2c5b44452deaac6f768b4fe6,13,15,4001,2943,1058,17,12,4669,1761,2908
ca0707cee1dbbc4da6b9e78f208212ec,123,100,235445,57411,178034,140,98,266046,58788,207258
6dab522e7695081d28348d87bae0f60b,66,60,98911,38700,60211,63,46,133153,29376,103777
c0ceb3ff310002f7ceddbe038a7aa0e0,135,109,399826,50860,348966,128,110,335270,54756,280514
542ac1fef2eedb52866b3ee58219b8b0,41,33,47608,19000,28608,42,40,50734,23094,27640
3b7ade680f8afd4c388b8a5c6cbe096c,55,49,98778,37281,61497,80,55,120356,42500,77856
73def00d666ca81b654c79e4d133a63c,74,58,124629,49729,74900,64,55,111918,50294,61624
3f102721a1513a98021a044997824eee,26,22,14489,3831,10658,28,19,10419,5961,4458
039d9fe36ad04ffe241d5bf230e13a9a,184,138,768777,209984,558793,163,126,819368,156656,662712
25ddb98a1641c3e594f66daa6563adee,73,54,131749,35858,95891,56,42,77028,31036,45992
0a72ff539f0518645d88a79884414860,169,115,521914,73228,448686,186,114,386460,83239,303221
3b60526fa9b121cd3f639612c05fbeac,25,15,12969,1816,11153,19,16,10393,4964,5429
8d0b9c9e91f81f0ec051e8f2e38eb407,117,72,267006,66002,201004,174,113,356700,100595,256105
1977f929fde76f3a58d4f94e52a033ae,103,71,174817,44039,130778,72,54,92787,56761,36026
f203c1b827e59a30a4de3cda42ce1498,25,21,16465,6091,10374,34,24,14988,7057,7931
a2940c70cd57c88593e36ba936551314,172,99,631672,61609,570063,190,120,532775,89600,443175
30b378688a5d51b1b9022e5edf9521ef,73,59,95542,30218,65324,85,60,117042,33677,83365
2aff9a57c83546f66d6693bba0d672bf,68,51,69593,17031,52562,58,49,70402,20768,49634
1f947d8bbd005d06cfbb666b6e6a5959,171,141,506605,131766,374839,171,128,523924,108945,414979
53a850a5f137fcbd769e394754e978e1,96,70,188579,30452,158127,90,73,138494,41617,96877
0afca81d951bcc93f90bfa44f68aca80,219,159,1141457,113460,1027997,188,140,766109,112728,653381
a1c68824307a57adaab063139d4921a6,55,38,52702,20509,32193,75,64,124617,30604,94013
70ee2e6cde6a3dc742a711fb2c3964eb,25,22,12485,2808,9677,27,18,7971,4610,3361
ee8d8e8273f580efaefb50a54b1d0f24,179,98,507496,124921,382575,228,162,912392,174922,737470
7d6703eb25e164b99fcaa13d8db30536,45,39,55743,26937,28806,50,37,68308,24619,43689
ad374a5185f6c016cce274b1e3c9fdd9,195,163,541488,132316,409172,127,101,402448,108958,293490
e665761946d0d149f2bf2daec3824de4,163,134,888403,158105,730298,190,147,872163,158893,713270
0da85ba6c9960d2315915b0b0c89fe2e,115,87,190346,60089,130257,100,68,179077,50147,128930
7a3e0d21b45a251315473e06cda5e2c5,127,84,327176,54847,272329,100,78,209306,76090,133216
77e41f8f414446e9e58ca2e557b309aa,110,89,160088,33484,126604,99,68,182893,46073,136820
cf0a7a081748d4512221eed751119245,126,101,305051,76774,228277,146,115,329708,74062,255646
03329f74d3d040e17f1122a6389fda68,187,159,700045,136841,563204,167,141,516413,139853,376560
74c1880aa9ed8ca623213caeeb6019d0,25,23,11858,7511,4347,31,26,14195,7034,7161
3c7a2935892dcc30cfc0b6783c152ae7,32,29,31666,10352,21314,42,37,47302,6302,41000
09f22bd90e9c4ac76b8c651cf48e958f,3,4,193,524,-331,4,5,524,307,217
24aaaa26003cae78663eff12267a4450,39,32,26704,13508,13196,54,36,48794,11940,36854
bb3ec3b4bc9ff77120afd5a55c2fdc33,64,45,73159,14841,58318,71,65,91244,25773,65471
219ed12b0fdcf3a355e9f19e324ab8a2,3,3,52,386,-334,2,2,366,32,334
0b1f25ad2f5983d8d51e591c31e1be94,244,154,920967,143747,777220,218,163,891689,191930,699759
36ab32cb72b72ae9a39c84ee86612368,63,36,80666,14965,65701,66,54,119710,21400,98310
f6ab9bf13a3e7fa4b7809d14f9af701f,30,27,15116,7811,7305,24,21,9040,4164,4876
22bed6aeaa53d5d37e8181a70020501d,107,80,215772,47312,168460,102,84,193162,53455,139707
41e419cd23424c83efec747385f65702,89,74,137991,32767,105224,64,44,79177,22035,57142
191767ce2c792dc278cb5b21846fa45b,43,23,34504,16079,18425,41,34,43329,13861,29468
9f477a0a8b8e71331c8b4bc1c995d8e5,114,84,297288,82054,215234,131,117,317431,92804,224627
fc90fc389d88479b0a66398fdafc07f8,127,111,427137,136983,290154,116,80,382096,121614,260482
5acc1bf6ff0694a8ccda19b58a42fe20,94,80,229460,57069,172391,85,75,196293,56884,139409
c78a7681b3ac541569155e55c7fab6b8,120,69,257347,51046,206301,156,87,318336,50338,267998
9c73685fa526923362e7bcc7eb901155,116,88,278853,97800,181053,188,106,450983,57533,393450
834bf775394b885995061e8abb1658a4,44,35,54225,16346,37879,42,35,36274,21616,14658
c6aa35e0b3044b15d9caa6da16be4ca8,171,134,743525,140792,602733,173,128,606962,154539,452423
21b219971a728e1308e8ee9bf6d59b24,166,131,641041,117560,523481,203,137,600624,71747,528877
7bbec98a09f43f1bba031b7493fcc132,116,93,251597,68289,183308,128,95,365007,58243,306764
c9888aaf547747272082860bacc03658,20,17,5834,2139,3695,24,13,7864,2080,5784
b2cbbaa1c9e5ef46f9f66f12a622cfa8,40,36,34788,13112,21676,37,31,21051,10292,10759
328d55bc01622874e37d6b03513a16cc,53,35,75058,19064,55994,60,50,73433,23134,50299
6573b4240f9a5b40b445474b6b470d62,49,41,65123,25807,39316,49,40,80120,23607,56513
6879bb04c519376603a64cc2d9718b4b,163,106,290814,66905,223909,96,73,153170,79343,73827
7afcf305bf43bbb6a6e43f443a17c166,112,80,271342,61551,209791,139,116,370294,80188,290106
656d84dc450945f1a0d42b733e6d8c57,28,19,9848,3232,6616,22,18,7246,4153,3093
12b29820485e45720c0cb444bd1dcd02,29,20,19838,12108,7730,30,28,25076,10572,14504
43ca59baca3ae8a07206dcaab0f9ccd0,34,24,20544,5462,15082,26,19,16243,4179,12064
ecdffd8fd8029e898a2a9333cf7e1050,116,87,211803,76203,135600,121,84,196081,49807,146274
0d17d3ec0ec46029a9b11b09fbb2348e,34,29,22914,11765,11149,36,31,28022,8768,19254
6b66dae2811482ca3d60d62bdc720579,24,17,11963,4658,7305,19,20,7498,7140,358
a343c61df6f1d6975a0134bf5ce0d84b,121,91,231733,78126,153607,66,52,172639,62709,109930
97c40d33d46b457dffa748ce265ee64e,187,120,554166,152432,401734,178,143,610552,160268,450284
7fa4296b261b4a133e3c26891bbc2c41,192,142,655817,103398,552419,161,114,610574,108405,502169
7a2be1dd185e14c596931a969a31c1ad,1,0,52,0,52,2,2,97,20,77
17ae84416e24eb21bf2beac5198549c8,171,124,404291,66553,337738,102,90,248061,77482,170579
b759264b09d0bff80084fdf0de635501,65,48,84945,20930,64015,86,81,118051,30543,87508
12d7e5c2aa52a5c7f63a08508ec7e1e3,66,53,101601,23423,78178,48,42,80232,31360,48872
6412420611eb039e74e2e42b6e01848d,25,19,8737,3924,4813,27,21,11636,3305,8331
821e5218775089c9e77eef2b5355b8a5,81,62,229840,42059,187781,75,64,134882,53667,81215
76ce54ec525e8ef3c56d6dc664c523c4,7,7,984,1216,-232,10,9,1896,1369,527
41a4040ea74516da3b4718d198fe8a19,95,85,184010,46896,137114,89,61,128320,42801,85519
dd565104124382e50029b42741c0051d,22,16,7712,3860,3852,13,17,3866,3873,-7
ef6e0bafe788751785c66b401a20b56e,159,137,509376,119641,389735,133,106,434246,88736,345510
c29ebbd3eb7f489923c10bb002b64cff,133,99,442889,89096,353793,150,103,457589,109025,348564
de3c9b5945d52f031de5b248e75c1fbd,183,136,520823,81922,438901,129,91,260125,61437,198688
462658004d9a40d16149ad313f900fdb,216,169,1704711,231046,1473665,216,129,898050,260105,637945
d91d8ba057807bd732f136093e16c249,32,22,20322,5675,14647,35,25,25809,4729,21080
569bbf5c4b7f2181be55ef5a2647b9e7,33,26,19572,6647,12925,27,17,13603,4886,8717
0608633914b5eb12f07b33f0018e330f,148,109,371750,70299,301451,143,125,353110,118019,235091
3368b0d743dfe50bccaef8eeb509bf83,116,83,215969,48798,167171,107,88,240743,60096,180647
b38c37ff86ab05fc9bafffe0bda6b724,48,32,44179,13938,30241,36,28,40560,14900,25660
ff1fe75c4016f074ff248724ffd34313,133,93,437410,84497,352913,162,131,463862,78175,385687
10f2158cd42099369e2bfa74432f59c3,156,149,485763,78668,407095,125,96,278392,65534,212858
54f6f28d6e8c0f8ba60bfd02b5895f52,37,30,34180,13614,20566,36,29,23324,14674,8650
1af947af5b15ebc7aa9bb4942450f749,131,103,335228,90776,244452,124,89,299336,80921,218415
738c274847cb97ccc4ebdd2bf8859293,182,137,412771,96646,316125,146,91,433697,68234,365463
a05997dd6967c53e06d241d2a224ceee,131,95,475541,100008,375533,187,159,663590,108226,555364
aea4b42f7400ae14a9b9ac97cce949bf,46,40,38161,26642,11519,52,40,54886,24005,30881
5c9d61aa37860a3f70217348ef782162,67,51,98829,41800,57029,119,84,195100,39608,155492
adc85e0bee9913d378a5c5b1a808682b,42,37,44206,11343,32863,47,37,28230,12007,16223
9e6cd9130e0eb04e834582e03cef5f2b,48,37,72290,25682,46608,60,57,89955,24057,65898
13fb04cef2057842f26f9ba8bdd7cd28,49,36,54284,26842,27442,69,60,85007,25672,59335
8d1af66fae9a74934c27c67e9800b97b,73,59,95005,26819,68186,93,64,123315,24038,99277
2628dadcd969c4b5eb474e08d74b7933,23,16,11556,3047,8509,23,18,7233,4444,2789
fe01f3eab0682fbd63d4314701ebb321,112,99,279476,92397,187079,99,77,204543,63280,141263
6303a374977f42ac2543c45d403c9663,38,25,24438,11191,13247,31,26,31970,7671,24299
6ff2d1e96dbad4187b1ace2dd67e206b,62,54,125371,30870,94501,52,47,82460,22736,59724
4832add683a031c4fe34abcf32e21d39,150,118,372168,64366,307802,122,103,304974,92902,212072
2216f58780f5f4fd074fadbf073c6953,88,57,160464,42794,117670,103,71,108771,43918,64853
b956251182f901dc6147dfe8bcf3822d,125,84,336210,100126,236084,118,107,266684,105188,161496
9affd1bc71c2d14c62e105edb5c82348,149,97,263290,74612,188678,151,108,285805,64613,221192
64b88fb534e63fdb1d8954e6d218df94,75,62,96382,34731,61651,107,75,130701,31029,99672
26b5e9d20356ca248d2e336f08989e75,45,31,27558,7150,20408,44,34,37230,10251,26979
fa597b79fe9140c8e84ee619296e4e31,159,134,668283,250699,417584,214,156,875660,126743,748917
f28aafbc43e80ca39b50f955fa844642,130,107,314145,52831,261314,126,96,229957,64842,165115
159f90d02b8777edc829d371dba8850c,51,44,81491,41006,40485,51,43,86763,33510,53253
126a9d42ad459514e25158cd782cdd2a,174,142,442243,78047,364196,119,101,267831,67139,200692
442f1fbd228b7e3d35d09416ac5725f5,94,61,115240,21050,94190,80,67,102186,36250,65936
c482f14625b0a595a3903677b9cad4bc,91,73,181873,35586,146287,121,95,261928,45969,215959
a280f22c071f67a2f1195b3c29205867,48,41,61661,21983,39678,48,43,56668,20827,35841
f9c117e8bc3ff0d87a9ff071ce05134c,134,80,323683,116475,207208,184,123,461746,114088,347658
bf700f005c6f98f0325191bdd9f9e531,70,62,123549,64198,59351,88,67,150765,51755,99010
78681ffa0dd4594c6d64b7a65c9504e5,127,94,260864,45737,215127,159,136,435639,62109,373530
107549fb1feac3ead14cb6e2e9acc2d7,115,91,255753,41947,213806,135,89,243650,38695,204955
0f0aaea24877f26d805f34ebbef7d181,12,15,1706,888,818,13,7,822,1090,-268
13b4b35ebf79cad915decbe2dfb4ac2c,84,59,79942,23505,56437,71,57,96337,26317,70020
b03bc494d7eeb4ded3d23806e711ebc5,65,54,74982,31891,43091,67,45,98621,22270,76351
5e335bfd69ad9c8987a7210f957c4f16,138,108,305914,59324,246590,110,102,181819,71047,110772
ceed00af78fd7b6b57b3e7514c097764,68,44,96426,26658,69768,79,65,102118,36054,66064
72be2ff414be9f88eb18a9b3c7467986,37,28,39266,10875,28391,49,28,38884,13890,24994
b32b52de4112c454ff05f763a01bed62,16,12,2099,1524,575,15,9,1841,1014,827
fa69e19ea0491e23c49d5d9ccb51abcc,3,3,297,319,-22,3,3,319,297,22
c28028de395ea8953ad3de654861a8f1,46,29,40282,11594,28688,38,36,38761,15196,23565
0f3b9a2a9cdfb6823a144ad64557141e,55,40,59633,14483,45150,40,27,42355,9224,33131
17bf00b6314f11ecb261fb676f7ea59b,30,31,39745,14424,25321,42,37,42518,13366,29152
0ec834b750929c2177ca9f6f18658f2b,25,19,7938,3131,4807,31,23,5991,3666,2325
ce8e3c140a65540c352157ace8d2bdd9,76,64,162797,39955,122842,91,75,152743,45444,107299
6b14c828329f9321255f739c56a56b63,63,55,66700,27891,38809,78,65,92473,25605,66868
4c50b09f495ccaeed0b994e6edd3c2fb,40,25,31835,11144,20691,38,31,34737,11861,22876
47feadd7cd165feda9e2cadd32d262c0,48,35,75961,19851,56110,37,33,52831,26938,25893
f4a2d043060f5ee0c75eedb760a85eb8,90,69,168144,41572,126572,92,74,142450,50874,91576
106eaaef5f4af1971445e7121608fa3d,59,51,70369,21838,48531,57,44,46115,19295,26820
7722b79d86a99a42308d795466e7d2b5,140,116,420242,108001,312241,185,118,590696,127454,463242
3ddc8fb9bede04686e556396b98de128,172,104,533093,75353,457740,170,130,693165,102600,590565
9de29b40f489f4566faa97f75a3a4bc5,105,76,206369,56823,149546,143,116,331620,55781,275839
b4d26832f3260fa926a298009157e12c,151,125,495710,146028,349682,202,148,760998,114103,646895
87872e82eb2a66b27f754d987fa31326,150,111,727688,121769,605919,176,129,675967,111601,564366
60be639523679af79c4812561d85228e,178,137,1275099,234504,1040595,219,168,821465,223287,598178
8eeb0bc31b05016acfe05a0a3521788d,191,134,808708,194026,614682,139,110,591269,150708,440561
74709567f25b1cc697788a420fbc63f0,41,34,52019,16385,35634,62,54,80070,21413,58657
66ff8aaf027a8bda5b243c221f99998a,18,12,4914,2255,2659,19,13,5373,1872,3501
e8ea6ffe0ca9c69af1257f7716712abd,40,30,56380,24960,31420,65,61,88222,30098,58124
09cfc23289c9fbabd8a0cbc7d27a23f8,146,113,475540,124331,351209,152,80,435035,103753,331282
3c607361902e94028d3cab4cdc4d4487,124,95,243456,27761,215695,127,100,204803,45290,159513
25d39dce06d8b769f6a7a5e059f3c6a7,173,138,641018,115588,525430,150,114,421681,98703,322978
000c4b8cb4b083a6cf04c665187e4b30,100,81,228722,52497,176225,101,83,185207,71022,114185
0fc301eca56637039fe090c04fdffac0,3,1,754,225,529,3,3,1342,754,588
f62d3986a54e5b962ce59635d7f2f7a4,126,89,359784,110880,248904,139,112,406550,114431,292119
7ac1cbb7d5bd9e814d1f808b01fe2365,56,37,53951,26180,27771,63,44,87262,25216,62046
259ebc3da9a196f45b42e32f94c620d4,34,28,23571,11690,11881,32,27,35725,8546,27179
e604db9cc273f6e8c266c9987d80998e,22,19,7834,4107,3727,20,16,10585,2387,8198
4022a9fa89dd79b47fbf0831c47e3988,167,107,458607,120934,337673,209,164,809822,111477,698345
eab1c96b01417778c6835a92641b2573,35,25,36776,10602,26174,42,30,44212,15968,28244
b2229962d8cd82d9ccd92cb78f0f7f20,10,3,456,66,390,8,6,523,250,273
106688a4d74e3b18e7648d21e1152fb2,171,125,615632,99816,515816,142,107,439312,143778,295534
f10129460e90e2a5aca9b7d65d25f757,126,93,332708,67264,265444,174,108,386704,54094,332610
f6349168fb29b32839353dbcfb09a83e,131,120,411546,68083,343463,189,159,549291,85276,464015
a039379d8ed3111277d4d5b188858b3c,47,39,79564,21823,57741,70,56,81947,28986,52961
af37d114a3d18eb6e79854c72db1c3af,13,13,1509,1610,-101,14,10,2751,1137,1614
bf656492aef5d42ee42f40470d5f3e8d,47,38,53511,16664,36847,42,29,32977,12908,20069
2a0d0e513eafcb6095db34800b00d6cf,41,23,45007,13379,31628,54,49,69684,15737,53947
0570125f736af1e2e96883cedf7bf2b7,61,35,77573,19873,57700,46,42,47373,22441,24932
386df10fa157cac702576f61b9a131b3,60,32,59056,14246,44810,58,41,66754,13745,53009
ab49f5bcb8bb0987b5e80d828107d95b,28,17,13342,4096,9246,29,19,8179,7328,851
f804c5d6526480da728e64026426db29,41,32,26886,10258,16628,43,35,33776,11143,22633
c2b37e1a48cf15b273a3d9f1da99d9b4,46,30,45783,13772,32011,52,49,51657,15122,36535
eb02cbe225bd8e5a52f17f3783a407f7,65,47,102664,39692,62972,92,59,160912,34741,126171
56512244dd01fc705a429c1d7fdc472b,102,77,216740,47393,169347,115,81,224865,53170,171695
c39add3ac10a957486d88a07d0d408dd,19,17,9833,3877,5956,21,16,8094,3406,4688
83298888acb43463394bbedd2398145e,28,24,11949,9521,2428,26,23,23017,6809,16208
30bcdafea93977aea375f368e7e6519f,23,22,13447,9223,4224,26,22,21080,5666,15414
071dac94100e5afcc7e9380f0a4193e8,100,66,169917,27100,142817,71,62,93583,46192,47391
b9d5093e54ef6c9ccc9fbdcfb556fa5a,96,67,204440,52873,151567,89,72,233293,46282,187011
089a659781ab6d6116c63507d737c382,43,31,26634,11171,15463,39,27,32142,10357,21785
9e388bb284e3081d4e9d72a7d82d87e2,92,79,161061,45291,115770,67,54,114346,34978,79368
50d3024fcf968b02a0d844a200eaac4e,58,44,80174,30281,49893,60,36,68087,31758,36329
684c42a2ce50abdc6b01942395c26580,55,49,68109,26488,41621,57,45,62941,25055,37886
07478046e573bdb07ae5f4f723a172db,222,140,1204851,150354,1054497,182,143,1466205,184985,1281220
2fe648b37440a36fb423595aae7eb998,23,17,4666,3316,1350,21,18,6297,3045,3252
96821fdffc96538536902eb31407a3cd,110,83,242760,46520,196240,91,81,178560,46071,132489
64e9e4847a1198a05748c225032ef6e3,106,85,198439,62320,136119,112,95,260412,59223,201189
6a0c9ce116bd1b5562805bf60e53566a,59,51,75461,25404,50057,68,44,66956,25691,41265
18a6e9de4f197e790b167d93b57579a4,85,59,169841,29324,140517,67,51,86877,24692,62185
e16c28c31c907fad57612c6dbf647112,130,81,370997,68338,302659,185,138,576849,83121,493728
c0eadbb70c09e5586680c2c4ba4123a3,112,78,423473,101402,322071,139,116,478444,85459,392985
56f3830b635709cc0aad33c8cb63ee1e,90,77,157041,57054,99987,94,82,231910,45877,186033
6d94d34efd3bbb6d49c5b72edb2af5b7,49,35,60440,18891,41549,37,29,40848,23200,17648
f8300743b45626b13dbca5a45f0c9895,122,106,351459,99929,251530,147,112,433020,94037,338983
ea28a901b72d8dee7824d98fc876b933,112,89,322337,79342,242995,125,102,241347,87228,154119
8e2cc0d0b0940b4024211a90a8bd6b2b,53,37,63320,14823,48497,34,23,39241,15503,23738
ffd4c6a9b443c76c3a05d02c75fd9f0b,137,107,506583,98464,408119,92,73,295645,117884,177761
8e0c95d18145a4ab357e4550fa217d51,130,103,263611,49451,214160,120,92,209251,58825,150426
b70c4ad3ad86c25a26f1d143c0b8bcc3,50,36,69829,21721,48108,37,27,40586,18311,22275
5886d7cde19ccf710e73926d6eb1ca82,112,74,341662,122523,219139,179,120,494371,149553,344818
e37b09ef423a7a2dbc0c37e886e97bef,171,107,457173,84634,372539,158,134,470378,110997,359381
ab94c67b4aff21581251f1dbbe3de84a,40,32,92295,13107,79188,49,40,56590,17900,38690
fecb32e758a548f1673eab820d1d7a24,137,108,240261,61983,178278,104,81,214458,57795,156663
4ab377524e0aee4e1da67815ab27cad0,57,45,59686,18493,41193,40,38,36521,20745,15776
60aa2cc01edfd267a6e572fd4be0bc41,38,29,22586,9658,12928,42,31,27337,10158,17179
d55b6ff7be2fe0061ba3b2456651d1a2,6,5,920,671,249,6,7,686,935,-249
1ff2e422e2620ef2e4c7f5e0386effc9,26,20,18129,5402,12727,26,21,16798,8961,7837
4f16411693e4b679941d316c6d8f145b,98,67,190791,30897,159894,98,72,159795,32942,126853
4cbc14c55ab3f6547edb4b42b12829ec,25,18,8239,2424,5815,18,18,4170,3843,327
a733f7d657f0e4150ed55711433a3dbf,98,68,154829,27326,127503,84,78,136326,38945,97381
8a01917f2d3868b323635f7616a15b93,17,12,2824,1405,1419,14,13,3630,1246,2384
172b67f089cd5270099d06d6a11d0f04,119,88,237503,64031,173472,101,90,187958,83098,104860
3514b8b84e741497095dec473f501daf,27,22,9689,4569,5120,31,25,15267,4933,10334
cb439dd3f33973699ec817f423f6ea9a,130,95,281905,57540,224365,103,85,238409,61791,176618
5c2cb2a174aa1360b9e42c3ea239dd05,175,124,683708,137350,546358,146,124,560931,120638,440293
7b2c56ac7ada87262366da663adc6fde,141,111,377111,65316,311795,157,113,351699,68310,283389
5106ad95e65974c743800a806ec03c9e,152,124,634076,163034,471042,193,138,750755,187069,563686
340272d593540167ac196f2d59b80555,27,20,40877,9177,31700,40,27,72181,17270,54911
9d93ee85059ddacaa7d253f8b576d782,113,74,228830,59216,169614,115,103,215247,69501,145746
7895304a22a08e0406ca6408f6365c5e,131,92,348721,50948,297773,123,101,390776,62776,328000
b4677e9da129c57633afd80ccdbde764,95,73,210527,49844,160683,95,83,239098,55598,183500
4ab553b577e8651063fbabdce9ca0446,74,54,98579,24818,73761,63,52,88765,31133,57632
79d8d9e5db8efe42b671dc70ac5dec4d,17,14,5581,1183,4398,20,10,3673,2127,1546
c68ef186b78e1aa2d05540e3ef60b14a,144,117,360901,91595,269306,192,126,476335,71514,404821
affe82a763e52289d15e3a894f30a679,86,49,107283,48611,58672,116,69,186562,39394,147168
b3fa2ff59cc23eb24140a646c5885066,135,113,336555,102952,233603,140,117,473408,89706,383702
46bef1bd9ddad5661c5fe670efc985c9,86,75,182140,46299,135841,103,79,257357,54653,202704
460a9330dd50fe9bddb046334989e65d,77,60,59269,17009,42260,48,49,51583,14902,36681
6885ae7af7486a6b33ce7d5d47b9a29a,64,46,83688,24370,59318,65,49,63369,21683,41686
1f1004b872984704bb0d7018d06bebb3,218,150,1197179,321505,875674,210,161,915919,209948,705971
f1e07abcca7d20d31c3a4a7c64a6ca7f,27,21,20054,6204,13850,25,22,20384,9948,10436
d81fa546d0055d602800de7d69c37d34,184,147,541598,105825,435773,156,123,614553,118334,496219
f17f2f4302b4ada92dc00032a1e0e65d,195,157,906244,199061,707183,201,146,792653,190879,601774
c5775b9fbbad15ed9f5c49eb83215977,6,5,718,903,-185,6,7,945,726,219
cd8e031830bfbe4907bbdcb43b146a43,189,127,624119,106558,517561,172,142,660908,191619,469289
667624c305314750985e402be02f4e61,25,17,7567,2867,4700,22,18,5251,2926,2325
7a7e334a401b8a15799c2c825ceacf2c,51,39,80369,28321,52048,52,46,87945,32068,55877
b588f5e1f1d111da26fa3fa4e17eb843,136,95,327394,112853,214541,135,96,497524,127998,369526
fd2d45ea1e3ddde087d15a53dbec98ce,0,0,0,0,0,0,0,0,0,0
bef49729c3def441d6f849ae454e4f88,65,44,93527,15216,78311,86,77,115974,18564,97410
b7bc3928dcfe7ae63004add24bebd291,132,104,453223,102026,351197,126,116,406296,129519,276777
5ad5559628980540fcfca684b19d3142,83,70,213519,62199,151320,105,78,214938,49774,165164
8a8f10ac34089f1ebd1bcf60b26ec203,153,115,343768,72107,271661,150,95,372736,50812,321924
43aaeac9c87a152a3105baabaf336743,87,74,167291,56387,110904,125,94,266867,55464,211403
7323968f505d04686f0303f39b067a4f,147,95,359495,64261,295234,166,142,543109,88130,454979
f939c2c1ec7a42afb0eda643000979a1,131,99,300256,72905,227351,110,92,269710,73600,196110
09c6d1b642816d5228cc2003e19cc5d0,31,28,25788,9399,16389,30,31,23689,12477,11212
0c80494e687f87809030c230f56ecba2,2,3,566,330,236,3,2,330,566,-236
9b24b8b62adb4f2e09c5c7ad23f6a957,28,21,16795,5603,11192,31,29,16416,6188,10228
83d74219439984de295fa0084f230fd6,117,62,233545,51599,181946,91,56,177695,77060,100635
44b254507d8f4580451b9464b792632e,110,89,196727,44296,152431,113,90,209981,49592,160389
bac213d90613831517a7049dea1e36d6,122,97,297045,75081,221964,159,107,441410,59768,381642
acd157ddc801607431b3125fbd29f7ef,108,67,173165,26367,146798,64,53,80486,28030,52456
b21bba9bd03f4c0d503648f298869bde,184,109,565420,114646,450774,196,139,715074,90419,624655
d3f70130e26530e107573908826a4546,113,94,350856,108635,242221,160,122,394926,85915,309011
962cdde17e7befd0e8479cfc4c15d1cb,212,156,618564,159893,458671,180,147,668066,179873,488193
7f8e423201ef697dddd4f29ec8e530ba,144,121,294906,88560,206346,161,132,438389,59092,379297
745a4c566db5492cf91135ab4af853e8,54,40,44381,17181,27200,73,67,85965,18813,67152
b2bf395e87317baac9c76ae977d40ec8,109,85,249529,60194,189335,101,64,222495,57569,164926
575917dd34043d674076ec2bb3d7dc35,150,129,464350,149451,314899,141,115,456379,128598,327781
dd773fac1ef85a1aeeb8f552c9700dd0,122,92,271456,53486,217970,131,101,333912,68827,265085
d388fff352fac166712e8dbc0fa39d7b,50,39,70624,19615,51009,52,39,53109,30303,22806
fc8558d63b6e7eba4e766b067f5a5214,71,62,76595,37473,39122,88,56,125143,32550,92593
f4dc9814f0f30215c24d6a47a92f32c9,88,73,136542,51709,84833,76,51,98866,35454,63412
07ee2f4e72316d417dc55fc981df1603,60,47,89460,27794,61666,107,69,157645,26395,131250
2562511befdb7c32885eccdabe052c9f,68,46,115144,37443,77701,83,65,143149,42527,100622
ec218c11c8aa98ce696ba7770b45392e,56,43,74660,25037,49623,49,35,60625,18749,41876
71d6addc74b5055f17fa2b9d9058749b,93,80,208733,71119,137614,134,118,360895,54383,306512
d4b3abed0a74c7e080319b9f545aceb3,103,79,363383,126274,237109,127,93,433629,99057,334572
733558d3ef3c54714aa92b6e7d47947f,105,82,295177,116342,178835,144,121,492942,103177,389765
8cf5a4e574b1aaf3dbb8263554bf0fdf,35,30,18422,11126,7296,34,23,25267,6903,18364
4d9a583fb28bea53c146622306fe4205,22,17,10670,3981,6689,23,16,8276,4685,3591
b359fc8eaba4d7aab9744a94b509c1bc,29,22,11984,5358,6626,30,23,19398,4531,14867
daf802a83d4f685cefeb7ad5b58255c6,117,89,327125,80284,246841,132,92,316839,72949,243890
55ff61916ce7af34e965ef8b2e0dea6d,30,24,18364,5669,12695,28,19,12267,5226,7041
76f1c280d440ae85226e88d181fbf7ed,142,109,407198,68986,338212,104,89,317958,102812,215146
f39ac2828a34dfa0b1654b8a91d632e1,108,100,173294,32799,140495,108,95,190022,37989,152033
77604689450145f64103432f8b83a4f5,149,134,452876,87115,365761,163,133,475350,101035,374315
ae804eeeb2298334b4cda9d63e47038a,57,43,91369,14075,77294,46,44,61718,14373,47345
057a3aeb6af6c8b7d25b39a0dc748574,20,16,4131,1854,2277,16,15,3374,2459,915
5f2852e49fa557d162e78e0676e88be5,51,40,68781,30021,38760,70,56,82453,26444,56009
5054b46134d68369813ef9125256718c,78,45,99265,24899,74366,91,78,152883,31962,120921
b02e0a69bdf5ca1e68aabc9288f62424,137,95,497269,127609,369660,169,115,457878,119218,338660
94c7742c54350661a978dce7702e8653,150,107,404467,54072,350395,96,90,240481,104071,136410
c4c621b5d00e5ba365274a0459177c6f,12,9,1333,777,556,10,8,2629,516,2113
e5d500217572a21fe5f84c6ebf220371,50,46,65700,22880,42820,35,30,50937,17633,33304
253a1c0f183c54d77aca8905bb8d175a,49,38,45110,17814,27296,47,39,60966,16800,44166
ee6403f0dbcfbaa7c1df5c5038b1d324,209,141,902772,130452,772320,143,109,610615,123850,486765
1aacaddaf3430837dec555af7556d90f,32,26,15196,5301,9895,30,24,12931,7747,5184
ca50c0f8eba2a23b00643fbe0234ed64,201,133,830508,101751,728757,226,137,753110,156533,596577
732078745485d46bb08d98d5fa9c84ee,75,44,57846,14824,43022,63,43,52577,16661,35916
9f11bb0ce686558c0e31ed7a53363dea,43,35,37738,14071,23667,41,32,45952,11308,34644
010a2e72ec7efca559a24c8822b668f8,83,65,152845,60845,92000,110,77,323108,45889,277219
22392c693dbcbd1383944e05ec105b22,210,153,766831,281675,485156,205,150,899315,245744,653571
80b9742bc8ed1e366974bd10889ef8d3,151,109,376472,94345,282127,142,108,390038,67973,322065
d979167b4893446e92223c8560297e0b,122,100,310433,62935,247498,116,96,296660,65086,231574
d175877f609d3d34b6dc7cb4b8307b00,136,90,510414,103240,407174,170,124,572285,168782,403503
bc472c681014100b231d920577545277,0,0,0,0,0,0,0,0,0,0
8e3e1916c4678cc6717fea44ed2f3bd6,35,25,27262,11631,15631,33,24,23739,9395,14344
2d87d6b5bc3e81b5ff0ba634fcad7b9e,22,14,3904,2376,1528,15,17,4892,2574,2318
545db65aa23247ab652b1837bc5f0688,53,34,45473,15657,29816,53,35,50736,13331,37405
7119fbf99abd2c64db8194a63b7746e8,42,29,48191,25009,23182,48,34,77813,23975,53838
0d34e4a526a4daa80d87bd77b06fb3e6,96,63,155896,26561,129335,85,75,101402,34082,67320
899103c3b128f1def21604d5b00a3b7b,19,18,4503,3454,1049,23,16,5122,3518,1604
432acb0d8d495e155b12af8ff7902a67,43,30,37835,13373,24462,34,26,32927,11547,21380
09cf70df30ef87ef6cbacf06ea36d43d,31,23,14751,8541,6210,32,28,18577,7615,10962
e6c9791250cec7ceaa1ec53735080e1e,124,103,352584,44666,307918,113,87,175423,55696,119727
7b2cc1a3058e4de166a4d49398ca3030,48,27,24333,7993,16340,33,23,20921,9085,11836
52620257113b1c6ee93391a661d39271,85,67,182554,112519,70035,116,74,302333,82406,219927
1cbbc8389f558ea31153e31d7f6b999e,45,35,40961,17439,23522,41,39,38034,17229,20805
3b6c78491d2e4aba9692f1227e10fdd8,58,52,97378,20525,76853,43,28,60919,15434,45485
0ad762849f74befae6f598ad45e982ad,104,69,142718,32437,110281,115,90,153916,35058,118858
dd2a314b5d067d35629a822df40eea2e,31,25,29669,11032,18637,50,45,51032,16937,34095
52cff610fcb9acdcd63e251302b17590,33,26,15174,5588,9586,46,36,36388,8114,28274
5c32c3b4b2a619eaee4a2bbee340dc0e,56,41,61714,18596,43118,51,33,64176,21449,42727
bb7c65b5f26abf699a48c42844d40981,114,97,235747,87393,148354,166,120,422532,54993,367539
eef4aa3b7a83a96c2b57c7c1a11ff7fa,79,64,159595,47272,112323,116,93,245369,33260,212109
5b5e6caafb36243f0a05a0a9a172f9f0,108,95,257114,57402,199712,129,104,277523,63788,213735
af8a6a51e96d7a8d693e3d5b0a89abe6,130,97,440964,92415,348549,133,100,428028,69895,358133
0aa10b43e97e1203920b49e669be788c,130,108,348808,88467,260341,90,65,203072,84239,118833
727fb6b4c430cb3b1ef49824cda721f9,158,106,495590,113074,382516,147,105,471936,75619,396317
211257e10f8710f72ae196c71494b984,38,29,30340,12398,17942,33,30,27204,13068,14136
7c092abca08ba6f9471e1a6753d675c2,50,43,89633,29408,60225,65,47,126196,25911,100285
8f6078fb8a20739f13cf1a03e439b04d,238,168,1744165,206716,1537449,203,160,1261433,234410,1027023
9f8dad7bb3b263a63928f7a2c4a0b78e,22,11,5485,1472,4013,20,16,4223,2995,1228
b196cd1e62c40e5b07dca3ca90deabef,17,8,4271,1116,3155,13,11,1822,1899,-77
aa9fa0f687680d8366980f2e3513f605,51,34,59001,18209,40792,54,42,62087,20698,41389
6113b001e2ab20bd166e9da5da88998e,100,73,188890,59226,129664,124,97,217628,77094,140534
6be6be59070ca31d9d10226f471e2783,104,98,205870,61930,143940,120,93,211385,60785,150600
004f258cb0aec3c2612ec04ab4544d6a,2,3,320,346,-26,4,3,366,340,26
d4f59d67a9da6ad0f7bd9f93f33bda9c,35,31,17482,8680,8802,29,25,17888,4769,13119
c8b25dde34a646a7f27f71505c30892b,38,28,45762,17820,27942,38,31,53876,15364,38512
4d74473e88b3ac7ed4ef987bf9080d04,50,49,56962,26641,30321,46,31,62509,15969,46540
44dd4273b6b9a92864426d60bde09087,34,28,25317,6154,19163,42,32,24570,8315,16255
a616d69ef2881337cad4d479b6eea686,80,64,158560,54314,104246,83,67,180148,67201,112947
17f82bc8527518418fdda9239d12c50c,94,61,186956,51031,135925,173,136,331910,78676,253234
cce73bfa408fb2b33db6565364b23ad9,129,115,318835,74132,244703,141,123,419545,64660,354885
9b15aa34115956bb5ef68d0be1c20ee9,123,102,232541,83494,149047,76,59,154422,80510,73912
cef0795c882c68ec17dedc5f903c5048,121,88,327939,106400,221539,172,121,461537,79204,382333
e86004559ef1a26115a25ab8f3724222,124,100,341795,92901,248894,121,96,332969,96573,236396
8a172f86da2b0a896944c38cd349139c,29,21,20532,9000,11532,26,22,15906,9020,6886
3b4ab162eadfba91ddd4cfb3361c78b8,198,157,680671,209559,471112,223,178,843618,178785,664833
fa00b39429a544de5eeda073a8c7d735,117,87,226562,37936,188626,123,93,236344,39327,197017
31268c7c97ca10919562f4c71d5c29f8,33,29,32759,14731,18028,38,27,31202,12769,18433
e0c113d0b27a9b3817b1b2e5f559a50f,32,28,18693,7462,11231,26,27,15609,6502,9107
dfa579e336f289d7e5ec3921a7572350,203,147,769626,166778,602848,212,136,821994,211098,610896
4891b69c2631eb2165d23c2cdaa9c45a,121,105,237459,48089,189370,141,93,259230,40118,219112
d73be4849e7216edab4d503216d2c6a4,43,30,60170,12919,47251,50,47,51389,18754,32635
94820bf6bdbed3352e83dee5312a891b,32,23,22064,6878,15186,42,32,30011,11005,19006
188a6b04c984cc8af0ab411e6956134c,50,42,32070,34821,-2751,64,51,102505,19034,83471
ea60fe607b4a0b7a44ba2aa37fe263c3,70,58,79464,30699,48765,80,60,127145,28165,98980
2b8ceae22094ff89635a94350ef53769,47,38,68926,18586,50340,36,29,52235,21312,30923
ca2fcc45248c3ce84413eb2e8faffebd,106,89,234214,42069,192145,89,73,163101,48345,114756
dd72b6b5cc681728e3ae71defb8c2013,69,47,83168,27892,55276,73,74,108576,27742,80834
80f579a863e9a0c483a20faa0b22cd66,11,7,1648,1854,-206,14,11,3523,1726,1797
27ee759575b9af16557377f3265af6a8,42,38,52216,13891,38325,26,20,33509,11171,22338
b2936c797e07161185da4245680ac213,34,20,32520,7698,24822,29,27,30544,16047,14497
776928100c6aaa0d42a133681435a914,115,90,306001,76887,229114,122,98,311260,69996,241264
da3306d945295c315ddea8e31bbc0f59,25,19,10409,3013,7396,18,17,4458,3425,1033
9b19c898a0874f0e9a2a08a401ad4d30,87,67,114279,38067,76212,89,82,187674,43734,143940
dd28d5c0ed6b791500b499bb62ff5867,67,62,95018,34049,60969,110,90,165813,32103,133710
e7083b58c2092d1b4286684d02c01253,93,86,214780,66425,148355,125,88,289897,57375,232522
fad91066d335d4c169c837e9ddab6d07,93,75,125326,32200,93126,68,52,81967,30169,51798
fde604e6ef3ddb53a140ca047391b77e,200,143,659874,208938,450936,211,146,941688,182768,758920
1ecf43ac04db2f4328af4c52eaa938a9,171,145,513698,144587,369111,179,127,631464,119658,511806
be5ea66d4b594b77d184b50fc475cb9c,25,16,10911,3161,7750,20,18,8793,5158,3635
d61958b93239f57ebc9153124fc0d21a,13,10,1688,1479,209,10,11,1746,1036,710
b1bc8d7074de904fa3c63e3974aa0d0e,107,87,117592,39972,77620,90,61,141055,22903,118152
5038db9cfd7ab9862e834474dbe857f9,71,62,107284,42264,65020,60,40,103051,34809,68242
abc299b649323d51a7b423fbbaf49298,47,38,45726,18814,26912,53,41,67507,17773,49734
8414a5d316d4e8340df990d309396f17,193,136,625482,102312,523170,189,148,656380,103739,552641
0b7dec1f3cc55ceef8a6f2278550b634,109,95,275104,77662,197442,126,113,340744,87985,252759
78843a2122c47237a62f7b0e7c8ad8f4,115,94,225650,64806,160844,92,78,163479,63604,99875
7b6952c6d89f9c7d9a9259e274b75719,71,56,105071,16770,88301,43,35,41394,12827,28567
85fd469eb2166d24718d47169535875a,121,92,217399,60660,156739,106,82,235273,60186,175087
e5b10fa5568afe67c9227339afbe1f39,28,21,6853,3600,3253,21,20,6804,4369,2435
cfc21b58c3310e78f23469ab3b50c15a,123,111,498865,90747,408118,135,118,491022,95336,395686
ff96cf344e15a8e81fe14ae905250b35,91,64,146735,36490,110245,105,75,157247,34711,122536
76d8ed8f61a7c32c5ccfba1e0c06545f,80,68,142276,30113,112163,76,57,96993,32892,64101
57ce8cc1a29b427e84e13a42032af56f,119,95,211626,56993,154633,122,90,195902,50684,145218
0332a0734e2ad1e300fb9e1a1adb3dee,76,71,168136,38010,130126,92,70,152637,42476,110161
b41752d1d59c03c9759357b5aa1700c1,45,29,34390,11828,22562,33,27,28432,9020,19412
1eca5714d54d7da718df0f9b0c00e5ec,103,63,187466,46750,140716,115,74,228474,54872,173602
69eb6bf2edf9368783585721b47e006c,114,82,244393,78219,166174,205,168,504065,73120,430945
42f94fd2b59ff0080cc16b16624f6ca8,32,29,50961,16613,34348,43,32,45372,19140,26232
61564b06902dd588bd0538ed96928c52,118,75,259412,38552,220860,112,90,198759,73817,124942
d5214fff850ac31f26baff018ed5370d,34,26,19949,6953,12996,40,22,25730,6033,19697
75cdaa7798e4adab6f42352aaee5684b,77,65,127891,35493,92398,68,54,95255,28280,66975
815e291cb61f68f841a93f4050b8b277,48,42,74536,20549,53987,40,30,63050,22908,40142
7102e59a2129fac8e9ffccdc9dc360e1,103,83,243740,48610,195130,90,74,177177,43441,133736
d9ff37f400df3bf26ba75edd92370664,30,32,22115,12805,9310,38,29,25128,11417,13711
76824984633469d3092169d68f30d2ef,35,26,35200,11299,23901,52,49,55335,14692,40643
22ebaf1fd5b253d39e07b17ea0ff2497,39,36,64398,18533,45865,33,24,45690,23144,22546
63580558d19928d9067f763f65fda86d,36,31,27730,7700,20030,33,25,22888,6946,15942
1213591fb7e58f7d70822d56724a932a,24,18,21348,8789,12559,24,23,16933,8315,8618
9c12569bd38ceeb6069b86304fe1eea8,8,5,860,808,52,16,11,1930,787,1143
6f7425d5c0fd3400a9042052769d9df7,139,112,587722,105396,482326,172,118,633138,137428,495710
a962fe5fb6e476b7328c04c60ea5b80d,85,64,158990,24043,134947,84,59,135707,39632,96075
68203a74ff1d728ab05eee53fbceec94,121,85,250383,86880,163503,76,60,185315,75654,109661
a683052a399c5b2abeb041d3d1629cb9,152,116,528905,124477,404428,194,155,631818,119078,512740
38dd31b6429700750823325ab2d4f121,98,85,151725,32859,118866,85,80,118412,30495,87917
da847c6580eb1c6a87de3cc657ce19b2,143,107,308613,57865,250748,118,61,179166,56171,122995
528ad03ec5005b15bfa65d6431cbafc5,71,66,120461,24587,95874,95,78,164882,36705,128177
edb2e83d9ce3101533d2f0123552ea4f,134,106,425957,109284,316673,205,170,652418,86289,566129
3d0c23a9c7285a4d97712603737dd65d,92,75,183292,53449,129843,126,112,206805,54831,151974
881a66289009ac7863b9c906abbf3e8b,59,52,79124,40411,38713,81,62,141036,31979,109057
7b8ca32145a131be53e6349d685ce53a,175,98,339398,59315,280083,147,90,331050,55075,275975
64f2d0b4cbcbd11bad3c879d969b2450,131,101,265086,62702,202384,112,98,267148,67915,199233
cc40e452ba0954f02f53f0ddb43156e8,85,51,118713,37060,81653,79,55,112538,40036,72502
a77fa3a18d19c77f509ab0f17105400d,28,26,23681,11720,11961,46,28,47920,9763,38157
243e007dc0736f230759b821d3c74e99,142,83,414935,92906,322029,134,119,451932,134379,317553
0f92724d1d5e24b95f702924f2161785,62,56,90396,36858,53538,71,44,107971,24744,83227
05e46b179ca4098fe5ec5dc19a4ae6a8,38,30,42953,12310,30643,35,25,28205,16564,11641
1433f450d083ddb32f4153879eca0930,28,22,39202,14886,24316,34,20,32771,13213,19558
463cdee4c9b685ba66a5cf58609f50f5,151,123,740351,175691,564660,173,132,583633,179115,404518
f8176da474050741dd4b6d83c301af63,89,80,395547,137012,258535,104,73,427029,127857,299172
69766c68b05f7267ba58599426f62e1b,45,36,33516,9960,23556,52,42,54881,12206,42675
d9cff18d92f04697d0c901a9c3b72fd0,40,31,33747,15426,18321,41,30,34523,13690,20833
0f8048162d727b9ef8ea77084bb1005c,40,26,30968,9647,21321,34,26,29551,13923,15628
97f6a55b27cb086775ba36ad6760df33,31,24,20196,5534,14662,38,30,19715,10177,9538
ca158218b6339bc711050d302d9c52e7,205,161,958921,176075,782846,205,163,1101275,201317,899958
e19dd0e3b433caf38f440a93349e92f8,157,134,702756,131126,571630,195,147,836294,119748,716546
8a7e853b67715c1be4d12e72422bb320,73,61,176058,63108,112950,110,79,219538,59942,159596
982f839bd47986cb8174e20341e86c1e,94,79,262163,72659,189504,121,96,366591,79757,286834
9fde7ff8956603ca9695021bdea26aa6,158,84,328444,55201,273243,85,74,185601,73961,111640
8eb650bca51c0e57f8a31d7db19866b6,25,23,15360,8964,6396,28,20,15322,6567,8755
b6f4a0e6541d067a7c3c2f2fc74f3e47,43,38,31396,9275,22121,46,40,25396,11854,13542
3c72e8de33cfa7f1369a2a46780e0e57,109,89,229114,63951,165163,132,102,262999,84945,178054
b185e379ffc346e59ec6dbdbfa68c3c6,87,67,112609,31170,81439,101,75,149318,30514,118804
998c7f3037306c500b4cfcb45224776a,89,73,145008,26714,118294,82,81,130311,39397,90914
d932e8da75dc7ba9b773c3412be4b767,115,94,358693,78020,280673,117,90,319404,87124,232280
28bf8c645654c457c8fa2b845da0fc03,68,62,79230,28502,50728,53,54,74084,28006,46078
75e9cfeaff2ceaa6d903f0cc2466cc9e,32,28,25006,6626,18380,48,34,42378,10688,31690
6728fd2dd4dd8fbea2e19387e19a6e1e,149,94,264242,61456,202786,141,125,307994,86019,221975
9a598c12c9102a184229310dbb4a365d,123,99,440694,78946,361748,117,90,285081,66215,218866
d80746a43d74ba5c6fe5399b3cd99103,33,26,21467,9936,11531,44,37,51402,11194,40208
d281d7e2214ea59acfd2f906be43440c,54,44,73156,20085,53071,59,44,80907,20232,60675
182cd4a3a281a354a5b028b41b4359e1,92,82,150696,28795,121901,90,70,129286,26228,103058
6be2825e0ef2af23dd3628b3e36b337b,81,71,150073,39465,110608,82,61,139920,40279,99641
15ace4328db84eca002f478dd7f65450,40,40,36317,15214,21103,37,28,32850,17414,15436
51242b5f670e419cc469a73390b69248,193,145,534248,62796,471452,127,95,393913,81977,311936
c212209381b74241904a0bc79f397dbe,94,74,146622,41277,105345,102,70,130113,42665,87448
49812a9086300eeb664ad7a495cf405b,84,58,195493,44765,150728,150,122,378553,75569,302984
535157518d1f089fefc8907ad5db1218,74,59,106713,45070,61643,86,69,114377,43920,70457
e770125871d879ee639a7cecec9e8483,121,81,247237,44056,203181,122,92,195285,57999,137286
b87aae7af4c2ee75f1ca0af632bed486,69,52,128195,34915,93280,61,52,109784,30250,79534
48fa3073551ab3337d7b34eaface0c3b,108,87,242149,55258,186891,123,93,265366,48728,216638
bc58b0aa7a150a817bb9106709f28f01,194,141,659182,170381,488801,184,126,821654,113380,708274
8862d9bc4a1f5b612492eb8b9d5260f4,52,30,62877,10205,52672,58,52,73084,17564,55520
ad473e1456b1380337e2c65087aaafb1,121,95,365419,83162,282257,166,109,349009,91198,257811
68f66d2fddf94cd368a91bb865707348,228,174,931340,172979,758361,189,156,799519,137523,661996
0427d297464b64f77de4a14bcdf4b363,129,84,321657,98985,222672,145,125,428380,99700,328680
7d387136122324d6384f7ea2977565ac,36,25,40903,13284,27619,35,26,40493,12062,28431
444d0f7c697ff8eb3761288bc97729e2,66,60,155836,33355,122481,44,36,62967,22666,40301
c19d004353612c022a4065c7583f3a05,25,23,26213,12503,13710,28,22,27169,12462,14707
67e1bd08e9c503ca2eb45fff4045ca17,39,36,31282,17799,13483,46,27,38368,13242,25126
65e1feded81f99bd0d0a8cbd14f6e1f5,142,115,512172,112907,399265,126,87,353585,84937,268648
5f9e71f7b2e7e6c4ad9f46386f8e4b1d,62,55,68804,20452,48352,54,41,59068,17855,41213
ef18b694c59be9401b3c08bbefffee6a,0,0,0,0,0,0,0,0,0,0
df435060ec45eb403c26f436f05f8ef2,53,39,52978,29344,23634,60,47,74102,24767,49335
2bf0d3c76f85a680d2ab7dcdb77f7cd1,18,17,6609,3499,3110,28,18,12599,4404,8195
e9bfe9a263e563155d9ae4fae3971e10,90,58,147783,31764,116019,79,62,125959,28619,97340
51b8eb1ee98c2af834e671a509913171,65,53,89991,17292,72699,65,51,83213,25922,57291
579fe6ce704769e71a076b9aa237fe61,78,53,97560,36606,60954,103,76,201381,40747,160634
468d7c1988af84ef0dc79384651096aa,70,57,96800,39617,57183,61,57,87637,34758,52879
a5f9dfa27831d8da2b1298a1d9b094d7,116,93,209553,39396,170157,90,82,177283,42530,134753
292df8f67db6f86e8509a3d52ebed451,102,81,238243,41469,196774,87,77,126835,47283,79552
042eb5350bf97e647b57d3b0c9fba4f9,33,28,15449,5835,9614,26,26,15183,7262,7921
a1e551d7627e43d5fe2c6f39a75e5ed9,46,39,54395,25745,28650,52,34,63301,19386,43915
ac5b8c46f555c0a9de279619ff9d995d,124,83,284149,63107,221042,116,82,235588,68122,167466
69b6c4e6b61f75c229162e765d957854,19,18,6782,3048,3734,20,19,6361,4669,1692
94046dcbe3a4c2841bf1f5ad4ef6ba1c,59,48,77439,24699,52740,88,63,89301,25351,63950
86a2a2d099b01011e9e5c70054646072,76,56,154224,52573,101651,99,75,195708,52569,143139
5362db7d76e14d592feb359d47559ce9,71,61,172754,43876,128878,67,64,126914,52485,74429
7674066cb121730a216c4218eb9cd4e7,83,61,126189,29216,96973,96,75,109155,37940,71215
0b71be203adbb968b1a3c3c08b1eaece,125,94,373932,115175,258757,189,136,654945,72055,582890
180b51f1e7a3532db55b341112f7560a,165,133,539724,88055,451669,170,123,507508,112969,394539
7f7fd79688a4e2bcadb5eac0e9df0cfa,20,17,8647,5399,3248,22,16,9918,5493,4425
ae8c5298964555ef03720c24bc41ee35,178,128,689113,167406,521707,176,136,681682,98225,583457
d2eac1413f62dd5d718e938ec3b69b8d,38,30,29038,10436,18602,29,28,21598,9427,12171
8f1921e00ae3b4e3bff7341d3c0b2a14,68,44,71535,19990,51545,52,53,83476,23772,59704
add05e874b3540facee11eb34c4ab505,116,85,234551,54612,179939,139,97,220042,55980,164062
3cde28d430786b8a2eef66cfd980efd4,133,108,290056,74588,215468,69,43,114610,38039,76571
3d8d05f06ce0929abde1575cb373a4eb,222,179,1496144,206722,1289422,214,157,1239646,177273,1062373
648ce10a00288458b2c8b35ec88134cf,134,113,407610,90139,317471,164,127,444648,68274,376374
49eda2ec31cf91adb08fa67344964777,161,112,372843,50877,321966,108,83,318281,44003,274278
976a860c6d021d7d950f630aba8dfad3,43,27,24867,10008,14859,38,33,25381,12976,12405
2e6a23f884d13fbdc7982dda16addb58,79,43,91238,16366,74872,57,43,65714,20390,45324
09b8d3ed0a6ed2f5651da00f6dc92b73,158,129,474768,99200,375568,136,118,472176,91042,381134
fa8ffd01cc5d1a158cc9bb8cec4df7b8,87,76,115096,32626,82470,104,91,214714,30898,183816
3a2a55b85e7c0c979876d7f07063e64b,134,102,510968,121871,389097,147,113,618905,123412,495493
2f7ce2cbe37bbb2ad161fa08b785c2b6,86,73,168543,24526,144017,78,66,95073,39243,55830
7ff18153917926e2fffcae3af105a00a,44,36,52395,18592,33803,36,28,29955,16128,13827
2d5613abdd56e5a7be2df4f323337387,4,5,372,725,-353,6,5,865,512,353
615b430f8cc652e46db2b02022994156,39,30,24500,8515,15985,36,30,25472,8504,16968
49675b600fb448bc2668702a0a7cfd81,122,76,233441,59002,174439,150,100,367691,47498,320193
d13f5ab7225f25216632219e5954ef4e,143,93,355471,111893,243578,166,106,515778,94085,421693
89b138152ef9430d9edac5c1faa0c372,95,83,177775,56547,121228,107,94,210710,82802,127908
8c164dabc705c3bf2d91de6e3377980d,21,13,6645,3019,3626,17,12,5921,2333,3588
ce86af0e8c7b88468bfb26888bdf761b,31,25,35658,13362,22296,34,25,30114,12469,17645
92c8e5e0fbc1f364e25c2efb02802268,24,21,4978,2970,2008,20,20,4355,3159,1196
f94b0dcfb5b41d2fa531256dc25db047,45,34,48430,18838,29592,53,31,38523,21521,17002
7d2a94a6fa645d4b4772966b27eba306,94,83,231061,45655,185406,104,86,187464,71692,115772
9f41227ce42f5b412f32dc9737b259fb,108,83,328540,66189,262351,193,139,382864,55876,326988
ba48e9d0961c22c0a98f0bc668303a42,25,17,7060,2778,4282,20,20,5164,2587,2577
5c6a4653ae068e06b00910adc80fe9f9,82,56,108386,25938,82448,94,78,123505,39678,83827
ec20dbffe5fe71bd78e51d78cba4d599,25,22,10777,8030,2747,31,23,12707,5688,7019
6eb76d7b7511eb4fdb75f95d5033c23c,22,15,9492,2152,7340,19,14,6750,1720,5030
7d0c0d0ba383193d61a37a161a0bee07,137,123,251571,111024,140547,173,115,481890,84838,397052
54edd738b4084b1c69477266a9d253e1,134,79,243882,29268,214614,142,102,258635,48536,210099
9e7669a7350c17bd79f1c8fe09bf465c,92,74,309520,77686,231834,148,113,345433,87822,257611
9f34c2ff5128be8977200331ca3fc55c,207,169,799098,168158,630940,200,176,967211,178567,788644
4cc5706ad59b3ab696f737db1111c772,94,79,172533,56401,116132,108,85,222898,52669,170229
a529db0649f34cb4394a9b7135fc92cb,134,104,331149,49224,281925,136,118,355301,62223,293078
4c2fb5355546485980e943e37279e0eb,83,59,280311,92655,187656,165,144,494534,93119,401415
14816ca0f995cdf219e2293695103f7e,125,96,296725,58469,238256,132,105,256207,76297,179910
8d1b5e828d5fccb346260fba8d7d974b,171,128,613605,150611,462994,183,142,530422,120613,409809
e8438ed449cd765f57ce9554e95e963c,112,79,205073,43636,161437,160,126,275090,57905,217185
47389bb13d16f1aa3c22bfe10a39a001,29,20,17473,4965,12508,20,19,12141,5800,6341
2b8237f3930796a119e6acb5f29d1993,37,23,31208,9566,21642,42,36,47162,11376,35786
8b3772cfcd4c5ba6b9b0963c834d0586,153,98,585628,122307,463321,175,123,692667,169801,522866
047bdd9d8359f5127b34b3790811c9fb,28,19,16049,5999,10050,31,25,14034,8066,5968
067641cc7232e7d7a42ae10f9d48e7c9,17,14,2741,2311,430,20,14,5119,1800,3319
bb1bbcd4eed794267eb44d9ae6fa90ec,133,107,505587,99631,405956,131,107,398720,123259,275461
ae54f5d133ef5a7a435790d57660395e,127,110,386911,120661,266250,120,109,322004,102065,219939
40a14aa36d9f5b6f7a4133de8772d676,7,1,1593,43,1550,4,4,233,297,-64
6ddb3c74ee25c84383267578e5f697bd,164,126,501783,84872,416911,167,130,469951,116139,353812
cb81bf6f31844970489632afc9dc45cb,42,36,54248,12862,41386,36,33,44423,14275,30148
29009a8602583cce03fce14b1c76a737,159,115,575306,97293,478013,137,109,638409,118604,519805
52a7aa78f1914f3fed0fa102de92d547,86,62,150632,35976,114656,96,89,171264,42786,128478
fc79e4da5a18a04204696cd7b7528b07,162,120,894577,111708,782869,195,161,775093,125737,649356
e72d620bf92383e26e222b613c838cf8,82,60,105305,31304,74001,79,72,141840,25676,116164
b189127bf97df7e6b3a341e8835bcdab,127,116,424453,101541,322912,159,117,470416,70517,399899
37b82d627d1727407b5e97d3531a5f87,87,66,123684,33708,89976,72,60,99425,34827,64598
e5546579a090206ef1b0a833c99a6ff3,167,138,494582,165491,329091,151,120,432619,101271,331348
3b060b9e4977fccf9b9239443adc4001,1,1,73,304,-231,1,1,304,73,231
a8f594f6904efa7ca6fc01a0363c9373,73,48,133020,44194,88826,72,66,164527,39469,125058
56098c5a2c6b1c2e90e6b2b75caf14af,93,74,163139,28198,134941,78,68,121697,33250,88447
04d0af8cca5255fe55caa7ceee4e5e86,104,83,157812,61850,95962,109,89,198938,53450,145488
4918d1a9803fadcf8c379bb355b11506,110,84,301677,58325,243352,121,90,228095,52016,176079
0658f38b90a7fc7a057b4acf824d7db4,36,28,39685,12804,26881,35,26,27684,14671,13013
7a540a7b12218e81b55ee33bb7c5bde2,14,13,2504,901,1603,15,4,3250,245,3005
5a29972c0ee306600dd340be4be3b7a9,48,51,69336,24266,45070,43,33,60438,19799,40639
a441149fe165f0f957ea2bb967ea4b21,15,13,3077,2068,1009,12,9,1684,1777,-93
3953af7a62ecb1d13e79ad7c4140b211,25,18,12910,4490,8420,23,18,13397,5116,8281
c7e1222aceb67526e261e26aefcc8483,113,86,197843,54486,143357,138,102,274278,45717,228561
d4d1309e55b24ff60536f6a464f57222,163,120,394447,83362,311085,116,96,344183,122334,221849
51a2202e94ecf949620d5f17b1422b63,37,34,30426,14425,16001,44,40,54329,14034,40295
52a71be44f59f1837253f3e46daed2a1,140,93,379637,70393,309244,125,81,290855,74650,216205
abde54ca5828278396965f0a7da2db02,90,72,179119,63953,115166,86,68,176063,57281,118782
d829c8ebd5170e312990411f8f8ab49d,117,104,268201,45521,222680,93,80,161963,52446,109517
e376553040127967b4fa1a88b793c009,63,45,88871,27859,61012,69,59,95349,30000,65349
960678d381b5f7e5d0690a7a5c4f80c5,33,27,28780,7843,20937,31,31,26123,12510,13613
d0c3f54fc7bd83c769958d9fc045c52d,34,23,36506,7422,29084,31,26,14570,10776,3794
c895be7b46a750628cc97d0db37bfd06,157,106,410847,102352,308495,143,91,383785,76446,307339
fef79476baf021a4bea7b9d455c4d51e,41,37,52036,19601,32435,43,34,48224,16376,31848
b6e37d7b295a425e895e118f422deed0,155,106,425260,83639,341621,124,103,314121,102221,211900
6cb5b6298a3a6d226ad6e03930badff6,146,111,441941,78632,363309,117,94,391083,104021,287062
2dcc2dbb277f41362f6465b0aa3c27c3,127,93,261145,52501,208644,118,94,255893,57400,198493
0cb9cb5dfec7397e091d6916940017bd,54,40,67065,13908,53157,43,30,44703,14449,30254
4017f6c1e14785be6ff0f19119085a6f,150,121,360935,63166,297769,130,97,274565,70807,203758
1137917d7edec128bd158a2cdc2b1eb8,177,134,597346,130840,466506,191,167,664762,161078,503684
00ead41bfbcad54f7551410c37b77ea9,71,60,91704,37998,53706,75,73,125422,37927,87495
f61a50de84a5b13072a2dceed9d1cca3,89,74,170809,55509,115300,116,86,266566,41798,224768
0e516cf0072d2fb5e95aeb1c84b88da6,113,88,233033,40500,192533,154,105,290620,48328,242292
a295242420e7abe990c3ddea0e9f2a2a,37,23,19462,9358,10104,45,37,48084,10050,38034
01f3be72087e6c5f5fc36ba2cbc00540,150,115,376790,63811,312979,127,100,328742,82197,246545
9db4fc3806ed5421474415aa60d380e0,38,26,21441,8390,13051,37,25,26699,6930,19769
c161897c74ff18a77b8b8d2e73e70a9f,172,105,401754,90174,311580,135,83,323370,67026,256344
af55b4fef1ecf07acd64fc372b79fd6a,60,50,77539,45347,32192,74,61,130429,29476,100953
986f3be61f7856a87cfdb4f4c6a41f8f,112,94,256767,69507,187260,142,87,333189,58476,274713
586724307635a47b3ed4caf9234680cc,145,121,400065,69288,330777,131,112,286344,69801,216543
6197e51432c82a59b57b4038afcecc96,18,12,3666,1202,2464,13,13,3096,1461,1635
815805b2b3cc650b403d6acf452302e9,83,67,148233,25798,122435,59,49,95321,29975,65346
069902d3441d6e3a8077361dfe395316,25,23,16666,4231,12435,28,19,6468,3076,3392
0e91128cd21496db2419189909ae59e8,139,118,421122,100000,321122,112,91,373931,91387,282544
32971d1a4b7b2dde7c9e9a75c6a1d6b9,114,87,253069,43173,209896,101,83,246172,43884,202288
ba5ea2b6f95e724d8f8c79b766ff6b6f,98,82,223009,61685,161324,139,96,283241,55725,227516
cd3534a1284da56decdc52694c12b738,138,109,356255,80071,276184,100,87,257827,92262,165565
eadea32f40cbbcbfb5bfaf30813876c8,161,144,554156,149833,404323,181,116,462847,112352,350495
bfddea1c4182abb24208a0e3c7101c0b,138,107,266481,35746,230735,116,92,211010,64195,146815
a46d1fc2055bfcb80b2b80e338660ebc,2,1,724,145,579,2,3,261,840,-579
233e0952d5d113eee9f19de8094d608b,15,11,2530,1103,1427,12,9,1299,1486,-187
97a487b81e68c40a3a8d255216c86deb,174,129,716409,153344,563065,174,130,700773,170623,530150
7551d5706da7edb80b331022c1294798,153,86,287383,41839,245544,125,108,245236,65167,180069
2a75b14cd9e77b72ba4b156c5a2983f5,127,78,271603,38919,232684,148,111,242578,53063,189515
b737b3e5188362baef74ed88c9d1677f,67,54,99882,27782,72100,76,65,138136,32865,105271
f9a62ea6287f57275eccd23fb3bfda25,78,77,192220,54412,137808,83,68,180298,54427,125871
f55a4aa5a148120e593b2546aac3ad2e,126,105,284217,58682,225535,132,97,347417,42755,304662
9397e63e3fd11a7929c9ab367acf94a5,15,14,5311,1300,4011,24,19,4520,1641,2879
55241a6bad7a71a637199a2d3029f3e6,39,25,33536,11262,22274,65,45,48599,10534,38065
e525b0a9627d0d0ca99d07ccc8c0e161,169,129,355305,117358,237947,163,111,407609,65969,341640
7bb49c75a051cd79adfda960a07877f2,51,40,76995,15496,61499,37,38,39908,21982,17926
9ab5b53edb6fce4caf4916d09d680cd3,143,106,511604,102068,409536,163,112,493324,91375,401949
aead8f3d5e20ac65d5b225d205770acb,97,87,154648,54734,99914,78,59,121536,34642,86894
e8a4e2ca4687d93afd2d8036036f86cf,50,46,82245,17050,65195,40,31,48437,13891,34546
6299b3ef21f7a89111471c376e08ebfb,62,42,110490,19833,90657,62,46,77142,28851,48291
b619a8b137b09e01218064c213037c7c,115,87,214587,49126,165461,94,77,258221,36242,221979
2e89ddf1edd995468b4e357de3f0cada,79,57,122772,27658,95114,70,57,101647,24686,76961
8cd497cfd279221a605b89a77b201c97,15,9,3296,845,2451,21,11,7223,1086,6137
d85c2f4d494a0c8299138613436fd79a,143,96,299520,55724,243796,126,94,225798,61754,164044
83fd7065531aa8147d7f4c9f6b3823b2,164,121,532005,109780,422225,115,83,321988,79969,242019
d74f98cfc309e5a519a6f43f4300febc,38,34,28083,11338,16745,41,30,26926,11653,15273
fe634ffb28de624ae3504880496af719,37,32,28108,13496,14612,39,23,41276,11239,30037
d0ec2729bf91b24a285a9d9b4cb5f860,28,21,10079,4979,5100,29,19,12990,3634,9356
25c92d15d055a7b4c62be988ffdf3b8a,132,94,278824,40597,238227,91,81,173448,51443,122005
8a936e03d182ff509aa24e2c6a0a5f6e,204,138,709858,118631,591227,187,135,800612,124134,676478
877deebe806ba3f6b53b80b07b57874f,163,131,428081,98782,329299,147,127,485637,106638,378999
5265f43bfc4bdcf96420aa8c300b4a0c,36,29,34454,13154,21300,40,29,33491,11455,22036
af02c0b7a302eadc543325e2949c6b8e,30,22,15642,6044,9598,35,26,33977,10813,23164
c89ed9a238acb045647de15c58f0ab8a,196,109,445364,59814,385550,167,135,541913,81132,460781
53032092edb973c470bb933e8d87e65e,139,117,427387,80522,346865,105,91,381241,102013,279228
ea897c7600409c816cad2172d886b009,144,113,444269,74414,369855,142,106,407805,98824,308981
42526b4a839152adce09bf041b991843,109,94,207229,61087,146142,96,74,189556,60659,128897
4422819bd9367bf9cedb28a73860adf3,59,48,96111,27496,68615,67,58,102086,22764,79322
f17d1659c2b06d9f0f2da4c567f60440,150,120,707230,160929,546301,183,156,944153,222521,721632
1861269ccdc5dfe851e06c6ebbc2196f,11,12,4722,1642,3080,19,12,3630,1107,2523
a2e3d4f2f013984758ceced7045838ea,86,56,131716,42362,89354,98,89,200377,51771,148606
e2011f1f5bd011d4da29793122af1f1d,32,25,24489,6279,18210,26,25,10750,7029,3721
5863e7a977c4b87ce1c6e8e449a1cd26,128,85,373483,50350,323133,150,126,396719,69974,326745
762feced88b22ca8ef274761074e1a07,41,38,51035,19058,31977,48,46,47757,18955,28802
24182144c34305e327b3395124de06fc,72,55,110490,36060,74430,85,61,127703,33587,94116
9f992f180966dc2a8e0d6d1bda3dc664,140,108,384340,114368,269972,154,114,349373,99407,249966
e366e6505166825f8c91ed0c58c9d115,181,131,596258,120721,475537,162,132,562509,97253,465256
bec09243883ae10eae55568006c1ef70,30,22,21271,7349,13922,35,31,17128,7844,9284
bc49b8b7a50704d2a1dbc6bac282cad3,134,108,340579,98004,242575,156,116,414675,105949,308726
3614aba93004c888a86a4b2a909a2382,123,85,387843,60384,327459,170,139,466992,86714,380278
ad846394e5a1d43881b58d305f13b5e1,22,36,21842,56248,-34406,90,79,203631,22307,181324
acbcc70f17ceb413a4f74d88afe1b836,16,15,1453,1119,334,13,10,2018,469,1549
3947f5c7853c1714a8a90323ef1118d2,64,52,81248,18735,62513,74,56,67773,20171,47602
c392a8fcb1dce4ac956de28ebb4ad70e,106,88,226485,57849,168636,153,112,284457,60515,223942
f0c8da268985d249d897de202a223c98,100,82,218242,44744,173498,110,88,273581,65424,208157
9d85ee5dd50fc54d25f4208a05e3f0cb,156,124,450421,95482,354939,143,103,450567,85546,365021
4d538c52d1ac7806df6d50fa19abf1ce,62,45,67531,22956,44575,64,46,87767,17907,69860
8f21d00e187d47a918a306a918906038,192,131,745446,225924,519522,165,129,704197,139426,564771
d2ca1d41acd73d5093f840a07769bf6d,98,70,183985,39357,144628,88,65,166334,30368,135966
7a4f2329728e5855d97af49a46a75d38,105,86,241909,59603,182306,142,122,309198,62151,247047
c8ebfac65345af599c4f318473866fe0,35,21,13424,3168,10256,24,22,9918,5378,4540
01088536ed4412353a2fab9c808484d6,128,92,320075,103591,216484,142,101,503898,90331,413567
62cd6511a1179c58bca314bcfd9c3271,63,43,89648,33972,55676,76,56,121483,36196,85287
53b9f8425491b84e944c16a25fd3f386,177,135,605397,124768,480629,188,134,653966,121697,532269
00ad40d4406ba6666c184c8b2c80ceb0,8,7,1017,838,179,8,4,1723,667,1056
1e5dfa4f0485e260675cb1d6d1a6a1fb,60,57,71954,35971,35983,88,72,117634,33174,84460
db7050396622d08c6e8a5d6aeedf5f44,165,121,391785,55307,336478,153,130,414452,67343,347109
dd59d29fd2d539d96f8e7907db62e83d,20,15,8030,4491,3539,25,19,9522,5919,3603
f426490789593683dc86f7b2b4edd460,84,68,203195,60519,142676,126,96,275954,62930,213024
b17ff8b8a1b60f72f181640233044c1d,61,52,85539,24251,61288,65,43,59632,22350,37282
f2edb30830653a08e9ee741f41c98c1e,148,114,393508,109819,283689,154,113,450578,86540,364038
d24a6ad4c77b0e391c3469133aaa61ad,21,22,6548,4201,2347,19,18,5816,4741,1075
9616f79d8e9d8de40c6c8aa26ee97cf2,36,35,49028,15853,33175,46,27,50070,10058,40012
63942ce14933b839a154f24583aef310,26,16,11305,4090,7215,28,20,13875,4212,9663
eda7885aa0612137aa9ef79c2b171502,79,69,137307,58635,78672,122,91,268834,37809,231025
932509db7aedac244afa1ff39494be55,87,76,157965,47908,110057,89,77,150824,40391,110433
48baf96e5b3ffffc716d97768cf0d61a,43,40,56545,14543,42002,40,31,41608,19230,22378
ad34d72ee33daa11bb0f82e8b4381932,107,89,283748,89767,193981,95,72,213972,99141,114831
2997ac4ba3f54e1b5c2d383c7f1fb3b1,191,147,759925,124291,635634,182,153,745403,121815,623588
b9de90776523810dc8dbbc6f3ed9a586,26,24,12723,4893,7830,29,22,15621,3174,12447
e660aec5ad3b2dc244ea201a232a291d,111,96,192378,48376,144002,110,98,158331,41587,116744
0a5e52814ef8d1815a96f62e52ea6023,26,22,12746,5930,6816,25,19,15948,5306,10642
0ab362bb559f1e4c8bf47302ac1a7122,86,59,193493,49998,143495,100,79,199045,57480,141565
0ac0c4697cc4b0f599de8b7576aa6bad,30,27,35527,12764,22763,32,32,22379,14118,8261
0e2e3bdaf446be048e1d8501fc58fcb1,149,117,406459,63348,343111,121,92,296582,61189,235393
dc0caeee163e6308c317443e689afe4e,80,60,127841,30644,97197,100,78,149068,38353,110715
2e4750a3bdf94c3ba936177fb6d18916,87,62,192872,41026,151846,62,45,146110,39073,107037
8a224c996ff8b620df825321ddfce4f3,41,24,30296,5714,24582,43,32,31519,10113,21406
ee597a15114d6b454aaa8c127b326f4d,114,88,247270,93292,153978,187,116,483798,63160,420638
fbcdef1ce486ed47ac4244bf7ac7dc5c,68,49,109797,22423,87374,45,38,61566,24902,36664
6342eb890299b07a70b10da07e2bd4e1,38,31,33614,9652,23962,31,27,22507,13872,8635
5e949a5b1ad6a91334d0e3ca604228f2,126,103,296606,52711,243895,104,86,244654,49344,195310
2e81f5ba5ffe5422009b5de286066428,37,29,30514,10092,20422,39,33,27676,13856,13820
bf24f59ceea2c10ca9c1ce2ddc056489,89,69,155375,44372,111003,67,52,130245,39844,90401
b6473244d238b065ba13e96002201796,110,98,236894,94061,142833,131,98,329573,100759,228814
315049ea5d2c89a4571e68a1f09e5b71,72,49,167837,42135,125702,88,65,224650,50987,173663
e495eafaa22a57406875c8a184249390,25,26,13194,8275,4919,31,22,15664,6382,9282
1c2b0a090abae5bf42b69aed2d7e0094,99,72,233685,69131,164554,133,87,272433,54868,217565
d92b30204f073dd50ead94fc89256827,114,71,165559,56412,109147,159,109,390133,49165,340968
3f5d369f4f9a99056a009b9078f1caad,41,24,25922,13140,12782,38,34,38841,12855,25986
0e937cf0d83d46c7ee06106063ac9f2a,136,113,233705,60415,173290,87,66,164887,55578,109309
ae40e0db2156b4ab6c229acd4f3e5384,56,45,83414,26597,56817,48,40,75725,32000,43725
18e8d8a15496e3fa68e858034d2efa51,166,140,565741,126281,439460,174,131,545968,104945,441023
b7e69a59a639a365f76e78b2dbabac3c,163,121,565315,122123,443192,188,128,694945,111931,583014
b1668e98ec7f16534a3922cf165d771d,124,103,284993,85079,199914,104,87,271534,74900,196634
e27e2d7aae6e3148a816fdf9b0af28ff,86,71,131843,44098,87745,131,103,217016,60325,156691
5a168431319d11b58885a1ed96189956,158,122,506695,80412,426283,172,128,503319,73204,430115
d64e4f2fb0c79ecc54281f3f45686e0d,110,82,185671,67678,117993,148,81,329297,54279,275018
6357e3df3dc227fcc214799f7e6c3088,126,111,320865,82469,238396,88,65,243777,67981,175796
a695c00c9de6e369cd61815172b7bc6d,129,96,272283,35382,236901,98,86,182015,50018,131997
1790006e36394d9f82c97092b497e792,144,106,451756,99339,352417,145,121,351575,96489,255086
74f71cdc96438ddc744c503914b4a708,15,15,5750,3094,2656,30,22,12518,3883,8635
a90b646193d8510ab0dc68e0c468730a,109,88,241471,36454,205017,101,86,166972,55628,111344
950b00cb22c69713624b19ecc222e79c,50,41,72160,22076,50084,54,41,66449,21234,45215
f1723c13232ef7c1aca0936804172423,134,119,418544,96822,321722,146,109,434361,62369,371992
31932980953e60324dcfd0aab4bc9e70,77,73,116570,29146,87424,42,39,48421,17357,31064
22d39d2f1be4fee26cca7a18a13135ee,184,145,791785,223465,568320,206,157,926147,243115,683032
d899f61f7172155a1129c87d6551004f,46,32,56393,12890,43503,45,43,33721,22977,10744
862a5ffaba3890ac47dff67ae3b12931,152,111,325126,85306,239820,125,94,381317,84389,296928
69fba09164d82c323f554127dcddc36d,83,47,122115,30893,91222,77,57,96494,32132,64362
b4f106f4ed76702dc3534efdbd8dda1c,103,67,175385,33940,141445,107,89,229788,43964,185824
412fa456d241dc685f004db039a4507b,94,59,139450,27425,112025,92,78,188043,56096,131947
07056264b8857e420dcd310ba8139f6f,189,145,1060873,226718,834155,225,167,1180331,194168,986163
c9e8bbd77282c9722d7a21f07862dd88,55,49,61962,18795,43167,35,30,28173,19249,8924
f19a34632a1b9d92876da05af56782a1,103,93,240310,63627,176683,167,127,396652,64237,332415
cec55670cc5f4376375f74625bcf85ed,24,19,6160,4077,2083,21,13,8697,1997,6700
f114f0345abdd375518535f664938259,140,101,431949,151737,280212,183,136,584191,114024,470167
474e9c84afd9a65d3234561da2df1fe5,67,57,102655,22767,79888,54,48,76686,24373,52313
0153fc2f934a86d8a60e07a9f648be83,34,27,53597,12478,41119,35,20,32269,16106,16163
6c41507bfc245717dbea1cf828ae515f,115,108,298109,70779,227330,163,138,459923,54163,405760
fc79c8e863301561e22960f84262e3c5,34,30,59013,15422,43591,46,31,65585,19998,45587
e0deaba4884b7e217bdcadcf14f94429,10,9,1073,921,152,11,7,1242,463,779
d38a600d65348886a872964b9a6e996c,39,31,36880,17571,19309,62,46,76823,16976,59847
f44acc9428334ba13b7068550b72e59e,135,91,368283,71187,297096,145,108,348309,88769,259540
337fdd64d924b8bd563c3376735f1fe6,49,35,74108,25162,48946,50,34,83607,22342,61265
dba9e611d79c15a61b9849a8f6e28d6c,100,81,192132,82448,109684,120,99,272700,77238,195462
672772ca432d967eab24d9d70a55cd5c,61,42,74072,15967,58105,38,26,56099,9791,46308
ee493b5f0dd2807d77abc82d532e5a9e,164,93,397237,48619,348618,147,107,334312,65529,268783
a625e01aee447dd65ed9e849cd231d93,8,3,1090,266,824,9,5,989,811,178
d1011cf23bbd8ddfc752c9a4ebecb1e7,144,118,328968,64338,264630,131,118,284184,59803,224381
1c508710ac9528363be4b90aec2e531f,24,28,19681,7150,12531,36,24,12511,5098,7413
fca7dbcca0b96936d4ac2df3ed0801c5,22,13,3993,1302,2691,11,10,1763,2072,-309
748aeacc0e1fa74802cc720ea3a46095,21,19,14044,4571,9473,35,30,25383,7162,18221
7213f4f39c23d0239910ba7d82ccb14f,15,11,3244,1347,1897,13,15,2948,2062,886
d82b4552c47b3ea48566f8dbdf98ef5f,79,60,108226,44697,63529,88,62,138345,45715,92630
54085a57552e0fb6cc421a146bf1c9f4,104,76,225656,53496,172160,107,81,215371,41233,174138
d105bcc0049eaa21f8944fdfe50196be,44,37,29384,12738,16646,46,34,31479,13228,18251
1be3963d1d266d93062d96722d059eda,93,79,193575,51860,141715,110,104,220545,62053,158492
b955042ca82bce70cc28f43625aca6c1,41,30,44178,14416,29762,39,31,27166,18250,8916
e1ce2829991359b0d43661564039f72f,178,130,599408,151094,448314,196,142,717275,156399,560876
8136a93be4b97f8f6f795fd8604e84b5,137,100,222392,42421,179971,110,86,165940,38323,127617
bf03cb7e2bd7d0031077a84b24407b4d,59,62,116617,64992,51625,71,57,141026,56214,84812
5e58eaef3d9e79ac4dbd6c38ced6b587,115,97,261876,72335,189541,156,130,442674,67419,375255
3e16392eee717f08a20a27d785e3e2c3,118,93,206562,42802,163760,89,69,133488,31056,102432
85ba8c6c31f8e00b143d7f133af6b3d6,18,18,4642,4466,176,19,15,5592,2613,2979
17a590d4096eb4129ba6c67f75112cf7,136,106,438062,108903,329159,175,141,600160,106947,493213
2cc69538716bee42025d3fd3483fbf00,24,23,12179,5366,6813,24,16,16687,5120,11567
1498bdf6f8500fd64eef0bab4a312cec,135,96,280683,66751,213932,111,91,247427,74872,172555
65d721b26e5b08f3c52aa85e8cfc01b8,72,66,121265,29225,92040,61,49,112744,36177,76567
a94a6e00596a34de95b58f5c5473ea87,83,59,152825,36267,116558,122,84,222582,49370,173212
a8023b8afaf9e90ea4044d80c1ae746f,103,82,232584,45275,187309,89,58,174367,42865,131502
4e40cbdcec43241e5a88d8e1e884f7fe,64,55,85668,41154,44514,82,59,109640,26097,83543
35ee7d92ec49502ad320bc9477db813e,157,114,379726,50163,329563,172,110,357799,64017,293782
7d646331e6693910a156228648e3576d,171,116,968525,166270,802255,203,128,943758,158121,785637
d32ee2c5116e301bf67edaf8f6995b66,98,75,223016,44170,178846,62,57,125080,56635,68445
dd1017d90bd6a0625e1de9965ed7091e,120,102,270685,63538,207147,113,67,204781,63013,141768
3beb3e7c1fae7c93dc7981f9d5795945,23,23,13401,4784,8617,34,25,20625,5422,15203
258c71bb797adde2979a662304c7bc86,102,75,187787,42073,145714,89,72,158170,37968,120202
6b70380d0c296dace131aebb880513eb,62,43,58914,12674,46240,57,45,44475,16717,27758
dc1f6c021d8fe70c3c773f54a274ec14,57,40,121491,33301,88190,75,52,138355,40158,98197
e521ecfddf0ce783f264fd035e42b9b3,67,56,99880,39327,60553,101,83,182002,32134,149868
ec2f153c50917be16a80d4691ff0e365,60,54,77734,31742,45992,88,67,117448,33124,84324
f4c3153c41e5124046a09a677d6f67c2,128,97,297987,91089,206898,107,72,255580,83425,172155
5c5e3a4b70fb7ec4be822ccee6287685,93,64,215533,74620,140913,109,78,272397,89588,182809
0752da30387dd4c90a003bf2d29cd2c6,0,1,0,58,-58,1,0,58,0,58
aa84db73e54dd455cc934bf615dd7754,196,163,768192,166073,602119,204,142,781319,163111,618208
958193058666d9a20081dc1a6b84d384,103,89,210826,38150,172676,84,79,220456,53070,167386
151c77aef4238f7377bcf931af048c29,56,50,74773,31628,43145,82,71,125839,41163,84676
1bf9c809854451e2254500d7395dd409,23,21,11816,4933,6883,26,19,12079,4723,7356
60fc6f0f1b1ec0deb130d56f7b70cb47,157,112,431672,72578,359094,115,79,246848,103631,143217
7f5772d8685540b9a24fe4816df2c402,121,86,319662,32167,287495,138,104,323967,36994,286973
948da2fed1db9d8e9ccbde187d463af5,161,110,475277,124852,350425,163,122,481991,112205,369786
a61442ff3011570004d3e5c22e65b0e1,36,32,44592,15510,29082,42,40,46620,20420,26200
7070965333658bc482df47b869ddc7fa,40,34,38365,12037,26328,43,28,28315,12025,16290
852f4089e9987f9c6fca9872ae469322,70,51,104068,32903,71165,83,63,125218,23851,101367
1e21c4eed99dec71fd1694f04a6a7c79,95,73,146466,54780,91686,104,85,238960,55123,183837
263970b386ed96ae83ba7c6cfacdb52b,110,96,195768,54641,141127,90,70,181069,43592,137477
e1ab79dd95af1780c7eddcdfc290914a,54,46,86967,27967,59000,66,52,94884,21480,73404
e163f7af445a1432cf75a4992666c54e,88,69,156288,50869,105419,118,86,211033,59121,151912
d5ca6cbbab87bc92c829d5493f248986,39,33,40458,20935,19523,36,33,42337,17000,25337
012d4a31b9a0accc2a6c87a91c680410,125,112,299371,83157,216214,140,115,369197,70327,298870
398c5b7da108053a7e1def6603a8ae00,98,92,223674,71978,151696,135,100,324488,47922,276566
db7ad95effbf52a6cd81fc78964ab150,188,146,775895,144491,631404,188,141,611056,131628,479428
809abbec2796d1d40f51d81c3897c725,27,18,9518,3975,5543,25,22,16534,3731,12803
32f89a5473f68ece6039bae2a4de96b2,46,43,59676,16801,42875,52,43,53423,18638,34785
4d15a0fabc8f2351d7cc1cf98e76146b,54,46,82552,21127,61425,39,20,44450,17703,26747
59ea89e442e91ad3a89b6f38b8f4213a,18,6,2752,316,2436,9,7,939,752,187
4070daad9bf07d522997ba23cfd3fd92,0,1,0,45,-45,1,0,45,0,45
ec8eda5767e405c917101c4cd214509c,56,50,85246,23096,62150,57,53,47051,25888,21163
f018cb53453531b54dc59b38637bb3fc,117,93,202932,78979,123953,126,97,310090,65341,244749
6236f3acc3bad396061aeb464ccc370a,166,122,546671,68517,478154,173,119,446807,77082,369725
9a8f57b689c74c696445e2b12426c83d,116,96,270300,59578,210722,101,84,225923,76584,149339
fba12ed263c222544ad712231f407427,70,46,84560,34018,50542,63,49,76435,25598,50837
73820f8cfd42c2f2fffe5d2d1f8b373d,144,113,253932,57271,196661,150,97,228832,63289,165543
a8f56a6b2192fead229b6397b9ebbb61,92,59,185058,42381,142677,149,125,366992,59764,307228
e8b9af7b4d186606b29c4f28ed06ffca,75,62,100370,24292,76078,67,57,74236,26328,47908
545e53a3fbf5b2cc3deabd2e2aae5012,63,53,79320,22793,56527,46,43,50229,26290,23939
2b6533a1f4b04322f5391e6b3ef35b71,35,28,32116,14163,17953,38,36,61051,17056,43995
cd02a95cc983352030c3f72c6cb8428d,167,121,605415,135350,470065,171,118,612855,179714,433141
7d12e6aa3ecc1995c9e0a14b31c16560,140,81,257854,51966,205888,105,78,198970,44421,154549
edd90371a5e8d615af0e7d6c7c1da741,46,34,30883,17462,13421,35,28,42182,15958,26224
cbb729ef793a7bf99fe37313279f9bd7,51,48,44039,21534,22505,44,39,49420,16385,33035
28819005fb235587cc60e1c3c2fbab6e,177,128,451973,96854,355119,178,138,546493,90685,455808
d7a41ff4e7a726177feb76d89eaf3906,43,31,49776,21003,28773,43,33,52983,15053,37930
5cd8ee37522faa05cd0f8aef1f440da7,19,13,3490,2261,1229,22,12,5666,1556,4110
500ecf44260844993c5fb3d252717dfa,71,42,105477,24651,80826,74,66,115893,29407,86486
1aca653969a062648e911bc74a6c4eeb,33,23,21112,7890,13222,29,22,14805,8637,6168
411e2488b696b3d3eed0b5ea0bfa2889,71,49,88463,26048,62415,60,54,91541,26839,64702
14334167c5365ca98cf68290f640b54b,116,106,253456,52772,200684,94,59,138089,58619,79470
ce336d51ae5dcda021da2c6b736dde62,111,76,170363,47329,123034,123,90,221671,43131,178540
88eaf2ae83951787461ea65f8dafbed9,44,26,38174,11280,26894,33,34,33977,14155,19822
bdd9ea0a8189ab0ff4d45678134d4802,127,110,297130,65603,231527,124,93,283698,64835,218863
7823eea85307968500dcd694f3284a12,150,120,342735,66792,275943,128,104,328163,61110,267053
6d060f84f2bed3a2302b15021a9ccdac,55,44,100162,31038,69124,85,54,113621,35721,77900
d98bc580067d9a9e4d92c0e118018bd4,180,147,523950,108019,415931,169,136,503554,80658,422896
3a03a7b3fef3935a079a3e6f1a28dc70,49,33,76900,18007,58893,61,55,85160,28169,56991
8d6d281bab9a82319dcd9486a46cfff8,87,69,133338,32224,101114,85,64,106030,38714,67316
3970a57a43ae661d9a9a63dfea5c3539,40,36,42518,14252,28266,51,47,43858,16112,27746
ae7db916a7eeee9d3c4bd47d25e78a37,20,14,3946,1643,2303,20,10,4594,1319,3275
ddde9a0ba882ec30b373adf3db850813,144,101,399473,94926,304547,118,104,417844,86390,331454
25e11e188fc58e14e5c656de55b2eb73,64,44,59101,31859,27242,81,58,112183,26315,85868
b94a6c3975f93834b76268d49353e085,27,21,17585,7170,10415,27,16,13960,7451,6509
472228ff13edb7f8140a8c835c7761d4,123,89,190443,46042,144401,119,91,182062,44975,137087
122d531d7c8b457aa3fc447d2046b785,159,120,607207,184149,423058,197,162,897722,137905,759817
d177b81849d3f807f2ae436e95013dc5,102,74,327799,102973,224826,115,89,301471,75107,226364
ce97abdd051e048717d386280eb36941,114,83,340643,95824,244819,158,111,488893,106002,382891
3fe79d92ec96d08864de52f52e1499d1,105,60,202579,33569,169010,76,62,100261,27894,72367
bcdc9d66ea4a6e5cf28a33f1353999b4,48,35,25123,7407,17716,43,28,32721,8739,23982
9a023b9bca687fc4c32d5178c7856430,47,29,33271,9094,24177,37,31,18319,11135,7184
59aa62001df62cabb7862603c4534f50,51,44,63207,21546,41661,60,48,81055,23789,57266
d2e780cb408bb587876ce9402797d805,5,1,974,42,932,3,2,207,89,118
8a9e636c75bc11c04ca46d6004086c68,135,96,228004,43641,184363,153,87,268246,47781,220465
27ffc6300757b67e6057b28f874942f5,110,83,160630,52257,108373,102,86,213413,47562,165851
598449df25b1eb312a5ee75aab7f1f86,145,91,295459,74857,220602,177,122,385685,97517,288168
acabb612205076c9bdc100be69df6afe,137,86,325232,78846,246386,124,92,315201,88094,227107
0372037e6b16c7f68afa73b0f6681e84,69,56,95795,57330,38465,82,58,154848,38430,116418
6b4c52bc750b2688b16250f63801fc62,46,33,33875,15241,18634,38,31,37322,16247,21075
8236fd9d2a7563fbe8341b980f310699,63,45,82062,19077,62985,47,38,49409,29252,20157
d5938eee8329f9657b8e0ddfd2351743,170,128,541897,173274,368623,143,98,413788,142343,271445
b0c4b70952582d27477419553fcf5c2c,59,47,100904,53821,47083,72,61,136757,31322,105435
9cc9e2cd3a4e8108400654bfc25024a5,215,152,1176873,218279,958594,221,135,1009115,215910,793205
e789613dd6cc80843678162eb21e68be,172,101,387900,67798,320102,129,94,411431,81559,329872
68a021b4a4d154e155132d93e82a1bfd,47,40,53028,14754,38274,52,37,40948,13533,27415
078bd5038d67e4c25883f9a8e8bfd7c1,142,89,257390,49366,208024,131,88,204832,75254,129578
4d3eb16831201822d8aed495953894bf,54,44,67948,25909,42039,53,45,85037,26258,58779
0f68da0c50f84c7ce429f7df408d85fd,108,70,231464,48095,183369,94,75,206991,63157,143834
ae545b01f614fd1556472971da9c26dd,68,48,92595,21041,71554,63,46,71564,24380,47184
b948bb2106d79e04ef89527b3a06a82e,22,18,7163,3029,4134,19,14,7077,1237,5840
4fa849cb45be763cf6c77c24be28533c,37,33,44733,14055,30678,64,55,63356,18727,44629
b4dfc0e7f5a67ef006f267fa73b8a1ed,33,24,14957,5010,9947,29,24,14275,5005,9270
a57e8db499d8b161043a3237088bd944,72,42,112664,23844,88820,59,46,85229,29542,55687
733e3b0132587c93e5f21a0be5c17c94,98,85,343583,119795,223788,173,137,568361,80223,488138
fd3382168e711f3913a7f7f4573ee047,171,133,526871,91251,435620,171,123,647208,119692,527516
048c80e7fdd7696cf0a8632d2c0f81b3,45,31,51107,20612,30495,37,33,45003,20725,24278
de5d486af11490f7ea415a3bd385c038,27,21,16954,5567,11387,25,17,12777,3819,8958
c76ab568b39fd6773d9d78ef76d770dc,122,82,304470,60564,243906,100,80,205535,55172,150363
3ab9a5749503cecc3400ffca20fe2080,158,124,496938,84394,412544,187,153,494775,80010,414765
5182249ac34ca6d40e426942c277434e,73,59,94184,29160,65024,63,42,73562,22578,50984
059dd94b07ee4ab54bea8417dd597621,5,4,634,318,316,4,3,573,213,360
4cacdc3453c48ade7d94b665abb3a490,102,70,233692,50267,183425,127,89,191323,57708,133615
9ac6710db9a495008755b30291c55ab5,56,41,90225,24703,65522,66,48,111785,23336,88449
ddd41a837c9822ca6e9f275db86a1fc1,107,94,306027,72821,233206,103,76,270198,52922,217276
6be4a3bec9f739bdbebd6df1e8bcb308,62,48,63844,17667,46177,49,39,51702,14922,36780
ff1fc94075a8e5457588a44f7f30b7a8,29,16,7529,2175,5354,23,19,6351,3529,2822
dd43098b6fcf5a27c5e5e9bcda917f5f,161,102,461596,74137,387459,182,116,461738,81228,380510
328dd45b6e587d7e1dcc24d30762f9ad,125,110,339165,83533,255632,165,124,447167,66619,380548
0b4cf483f857055d294237bfee2bd77e,178,138,517025,97286,419739,174,124,605683,104363,501320
5e325222916bf0be07f96542bf2510de,28,21,16086,8876,7210,34,29,33444,9361,24083
dc6b13a9fcc0b7932a571b1646a9e3fe,78,63,112808,16295,96513,74,63,98472,29039,69433
210e32871c94c3dae8b9f07953733d1e,61,46,61487,19140,42347,71,55,61198,23918,37280
3334836d7d3299bd72be4000703cbd21,159,106,548749,87085,461664,186,154,681827,71275,610552
ecacaaad2bcddfa5fe2ec8b981a240ce,167,129,588858,119469,469389,153,124,513951,104907,409044
31ef6b96fc42d837ed6cd7ef83d27772,147,86,333932,71397,262535,144,96,454591,55595,398996
e6d0d6f03ecddee7d58ed91e9db64ed1,17,16,3487,1790,1697,21,16,5646,1745,3901
28d96844c42d66a60af61a35604b9a9e,92,73,180003,43095,136908,123,96,236137,47479,188658
76b131ed21f84242752767de4448cd63,145,127,449027,95181,353846,138,93,434025,115784,318241
e388981ff41ddbde2bdd4d1db405c70e,132,84,343655,64351,279304,163,124,426353,67006,359347
9592304f920583b7d13f9e7316daac89,174,137,590940,125723,465217,205,150,689717,132623,557094
9555a9971ed7402e6596eeb15f9d429b,136,103,397958,79429,318529,128,101,396088,80867,315221
373e1fd198ca89f583fab2117b1c1ffc,157,114,424799,93990,330809,171,143,559809,89712,470097
c4d990f6268e8354e254a3f341a9de30,36,21,22568,5521,17047,26,22,8948,7008,1940
5499d9d2566ed0035ad5531487658a67,158,112,390300,64177,326123,119,106,340905,102839,238066
052cd891f6620a57796c1b8dac7afe9f,83,60,122557,34097,88460,69,53,105549,34233,71316
cbc261a3b6c69ca5d962f65bbd63496d,43,30,40325,13184,27141,37,32,35111,13477,21634
706b284f90ebeac3192b42dcee3b2076,131,119,386962,108539,278423,162,120,503114,74697,428417
77b2299c94a10e114239db5e86800a5f,118,94,427491,101340,326151,131,95,419206,119284,299922
e6fd7a1ffd07c6e0f51ea024883fbb64,135,100,335292,59326,275966,102,64,204743,45518,159225
9ba2319cf78199e70afa489798004310,87,69,133865,40106,93759,85,72,160826,45761,115065
3a2fa773369cdae969d86540d20ec5b2,80,71,142679,32598,110081,59,44,88593,32009,56584
f90372d474837e65a2eae9a54d50a634,120,77,328177,110649,217528,138,113,446050,87873,358177
c2309d5bef53fcb96be9c59d908bcbee,16,15,2985,2463,522,15,16,3717,1869,1848
b1633bc503c93effbd625b22865f0355,2,3,99,161,-62,3,4,161,187,-26
ec5f8daf64020fd2219d5a4eecc608e3,93,73,152913,35214,117699,83,64,133094,35047,98047
d45c1d30f1512c26d2e30802a3cdb71a,42,34,60091,19208,40883,46,37,40869,17768,23101
f992b644acc0d1bdb65d911ef1601fc2,120,103,282060,48945,233115,141,108,320035,51038,268997
e0ad2d35a7013f94475a1012fc887b8b,64,59,101978,35983,65995,93,73,144221,29077,115144
025605d2503647e0c64cea7b5cb9eab1,166,134,515027,75625,439402,145,119,500901,76173,424728
3d780136def98f72ea1a1820fbae1a10,55,39,60254,21822,38432,51,44,59822,13769,46053
c06c44e4935b11e862314182ac1da044,124,81,331773,90172,241601,175,156,515951,111840,404111
78928298cf317a96c140fb401754938e,19,18,7184,3126,4058,28,21,9564,2925,6639
482ea40666685e392c5b0a566fc0ed00,38,23,25507,5895,19612,39,31,32459,8823,23636
427920ea946b4b7fbeb3bbe766eda1cb,65,51,124727,37654,87073,63,56,100841,22336,78505
31850be47444317e48e0da4dfa377c33,110,82,354751,73904,280847,145,129,451566,69640,381926
e2c1f34f8c81ce3a32ef87debffe9a70,126,102,258479,37581,220898,116,97,222635,44994,177641
db3974e88170a084300088ab76a8c2e9,70,49,120152,33710,86442,64,45,140480,23280,117200
0ad339634858575466e3976af30ee441,90,83,160624,59003,101621,87,67,167266,45712,121554
07f3ada0b9f4bf7c1635b8ca7257e55f,105,87,186399,31225,155174,119,101,165342,39238,126104
d49a798f75629e5ad31150a98cd459cf,89,69,158813,61212,97601,133,101,240170,52889,187281
49818d9be79b5dca2a9f86e96132eba1,64,54,93051,29390,63661,64,51,83131,21754,61377
1043fc411f09026685234ba742d647c7,137,100,287546,46602,240944,149,119,366600,56224,310376
e933d13f7fa615ba93d484b06e4769b9,97,79,176342,42400,133942,104,77,164208,37109,127099
f8bc1108d4968b481ad10be57f9a7ad1,77,57,153842,72422,81420,126,88,228909,45358,183551
5aac3e88b5666fa47d56a1e7a6637523,36,35,31031,10117,20914,29,21,20870,8122,12748
c9cb0e198b112c4f5563260cab5f8106,70,50,128997,28569,100428,62,51,86584,34132,52452
96913abc415e736a1fdd0267ed1068db,54,47,65983,19370,46613,53,43,59102,16268,42834
2d79d40122f320a967bae62320531597,89,83,188926,42474,146452,97,72,176441,52952,123489
84301a559d9ddadfafcaa2353769595d,16,15,2489,2098,391,14,11,2462,1956,506
8fe33a7c087083fb261d20460d77ddd7,115,86,271698,64751,206947,116,90,265957,96000,169957
057d8e3fe1f861f32319bc79126653a8,27,19,16522,7883,8639,29,22,12994,8736,4258
52bbc23503917718816dbcb881378b4f,58,51,84663,20376,64287,57,48,76273,23024,53249
79681167e50ea0689cccda30a7c987fb,44,32,53396,16578,36818,56,51,57756,21574,36182
9a35453994770a314f1eed16592f33b2,57,41,43735,13049,30686,73,59,50168,12971,37197
bbdc84f98756a390e6cff0229324fc01,66,56,79156,22053,57103,47,38,49172,18108,31064
e1cc0d3e1b97a7d3058d4817a9a14bca,122,81,162686,35534,127152,102,60,112641,32387,80254
1835b9e4d5e2dfbd0ab6bbcb326a529c,90,73,153624,30994,122630,78,71,119616,32407,87209
3ce42810ba35932902d98082d2b0a33c,148,125,329113,58840,270273,123,102,267761,73755,194006
caa5917451ea6eaac704e3b0336e71e7,33,26,18628,8046,10582,29,27,20457,8145,12312
9a33ba88ba289b74145e0f54cd61511f,134,96,270158,57941,212217,96,80,167870,86150,81720
88380b169570f2ca664b54f6b1a226fb,111,98,385922,150372,235550,155,123,423256,146930,276326
722eef1e977d8f134e9f714bee1b09b5,30,22,28168,5742,22426,21,18,12834,5902,6932
0e6a53cf0836c13a424089f82d95563a,136,119,325275,61417,263858,123,101,261723,49264,212459
da140ada5ac741a44f6f37a2657addae,118,103,272244,55622,216622,88,74,173810,47310,126500
fce369fb2fc522290aa8b51644c567e5,143,111,322588,49638,272950,139,105,328795,68094,260701
ab983e8b8c63edbc6f94f840f638d5e4,160,123,444036,84517,359519,179,146,493549,98789,394760
c119601c3c4e13d5c767d9610937c25e,47,40,31949,18942,13007,42,32,34094,17793,16301
79ae0b729d7e31af75b4d441cac3ea9f,194,133,626133,95381,530752,186,155,481082,100067,381015
6e262422677e9e303fb35e4d17abca74,119,92,259803,68168,191635,117,93,309808,55930,253878
23d6abff9c6336cb0a1d13874ff3ce20,94,64,171257,65840,105417,120,87,241486,46819,194667
d78152c7d5e2af924ca953d1b8e879fb,173,117,469941,84662,385279,165,128,490471,76698,413773
3637358c88e16f4b509d008f557c724e,47,39,43031,20031,23000,41,32,43643,12932,30711
3fe54431bc9c0b872a97d5b93b2ee96a,24,20,9755,3620,6135,21,20,8637,3288,5349
49bce7ffdb6d228d3711293bf5558230,42,32,40776,13130,27646,41,28,39481,13939,25542
b10b9b30a6f59198b27acc7349aada13,84,74,157089,39365,117724,95,76,162147,35594,126553
79d7fcd6dc7dc0f6180f7b8563d14828,138,118,418594,124993,293601,161,129,609365,74842,534523
ab4c8d755ad474aa757246dac434735f,48,41,45583,17283,28300,48,37,38257,15306,22951
7605d3864cdb610ca2e247d314155b47,46,31,53720,15325,38395,54,37,76216,16013,60203
db32e25f065504e474ab44fb0411ea68,48,24,59433,11209,48224,35,31,32779,17299,15480
0b672a2575f1add2965379ae0df61e08,38,32,37736,17000,20736,50,36,43550,15412,28138
a83990eee829707897631a8a53df24dd,70,54,76387,28790,47597,60,46,67875,28163,39712
bbc30fb46bc4cc42a7c9235949b32483,132,85,275246,49796,225450,101,65,202680,71133,131547
8b4ddff03da75be99ffb72ad090e9beb,29,17,11395,4832,6563,22,20,13356,4375,8981
1dfdd0f14d7f0c42a3324efa585b034a,60,45,87004,21864,65140,73,51,82923,18540,64383
eb6413c4801045addafe61f0538a7ce8,51,38,65227,16115,49112,36,31,57580,15441,42139
e6432ff0d234ecdbe12dc34670604c3a,61,49,46175,16594,29581,49,32,48498,10908,37590
bcb6f3dc651450d1e893aed9166c0a45,124,95,303452,109707,193745,109,90,241879,80775,161104
18a00ab26dd174841dad57c850dfb505,113,89,405388,121503,283885,163,134,520063,132494,387569
ff8f5a677edd6c650dda3ae0b207ea7e,66,52,139827,41404,98423,68,63,109412,47771,61641
a70105b5d0097a4e0bac45cff2520f12,160,121,474887,98229,376658,171,122,564860,120619,444241
aec5bf32af8ae222a5eb92591b23343b,123,98,218718,40834,177884,101,87,168661,39944,128717
802b981e8b74d9b4b71510effe1d479e,143,87,291517,64651,226866,69,50,180692,56720,123972
3943def594791cb8833084df3ecfc29c,106,81,221447,35457,185990,111,84,197394,48404,148990
523d073fd19ad446647d76cb0ef04436,41,34,43770,14276,29494,45,31,43056,13595,29461
0665d625b040a25d00636048d1922045,108,82,254906,57133,197773,77,62,146823,63411,83412
07a36a056bb2c6f0d61672fa9dfa0ad2,18,14,4213,1774,2439,16,10,3811,1508,2303
9c503f471b914320f00f5c854b3c6e5c,140,112,357215,76184,281031,87,78,212696,69996,142700
76f24da784ce6ea3bf645248304d00d4,46,27,47923,14151,33772,56,47,80196,23662,56534
120425745f31547434f4b34f37223eaa,147,109,325907,86580,239327,137,87,311040,91086,219954
c2ca99ab63990899b81de15ccd8144a2,112,90,198869,88266,110603,134,111,327654,66621,261033
4493c8b36eb30d6e53a4d3f6cb44865e,95,77,164794,31672,133122,116,83,196534,55899,140635
83701f473055e5c9288fbe09fa47586d,89,79,253858,110479,143379,148,104,366021,84863,281158
cdf3978f8ae92dff27bd85a6b03ba2a0,173,107,470702,141091,329611,144,98,538764,153347,385417
797fb49147b210302168f90f83dfbcbe,106,72,231983,51642,180341,107,85,221628,55043,166585
8868f43d39c3407d8b5f8ac5b6c28c62,50,28,53935,14021,39914,32,34,42930,21181,21749
a808fac0379d28a1646ffe294a7103e8,4,1,621,102,519,1,4,102,621,-519
d4063143b2a626cf45d472edf096a8c3,74,64,163024,40758,122266,85,60,112335,39637,72698
fcfdb3c8712ee4d40c3de0b7994766fa,127,96,372123,72844,299279,122,87,259129,70312,188817
78c5789ed53fc9c80575edc9be2fc751,35,23,17815,8929,8886,35,28,21737,9286,12451
218b3cee4af30f5a9844cf42056a15f7,138,108,319862,96760,223102,111,103,303668,64843,238825
26856fd980dc0d6f1f91ba50afdefdec,55,60,82862,24781,58081,77,60,75648,25227,50421
755e6373521acc0ea6d6ff503ddd9019,109,89,243788,90816,152972,154,125,347266,86547,260719
f4ff52656b955873a6f84a0c1ca12c50,26,13,13818,4736,9082,21,20,10776,5381,5395
dd0305b460375e0971b2a54bfde86e1c,58,46,102625,22323,80302,54,34,64779,25085,39694
eb3dd9e9f47a108f2d739b7ee8fc7a25,51,40,70798,20345,50453,64,49,64053,27122,36931
c7a45507ca92507b8973853b5968a826,52,39,29773,10160,19613,65,44,45203,9603,35600
f9ec8aa4be2bfb4c4847d7fd05f40b4a,151,102,341550,64126,277424,151,118,295988,80095,215893
7ac90f7ab92a290a7ebc13747c009fba,159,130,387098,67306,319792,138,110,376908,59958,316950
853a7b061b56c69a20ec5692cb12fb1a,136,118,334442,111325,223117,172,130,485025,79245,405780
8e78031763cf3526ea84d54e43084604,70,47,76605,23177,53428,56,51,86279,22822,63457
9b840c0065634321985c4ecda264035b,62,58,82553,41456,41097,65,43,80380,17464,62916
1f66e860ddc274ddd2812aee780405a4,120,98,363107,70652,292455,117,86,351647,63660,287987
af29275164993a3d4fea5e7bd49500c5,90,71,142475,39058,103417,75,59,101381,32277,69104
2d832b30d068d0a4c5c687d915d35f3a,45,31,49900,11858,38042,35,28,44568,8209,36359
22a02d728db30fbf176cbea953d8eeb7,25,24,19883,6027,13856,33,24,27326,3209,24117
baa062ff9249af87ba3c1a1b9eb1e754,132,114,424490,91235,333255,140,115,470310,104059,366251
2be24aa082decb8cd1bdc2478196f335,152,97,432747,70309,362438,113,77,290619,95812,194807
a245187391f8afb192a5a9e83a5caa46,184,124,860763,116859,743904,191,145,671725,215857,455868
6252c6fbb655edbb577b581f9fc0702c,110,84,199757,44077,155680,132,103,255790,49150,206640
21965b4b5cf2a25f9a78b1c673299676,94,75,192506,63671,128835,115,95,237558,57997,179561
6e47e4dceb8a98252f3a59f112af0b76,72,54,80999,21650,59349,52,44,45151,26672,18479
74956f64a9fc10a1d19992337c9e5c23,113,75,145930,35798,110132,97,73,173713,34470,139243
001a0010fbdff61042aa3dc81b949903,91,68,161325,39185,122140,79,47,104336,41323,63013
6e9f58b6e1ea87c435aa75dbe55dc5f4,191,148,480339,112054,368285,131,93,371944,95952,275992
278ac1f0cd9bcc44bbb85796948aba8c,141,93,326261,73073,253188,119,104,320384,79111,241273
58a64210c21cd819fbbeaffa5a7fcfbb,88,73,134662,38911,95751,72,53,119476,30609,88867
eee7e55c4fe5989a8f13082e84753784,118,100,198017,38330,159687,93,74,109535,32786,76749
16ddcad7c3e3c8c2111ce19f112fb2d4,158,112,560436,84906,475530,211,170,638105,133499,504606
85767986b40479565183285219af4b28,114,83,218771,66880,151891,102,66,182896,59139,123757
54aabd1a8ce3e11b92ae82af6b3a5c40,103,88,242078,52195,189883,93,69,192939,51644,141295
0413621e54a884f1b6fb024d58994fc7,76,57,145787,33064,112723,96,83,176369,64292,112077
a01ef1953abc60535d722bc5d63f3fa4,185,89,482842,97205,385637,138,108,439020,75212,363808
648d2f9cebbae6405e4edd871d4ee322,44,32,52170,22061,30109,57,49,73804,20836,52968
f1b6dadc32c799c42daca79f5a1f1219,157,122,413774,65308,348466,174,151,453271,84926,368345
76726f251663d891dd01ff04af501027,10,9,1049,417,632,10,7,1468,344,1124
ae59bc5ffb6b5c000fcf60bd09c9894b,26,19,19374,3902,15472,24,19,12922,5438,7484
a2f59763b2661415da94c8974c9dae14,33,26,11805,4108,7697,31,22,9398,3757,5641
a84b121759b0df92df32824cb9f7ef83,1,2,45,76,-31,3,0,209,0,209
8b6e430c796e072ac6c0759237aafe7a,82,52,149882,26645,123237,65,50,84085,41391,42694
332b21b6a9d82038b0d7c93d87a89ba8,20,15,8422,2567,5855,25,15,6069,3101,2968
24966179b6aa92d94ee06363dc2d9476,125,106,208330,50211,158119,115,90,211803,50162,161641
95f4e216601435df64b3f01b1a5fa7f3,49,41,48928,19771,29157,48,43,45115,18902,26213
0304f77e7d444a9122355553b701e723,79,66,93534,28090,65444,79,66,119030,22658,96372
4de0d381505d8f2219f1e06921eaf082,137,119,398718,76932,321786,180,167,550915,80676,470239
5e89e55852ae6aca1b6b548ca9ae3a9e,32,27,22551,7789,14762,25,16,14661,6895,7766
aa2d501fe751a6daf81b90fae9e67373,22,17,9107,6780,2327,28,20,13924,4977,8947
12aaa423b5366e98073de1af6e3dedba,82,59,144098,30978,113120,55,42,92837,21287,71550
860027b8b9b7d8e9da15f717a5523308,118,87,282523,65856,216667,129,108,288064,93686,194378
8dcde1329e78044b2c684950c1d7b030,63,56,77106,39467,37639,90,70,119343,33619,85724
46a0febd8872f1f905ba7cca66dcc2c1,42,31,32375,13298,19077,51,34,43882,14780,29102
e409e6b970914c1235efbbeafdddf476,149,108,504185,105900,398285,157,132,567273,107013,460260
49aab77b99daa9c78ba66b41569af698,75,58,126952,21395,105557,51,44,60177,31211,28966
c3c01d8a1130893daf1da6d2d471fc76,211,138,760228,140096,620132,170,111,864601,117788,746813
1b3946b8f6bd80914bba3df7a1df1f49,74,55,60499,18073,42426,65,54,103516,24154,79362
d9a8325a23a3b37e1d81860fff3de026,53,47,83946,31532,52414,74,48,99803,25936,73867
1bac2c21755e1d726efdee2922199141,96,79,150700,48680,102020,105,79,185829,35020,150809
7f1b3758d9342d97e82a8dd23ea9054c,52,33,46718,22679,24039,46,37,68831,18097,50734
0a76b2d6254260573ca6b7ab38c3d8a2,33,29,19431,7402,12029,31,29,19459,5736,13723
7702dffe6ef1b69c91348b78bd4e1a70,148,92,305795,66129,239666,90,68,217430,70466,146964
bf4b21b9c8672152b32b9999cea613d4,41,34,19911,13498,6413,44,36,31410,10559,20851
12d435106fe0b89308c3738d142b98e6,177,156,712063,170560,541503,225,161,977612,164508,813104
aca07dc73156bc009e413c311427a412,148,106,329487,58299,271188,122,96,246260,73060,173200
fcac19e51852df5f6b23dd53b8cea7bf,154,100,298686,74571,224115,153,133,329361,81818,247543
b8cdec2ec41734dd0a30911c77362af8,87,60,120728,26658,94070,73,51,83609,31871,51738
3a274cd6bf3efed9b5988f736e91e038,136,106,281935,58795,223140,120,92,260455,52356,208099
a95dd3bff523240eeb11f2e604984508,60,48,79233,28491,50742,60,45,76139,22000,54139
12a74dcdab3051e58015687a9f02cd98,5,3,599,211,388,3,2,211,432,-221
4043afc50a398895ac2d6167301ee4bf,26,21,10131,6231,3900,26,21,7844,6713,1131
de08044eb3beee310da2df218f8d6a71,47,39,71479,19788,51691,53,43,60076,24323,35753
7b64a6819f405510ff5fd066fdf0c474,110,89,259280,77564,181716,116,87,242472,64460,178012
657379fdf7efbbbee64133957804bfcf,81,59,105806,20166,85640,56,39,71308,15007,56301
5796dfc20055f34d0cf556c649acef40,36,29,30468,10178,20290,44,33,46248,11746,34502
6a5a73dde9d142a4d73bba8d5ba6bd8c,47,29,54986,15760,39226,53,31,70716,13312,57404
62582fca030c9cd54482241315c01e57,142,100,252446,41879,210567,110,81,189482,48690,140792
b995359faa5165f07e681a5e2c3a9461,41,29,41346,13451,27895,46,31,45606,13412,32194
ec11c043e0debf2623d847e27da59a40,61,50,80572,28226,52346,77,65,103698,27705,75993
786b48c4e619f9fdffe9b43eca86c46f,83,64,179927,67779,112148,99,91,223862,62165,161697
c4415cdf0b23a73bd74177ddb3fb57d7,129,97,243142,41168,201974,92,72,188015,65220,122795
a3d0bbad11e91bbaac1bdce86e5ded9c,56,37,67576,23421,44155,62,51,83566,29023,54543
52a6727d57045daf29597455a1ea191c,67,69,111308,55973,55335,95,69,179493,31571,147922
8b06848ad0ffff48aebe4f5a98a26387,106,83,270767,41692,229075,85,76,201408,45888,155520
062f6508b203dce18cfcbd2cc22ec6ba,33,28,25578,8044,17534,32,20,16495,9412,7083
a92b05607f5b90dd83ba69b8b72f85ef,160,121,394596,105187,289409,104,77,278565,82738,195827
3e45e53704344545a77437a35d84d701,124,102,379061,84447,294614,153,115,319169,88132,231037
9aec51a46836c4e46d4e2f5d16f0eecd,106,80,368000,123506,244494,130,115,440059,112800,327259
67861f84ef327db86c643472259cf458,86,63,141833,31794,110039,94,87,183272,43099,140173
024a32abb562d8e3f0e81fce0232e20d,108,86,183869,46145,137724,86,65,149564,49227,100337
1d3725f940a6fa1b2918f2bc93a2e2aa,110,85,230305,36173,194132,127,94,259109,36742,222367
1e942e2929504d8e5a547b6376e0bde4,128,118,331687,62469,269218,132,112,260999,74198,186801
6d526e6d975757d32501ef973ff6068f,111,85,260364,65028,195336,119,82,253250,46327,206923
60981e8764600f7c149a16fa2adb85e8,169,143,516475,83871,432604,118,93,261159,77624,183535
69be8cff94c1312ae6c8e14fa2c074ec,143,119,366462,93765,272697,158,113,593342,69642,523700
6d0b502342a86ead09c89573c71f2881,222,170,1100182,124094,976088,178,139,856843,152347,704496
c2cc98c33e2397fe177584b185b0aab5,133,89,450732,121817,328915,201,158,793068,116779,676289
08952973e816a318ccd4a59d1bf6135e,107,79,241734,56264,185470,127,85,253414,57322,196092
25e41afcee3554888fa1a6d62159fd09,183,136,455130,105002,350128,188,122,567423,100229,467194
46372c542285ba542cbffaf0765089dc,159,116,576142,182378,393764,178,140,556045,149562,406483
7cb9ec80f923a97938671743a7c5014c,142,129,535380,130925,404455,174,127,600423,154209,446214
0d8f04cbc65682d783fc7c37842ae565,83,77,139385,28165,111220,86,71,94696,26065,68631
084f3305e692cb91e37b28a4e1159b32,22,16,7824,2662,5162,24,21,6821,3070,3751
fbc035eab703797a833a14064eed4242,133,109,241311,64187,177124,93,68,161365,73740,87625
9fd13eb3e89849aabce571265b5a78dc,27,24,23977,14827,9150,30,25,42292,11603,30689
7b6d88163a33a9baaa859536fedae0bd,64,52,82960,21193,61767,52,43,46656,21203,25453
9d0ad0ef51ba58501cf858a7d8e71625,130,79,249420,50479,198941,116,68,167346,57991,109355
60730f4e762683cdee31acd8af9a9aa4,47,32,41112,20206,20906,42,38,53703,19735,33968
a63a360271f8118e33dafd9aac2ed73e,25,20,7686,3995,3691,20,18,7555,3167,4388
69b609e8414b80ecd8eb7da5a8d787b1,156,128,347798,64110,283688,112,73,205174,53655,151519
f1424a841a5f844815e4774f50b1c4ae,134,92,237278,57300,179978,107,82,266931,60899,206032
c3d42128efdda2d893bfb4bba3c08302,149,97,435120,137218,297902,140,76,369217,88714,280503
2b0a1136d387713c06320f83a82b9510,79,48,95597,31736,63861,84,57,118408,20874,97534
fb00b40b1f15350219d6bd9dbdea6e83,155,116,608621,100609,508012,155,132,473455,82459,390996
3a80a92eb0273fe341db0cc82a5614a9,153,125,561954,130975,430979,144,131,505117,140810,364307
c6f018157a3e6dfcd1c58614a6cc9db0,36,25,18941,10112,8829,22,23,13586,8611,4975
81d3286f5281d2a0ecfe5a1ea71de7a5,182,137,669954,139740,530214,181,127,659098,148073,511025
41ef87217c0397b4ed6597ef75b98015,91,68,140309,36779,103530,115,104,226321,37410,188911
f4318a2f39ce75c9def7d054f8a90a82,140,123,369540,58693,310847,146,103,334381,44366,290015
0c937eed9ff318539e75ca510b15c74c,154,114,393729,62744,330985,139,100,446703,107476,339227
c468df4b9c57b66b275f3a58bade8558,75,55,111895,23224,88671,52,41,65412,16930,48482
98f96d7ff914e6c3205395032246a8a2,92,65,159131,35934,123197,88,63,177984,33388,144596
7e908fd52c781470a97a54ee74dd95db,211,136,641626,136614,505012,153,105,604177,105911,498266
2bded50f8da3774affa349ebdb6acdb2,140,108,460190,76737,383453,101,90,363733,87965,275768
042fe1743df73a5f7b2e36982d07924e,95,89,164762,33042,131720,71,60,103380,37327,66053
bd08a063c0cb0edcf9164de88cf9079f,73,66,123139,43572,79567,46,41,93875,29617,64258
be7cc6697fbef18c625966ef2c789f31,124,89,166206,28255,137951,71,63,104692,32691,72001
6f115bfe44be6a01f07a93db250fd09c,161,112,344197,77222,266975,142,118,451540,110562,340978
607ddbd01874571fe5bc8a841c857f90,76,57,136021,33989,102032,92,64,117889,28898,88991
35916a424c17bcd344984e583923d3dd,50,41,70263,22751,47512,41,41,62448,32963,29485
6874f494f74738478787603f936adcef,15,9,1952,889,1063,14,10,1594,1339,255
bcf739db611c4305f885477d296dedb7,55,38,37148,20244,16904,63,43,56389,20983,35406
6e4575139de8d6de85345a67c2419144,12,14,2128,1772,356,16,14,3668,1433,2235
976e98044276ef199b0a8ae04885c6f7,59,53,61425,27477,33948,47,35,51487,20585,30902
8f05fc864b113a2fba0b264a0f54944a,89,71,146401,32308,114093,102,89,169613,30707,138906
48c28a9f24e4dde4a894b548026c80a4,80,59,123918,31836,92082,82,66,155542,34172,121370
5fbfcb0c1d9aa835e9b7fe0348aabf05,117,82,168860,26030,142830,69,49,94106,22248,71858
65be1015c1042f6469137e037923544e,179,109,373632,66972,306660,140,110,347841,68737,279104
754608da7bebd9442a4dc73b79ced39a,110,86,236714,78258,158456,156,127,361806,69033,292773
788281d9ea30d91cce76af268215dea8,159,147,607004,116234,490770,175,114,711230,86898,624332
2921067b1b95196f6344155c642c6aa1,60,44,77064,19209,57855,86,63,97638,28418,69220
3b95a8de5a14296a3e2468e547bd1499,51,51,68281,25554,42727,71,59,78717,27350,51367
ee05e68fe2c5f4fbc9aa28f9146a3c8b,151,107,429003,98710,330293,228,162,534591,95616,438975
adb647714b20c99df3b569216f4c7ebb,75,51,131108,33364,97744,92,72,151363,43401,107962
b2aec27c3a1792efb7f58956bd6383ad,121,78,235631,55539,180092,169,125,441087,52174,388913
882eae577b2da69c0a71f75495d69ed9,117,88,321944,113274,208670,142,92,433775,105984,327791
ec17de1c0ce54dea9c5f345d4a1895a5,166,111,591631,118313,473318,172,120,509617,118167,391450
e7c4742afb5d62582e02f1287d82ca4a,46,35,54935,24189,30746,48,32,53299,16796,36503
2050ad8a2a669bbfe95cfbfa6e63e953,141,98,394754,80609,314145,165,134,474302,108779,365523
bd9c8defa63b5150b7cf8afa900fbbb0,124,97,199059,61513,137546,105,90,247047,53448,193599
d5b9eeb370ad99d1a1eb2c4aad68dec4,19,14,8161,3072,5089,20,13,5095,3663,1432
be86f00b72259d03629047d416b7c387,16,9,4060,1304,2756,14,13,2354,1916,438
4f00c504b27848278719daf9b8adbfde,153,110,495902,67947,427955,163,134,440523,103692,336831
6b7160d1d3322808ac1c48292dc9c3fd,38,27,21341,6886,14455,35,26,19696,8584,11112
fbb80eb8871d7021c73bd57abeaf2a79,1,1,65,51,14,2,1,89,65,24
f10cadd65071889d6e3f7b23c3a1e643,4,2,775,207,568,1,6,133,844,-711
ddb6bc99ba0d039751730b1c58284541,113,90,294370,69443,224927,161,137,425876,80600,345276
70b794e4d360d65f2afa848d33c9dd90,188,135,517998,90357,427641,140,108,419147,111430,307717
7e2bb0cbe77483f1931964ed9e7ca879,28,22,18504,7533,10971,29,31,19969,9741,10228
ff958b4ed1899f6e53384d0129f64626,90,75,133525,29139,104386,100,75,128271,34294,93977
6af4d7630041ab1010669849f169e6bd,60,47,86481,29604,56877,73,60,112017,22893,89124
b74924dd488856a9afa5c3974f4760ca,173,124,476240,83637,392603,122,87,292122,57577,234545
ac74cbd2c2631243b858b88727d49e25,60,52,80614,26629,53985,56,42,84966,22999,61967
fea2106d0a1a4488b32633fa35734715,62,50,69011,30488,38523,53,47,63964,24860,39104
b34d28775981af6eeb42688607ba562f,101,91,215505,54584,160921,132,114,274447,56730,217717
6d657d4925a7d5061bc57a775a68aa8a,120,91,209666,52962,156704,105,76,199981,47911,152070
ae588fc356ce88942f8290920a64e5f6,39,27,20885,5858,15027,40,35,26496,9035,17461
6a948437547ed9469758254d444f7322,93,80,249044,52022,197022,87,68,194871,47142,147729
98083f3ba62635c9e1b79a2899bcf4c1,166,141,678033,125251,552782,154,117,559490,104900,454590
bc081fcfe55e9de69c150106a275834a,61,53,93098,27668,65430,55,47,74110,25713,48397
db9e45e279511a14c1b393798d20834e,138,100,422137,98539,323598,180,128,596054,128644,467410
d97103a3bb9d2b000500f64974195daf,62,48,81658,12809,68849,51,44,70101,22851,47250
379e609c18eac81b43a64b8a69135774,124,99,327651,63731,263920,107,85,225169,53782,171387
c0c7a72566798ac5744c582179f1c9da,72,57,153706,29095,124611,104,87,142638,46228,96410
8ba786299efeba2b17c2a772aceaa3de,29,22,14754,4482,10272,24,19,14365,4710,9655
46481256f603488b280a154b588deed0,142,94,333357,48752,284605,123,87,258207,69863,188344
c1aabbdfa2be41f3c538bffa21cd460d,164,101,447900,112025,335875,114,91,396016,109518,286498
a117e44030699a9cc05a1dee13be6e75,20,17,5385,2534,2851,22,16,4137,1127,3010
68a72cd009bdeb4b943743c82625ab1f,191,134,493665,120632,373033,135,97,297815,102461,195354
e970b3ce596590fcf7a070ff42e0e1bd,60,51,108910,67001,41909,103,73,209379,38051,171328
86af73098b2bb2b835d4fce7abcde9f9,26,28,15978,5682,10296,30,21,14688,4496,10192
47d0bbf475ca4f09f8adaa4efab4ca3a,87,71,120454,33316,87138,99,72,154202,30336,123866
6b018be268b4d66330de047987d2b82d,180,128,689104,128440,560664,237,152,991985,127101,864884
7f0de7cf30497cf3f9897a1b19765e1f,32,22,20232,8067,12165,27,26,19916,10699,9217
938f77a6c87f7c91524837a70d37f383,47,37,40320,19411,20909,41,32,42097,13354,28743
6bcb006a88aadf6428718561fd8ce8bf,54,41,57018,18285,38733,52,39,41443,17851,23592
a5c686d8cafcc92665d9c815dc1f9c72,224,165,712391,148652,563739,248,153,817016,135356,681660
b773a08dad5b63ed58069224b03b19e2,145,97,239900,56681,183219,166,113,283924,49091,234833
9350fd76078ec5b6406f729fc909af5b,29,22,10945,7671,3274,37,21,20509,5454,15055
63107d0efbae6d1702dc3fa359c8307a,148,105,362185,45211,316974,90,72,183720,61384,122336
bcebecd06d4bb81f61032357102d3b59,51,45,67364,17503,49861,51,33,47876,11788,36088
da5c15ca600941e83e733027147852da,35,23,19873,6879,12994,33,28,24015,9038,14977
03138ab516da493792444640d2da421b,29,17,10044,2376,7668,20,17,8893,2376,6517
0d14a0e1272db1fb8d584a820bd4b3d0,135,109,526131,85218,440913,109,99,283227,108957,174270
9fc8d3cd44c69d332173f8a5fcb2b910,63,51,99024,19230,79794,59,54,74237,28078,46159
c78ae11ae9865abc823bf61f847cb3d8,147,106,376439,117332,259107,166,120,456154,108322,347832
2a338cb7db5186508cebbe8a69785f06,23,10,4837,1027,3810,16,15,2818,1657,1161
7bb2a521580a6de807573b79a40b9e36,78,63,124592,24677,99915,51,40,84636,21174,63462
8dab82ef65a1741d21dc51d67c0c46b0,31,29,26271,11671,14600,38,31,30245,6156,24089
1c3a663ced6a662fcac362bff4ebe4b1,90,82,153161,38237,114924,74,56,120816,26343,94473
27e9dec90ec8e2c52bc79abd5c72f4dd,86,67,124208,32221,91987,61,50,58240,25259,32981
1edc611322101eb29c6426f87912c9fe,174,139,464227,66135,398092,74,59,177013,88048,88965
ef3154b383b77aa7f96301b9ed6189f0,14,8,2364,417,1947,14,11,1581,520,1061
f22ae371888c561478831dd82eab3dcf,156,119,437493,91019,346474,205,161,743613,88370,655243
2ef27dbfef8b0036cd6a6c12eee53f4c,29,25,12730,7117,5613,28,25,16003,5278,10725
94086087da461a4376d21ac63f5d57fa,80,63,132734,45645,87089,105,81,170520,45536,124984
8fec49f367685bfb108ad071d3a2864e,115,92,282538,70182,212356,139,112,459194,69705,389489
83ad639c0f912602b091eee7cf69fbd0,1,1,88,171,-83,1,1,171,88,83
58a7889950d4196bf292e19dd32cc65a,62,39,81537,27784,53753,53,40,61670,35399,26271
c1cf3ab6f78b28fbba46537b74216eb3,73,57,88159,30464,57695,112,87,207399,37906,169493
536ec481935cfd16e16446416a46f05c,65,53,92768,25611,67157,69,65,88262,27511,60751
6e7003445ff6014b556677722c4c4b35,174,130,538975,89858,449117,183,114,463031,107910,355121
5734c79a3296cfca3af6123a50038d7a,81,72,151754,29444,122310,80,70,143679,38114,105565
57c7d1de3bf7547c28d015a3af071b89,27,23,15094,4664,10430,24,19,11978,5327,6651
217686724ace22780caf69919d6f84a8,149,116,294700,49421,245279,95,80,184831,56284,128547
b57f74d059586f4e5fcabb5b32da837a,1,0,64,0,64,1,0,61,0,61
9e7edc37e1463a7be3153ef7fb5909cf,54,39,110889,30087,80802,86,73,155210,54035,101175
8700000cd10503a0d5d356d80eefff01,96,71,246795,64290,182505,91,79,211780,74968,136812
3ba6347594fbafd235adcf59424bfa44,22,17,7305,3690,3615,18,15,5151,2987,2164
b91d3362cda032112ac927267c7a065b,76,50,98780,30170,68610,58,38,76213,22890,53323
e07a364ab52840c62ba2d7a81c1d54da,49,38,83547,32199,51348,49,45,82791,26030,56761
d328063ed73c12226bff6d210bbf34f6,75,53,102490,27743,74747,75,58,120358,32868,87490
610eedb4cea07ac9de67000392caa37d,172,126,492093,129102,362991,184,134,602133,126003,476130
a9bfc5b29e81338dc7dbb37abb70f900,185,124,609180,87718,521462,173,142,526684,97087,429597
befc3def4025d0bf2609d52a0b3d3f28,104,76,182893,55992,126901,73,61,146828,56009,90819
820ade57c7eed0f8e17b086bdc49b023,96,79,283138,67000,216138,100,95,306514,94045,212469
642793cb9c9a7ff5895c51adcb53cf4a,90,76,167559,43909,123650,65,54,169575,37241,132334
0d94b5c9627dd9cafc6142bd260bc776,32,22,16633,7130,9503,29,23,14937,6526,8411
5e2fd764f1e9871a672842ffe3bdfaa8,111,93,202485,39019,163466,108,92,157131,47661,109470
9337efc9d49b5aa8b64eb0a3873ca3ab,61,49,70374,12588,57786,61,49,46935,18605,28330
8181fb8cad62d897062ba67fbab47e63,67,48,76972,35323,41649,81,59,128287,31110,97177
0f3512631f919792901d42e6d4c945c3,147,111,376793,89309,287484,127,104,328024,99153,228871
fc401daf221cca9ec6cc8677f159b4b9,17,13,5744,3533,2211,20,16,7239,1600,5639
fd52b9357d51ff875d4942358716f177,188,137,655150,98963,556187,202,172,821833,127713,694120
ba0921b558cd2f7fb36080faae882c99,58,48,71238,21391,49847,53,36,38838,20747,18091
366019177d57fa628f43e48bd96294af,84,57,140788,20710,120078,76,53,90117,22718,67399
f109c9d05a56963803c8382599de6347,163,116,454571,78606,375965,152,116,372155,86852,285303
05e51d5f892bd6e6a3d55e65a7b723be,94,73,157709,33833,123876,102,84,175791,40051,135740
52f5a4ca0f63e95b74b61b43c400bc3d,128,98,393775,88039,305736,122,105,368047,101778,266269
cbbdca76598bd8b03f09edb872ecedcb,124,92,277113,65202,211911,99,84,212475,89640,122835
c468a856176a5898fea6316b3b5d70a4,25,23,11801,3649,8152,28,23,15416,4799,10617
c90fa3ced8b3916b3146f144f625ef1a,51,50,62953,17145,45808,39,24,39962,11301,28661
688bc014ac9a6d9c7bad9ed85c1d374a,159,134,395079,84530,310549,126,108,318104,50444,267660
faedee122adb983440bb0023e42473e8,19,20,11212,5113,6099,21,18,12017,5680,6337
6b59b3847d2425f561d5bb42decb1069,58,38,61757,16300,45457,80,62,130354,20995,109359
45e5cdecd209afc5bb87bc03eeb5c9f1,92,73,142081,60887,81194,79,64,123884,55409,68475
09798d7889d6433b093bd143284d324b,20,16,3982,3233,749,25,18,6178,2750,3428
f2fb36f7beabd36396641e53e1555636,130,79,198433,46877,151556,103,85,216416,58261,158155
663d46cd739236495f61d53010c3993b,63,44,65003,26891,38112,92,57,119035,24425,94610
8d7c08a87b803223420234676b146f0a,36,30,36463,10431,26032,53,48,60827,17825,43002
e4fe052f0544009d5260a56dcc3d130e,51,41,53459,20952,32507,44,42,60839,19960,40879
e5482015215991925f2999b304dea671,46,39,82008,34232,47776,61,49,108799,32352,76447
a25d50a6a8f01a75d0a276331688fdb1,49,43,45834,23171,22663,56,39,53952,16454,37498
5f8c6697f83323ea4b2e468db09d2002,23,19,11381,3053,8328,20,19,8143,4008,4135
20581800fae401e1e80104ba334df7fa,74,57,88010,34700,53310,67,51,70253,21655,48598
6dd88eea2ba02fd83a73a1c66f3253b1,28,17,13222,5485,7737,25,22,15646,5738,9908
48968eac4c009c605f3fc4a8dabad0b3,76,56,104306,19705,84601,49,47,74154,19353,54801
b2756d7558936befee5d07fb065618a5,125,95,186959,88621,98338,167,94,296378,55411,240967
ad9ea6d1f0dd073925a283f0583c9a56,33,26,20067,5240,14827,32,26,11688,7290,4398
9f2ae78b3f3eded58c75513148c122ea,42,32,42760,11128,31632,34,26,25178,7664,17514
308562ba38132ed9d88facba872ca705,86,74,137820,45685,92135,85,75,123322,46187,77135
977356a9ac619967c3d042ec0316731a,6,6,915,1406,-491,5,5,1458,815,643
9cc4a837d79751d5c9e7561d700bf24f,131,111,277732,57663,220069,123,94,223046,36080,186966
d73dba7a120fd47b0b73118cb0d6c12c,20,11,3365,1695,1670,13,18,3212,2695,517
3e5f077dcc43510692f6baa1d9cf045a,176,124,537770,161730,376040,232,137,684007,116072,567935
bb676d17ceb193a2ee2f02797817a07d,42,32,30724,17372,13352,42,36,47267,16540,30727
34fd8c194c959847bf21b7a52aa6ce42,133,111,257460,58530,198930,125,99,291623,43747,247876
117b9d7d380e6b34ebc8e1818bcd42c4,60,43,119246,32235,87011,103,85,232548,41263,191285
589acea15a474debac3165efd5a7de9b,95,71,190768,44147,146621,122,86,178659,43030,135629
05091c0f9e3ce83b73fca1dca9613d3c,36,31,16510,7554,8956,34,25,18795,6349,12446
007210fd60988a98763036b4832835ac,74,56,82744,29057,53687,79,64,104315,26493,77822
053347794b37990d892bb45b8286db22,173,138,532737,128539,404198,179,136,491779,133423,358356
e4cac216a4cce0fcbea4e103d3f2c1f9,17,16,5206,2964,2242,22,13,6659,3251,3408
dd3352b1babd1b5b3b13f198fb77f1aa,28,20,22359,6600,15759,32,29,19009,9531,9478
522437ed04cadd16ad718d8d3a555a09,42,38,37974,13519,24455,34,33,31120,10455,20665
3b69e71c4e2c9936cc0362e64219df48,70,64,110956,33438,77518,48,32,71819,19563,52256
fa5861359af2a7412e9772b68836a011,68,49,95479,33925,61554,66,59,112482,46017,66465
0d50d6c00f369a07a40698f08d7f98fa,102,95,220633,54034,166599,111,89,219097,31481,187616
038ea06d9d4a301a4f3ae7618c19ead8,50,35,102923,27568,75355,44,39,69801,24839,44962
fb048b96442c4081541a69527ccf3f2b,167,139,431801,84235,347566,127,109,353863,78295,275568
3d8fa510ad6e1f2a18f24cffab75c85f,65,55,87177,26603,60574,68,60,78243,34104,44139
9526de2d661b997f79c5e78029d68c9f,81,66,104242,37643,66599,110,79,203160,37112,166048
1f22c526e29e10b3c75da64f73fe6149,148,117,408161,103736,304425,143,99,401193,77351,323842
674398cafc6d6fa1785a4171f9b1a7ea,128,96,338489,70402,268087,132,113,430399,77000,353399
ecb75a3c75a089d7d94b6e59d7deb719,164,114,508605,92402,416203,203,140,413557,94547,319010
40b359bb8145d4b025aa75a6f4fc1580,73,53,127518,33327,94191,99,75,210630,34026,176604
64c546dacebac065992bc5354b5a5ad1,6,3,938,410,528,14,8,1879,647,1232
35124c65d644ac7ab49096976acfddd4,12,4,2033,214,1819,12,9,1265,603,662
3d5eb3c9699704fb2234d834edfbb981,12,11,2134,740,1394,12,10,1358,1130,228
022a2790a77f45e34fefd0044fc9d3ed,68,60,94259,37870,56389,103,77,128376,37846,90530
54cd5ebc4c67556a9647e2fe11d39437,22,15,12850,4543,8307,28,21,14257,7217,7040
c59b8f99c162d317ba1758798fadb859,70,48,89838,20967,68871,70,49,85987,31859,54128
108f75bee594de5cb1756ae5d25bb7f6,171,125,465189,100408,364781,169,116,526144,86411,439733
781b4a83b1b12f06ff7f644b344aff31,70,53,126416,35690,90726,76,59,111066,39369,71697
9a1b5ccfd777be65b184e7ddce2d3a13,214,160,914817,130642,784175,191,150,803411,139205,664206
6e86eb1927e831c5a120f79a27383562,60,58,89594,25068,64526,58,39,75136,21332,53804
078befee046d1ac8855b2089fc2eb2f1,0,1,0,101,-101,1,0,101,0,101
da4a7c9a029c6878d6883d6cfbf10ff8,24,24,23543,13726,9817,32,23,27389,10963,16426
d7f86cac9519f52a52a92c5c3e23a526,64,46,91593,24793,66800,73,52,102930,23351,79579
7e56a617ca1236442f46b4b05bc31550,18,14,4230,2743,1487,16,16,5561,2716,2845
f3f8024d8cf7e34c9cd330735fde6dff,58,45,91951,24175,67776,69,51,95496,21709,73787
45126d4aa02743d1d737be5cfb9a4fb4,116,97,218088,41689,176399,68,60,116116,43222,72894
472eaa7dd76f48284d379351fc851a71,157,127,356301,108522,247779,157,110,465927,104286,361641
e6afe3b62dc8a6f9c5320f8c41e32bee,64,50,135438,21871,113567,68,60,111540,40996,70544
7d77f63af6c8ad61397d8ff4e0a1de78,42,26,51574,16874,34700,39,30,43821,20153,23668
76d2652f88960e6681fb6b772ab4e3fc,12,9,1699,631,1068,12,7,1376,951,425
4b823f15c48e5e97028118a0bcc95c85,47,40,82947,16635,66312,37,37,45762,25501,20261
830db87ca51536cd1ffd1c2ee395f116,39,33,27723,15913,11810,33,26,31168,11057,20111
770a8051dae436f88a01bc441f11f4a0,28,21,14230,3716,10514,33,30,14138,6099,8039
557739894d8f90ae6baef71ce757dadf,63,48,96775,42840,53935,75,54,134983,38297,96686
2ed23a0c9eec7f5bf6f8b7dcbed9a75a,48,36,79264,19360,59904,45,39,52372,29667,22705
1d43cd55172d4d7f56e660475c54c907,54,40,56655,17752,38903,55,50,47334,19320,28014
80e0cd25baf5aa09e625112a79cfa47f,75,53,130062,26501,103561,58,59,102118,44602,57516
9e508e642e03e7d91f71db0a2391bb4c,142,124,524321,123107,401214,161,123,511166,131314,379852
d6629122c258094e727b94e7b2823d7e,55,44,62187,30202,31985,40,40,72019,25863,46156
bb16fecfa6d2e6f7600ff8d76a44a902,60,46,76120,24879,51241,74,66,101771,30331,71440
8e1de092001f212731af061c345b8dad,29,25,11305,7249,4056,33,21,13829,4247,9582
a68e96ead25f49ee095575d016f35d43,61,42,68417,19135,49282,47,30,68806,16801,52005
a329cd39a2ab060b7b219302d27f8af7,54,51,75971,30772,45199,79,62,106866,26975,79891
2d6f45ebdcf8a17cf24c1b47556d03b5,44,27,41313,10647,30666,41,29,32510,13227,19283
d38dd22e7df85d6e244c5665a14c822a,56,53,83738,35386,48352,65,49,90277,36082,54195
fa2a95e9c79ac53f4aeec83ec1e1c42c,129,101,324315,65512,258803,112,79,255503,86703,168800
d5a3eeb6e52612344e4b1af2f0b02e61,0,0,0,0,0,0,0,0,0,0
a0c008031431271d566bcc93b22f1909,39,30,49116,15257,33859,33,24,26554,15442,11112
e9aeb4989b7a50e27e7bd39019234515,206,145,816275,189656,626619,221,143,643592,151804,491788
7533fc19c4566dedff41c4170770fb69,113,71,146240,25901,120339,71,51,98687,29633,69054
6d8ebb1c612180d50ebaeb08a76e7ba9,102,83,148449,54525,93924,101,67,218996,35316,183680
c2f77ba9d7a527ed7792756c7c541dcb,193,154,785363,133335,652028,141,122,446117,123840,322277
082029cde6727dba77d902a664b463e0,130,105,278187,52002,226185,124,74,251055,44776,206279
080021259daf1a5afeb589afd4d13df9,115,81,330360,111225,219135,106,79,341248,128098,213150
062b34249c8fc2eb40669f665b6eb683,41,28,53659,10846,42813,48,34,38667,18215,20452
b07b31091d713784260f1ebe3c9ebac2,125,96,211906,39369,172537,96,83,144950,53080,91870
18124863886205c39a36b127c41cd612,223,159,880617,135476,745141,216,163,822695,92812,729883
47d55e3b225bf5fe61ba56504bc5833f,161,108,406543,67488,339055,135,111,330961,81284,249677
a8e46983f58d167c366d938073c79580,95,81,119324,42917,76407,111,85,158694,40555,118139
954ab873eedda21e81ca446a04966371,145,119,354108,108494,245614,159,105,354753,89367,265386
0aecbcadb542aed48a0e2b7df4c8d930,128,105,331119,111474,219645,124,97,291502,85124,206378
603e4fb19c710d86d915b263d53147b6,144,107,513005,86957,426048,131,108,405183,109381,295802
6088ed7718799fb5498c373a856c1da2,33,25,38334,15832,22502,55,51,84189,19552,64637
3a71b0868597fe78d19bbc06fa2caa85,93,77,140612,30306,110306,76,60,111294,33812,77482
fdf78263938d1df7cfeb7992768b232f,161,103,385064,88057,297007,168,106,495910,85929,409981
89aff71ebe4026b1c49175d1a02f6c01,9,7,1218,1276,-58,8,8,1476,847,629
93aeb48772a0c6bc60c36695c21e33e4,116,83,241921,83887,158034,105,71,190381,66784,123597
278355f895152d0423ce648aa48a43f0,40,32,67718,22471,45247,50,48,82334,30383,51951
d4e2ae08d02b9c0a7fb70c24a7d8626f,56,38,93907,28508,65399,63,53,126122,32961,93161
49304bcf3fece98ba8544a267320d7a7,124,106,370956,54674,316282,117,96,207720,53985,153735
4b232848c9e8265fc40f849037efdac3,79,61,137046,27168,109878,90,82,99763,37642,62121
fbc02d88fae8e61c23a8a1759321b2c7,93,69,129573,29443,100130,82,70,111608,39608,72000
164ea1e7d33ab7122d09331c2058c21f,62,49,89579,30048,59531,77,58,176841,31215,145626
d2773e27b3cfe82ea08c50ce19df7286,34,29,18155,7944,10211,41,27,38581,7543,31038
11a72ecc26730c1ab222903939a4844c,26,19,13681,5474,8207,28,20,17977,4825,13152
e726f9b7948836ae7f233e5d13e729a7,71,65,186594,77208,109386,130,114,331940,45486,286454
3f175d405e98fe9b53d53ec621522ddd,134,108,352417,83095,269322,112,70,231393,79088,152305
fe98840698ad7a77c04c48aef8375d64,81,59,126664,31039,95625,81,69,104864,29524,75340
4d062afc271e948dd650efeebd278dac,123,101,211021,57347,153674,81,78,167357,52328,115029
17ee5d011a3cd142aac5997ef01b1408,44,35,23393,12631,10762,33,24,21948,9017,12931
3ebaea09611640f610d234fb52448268,27,20,10178,3769,6409,30,17,10248,3126,7122
8fb06e3a55446e03d43fd4944e04a624,156,132,533899,115449,418450,184,120,670312,77327,592985
d4d5c9c1b1274f9e4bb09094a66962d9,150,107,399606,69078,330528,148,116,371907,91117,280790
36e2389facd7669061f3d99dfdbe67c8,22,21,8321,4499,3822,27,22,11644,5064,6580
9caa3286d09c23181923229358ea0d51,24,14,7320,4200,3120,26,21,10887,3022,7865
4fd4b601fbbe1d6364bad59b47a37782,181,144,535600,128343,407257,157,103,421396,104422,316974
1df98ebc25ad097e56918691cbdce652,126,120,326122,47135,278987,112,84,197704,50306,147398
a15065cf166701fa287b9c5d10d07670,122,94,234581,100408,134173,163,118,412498,70869,341629
d719f58e4be8cacda10cf21581279ffd,172,125,548904,83757,465147,160,139,507748,124890,382858
ff9650957c2bc30942d946eae4b3698d,145,105,469105,75107,393998,216,168,620424,99479,520945
8ea361bc42f5c28624da5d627ff7e5db,136,95,450911,94258,356653,158,112,454631,94595,360036
a115574c01c2353501fab5c2e2045905,74,55,115157,48172,66985,78,53,137595,31487,106108
6a8dda4a3d8d2538dbb6aa81f394a03a,110,84,406889,131627,275262,183,125,547388,108167,439221
1d3fceac2e38a8c88cd9f580b51620c2,34,34,35123,9019,26104,39,29,27016,11670,15346
f0868784d1a0966a780718c15d26db18,33,28,36383,15619,20764,38,29,27688,15950,11738
5c0b7757dda5a21018997bde6d65c43e,147,117,404370,109332,295038,193,160,578609,111255,467354
a32ba7d099497c49653ea1939ce81261,25,23,21255,5801,15454,29,13,18539,5207,13332
fdbf9098d209263985e7ccbb9b40c761,48,44,53030,15593,37437,43,30,31549,8298,23251
c893eeaa85f3a6c6dfb16597e0086a29,116,107,300540,59132,241408,137,111,293987,52243,241744
e4b8ddf8f52d998c574ba0f91886ecc2,17,14,4837,2405,2432,19,16,3542,1850,1692
de2e339479cf8e5697aff693d190e411,210,141,779539,127164,652375,173,119,709297,123921,585376
402fa5904f6dffc45ea9a7dfb2cc47e7,41,34,43078,16993,26085,70,49,84507,24455,60052
f45508d8654a7393db66303c67fdfd9f,5,5,217,548,-331,5,4,548,213,335
43c2d9dc773998f16502b061390f10ec,171,119,567748,85246,482502,128,94,456666,96942,359724
b6cd8ea806c93b0c9be406a0da341827,72,55,132179,30068,102111,63,52,98098,31059,67039
58337746567d544d053cbfd38f9df29f,67,47,110598,28322,82276,59,52,68396,23829,44567
4d08270bb94fc0f507c0c394800ec4ee,155,112,341392,42369,299023,87,71,151689,59808,91881
cbb692bfb025aa14795965c14dc41672,30,25,24263,8221,16042,31,20,16018,9313,6705
a72a1deb792cb9eb36d106e180849570,14,7,1451,591,860,7,8,1542,878,664
2f29172471a90574d6444cb4f3d43285,184,128,566020,102654,463366,121,89,323999,126905,197094
5c36af67763441c2aef0a0869bfc2724,62,60,112077,50899,61178,57,46,92435,43807,48628
d581e63074ec59449930bc036bf2cdaa,53,44,49537,25613,23924,64,49,83413,22985,60428
768c79691eed66619f91ac9a2891826d,33,25,56444,12912,43532,33,27,48273,14099,34174
d84ebb0d078b4e4c35fd765f76f98fbc,170,132,489321,95675,393646,138,97,395141,94998,300143
adb56220ae8277e98a37dc9ae1ad1094,35,28,26964,8387,18577,30,25,21539,10979,10560
8132a0eb1708c92926fcb509fd88a33f,13,10,1799,1037,762,11,12,1742,1055,687
179d83bc1c01725100957918d4ecf81c,2,2,90,140,-50,3,2,216,45,171
0e2cd1416249418511c346b57d3723ed,26,20,8496,4696,3800,22,20,7286,4370,2916
55871e5da3d1592e22af639fd7a4de40,51,41,58572,26430,32142,87,71,162828,33980,128848
8e805bc3d548f76f1acfb275f04d79dc,132,108,441474,154273,287201,126,104,500124,157643,342481
c4d255d8a69ae0c349f3179a72c98c4f,83,76,114287,36373,77914,75,68,111659,32746,78913
c4696e6113cde61d399ed572453343c5,106,86,260458,70118,190340,90,69,189043,48810,140233
404f50512fb931fab702d869933801bf,113,57,226114,47401,178713,129,90,273211,55251,217960
a3237c05dfce1d8d07f3cc38c47d6330,48,35,37808,13242,24566,34,28,35660,10593,25067
6a91db8a46b5b1ae1aaafc8c35113ead,122,107,263011,70462,192549,100,83,209716,45660,164056
bae813d3dd6954fd6f245ecfc360d20a,64,45,89401,16227,73174,63,47,105792,27236,78556
e756fd167758650b340f40edb4fae9df,181,133,797233,101104,696129,134,94,448610,151569,297041
e8f20053274a7d140df64974e1bbeb28,55,38,67987,22088,45899,45,40,65705,30088,35617
906a5266fd265b96422d6f1702281f04,19,11,4533,2223,2310,17,12,3992,2724,1268
e7b7b6423150efecaef16a283c56db68,155,121,396153,74817,321336,144,106,314390,67119,247271
d4ea5387e09d303ac7f111096e632474,74,54,95877,22350,73527,67,57,79327,24065,55262
0a8eb9a3518ecc505bab491eb17c9247,84,69,115995,32583,83412,115,100,169599,49724,119875
17c20d8a2f1d4c128fded410f6d4c1d9,145,106,381527,75768,305759,141,108,353275,69922,283353
a7ff0f151c4eee43b028c7ac5870a1c8,33,29,47555,18188,29367,53,49,52881,25356,27525
9f0868f706d3da9396a49d44fae781b1,109,82,272896,85561,187335,148,94,342355,62711,279644
1b07dfed14a5487dcfbb16c20c8bba5a,61,48,88304,15345,72959,41,32,39691,15279,24412
b3176d04c58dab954bae0491dd1b6704,185,121,429355,78347,351008,124,102,350442,80400,270042
fb14b5a7dc73d98de474de680db318ac,41,35,54356,15991,38365,72,57,76730,15560,61170
3e501821cab4392a0ce4837432bb6d79,20,16,6099,3386,2713,16,18,6362,3305,3057
cc23eee4a954af137ab679cc87879b5d,68,49,95016,35650,59366,68,56,116818,42444,74374
db261711bd14a1fdaaea05a0dffd65a4,121,102,246451,62924,183527,128,88,270647,62175,208472
2ffdb2587e6b86758d89907169288937,145,138,415248,108332,306916,154,130,503050,78488,424562
d9c3ba13846eb0b45c6af51dafbea2b7,129,92,257487,30685,226802,101,86,153223,48172,105051
dc913468c68e1ad826fc9ff1f690908e,153,111,461301,85483,375818,152,99,355463,80858,274605
4827f0734959a0f79b2b75487657b6e5,145,111,350035,61664,288371,182,127,477893,64680,413213
1533f429519930a5f432ae37a67faa36,18,18,8399,4243,4156,23,18,11979,5288,6691
a6206e3321aaa5299f30748d74556ed1,4,7,767,560,207,8,5,705,121,584
8867751cb6f2215786cca1dc034d5600,162,118,443476,56997,386479,141,101,361726,86065,275661
9b6c05b60f86d46c2565f484e855cfd9,53,36,64012,18216,45796,89,66,120005,23723,96282
1c92a5e7680befce9518b941fc22154f,35,36,36247,11451,24796,37,30,22668,15402,7266
b2cf457c03449607545755a42cb6abaa,47,33,23044,14468,8576,50,33,27137,10391,16746
b57bbb967a00ee4d73ddb7c3b88ff6a4,76,62,117253,15321,101932,98,78,106509,31019,75490
50c8f678fab6d20117c5ee824afbbc2e,7,7,756,1022,-266,10,7,1342,475,867
3edc2700054e7bba2cb87e4ff233bba6,96,81,155135,37209,117926,63,60,101447,43859,57588
213bf90b0da26c5d3fe74c4b150de796,180,114,607882,100072,507810,235,146,769149,111877,657272
4467228dd20e7c95ddce36b65d290b8a,26,25,11109,6325,4784,28,21,10490,5166,5324
3cfcaf4555770524846181d7d83e85ac,101,82,216418,46874,169544,98,77,143140,45805,97335
dd86981a01f2754ec6f7cc9794f123a9,118,80,197354,35369,161985,66,50,123973,34332,89641
377cba1f5fb565b6561fbb0493f4e183,54,48,34206,11398,22808,47,33,42631,12116,30515
e24d06acd3b1cc7cf2bd113b72e18bff,156,94,359013,76810,282203,163,101,316033,54387,261646
6afa83a053cd8a4eeccf1585cadc5201,42,35,60911,22561,38350,50,41,62490,21310,41180
e199c29f2aec7730cdd69dd89e42222b,86,74,164820,38708,126112,86,75,170887,40104,130783
766783e4d5bab32602165823a3476bfa,30,26,20838,8042,12796,30,22,17078,9504,7574
5b5b1a64699861082143c664bc5441a9,90,71,146931,50127,96804,100,82,133799,37257,96542
b9f7c775d7aa1ef3a9a06ac2ccbf42c7,144,98,419982,82914,337068,174,124,396938,87166,309772
6388c1113e8aa489c7ca13b5161fe389,44,32,39610,13405,26205,44,36,33240,14141,19099
6157c5e4825cd7eb1264db868ba4cfb9,76,63,145118,32558,112560,90,63,148686,24849,123837
3f2c6f6f1ed508fc6cc45d4606c680b6,56,46,61114,20936,40178,41,32,43206,12288,30918
9c50055c33d1f93d47665ff1a79896ec,118,93,266054,56603,209451,72,54,144594,78412,66182
4e40ae89bcbec293b3793dfceee27206,27,21,16071,6119,9952,29,19,12604,5579,7025
2a14939b752107e9feeea2837b63dbec,55,46,68604,29360,39244,71,47,88824,25205,63619
84a4db1504d4022a88fb41b7949807d0,186,134,488295,154596,333699,179,136,669715,143411,526304
3f01b3f62a230b6c8049b8ed1a0ab69a,131,91,330816,58669,272147,121,97,341150,67980,273170
b4ddcab9216312a5ff366b65b974aad2,21,14,6549,1513,5036,21,13,4819,2018,2801
a6f821da87c9cbf7c947f3a95948fa4d,20,17,7111,2511,4600,17,17,4069,2770,1299
e8575616288a9ce997bd6ba2ade9b479,121,84,232056,69222,162834,169,94,311986,78629,233357
81ec1741593d7b202e7ac1e600fb911a,28,20,13655,6397,7258,21,19,13483,6838,6645
43e16c741d28914134e4446c30b1f26c,76,62,172400,38645,133755,87,64,173001,43270,129731
fe5771e3adf570a25cbb5d423828d8ca,72,40,120685,25550,95135,81,60,81307,34764,46543
550748560910edfe7064d1b9076e1474,19,22,6685,4526,2159,24,18,6572,3930,2642
82eccc7637fcb16dcde033fd44e37168,114,77,177369,43356,134013,85,63,128717,37053,91664
4e02f3588b64e8fc9f0ad054a614ec25,102,76,182472,51631,130841,71,59,149073,49098,99975
3f5ac0bb5a0bf152a8b9ba12155d102c,150,113,375082,96448,278634,171,108,487259,74971,412288
e8059391715fc568d0325176ad3ff97e,145,105,668595,111322,557273,159,98,641437,132282,509155
1b79c07c25799f02240030a94b7e4841,46,37,76351,16284,60067,55,40,66288,18617,47671
f9cbc302c1a39a013840ee5856a4c217,45,36,55282,16676,38606,42,29,38039,17422,20617
b0c76921af71f892ed784a02650c0ea9,101,76,181415,32176,149239,94,73,131029,39228,91801
1ae102b3cc01e12f5f167a17672efb92,35,22,28643,8451,20192,31,22,26290,8945,17345
b2b49bf6c71d90b0077cc756e2a79eb7,137,86,377691,88641,289050,131,76,356313,93143,263170
16626ed688cf4e4c7fb7b2780f90a6f0,28,24,20355,10593,9762,32,29,21400,8075,13325
3781d81a715aa138d2e9523b2c13f98a,59,52,115837,45382,70455,64,53,134882,31903,102979
51c1fa55bdbbdcf6eda2ed750eb4c9c8,20,12,3902,1305,2597,16,10,3531,1431,2100
dd452300c6807954080237cd07ea72eb,27,22,15704,8122,7582,34,26,20097,7791,12306
82a505e42287e6177124c2eb7a27f2ea,57,41,90093,29330,60763,70,69,140236,31868,108368
89ae2eff36cdd822337ebf0a2486c148,3,4,262,103,159,3,1,164,104,60
5b73d7bc05000e2180489a78c2231a5d,109,76,185364,47863,137501,135,95,258561,54345,204216
6a00c0b7da15bc25a3ecf1a9452491f1,74,60,223056,94151,128905,104,78,292055,81695,210360
12a7305c5f8f88ff22809938fd7f5dd7,32,24,20152,7649,12503,30,23,15069,7483,7586
35b157673e2eae4efdffe787db29beee,126,84,364718,81998,282720,138,115,383078,122553,260525
8a76fa244a9a42909f0b48720bc54464,61,41,146629,58813,87816,105,75,273394,79096,194298
cfd1a288ca2b0200791f13bc4f309d08,54,49,76651,20411,56240,35,31,53743,22453,31290
6a9b75ddb487cdefd49b3afc48d4cb9b,18,20,6341,3353,2988,24,15,7265,2704,4561
2db2ef94bc323cb95025df117f99a7b2,69,57,113339,25237,88102,87,68,124478,30456,94022
92dede94a557b47cbaa52f2037e5a971,90,80,161199,36768,124431,103,85,128406,34474,93932
1c5b5545ef7543e4b21d0474742623fd,20,15,5323,2971,2352,18,16,4377,2621,1756
b8aad4104b9c1136a53578441cbfdaf9,35,30,20292,9277,11015,34,30,16049,10231,5818
86553840bd36278f2ba4565ef9025e82,132,88,274920,59566,215354,131,107,229431,69843,159588
01820bed0f66921899313b557caca0fd,183,154,706518,128564,577954,153,121,676907,147027,529880
76bf7e65d909b7f06fdb679e9c6b6f62,45,42,44467,20613,23854,59,41,61985,18022,43963
c8e94911be453493c72ab0ff37df784e,101,66,131870,45854,86016,88,65,148336,34460,113876
394d825a4babe522c7de3f6b6f8ede86,58,45,60777,24639,36138,57,36,67452,24106,43346
e97da9d8ee2ed32f5a31be2aceba0594,111,93,441913,103074,338839,126,110,435542,113869,321673
9acabea35a2c1ed2416ab985e73e85f0,151,118,474744,124513,350231,162,108,386670,87071,299599
673acdfdc760078f8fc2a6982d23cbff,108,88,255610,98324,157286,166,121,393423,97987,295436
c3f27823b5d1e815941bd32c4902f116,24,20,11542,3548,7994,26,16,14342,2955,11387
6cce0d247306ea1ae3bc7131fd9bf91e,34,28,21953,12339,9614,31,29,23479,9676,13803
477cc2bed7ba8f9ce9fe3f4a2119b60e,66,50,123519,29323,94196,78,73,154573,43316,111257
57a7adad8ebad639b0e3c2e471e0fe82,97,81,131971,45452,86519,80,56,142579,45018,97561
5c98f5721f930bf3ff0723442de9a2e0,128,100,231164,51802,179362,113,81,215818,45492,170326
38e6111d68c26f802b9ec0d35e848b9f,34,27,52997,18358,34639,38,28,60303,16604,43699
91976d9c3f85de6dc9e22e9a35b6267a,58,47,92169,32453,59716,91,77,147900,32080,115820
c10024b80b8a06dbafec3c76df8a5805,5,5,971,707,264,3,3,670,838,-168
889063b788dc9627be4c0a4588b7eba1,121,94,266072,49292,216780,133,111,302890,50541,252349
5a2678cd2683df43f107aabe49db5bbc,175,126,553317,79294,474023,163,138,514884,107826,407058
cab74c1102730456056b473cf3d5f2cf,94,74,172475,79081,93394,156,112,329696,53935,275761
d9e2b2e8ad52baddd5d85b30f5b1ba89,62,48,79200,16511,62689,91,70,86322,19431,66891
2e2cff58e27f22f1865a3309a48aab18,23,19,12729,5843,6886,24,24,12923,8883,4040
531d6ae2ddf569ec430411cbe05c8b40,100,62,161416,44230,117186,115,96,234653,49828,184825
e1d773ada42361e02f177f1465a6008f,46,34,48645,17625,31020,57,36,54709,13659,41050
c2361f081847b0c9308ba65b491b3bb2,164,131,483062,106184,376878,172,145,488110,113389,374721
e61ec33ec566c722cdfde0e9b4c756b9,89,67,105709,31153,74556,97,78,159395,30206,129189
21853e4ba0440c236af8a34a6b2d6c92,142,113,499263,70571,428692,150,118,418529,85370,333159
bdc8fa86b8e43fa9be2c4a5ab699f75f,46,36,52430,18914,33516,48,34,59456,16140,43316
99dea183cf817431fa2c9082f46a9e1b,84,72,200857,42063,158794,101,92,241301,57660,183641
f0902685b8c53fe875c54de82c0b0ef5,78,62,94800,38665,56135,60,48,102066,23598,78468
ef84af080a433019c4411e10f6a060d6,136,109,327190,45695,281495,133,93,244947,44441,200506
48b6b53983bc00fefb45465bc976261d,237,185,1367583,212203,1155380,215,170,1165909,224187,941722
76804c70e84e5768d6733fd3297d47c5,24,20,11912,5696,6216,28,19,17152,4590,12562
9a10f0a2f5c64ae5638cdfa179631543,183,113,474082,86824,387258,154,86,466052,75038,391014
107dad2e38dac4303fc2aa3cbc8b9328,6,2,881,173,708,6,3,677,146,531
2a763978b48763d24e807aee1f07fdb6,39,26,55027,14921,40106,49,40,71225,23034,48191
489edcab90a34a067dda2e8ab48c5e9e,39,33,28688,11013,17675,50,33,30165,9030,21135
869b918cac77eb7eea3ccacb7520dbdf,145,94,312189,63365,248824,152,101,412357,79699,332658
cadfb4d2e3ac3860479cd522089da4b6,26,19,14131,5340,8791,30,21,14228,6789,7439
64e9ff4f339b831b02bd5edc316c4ee6,148,86,386502,54182,332320,120,83,252741,80157,172584
24e62a20ea671db22029fc4cd688055a,80,66,150096,48338,101758,113,94,285199,47408,237791
4e8fc90214620d872f1ccc10d3e7a4f8,84,60,195905,78791,117114,141,116,399884,80849,319035
fb2b6b76d327e6b4334d0a0362eadae8,180,146,870247,227647,642600,187,149,1046784,239073,807711
eb5b226eba1c5620ffeef11461373eb1,69,60,68560,28264,40296,68,49,74889,20460,54429
cc8994080f529d847afb23e0937ccd1f,55,41,108663,27358,81305,54,46,85731,34635,51096
c6a97d51c56569193270e18e7e5dee33,43,41,83465,21193,62272,61,41,111439,17774,93665
4674bcf862d351c5718210c8adf19d52,73,49,158495,35385,123110,65,50,86141,58094,28047
2c31faeeae084d8c109983790e394dda,123,106,408153,101961,306192,129,96,517841,82651,435190
ce31122328eb29bc13c48b21c8123c76,70,57,144977,50209,94768,80,69,169148,45032,124116
107226a6960efdf103866e48d37e6a0a,86,77,161266,44625,116641,104,77,210826,31126,179700
53051d4392e007327b1f60f09087f51c,109,79,187712,38323,149389,71,42,149353,53162,96191
bb42f8832d76e87321a807b95b3e8f0d,108,88,188164,44417,143747,119,76,236668,48368,188300
fa125159dc9247c4bab1b9f5e255124f,115,96,283163,63905,219258,132,90,241688,57512,184176
dba57ca8606c982f80c5c6c8021ef329,92,71,146003,32220,113783,85,78,150278,47383,102895
92ad954c3c084fae7707a811e61c2dd9,51,49,48676,16956,31720,58,38,47479,16160,31319
0e9d23f07efd8bd9606f9f898c90332f,165,114,379639,65702,313937,125,94,247062,70923,176139
4337a8273c84763eb59692515be05f92,140,112,459358,115936,343422,181,135,522480,151613,370867
924ea902cc80bea694154846f2b60d81,138,83,242780,53866,188914,130,92,192232,63430,128802
ff01d5512b2db6294ba308bb977894ec,134,68,265950,78744,187206,164,120,434076,66741,367335
0f8a594711fb9039e9f10f83a947da1e,26,22,16905,11451,5454,27,25,17337,12405,4932
e523f38543dba6a93f3c5e875e3e4b28,112,89,252619,60775,191844,112,80,310265,69791,240474
076923be34ddb489f45116bd742ee3c2,166,126,754956,159271,595685,212,153,910145,196516,713629
88680df46a2186a6cf3d3912fecdf3ba,93,65,185545,33103,152442,102,89,233543,51137,182406
339ed6e89943b4dbe48d173a6178a925,103,84,210376,53878,156498,108,92,222517,54534,167983
d80aab7e0e166c6c857716cbeeb747af,51,45,86758,25035,61723,70,55,90820,34295,56525
e901bd916c6959fa9ee19e30cb7cb083,47,30,30309,12343,17966,43,36,24713,12305,12408
73a7ebee6a5c77e3088575cf58f15d92,32,21,32379,6469,25910,27,21,15495,6764,8731
06326a9a4a10ee05768fb80cfe933e81,166,110,623703,136778,486925,169,114,478452,122491,355961
1af2830093e17dfdfda241b32b7b1a48,14,10,3793,1218,2575,13,9,2207,1000,1207
30f5ec7f815fc064cc3a7cbe574afd4a,181,146,753089,100601,652488,169,117,628254,100164,528090
386aabe41ae88d6920925485a5eaa19d,188,124,525730,130288,395442,143,122,462232,97123,365109
ad4b68d3c54525fd216408a719980c44,84,62,90849,25979,64870,76,56,101170,28202,72968
7e40ade7f1ffbf2d167cb9a6c6930c4d,78,70,220905,76643,144262,93,72,279047,63879,215168
d51d9b55af8bbf793386bfd18d45855e,117,100,348405,86104,262301,182,114,431239,63190,368049
62c60e284e23840096bb48ea0ad38915,26,24,20561,5922,14639,26,22,17055,9027,8028
221c4166e6549f53f9782499bd310473,11,9,1662,1685,-23,11,6,2608,1000,1608
7cb9a09fda988b359aa3cb57f54a5186,130,106,341367,70372,270995,106,83,238801,56726,182075
d27231d15f988f62c9a58a7de83bfe5e,94,71,197987,73187,124800,145,89,239672,57350,182322
474b40fba2d463cead7052195ec91e9a,141,113,403070,153498,249572,130,100,391019,90205,300814
14789a10bbdac8ff50858347e0272a4c,66,52,84301,33151,51150,70,43,78181,29728,48453
d7b5ced10b095b3657617b213add8182,113,85,238913,42526,196387,93,67,119681,46634,73047
acd4cbfc84bc19d5342a103e48112921,24,25,9269,5934,3335,24,23,9399,6906,2493
8f1121633564b0baaf7432d165100a60,77,57,161223,50203,111020,108,85,186349,51680,134669
a26a360fbd191bb3f34510529c4359fa,90,82,240281,67588,172693,116,101,254696,74155,180541
32888eecbe2b836029fea56fa0c41467,137,101,253132,63428,189704,109,84,205748,62615,143133
6f24e088e7816a77f1117085b00d4c4b,26,24,7241,4416,2825,19,19,9444,3385,6059
abd872307d3f4410cf0111e2bdc5f1e8,104,91,240416,58044,182372,107,90,211740,55650,156090
6558d5f93f59194d34a344288db7dab6,31,25,23716,5922,17794,24,20,12563,3358,9205
578ed94db97c9e8471b9e3a8064b63b1,126,94,298718,111364,187354,128,77,340560,85742,254818
8e1940d0cbe758b7f64f8c64bd5d2fad,127,95,253916,65411,188505,102,77,192366,71146,121220
0aa3689e5cda49214a3294aa4810d823,34,29,21558,8219,13339,33,21,19651,5898,13753
4726bfc0bacd5f1ac8c8be00e8616b73,129,86,273516,67787,205729,119,64,204731,55354,149377
fd50c46d9e3987d013f23a9ab663130a,136,103,330086,71363,258723,174,118,433252,67722,365530
5f42db7732b4816f3ae8f35be5e2db77,68,43,84470,22983,61487,56,52,71620,26570,45050
1050a6fb57b621fbb82afcef198deb57,36,30,25965,9180,16785,48,34,38318,8558,29760
8934bf3e1e9715052b6f11ff7a9b8975,29,22,19134,6717,12417,23,20,15016,8946,6070
9f24ec2e0ef12973f535c46d06ab1503,91,74,120244,37699,82545,60,50,73053,30542,42511
8ca54a554d52f78016a631da82da1a6f,17,15,4641,2586,2055,16,10,5782,1359,4423
49011a01390f32767b33349bc721b46f,71,59,83839,30101,53738,83,59,71735,25215,46520
3abdb2f46bd0e2a6c1c9e48b3945a874,127,100,268851,84580,184271,151,104,407681,75056,332625
9e70a105b14de2210fcab8fe68f08b44,84,68,107686,32417,75269,70,47,84639,20225,64414
d3744869e725809f474bb03ccc1dd402,54,40,71976,21814,50162,53,39,87026,24025,63001
6e79070914473aa045eb0f571b079a85,55,47,103329,42307,61022,78,54,177302,33671,143631
0b7a90ca574eee7168052f13f3599203,43,28,47218,11521,35697,45,34,32692,14392,18300
f48ceba464ab5f6368b3076425ac390a,42,37,27313,8057,19256,50,37,42470,9184,33286
b61562a68e269d4c12d4010047224405,43,28,33969,9756,24213,43,42,27334,16559,10775
2a9e7911036d3a1a3d99d58888c15aa7,78,60,106252,28238,78014,114,89,185723,35960,149763
9175a0eb940b10dcc5ec50c39793f9e2,17,15,3930,1999,1931,19,15,4030,1603,2427
446a1202f147791c32a915625e871ded,76,46,86032,26475,59557,61,50,71846,27812,44034
5bbb5b640af85b977a90dad49580ed57,120,83,202571,40268,162303,118,100,236914,47360,189554
b6723ba32c7c0587ec44a1115fbc481d,143,91,318731,69635,249096,126,102,353211,85097,268114
c1ddf128592b6b182dec1400898d5254,123,116,243044,70821,172223,112,76,249293,50058,199235
6af69ac8cbeb1bdf650a687e4ad20c66,160,126,583628,114041,469587,159,132,505015,100492,404523
926045233d0a60b46cee6e0a29ad1a6b,261,160,1868668,250718,1617950,216,150,1162477,268233,894244
beeaf345de4ebb4a9aa3f8d9f8c97049,20,18,6766,3394,3372,22,14,7116,2391,4725
43a28b90c23e564339d0ff3cd2852080,51,42,47473,31722,15751,46,31,71689,23537,48152
420efdd4269802ce5943c68aa24f47a8,107,84,201119,54306,146813,108,68,222526,44610,177916
4ca6be89542fa41d224e9706f572cb21,38,33,38241,16590,21651,54,50,71249,14483,56766
80734c9fda695df30dc35db76c16bf86,15,13,6841,2501,4340,17,14,7207,3449,3758
88669489f1509a27a45ecc229b76000b,89,77,149856,53258,96598,100,81,238654,53164,185490
ed64f64bbdc8634aea474b57fc91305f,61,48,81127,25682,55445,73,62,78807,22572,56235
843315e4c233ba36795155b764be72a9,165,129,491035,116081,374954,161,114,415411,90871,324540
422a0e4f75abffca21422ec0f89cba7a,93,74,108201,38539,69662,96,69,120832,43599,77233
c8954f448974b840eac55e83fa5d7b8e,18,12,6155,1633,4522,22,11,4756,2189,2567
9b8a8c1ef947d98562ada7bff79ee744,169,131,890749,186702,704047,205,150,816048,193116,622932
6d715f6285d68c05a9e57bde70231384,23,22,15098,9871,5227,30,22,25759,8800,16959
f5d8aa6b9fee5f755f4c040a03064765,140,93,253164,67903,185261,143,100,295464,62108,233356
2ea92dc92daddb66336fb78e864c5b81,59,52,92928,26708,66220,43,30,75058,15670,59388
a5d72ada69ef17473636a88ce72bed18,117,92,277985,56913,221072,105,83,230947,50916,180031
1b1ee3e662b0db806a3f5c033db51482,119,82,226603,44435,182168,106,86,225135,41982,183153
31329c156cbee2870a3ec7c8bbd97cce,104,86,249825,40267,209558,103,85,235049,46107,188942
8d5d7d8defb90257262f1b54b4e864ac,88,70,167749,34101,133648,73,44,116807,35040,81767
e251011e53f78ffd9b40d4a77329a60e,48,36,44123,13740,30383,60,47,39991,15828,24163
c92ee8362a80f81bcabbc94c5bb2a4b0,174,138,679598,157512,522086,181,151,739169,138691,600478
95f857acacdf4102eb076b1beb3c9570,77,56,98906,19257,79649,69,54,83975,21095,62880
38c39cc28530229b94c7271a85988cff,28,25,15728,7252,8476,37,25,16218,6246,9972
699389398b3fed75abf3882f5af1f4ab,114,97,213116,50978,162138,111,94,197425,57031,140394
25009c3556660f088e9a65f07478bf70,57,39,69586,14367,55219,44,37,44098,14849,29249
59d4b092f25522be22e121e26bcdf73c,36,32,22091,8453,13638,39,37,17876,10222,7654
d4c7785a4b6f100fcf55d19914807b06,138,104,462746,154450,308296,181,145,630917,109283,521634
865bd27f5025710f418a8d59319d34d9,26,19,7312,3411,3901,21,17,9434,4361,5073
47e455f5708ebc9ea962438eab965143,224,141,970543,157477,813066,212,161,796049,195203,600846
f15a1b55de6eaae006d8a65d9eecd741,120,78,187759,25502,162257,122,93,220330,28685,191645
624562d86d63abba0994f54601a56b9a,60,49,60417,21343,39074,49,45,62243,21386,40857
d8545d433ada7a421260c10cc042760a,71,70,149183,48725,100458,76,72,119386,58795,60591
7cbd4143c8f55d7bebc6d5ede14998af,167,128,657359,126631,530728,178,134,538444,159354,379090
ab3ed3e035185fbfc906d33977c2ea00,31,25,25006,9794,15212,26,25,16523,8263,8260
646cdead14bc62eb02f520cea14734ea,132,112,239902,50668,189234,113,86,201814,41826,159988
21a9402f5235761d5abdf3dc3bd705b2,107,86,205943,61158,144785,136,108,263700,48255,215445
1cebc127e5c7d15b08eee9646909f0ef,151,116,379536,57201,322335,154,105,344635,55733,288902
03ffcea1405c92f24220a0825b99eeae,154,137,475507,79934,395573,118,99,400570,70587,329983
bceda3f5246a8b9bc3890a1767ca0d21,35,29,39444,11821,27623,36,29,19117,15491,3626
954d8d2cea2f6bf4bde42c51b757d2f3,128,104,294326,58359,235967,124,82,220615,48847,171768
4a7dad74b272e993821e19a7a0320ab5,79,53,143534,30923,112611,60,42,104696,28027,76669
a1f1049b37de2b8f59361f2590bdce07,228,175,1545368,182420,1362948,256,169,1132765,178633,954132
7d9d81079b23318e7fb67e8cb9238c5b,92,60,216673,54273,162400,118,84,238235,69424,168811
ccf916a0282751d0c6964b0ddc774a9c,79,66,214796,62476,152320,114,104,298569,76400,222169
0dbaec38fa3bd983bd1dcc866754ac7d,99,87,215784,40976,174808,108,84,275851,33342,242509
ab3ae074c84081673e006aaec9f45c02,132,95,348856,95387,253469,99,80,265991,94018,171973
7418af2482676785a1e75806ca4df7fb,74,57,133921,46656,87265,73,65,179289,38380,140909
d3172c5efdf5924fdba334b8c7faa1fb,123,90,357981,116937,241044,110,97,342584,125282,217302
612697119708eb45fffd108ebd6263a9,25,19,7913,4067,3846,24,19,10730,3892,6838
cc1eb605ef0ef8ce173be0d89a9f99a1,119,76,324148,91401,232747,127,107,345666,74750,270916
710169ddc171ad5b4b0fbe5030cfadfb,5,3,595,151,444,5,4,481,462,19
3794fa867ce882d6b05b2f8f3ce0c5bd,103,76,184349,42118,142231,120,83,189237,42129,147108
e174c0ae5c90b0332444e03136891f11,66,49,69408,22120,47288,78,59,105491,24575,80916
f65a7488ab83501a835790f56dbcd4b5,45,23,36512,6989,29523,64,50,52479,11682,40797
3217b13959a08af1aeea272f6be63e24,61,53,85223,17730,67493,55,46,45671,18534,27137
5080f9bc25e9b6b68ddf455c0a73878a,103,72,204114,55583,148531,82,63,182688,43744,138944
36c5828f6a76328f938166149298def0,179,126,623134,110695,512439,157,128,459750,131553,328197
264d3589cebbb1c71f2d10a5925415c0,35,22,18591,11242,7349,30,24,22956,8506,14450
251fca34a2d213dc802efc65723cdd61,76,66,99607,38196,61411,98,83,188333,32596,155737
6a1f0eeea62e247259f04881a6c666cf,227,130,1204295,200516,1003779,221,162,1290151,242073,1048078
a606dfa36a78c4de7b8e99a93dc6d6fc,168,136,878151,225265,652886,127,94,548038,141459,406579
9c2b473dabbe51479dc21a8a02113de4,99,72,146423,48148,98275,64,55,108772,44093,64679
2cf9daaa7523921f37dcc515c87bb88c,145,126,428611,116352,312259,127,121,352383,167417,184966
0aa1043d989d1d951810c504414ec230,170,123,342400,53787,288613,145,115,311179,37646,273533
b4ca7cf1a8868f567f25ef6b31e63009,100,64,123100,29595,93505,83,65,108048,28781,79267
952ab58bf48b4c8e56326a8ed7b027f2,122,82,223261,31567,191694,99,83,145949,48609,97340
8e124f697522565571966899ad4e6480,130,93,347009,121838,225171,169,113,433466,85223,348243
792bd14e0cb0ce9fdd1bbcd1d08ac603,76,59,96676,23153,73523,77,50,62958,19527,43431
47c84c70c135c5cd951faf442da230e9,51,39,82645,26433,56212,68,48,73215,29756,43459
75858acd31fba0cd82dd4b8472008c9c,93,83,152505,28279,124226,124,90,185716,24480,161236
89796032122eb74ade041cd996f381b4,46,41,50249,12269,37980,32,22,18600,9135,9465
f3dfe34e54c3a6bf75a975dadc928341,178,124,510215,112363,397852,172,119,476230,150197,326033
b687b16b91c844826d76ff2328e41736,80,69,173934,57093,116841,114,97,237768,55304,182464
602d6d23211684a60bbbb27f14516b68,92,70,146292,45016,101276,89,70,151979,46220,105759
da51cd95ed605c3cb5c0fd170a373d38,213,141,631277,104702,526575,136,96,504206,98863,405343
6528a06a16a69d0fe38e3d488d645783,139,110,249217,50856,198361,108,78,201145,37626,163519
57b9f87e302091eef42f493bf47c6b1a,83,63,102860,30812,72048,95,73,153432,30951,122481
b680473163b29a978390a61c8aecb575,95,60,190366,43813,146553,128,97,289035,49836,239199
52990df27ac3fe7f1cd732cff329783d,28,21,25704,6944,18760,32,24,20033,10696,9337
9ebdf4b2e53611509cee302e81609a46,70,62,113971,35930,78041,85,63,131350,36234,95116
da4783229928c081943c5eb00e61350e,130,85,280176,61919,218257,139,109,252454,84215,168239
189ee9c5bfbd9387dae9414958d79e0c,156,116,467394,90332,377062,135,93,442732,117385,325347
bec335c102f317ebc7aa96957393d619,19,16,3484,2118,1366,20,17,4257,2322,1935
8885e16c3792d3f484994dffa0524afc,117,80,275319,88850,186469,146,109,341492,63811,277681
38b5906b5f1af19814a2ec34fcd5e377,36,31,20584,12683,7901,31,26,22384,6451,15933
09150a588bf68fcaab943e18dcdc90ce,66,46,60962,30535,30427,64,46,73307,19147,54160
61f8557fbb43a543ffa52e5fd994a391,56,36,63320,17680,45640,56,43,51441,22699,28742
051eb2a81ee7901726010d5394744c01,182,123,565592,82674,482918,137,104,417661,68354,349307
a057c3d0895b6d3d5a3feb04b53056c3,31,25,15135,4956,10179,35,27,13699,3954,9745
4114a6a5c45259a863dfcf05e50cca7a,191,120,820308,190782,629526,207,181,960414,241367,719047
e50f99e825d9db963d8a9f8720a0d9b7,25,24,19142,8002,11140,36,30,30454,7511,22943
5c14a25b2295b4a1d71c40afdeb84400,116,93,299524,78397,221127,175,136,563068,83188,479880
c5734a0455a3b03a5614325811f12cb6,35,27,27918,10260,17658,40,31,38465,11677,26788
e5eaa61fcc5135e513f31f17ce173860,89,73,175847,35394,140453,67,55,99932,22173,77759
b9905379494774466b076f7facaae253,91,66,141162,32287,108875,81,72,143721,46723,96998
da46739dd0ec288a10048a77d6622865,11,9,2640,1017,1623,10,9,2854,839,2015
6ed8c7a851090beda929bcff45fd345f,128,97,301026,102919,198107,116,80,347080,74177,272903
283538980a1e9488eb439236761feb42,21,22,6370,5386,984,24,19,7032,3903,3129
dfa51140a01aac2d562bc13582c1051a,83,61,143525,46162,97363,84,51,127795,27027,100768
23212749aa9dbee76b9bb7868bedda0c,32,19,20479,7372,13107,27,19,17266,11521,5745
cfb92d8e7ed904bc173796009f846bfc,93,67,164091,34824,129267,98,81,134139,41931,92208
9fd5356cbfb9929822bb2190ff6d9a8f,151,119,317874,81903,235971,92,59,176985,40983,136002
41c3185516ea93a82aaaec0f8d869b85,12,9,3114,1062,2052,16,7,2936,1093,1843
2986dc2fcee2d27b61cbade3c9cc1363,139,104,328461,63052,265409,147,111,353690,68842,284848
f525ba7874151b45d808ef3aabfe58f3,104,71,194340,61225,133115,102,95,215391,66709,148682
5e5c696f0e613d64f668b61065fdba8a,33,29,19268,10605,8663,44,44,20608,11822,8786
5e903e5479718e0cb8a5834f36dcb635,69,44,73511,20827,52684,63,51,80947,18665,62282
9d594a830e4ba65c1d0481bbc465af9b,189,138,882916,179613,703303,224,173,1065931,206455,859476
8601455cd34eee9d07fb10ec4efd741c,73,68,137497,32064,105433,68,52,76418,49724,26694
81371fd163616f1b16a4e288764e17e8,97,78,171175,58203,112972,99,81,206323,46644,159679
4ee99924e206b555daabf1e17aa604eb,26,20,14197,7813,6384,27,21,17860,6168,11692
5c664efc52c1602beddc09fa3284b8a4,29,20,12839,5834,7005,24,18,10530,5787,4743
0c54199bb10dc87926b906dc1f0635d8,158,97,320430,50564,269866,124,104,303584,77085,226499
0156cbc51aaab09e06d312c51daa2f8d,93,81,165307,34081,131226,60,53,110118,34191,75927
731875c7a719e92fbc85a201b4aef023,101,83,208263,76714,131549,138,112,351935,68715,283220
4b05c30260c05701379f1f97f9e020e9,150,121,382628,109243,273385,168,112,424818,67817,357001
d271b8c41a13d8a43b328edaa08176d0,42,28,50627,14418,36209,42,30,44897,14183,30714
213b0a64218b3d41c9538836651c78c9,27,21,24910,10437,14473,38,23,31507,9434,22073
cdf664cec3d9228ac56d8a09e1de4e65,139,107,317497,48149,269348,112,97,253358,63453,189905
423fbc56bbeb54287dc10f4883fd8dfc,59,51,69865,34107,35758,58,50,114119,24062,90057
ab1de2224b7046f27d533108123b42a7,92,66,152921,38352,114569,88,67,144591,43324,101267
df36f74058006926f97eebd0b375b489,38,27,47679,17552,30127,44,27,50048,16895,33153
cdb1a3f117bba90ab1c6311e284ed613,93,81,171508,39502,132006,95,76,187799,47368,140431
4a1b3756f15e7e9a8fdab8e5f7894bb2,48,44,50821,23822,26999,38,25,39565,9218,30347
d54f0f4826517b4ceca9716301903024,97,76,137069,41091,95978,78,63,114250,29010,85240
fe15d6f621551cad855ca1e9d59c9d51,103,83,249983,55917,194066,76,62,167609,52180,115429
ca72e6f9306ba0b2bf5f439400356280,92,68,243446,53225,190221,103,95,243269,72023,171246
e800718cacf4c4837e7f63d3fc323d52,133,104,207189,52142,155047,118,85,229542,46156,183386
d902a3b8a0138c01310bfccfb3e86908,20,19,6835,5895,940,28,15,12730,3406,9324
ae93d4dd936604ec8668eb099ebc4be3,103,54,166346,36412,129934,98,67,171466,42396,129070
ebfb09d33d01dfa555ddb3ed18bef24e,127,95,261029,49920,211109,117,90,217402,39545,177857
0df5be4b1c436d143373c312bb250a38,121,98,244124,65980,178144,134,93,227624,51218,176406
c4306f0390ed5d7715b13db78478c5eb,60,42,45933,18745,27188,42,35,49469,18281,31188
e7895ea1a1a7def08cb7043831a18767,23,17,10229,4133,6096,33,28,16561,6686,9875
68a598515a8f0cd1a240539b94a7b0ad,104,77,164028,32424,131604,56,45,99985,30369,69616
b0fe149f06ef951c80a4d6f316e43639,65,47,107499,32422,75077,87,66,189529,36086,153443
2eeebcc853963794b01053ebe8bcb988,81,69,139284,54110,85174,76,59,153359,44756,108603
fe113ad4b6cafb45d341fa79d70b153a,27,23,13292,4848,8444,28,18,14769,4214,10555
247de489f27447dc37ad628714c710e9,113,99,268577,49185,219392,104,86,226535,63921,162614
b7ca60ac88bdebb851a10a63af625656,98,68,211478,67196,144282,121,94,266892,76624,190268
1e7b6a3586bf8132bd7091b71aa5ed3e,143,94,509970,118030,391940,135,102,384919,173072,211847
40cbce6001b44cc835ecf06d90b37425,136,103,600795,136697,464098,181,125,502754,113376,389378
74ca20ef244cfccb616de748512fc0d6,88,61,138713,44797,93916,119,95,232667,34380,198287
7cf3c1375f8db2811408db981aecdcff,38,31,36449,12340,24109,46,25,30660,14734,15926
e6488782c0f6dce4a55ea173eb22c1d4,60,48,79063,39090,39973,67,59,106663,39632,67031
abc10f38134b9ea7b18edb92f5c5a026,28,19,14480,4953,9527,27,25,14414,5276,9138
3c7354e75ab4c52672988f4fba288d63,123,80,368472,86215,282257,151,137,409192,92409,316783
69a9cdb10232263d8d3103f91b7171a4,151,111,339185,68478,270707,167,134,409431,71606,337825
e76e84ae75cabc855b12d2183fd23f71,99,87,188192,44200,143992,100,78,171364,56570,114794
f4c8e5b3b015b0e53f4dd40b4420ae71,58,29,86389,13228,73161,55,56,42438,32184,10254
597b960119821a15f5e9c2c12954d96f,99,82,241291,71658,169633,135,101,251547,57220,194327
cb590eb3a8e3a334d917735efe613019,20,17,4751,1989,2762,20,10,4824,1171,3653
1eb132c60df2d03a59be39eda7bf9179,64,48,60116,16704,43412,86,62,96007,22731,73276
43517a77b000126c9bd8867b3db25088,144,107,459815,120685,339130,151,124,506849,140740,366109
a3d5557a97dced0db17f87c657887463,104,64,312734,92461,220273,130,79,312803,95511,217292
a9adf818abf5ebc9b75b998f54708e9b,115,93,223625,35869,187756,118,86,204021,50126,153895
ce4a4edc562ff57c428e521fe5a4c4eb,32,22,18173,8315,9858,25,22,21942,7370,14572
8ce5b9c74246609fd60d4ed1d2062766,63,46,113589,31194,82395,69,50,139463,34462,105001
6c24172f6b6355716e4fc47d8ddb8f5c,122,107,285086,69165,215921,149,123,407201,64000,343201
febc69b709a5f56abe4420e70025b3ea,21,18,8140,2583,5557,17,12,7949,2183,5766
e2990c1375b80000290a596905b4d3ef,46,36,80144,24082,56062,47,34,64553,29673,34880
e9212ffbf30d69c466bf2296e447b66e,68,53,102313,34388,67925,68,58,130853,26559,104294
e93737bfef22f4f5a8d89dd066822faa,46,36,60469,11200,49269,40,30,26002,11314,14688
8a47b03c7e55e32a888a57d6b89f9bef,124,111,256726,60559,196167,127,102,231615,61131,170484
f64c015c964f2e19aaac42ccc72ba6b4,141,84,450107,82448,367659,164,129,391625,84719,306906
da86f6057ef2b494a7c47624471dee5e,64,45,60456,14472,45984,40,33,46388,11307,35081
4be2313869be90fbcdce381c2b20536d,68,52,100596,26535,74061,84,83,116728,31929,84799
195875d0c4eea320a3d44e9d0cdad9f2,108,88,272965,66135,206830,104,88,244120,82446,161674
8e0ad8cbcf5a87c451e5e1e07596c443,63,47,105160,28293,76867,65,47,77555,35811,41744
4976034c366cbb5b9d212f3227586867,89,59,165292,30995,134297,58,57,124832,42794,82038
c054ef040fc24b22050b7b49bee0436b,53,39,74240,25247,48993,65,66,99687,32994,66693
8ecf4a02c723a1c615478c0ecb81fd9a,23,15,6179,4352,1827,20,16,8845,2347,6498
51d3c3d95ea37e17de66a717329419bf,93,71,190486,33480,157006,89,69,135010,34953,100057
2ed475b5a4b6588b83f4a71b25aef79b,74,60,128222,44072,84150,93,77,182447,41175,141272
421ff3eecd8751e59d2a72f7e52e39c7,167,112,400211,78659,321552,137,102,383657,76103,307554
51f4b36061a37314ece42f9a6d64ef56,99,78,204380,38715,165665,121,105,289497,49331,240166
446d8038acd21fccfc4f05a9b82702c1,22,15,4590,2663,1927,23,22,5813,3427,2386
1a8f9d10fd73213b8f27f6dca9c297fe,104,52,212597,62338,150259,140,85,248846,88248,160598
4660499b32d71ee3ba52933cacddd540,44,38,57254,14538,42716,59,49,56932,23467,33465
ff65a228bc5609847c5f9814a935fe21,96,54,83796,27781,56015,56,57,81751,40757,40994
2a20576431606bb52adbd2c0ae79b0bd,122,76,437222,128701,308521,160,120,479605,203538,276067
0b774a68ae8e9c5a9501923db1ff1774,16,14,4506,1447,3059,15,9,4137,883,3254
d2b4f4879988a24ed6d6db1e83ad3fdf,15,10,2380,977,1403,18,12,2564,1346,1218
87269c5c3dddaae5ba973ce280d41b4e,42,20,37732,6249,31483,44,38,43314,10901,32413
618723186a6b6da7108cbfd00d6bfed3,174,130,537805,94391,443414,186,136,476038,89960,386078
6518f9bf80c1b766d7d32b23411631c0,145,130,375586,100806,274780,120,95,303951,67114,236837
a2e2dd6771d98b79686de2111ce1168e,92,63,182923,33549,149374,75,66,168384,40418,127966
159f19776d9fde08185138f7143309fd,104,79,218579,40910,177669,103,82,208111,48419,159692
c752f3d570895ab59a6d22afab5a7f3b,77,51,122920,29128,93792,69,47,124316,31072,93244
23ac1e1e6c619d20bafe8c9476d949e8,49,36,44510,13385,31125,48,42,35884,14990,20894
4f8cb453038984b9d5ff1b7ccc1da6f1,112,89,227547,44497,183050,107,81,182176,57299,124877
d544632fba5fc46eecedd2acedd12c4c,5,5,525,645,-120,5,7,775,547,228
e82ed76e04b1cb61b24e6269110244d5,123,94,274235,52612,221623,124,103,350957,44756,306201
89b8c989a1590814968d571cda7e6635,37,30,29446,13666,15780,38,24,24708,13353,11355
084b7730dbb8881ac83eb1ccf6a50597,90,74,131861,33952,97909,49,53,89948,25910,64038
ff0e0cb14bcac52c3da5463cdec041de,49,36,65804,21769,44035,46,34,63280,15109,48171
4f45a97186efc5497c6f48809e8f67ac,17,15,3286,1841,1445,15,15,2622,1471,1151
54a674594a421c1ecba8791dbeaa3adf,38,31,37807,16428,21379,42,40,57194,21064,36130
6526368455c270a44b4f776e31c9ad53,180,156,568375,101560,466815,170,137,721813,85067,636746
4e60b784bc47e817ddcd1ced1c7c23b9,21,16,5036,3485,1551,22,16,4726,2954,1772
f8389c6c21513a354bda24a4d49e553f,88,71,122887,22167,100720,73,57,73540,31469,42071
590d09973d765e26141d403113733adb,212,144,660849,107844,553005,155,117,485382,117736,367646
103e3d0d37ecc865e781a5898ee4a755,90,79,185402,51101,134301,100,76,193084,52994,140090
8b58306ef4565dd6032c477280483ff0,156,101,257056,64197,192859,147,114,318252,65016,253236
cac808e75c784166c6a45ed81c5bc8d7,34,25,29051,14496,14555,38,29,28840,10785,18055
01b9bd54edffec19916cca03086eeda6,69,61,70288,31207,39081,58,57,87653,26636,61017
e8b291ebbaea157e43143a2aca863c33,99,76,156773,24341,132432,70,65,93774,36013,57761
2c383ca53e322a055911132b14b58f5a,147,110,292246,43074,249172,119,106,232273,53688,178585
41deda0dbbe94727f55370dc2cd717be,35,34,17909,7533,10376,36,24,16687,8306,8381
db854d80e6e2c40b2841d471c5857493,5,7,486,667,-181,9,7,1182,483,699
e1ed4e80e93257c6e1b14cb1caf50aa7,139,113,306761,61585,245176,116,94,243495,62611,180884
47bbbf616af8294351f9839f5feba566,162,120,624893,113709,511184,199,130,684234,93733,590501
59ebcfb8bac3b9ca348e84531ed2dae1,73,62,142081,40986,101095,65,48,123669,28399,95270
33d84f32143aebdecf0ae0737c3ab0b6,47,35,40333,21652,18681,35,34,58960,17830,41130
1a9418bb9ab22ce100b81ee79efa87ee,68,57,91077,25490,65587,87,78,146002,38151,107851
2ff7274e9fccb45356b729ebbd8ebc05,70,60,76670,20775,55895,64,42,106859,17556,89303
5fa9f2f2e2f4d97a45e7d0839f509d92,34,24,33121,9563,23558,36,29,33997,10375,23622
994220eed6153c738a1677d6e1c56cb8,21,20,10622,3678,6944,25,18,7047,3088,3959
4acb26495cbe635bcbe0807951d570c4,115,110,308834,53169,255665,138,113,358024,62550,295474
b435d31b849be4bc830771c13c659002,73,62,110659,37270,73389,80,54,131141,28613,102528
0d8fb951566c8ec9c9ab2085c307cc79,203,153,572250,95964,476286,133,101,346622,91755,254867
cf883f4aa1d8dc35aa7c5dc8af889c1a,132,103,206532,56587,149945,117,76,225843,49483,176360
6c60edd9788f2e024b28634b1f2e232f,71,57,95212,37955,57257,73,58,92496,24941,67555
94da014f360237cf1ca6c015bf084b6f,157,122,384554,101842,282712,175,145,473829,96502,377327
b0c5f899510b1a106531da2f754fe7ee,154,122,408685,100106,308579,107,75,297939,65230,232709
a72704abe98fbcaf38bdbfd4e355c499,39,31,44784,17526,27258,48,31,51130,17785,33345
f0353e503e0b12e7ba223398bb97b3d1,31,20,18180,2823,15357,34,18,14153,3649,10504
f2092809d971821355f2da79941070a2,76,61,105806,24428,81378,80,66,106758,30203,76555
dfc718f3fd738368d2319ea159b50f92,65,59,82124,21161,60963,58,41,54060,21498,32562
7e1b990de91f845421cc7bdb4cba81a8,86,63,132543,26332,106211,93,84,111770,43045,68725
d319fbae5e4bd59becdd10ac278330aa,184,130,825301,234890,590411,169,133,860392,173764,686628
1e9bd872f3a5ed17a34e237a1c2458e9,29,25,13359,4427,8932,33,28,12758,5302,7456
24b81986262996ae353630e4a86f781d,107,82,206986,46823,160163,101,85,216673,48514,168159
32ee4cdcf8380afa11ab09401b756855,52,46,105623,36557,69066,64,45,124248,36048,88200
659a1cedc836583130dbe45f74eea5df,111,91,228506,51269,177237,110,93,220961,59211,161750
db17fba264bd7491168a8c66b60db854,19,15,3888,3202,686,21,16,4370,2505,1865
2f57f4f51d0c0ca8794ff9ee2882b33d,153,96,369922,105802,264120,154,92,530204,91597,438607
4732f13ec482814a7099d77814dae58a,129,101,358104,90278,267826,179,133,403305,73688,329617
6f580da3de1829f8f8910b21c35fc6ce,121,104,348746,90645,258101,141,108,409157,80540,328617
62163edee7a42fee60351eae97e14a6d,107,93,275526,70024,205502,143,103,403103,72643,330460
8168dc45da3a692ab6d70533f60228e5,108,69,225301,63293,162008,172,104,466618,54833,411785
bf05b37c9daa7622b057c0e772b0e24f,25,19,18791,9211,9580,34,22,27877,9515,18362
43a262c8db82909b8b9e21db8b2c3b7d,96,71,157874,37047,120827,69,60,117437,30749,86688
f13a7630d00fce19992ab5c50952623e,74,48,122886,31394,91492,107,87,165488,43079,122409
57fd6373600372c451e339c7e44bdb19,47,31,37540,7413,30127,34,28,30120,10972,19148
e6febab25593b4a02e478f946e0db264,31,23,24313,9130,15183,42,32,24376,12372,12004
cc87f3e15857ffb09183e8b3b58f42de,87,53,124158,35336,88822,91,67,144784,37428,107356
35612061c97634d4ad67b0c9063ad8e0,71,66,173781,59084,114697,70,66,180813,47671,133142
aca457a9c6c372191023342e19ddb53b,118,77,249126,83961,165165,116,100,316973,77364,239609
36af92fdde6bf5a09f5378323266b69b,45,37,96630,31516,65114,48,30,75028,33413,41615
c36bc21bdf5a03df07d042a2c6c621ad,77,54,103242,38303,64939,85,70,131261,31910,99351
1167cdbf0bab267f74cc1a21587bc013,22,16,9467,3515,5952,16,15,6698,4167,2531
ec0ba527d53a4c350e5cc782b1a0d4c3,121,96,381844,58213,323631,147,92,461692,52762,408930
d682e4bd75f7e3e23d036521f602e18a,83,72,138939,42452,96487,77,71,117964,51263,66701
05ce2ee9409a914f94e05c340007e978,114,79,278004,50026,227978,138,105,298160,73189,224971
05dcdef7e0c5fe013d0b13c48d4b06da,149,104,443222,93273,349949,142,97,451291,103730,347561
cfe32062185347dc3becaa555f219802,128,98,257072,63207,193865,73,59,131294,59964,71330
656d2b75f7fcea0cee1ae05f8177b8b4,76,60,138150,41365,96785,75,62,178947,39536,139411
c453c29db1f556a1eb0df2a3ee134739,34,26,51921,11718,40203,40,23,34031,16120,17911
8ca44779096e40db08f0bde2a397f211,73,64,86565,29909,56656,72,52,96385,18847,77538
5a0d12cebe23cb404214ee2df28df99e,145,97,353883,76835,277048,136,98,329549,95719,233830
19b0683580296813cd1154405e05cac4,40,24,55402,23363,32039,43,39,63288,31086,32202
896ae9016c90ecc4e770c55e695fafd3,23,16,5719,1644,4075,23,15,6890,2363,4527
c9c0f399211c4c10546e3b9bd3d52335,39,36,42131,14482,27649,38,35,34115,17764,16351
77a0efd851f663cfb51e342035a9d857,30,22,16892,5438,11454,20,20,9383,3265,6118
1d7f2f435c8ab0ffa2f8443ff4648280,75,51,145276,29164,116112,56,39,81548,25447,56101
0c8bb6b3d025d128d399ffb2e58b6f27,165,137,583185,106669,476516,177,127,464834,122560,342274
5eb2a86ae8557c68ae0ba8b2ba34c317,44,37,35097,12437,22660,49,46,55414,14663,40751
8ced4863f254556b0da52b443f554e25,115,96,200622,52608,148014,148,116,268159,54993,213166
d04343a31fe7d82928a7f4c77fa8dcaf,21,18,10419,5215,5204,26,19,11128,4904,6224
fed3eeed40b39ac5f93c3b989064c289,48,42,74286,22889,51397,42,36,49353,23483,25870
5695c19a5bf120468430ab98a75c116d,103,88,233847,64397,169450,125,78,226016,62505,163511
66a3a6cd1f04d9f58e9488221761d02f,105,81,267935,52020,215915,137,116,327100,61081,266019
783c76bb1544c2db89c974caf9ff71e7,170,126,560493,97395,463098,139,116,366661,106731,259930
1949ef2fb978da2593ef08c2ac17c8b6,20,20,7590,3479,4111,24,17,5715,3812,1903
fda24cb4fd02958786b238f6b1d10a6b,152,140,449489,103841,345648,137,112,366422,77353,289069
9b5dcd2f531f54727a8e80a81f5e00e3,161,120,475147,142878,332269,160,130,534850,121912,412938
f03cf644dcc60f6d4cdc8b2000399a1e,104,87,248199,78166,170033,91,75,184768,67770,116998
3ebe7457d156c4f768ac14dc2e2f6783,140,98,353193,62419,290774,111,81,223217,60360,162857
01abc22217e458a9001236ebf681ac3f,130,117,430450,93587,336863,135,111,404698,88055,316643
1da617cef90f64742d2541b9d006c786,9,8,1709,672,1037,12,7,2137,866,1271
ef6afd79f0868d80b95cf033004b9d72,155,136,571910,137500,434410,177,134,557427,136720,420707
f3170c59e8f690ef760b57c44e0b55c0,3,0,540,0,540,0,0,0,0,0
7142792419a87028d17b4aae634db75c,57,41,63914,16318,47596,43,29,50773,10764,40009
e2bbf09b49dc953a0dde32854c2c1df2,30,29,31461,9357,22104,31,24,23482,10089,13393
548b40e369b10c41c36281b1035cc97f,46,36,59121,23876,35245,63,46,83190,24073,59117
86efd2b9b8245d36837a8fcb4b095094,57,51,100995,33752,67243,39,35,49616,30753,18863
278f265296f211310adfe913abf3ba10,161,114,344429,60000,284429,133,95,248931,81641,167290
87507d9a4a4b4a89108977e0b4dcf4a7,21,17,12478,5660,6818,21,20,13933,5290,8643
d45b7226ca193001c984897ebee71554,74,57,110560,43025,67535,77,58,108438,34185,74253
3e0aaf7041933ac89148717e85cd4435,147,111,361758,58317,303441,91,78,161870,69093,92777
3f04bf2471160a4f0c3a3326c38ed6c0,158,132,461013,70288,390725,123,102,269611,96368,173243
d7295d05b69df601aa2c3a2aa1909b31,23,23,12298,5713,6585,28,23,16150,6627,9523
9e63f57424e3eeb476291c85323e2a04,92,73,219054,60600,158454,112,98,232403,60025,172378
95de2e4262c713caaab3379f2d4475fd,168,147,753075,151250,601825,179,132,620373,188020,432353
26ec8caaa27c9f50e75588f25314e4a6,34,31,26518,15119,11399,41,29,26932,13262,13670
d22741bdaff79345152a3890a6f6d213,115,103,270407,70985,199422,98,77,248666,48056,200610
a50f4bedac5e78608b0a48bd12af1b73,131,113,477691,95712,381979,136,111,430395,72605,357790
c6c1d07a2e5e5d7df6a2091a4ce9b5a4,25,15,9969,2707,7262,22,18,9979,3028,6951
bbefb7e43d3b5fd9e552b6289a109d9a,42,30,32129,11609,20520,43,39,32433,12229,20204
e706bf40d5679b02a5f93002617ebebc,28,24,19784,5461,14323,30,21,15634,6910,8724
0a25db12b159663eb9d71a780ca7ecd8,191,123,482913,128520,354393,123,83,378009,112762,265247
a606b0910087766030389914a6632dbc,56,55,123427,35075,88352,90,61,171480,30224,141256
686b5d56b247fff2cc16e7948c4f6b0d,32,24,18592,9578,9014,30,24,18262,8691,9571
06f326cf1ef53121c2dd5a4bcb905864,105,89,264568,72316,192252,108,99,232446,67415,165031
cf3a29755dc19fd028395e2ad0855c85,24,23,18609,7216,11393,34,24,19823,7113,12710
69dba99ef40cb570e6540d6212949eb9,63,54,81532,35075,46457,95,83,142427,29048,113379
a34813248b0842a6fc27425ac5d22196,16,19,5714,2227,3487,22,15,5756,1405,4351
5888752b85f2f10bcc8ac11a4fab6d6a,93,77,132199,25904,106295,88,83,130216,29045,101171
759d8bef219eb8f12e8b9152adc4dfa3,114,88,204878,38866,166012,112,93,162376,49420,112956
cabb08857e314e49e861663d26a31249,126,104,265528,64002,201526,136,105,261644,65348,196296
754d8b1f8efa99e88d3abf6b9510218a,27,22,10137,3147,6990,28,22,6631,4382,2249
e448755b5f3e695bbf922b8839d2b53d,69,60,139422,43336,96086,100,90,182222,46506,135716
3abca0b4b3305bc574a1991d11bfb279,56,42,66026,19348,46678,72,62,98418,23484,74934
364d23855839938399374c4e80639bbf,135,106,337137,81083,256054,136,107,387371,81336,306035
109555f31cdb2c91acdf96e9b1fd90b5,29,26,21916,8627,13289,33,25,25378,9249,16129
240fcc962e64ea2aa516716c55729631,148,95,517564,102426,415138,215,142,665425,104583,560842
3180f50a0b12a318e72e12d9889c2958,189,135,689488,94760,594728,184,150,669624,90159,579465
5ab25d07dcb4829c0714c5e3a0567079,56,40,86423,15936,70487,50,49,59850,31733,28117
7d221d96ce5082384eb8150832c7c85b,88,82,173210,37484,135726,97,59,151323,20512,130811
84430cbe45ab16a3fe76f63558f2502b,61,49,71139,21308,49831,54,46,67614,20758,46856
73523a210edb3c7f026bd03b8566b926,69,49,111084,36409,74675,117,91,234179,36652,197527
9027f0577f0f8b96bb98d450baf6950c,32,25,26764,11015,15749,41,33,25791,11472,14319
7a05888921ca894ce9928dbee7279b9a,35,29,27090,7588,19502,46,28,46087,9097,36990
a1b20d36d86009591e3d6aa24db51d58,27,22,9626,3597,6029,23,18,5469,3625,1844
24e9f6c65b89692332a1987beac4df52,158,122,612649,135137,477512,184,137,832964,134564,698400
8c12a44fba888f0fbfa9e712b1d07fc6,176,128,561385,149350,412035,174,141,576624,114406,462218
9711f0067792e34ba6378dd669e64b44,78,59,99031,32826,66205,70,59,87516,34262,53254
6f660d48f8ec09a238dfd30c48b655c0,62,47,105130,24595,80535,51,43,67193,30355,36838
e3d3480fd177e53aeaf094cb7c50fdd9,87,72,183574,40053,143521,97,76,222016,33358,188658
cda960fd9e4df809b228d7f2f2e81ff6,36,28,43436,16370,27066,43,30,28715,16313,12402
662e281d18995aa0c7393ae93411284d,172,140,786698,129803,656895,181,142,679434,134673,544761
9ece319ea662c49480e4bdd8d31a734f,37,22,26467,9874,16593,34,25,25942,7226,18716
55c5bf2642be16cdecb96b0ee4611bfe,137,110,258241,47283,210958,112,90,245140,51417,193723
eaa7845648666e4173538d19bfd803ac,129,95,228574,53687,174887,114,83,183374,65760,117614
a0fde775fafb2f1eb06d5c0560533882,33,23,28849,5786,23063,29,24,14684,7415,7269
5afaf91125cfc8051327168598d3f09d,17,14,4041,931,3110,16,14,4168,2051,2117
04b214ce3b4a7678bd83f5610cb09e44,160,133,471267,82332,388935,136,120,345078,68290,276788
3d4d1a27e383bdf52527de3e6f078671,102,85,184639,52476,132163,96,82,178929,58121,120808
d5c8c97a2b3e4a8084eabc9bbc2ca648,232,146,1150971,160226,990745,197,154,1442767,203699,1239068
e9688a4880c847c639e05e32c658b8b9,39,28,30824,7825,22999,37,32,34187,11986,22201
876d00915ebd00ca08423cd9956b3b9f,68,47,92404,22857,69547,105,86,180029,29466,150563
55efe6e5e8527e6675fe13a1a977ead2,13,12,1944,1979,-35,17,6,4260,637,3623
5a7f6af72353b2cae9dd3b898927ccbb,44,35,48289,15689,32600,71,59,54577,13638,40939
0c34f427f9494313267f290b6061fda4,28,25,36848,11908,24940,29,24,23642,13157,10485
3b5f903e23c9556f5a00cd17f79af923,172,144,750386,96176,654210,229,162,739984,156167,583817
5accd53999009e071f5e18396d8dfe0b,103,91,202890,45864,157026,105,89,228229,63542,164687
da4fac9ad46fae11e28d9b95e3aecebb,51,37,112636,51505,61131,85,68,173737,35069,138668
15c930aa69d63106d830683315720e30,131,94,242277,53099,189178,132,116,260968,61296,199672
d4b32eec71fb241d5cef2cc19abd4fcc,164,106,471214,112881,358333,146,117,438039,98520,339519
1c9fd27f58388b20f5a98132e5f98c4c,87,67,129175,40221,88954,110,82,217412,37711,179701
57eafc87a8101789da9fb99768e6e4ee,102,77,145906,36721,109185,118,79,172016,35666,136350
d411f7392f83f409f3517de81c6bf047,149,101,369638,88104,281534,175,123,445456,106622,338834
0732e4c004dbaeb93c818230b58a4273,123,103,300181,61488,238693,112,105,269245,75249,193996
0e10c9624243063b2c4ac02e2873e290,129,101,309864,65661,244203,103,84,190515,55949,134566
f53f6339963b730a032bf7e81f76a30c,31,25,16920,8347,8573,32,32,18603,8198,10405
ca51c081432e0a76fb8a347fbfb8b790,203,136,631749,112537,519212,157,121,490263,140410,349853
623dca3bab613dd376031dc877f49eef,42,38,40460,16193,24267,48,39,46139,15436,30703
5fd911b147570637150eba18eb0b2ee7,28,23,37706,7871,29835,28,24,19897,11695,8202
1034acf37799d8a497524eac13d182ad,74,65,150625,58501,92124,84,64,191301,51156,140145
fac6babc6f9e973de2c4b54045de0281,116,94,205253,73996,131257,132,103,290537,53360,237177
89afbf4ff8846ab850d57ddfc7f7f7ec,35,36,42123,16771,25352,43,31,34015,16681,17334
3bd1174f3a4053b8963dedac12e6b81e,39,36,34827,8589,26238,49,39,51645,13302,38343
628f7abfd32e4bb06c0ad43fb6b3b43d,80,64,134233,34353,99880,59,46,88874,27674,61200
a4c22f262002dd68835bd0351ea9a869,142,103,258757,28500,230257,124,107,216531,52404,164127
72b88de083625edce4e72df9e64268a3,56,52,51721,19283,32438,62,41,66673,13424,53249
4c5e1512664757cf59277375e17daaa4,49,33,43918,18540,25378,39,39,48211,17570,30641
6cb74e591e612064f0aa1fbe5141869b,42,25,56762,11883,44879,24,19,34770,15533,19237
bb2d597e6a3b5746054545ad2ff3694a,60,55,89995,34736,55259,86,68,128178,38405,89773
60a8593449a76fcdf4e017dc5acfa523,39,34,44575,19559,25016,55,46,85131,19539,65592
6a3a6067700c25a35081414c7a9be75d,33,20,18377,5882,12495,22,17,19673,4130,15543
fb84b6a2b7ebdf32fbb8f655a5e25b86,178,143,622182,106001,516181,161,103,476386,67151,409235
241ac42a9f9a39367ddf3f8f93b47285,167,103,669748,125684,544064,180,128,669681,103789,565892
5d6c0c862dd4483b30eb73fc3eb5f7dc,150,108,383037,80952,302085,131,103,392124,110251,281873
0c3b30126b1efbae4f9a7a5174feaf11,43,27,48168,14844,33324,36,28,35980,15241,20739
68e3268bb2e650eaf6555fbe4558e677,32,21,11356,5590,5766,35,23,26302,5737,20565
87b1512b968ef98e696406341b400273,144,108,331270,99438,231832,165,132,394888,145392,249496
ec72360a1ca5f980e234c0b8e15d83fe,134,96,363529,81271,282258,191,151,459770,89637,370133
64998818b44adc359a8ff02dae5d6453,138,119,386424,90023,296401,124,95,340743,92399,248344
f09a2ea4c194eee8ca51d5a0dc62901a,103,87,167725,48419,119306,104,85,165153,52693,112460
4cd5ec7f6bfe4989c90d5ca056a1fe27,86,60,85195,16408,68787,67,49,74615,14750,59865
cab27582ecff44abedf4372dc309933f,143,88,318660,66753,251907,135,83,349871,82991,266880
ee950a46db514a55c77239ae44981142,150,123,334183,66578,267605,125,101,367813,58683,309130
1296d344fc95b87e898c67e37c3c2f34,8,11,969,1498,-529,13,5,2392,486,1906
53eb287161f55bbbb6d3e884e6e3cedb,94,72,200361,41563,158798,139,127,323164,65085,258079
e94104cc2cc9c641dad9d7b02cc1a9eb,26,20,24154,8964,15190,24,22,26710,9576,17134
99912e65aeb9e54b5a56f28e2ab7f3eb,30,23,20797,7593,13204,39,34,30417,11994,18423
41f2da69fd43824a8a3ed865f1d4e7da,131,108,303059,94887,208172,142,107,308577,99208,209369
9602d952e14069e674b19b30c03e7711,69,57,83055,14433,68622,50,39,34173,14655,19518
b44199972ca73a409170431d5502aba0,64,49,55367,19862,35505,71,53,63719,20436,43283
ccd948f461ef761e9075aa787f3df2a0,128,101,360779,96165,264614,94,70,222603,81810,140793
c2aaa701da02870933dd37e864c36c4b,15,14,2835,1440,1395,19,10,4384,903,3481
c4cf99acaf977dba31db1698b46fba5f,58,41,76347,28505,47842,93,49,133496,34990,98506
3269b78708b48c632e7d31ff477096ae,53,40,109890,23239,86651,49,51,65822,26751,39071
72b4f09c4aeec5d5a69e0db163452ff4,134,104,679830,125406,554424,162,119,526892,121653,405239
0a39afe3372a5154dc06a022cd5013c6,185,149,929673,182629,747044,183,161,817426,227084,590342
4d212ff59b9c354607f6d3ff0525bc00,71,62,109097,29636,79461,56,53,104825,32367,72458
f071f853e4078fdab221ae0a7c823619,2,1,108,81,27,1,2,81,108,-27
280618544f5aecf325c3490e5e281029,144,95,317031,79607,237424,174,127,481085,89163,391922
1e7c06e7d74e3046deaf2a3807a946ab,146,118,392251,78485,313766,125,88,277375,65370,212005
9d42936c63a3921a4dc2182ed3e27510,46,29,42268,8649,33619,36,34,47364,20545,26819
ea15f7bfd6e034795b91d43e5f740541,179,122,615498,85262,530236,163,109,539449,88934,450515
78428701024404543f84a52d6dd696b1,66,59,150511,33657,116854,47,41,88602,41997,46605
183eb3713afec283344ea0615ad1f0a8,131,106,261307,58898,202409,126,104,281710,71048,210662
c834b82aabc3f87adc208d5554689f4f,92,81,181230,41001,140229,76,72,141102,35564,105538
f4e0201b156766cf6d63c762563ed825,116,97,231165,75675,155490,106,80,250486,75239,175247
da11d15bece20fb57b6e33cf9fb5b5b3,125,81,274516,57565,216951,129,99,241658,68903,172755
c1464526b4fc506673a38ec649e5af80,113,85,214285,94362,119923,135,113,303712,84162,219550
7eff3a41a4fe1074f211db5bf9526c9b,95,81,194160,56857,137303,77,59,139106,40185,98921
9884bac6e6350d06d2df11a644ce2ce5,50,38,56878,16926,39952,47,29,56813,12210,44603
1430d2d8b23f4c2f4cf3c9d7a9d22023,103,88,191437,41072,150365,72,61,128931,34055,94876
4304f1578f16fd4ec626736e09efac31,28,24,9432,4411,5021,32,22,9689,3952,5737
21681cc60a5020de25ecb70e40a22d3a,138,101,440295,145217,295078,171,139,630605,97628,532977
40a7d04211c073ef884d60ea400c4114,54,38,44714,24169,20545,76,44,95943,19308,76635
5a8297d0811b82c66548548b7cfeb4c0,98,81,166417,34557,131860,76,68,95652,30687,64965
015b8fc01fff943462b486f4a108f946,83,61,150751,34184,116567,87,58,118807,33317,85490
9ad0ba3be506e935c78a6b67250b6300,5,8,608,988,-380,8,5,988,608,380
a65b1eaf365b8bd7455160fc68351d1f,60,56,78468,20286,58182,36,26,43130,13424,29706
16788a4ccdc1fe11108a4cedd9f3b3bf,130,88,289190,59470,229720,156,103,508412,48695,459717
9f79bac2d15342f642dfa1a54de1de55,121,81,279018,83904,195114,89,66,247983,72443,175540
15b1e821624defa6a5cff30bbe53817a,67,54,81842,22580,59262,53,44,65563,17733,47830
f72f0dcd054b9c6b9e850c08412cbc8f,161,109,309711,64207,245504,101,75,195615,62130,133485
aef3d95601ff9681db19ead5ce3bd24e,76,44,127116,25719,101397,75,58,85894,36113,49781
11290e0361f82eedeedf0426179345dc,133,103,324756,43227,281529,116,95,242544,48327,194217
857a1a911d84cc92b858fc8d0088d151,83,60,120769,28219,92550,62,50,89283,30033,59250
ae4aa75f3b262d3d246a1afe4dee638a,138,94,258783,48504,210279,125,94,239248,48501,190747
7689f2d60d24d4fd8a960087c776b621,2,2,95,427,-332,2,2,427,95,332
6ad18aa2fa069eee0b0a61deda6a2877,112,88,202227,59047,143180,146,122,310753,63771,246982
1394d9d618d2567969dbe9644ff49552,50,41,71451,21885,49566,64,40,67098,20532,46566
dc78649c36227bf6eb70613576e2f332,56,39,45844,24134,21710,97,82,109627,30235,79392
909ae56ec3ab1f82fcbd73998b82f558,67,47,100670,26098,74572,73,63,124499,25764,98735
8d9124cb5e758b4561dd9777046077cb,150,106,334464,63064,271400,94,70,199915,54250,145665
4acabcfa1c2d102ee8c556f74b6a3fc0,3,2,308,105,203,2,3,105,308,-203
8f1ad59dce1c8db1c5fc8d84cf97a882,92,72,149009,35414,113595,106,81,177972,39443,138529
224c7b5a9a76ae20e2027ff786d9ed72,177,147,901764,148984,752780,235,146,942399,118907,823492
93166b9447bbb6dd3aa4b1a228878d07,85,80,108009,40776,67233,92,74,130040,34343,95697
650b7dafbbbcd920aa5aeb0c8e2bfb15,142,111,428367,122773,305594,187,121,520937,109462,411475
c55f720974ae17310bedf77416b6c808,118,88,761172,168533,592639,198,166,1019175,191364,827811
1b044bc203b1c0867bd31c272d3c2562,36,33,39531,16490,23041,52,37,42730,17893,24837
2dd2d2aa107c5744c0c6d537aad03d5a,54,41,72268,19652,52616,37,32,41879,21619,20260
adb889311f49e966e519cac429652dbc,183,102,441739,81127,360612,172,116,512402,91012,421390
483d6d67d5c13ff31e4871adb6d2f373,62,44,74458,26695,47763,69,51,87138,27591,59547
ecdc9480a7055a49e4ccae7ff74455f2,116,96,173391,40989,132402,154,131,310120,42338,267782
09c5f29d5ac1818a9161404a2c41e91c,49,37,58125,25598,32527,65,50,87836,18632,69204
83e55c9d22d5619ac3ed77677a139639,129,104,299849,48809,251040,109,86,194948,48582,146366
d0f1f589a46d860c14e4b8fc01cfa6fe,92,71,163629,31945,131684,78,73,118395,60935,57460
adff2f2a51edc99e7f9f05d64551179a,68,47,88986,24708,64278,62,53,88395,20769,67626
a5bba2df809da52fbb1862b781b46509,119,88,334640,90538,244102,125,96,319871,80330,239541
971d2b4bb13c29094808eea5c0d5cc5c,138,107,374967,62006,312961,172,138,438482,88496,349986
8c69dd90d5e95a84098aba247352d49f,179,141,769349,128191,641158,173,132,843257,166294,676963
7496706fb68eb1e5c722c1c5e5c55109,41,35,32098,11281,20817,38,28,32996,10356,22640
a5547f72635c89319d47abc401a7e933,78,68,124046,32049,91997,67,55,99001,31379,67622
e48da14d64a3ed6f6a7c8def768ed3d8,65,60,91295,26073,65222,63,49,83886,26716,57170
83cfc266cb9b913d3a86f1db9c0a8914,119,95,542481,135124,407357,143,106,464539,110410,354129
1e0cdbd581a39872afaba0c7df871996,63,55,110647,39470,71177,75,55,147918,37201,110717
991a75c0914702829c64317aa663ae07,122,81,270639,55109,215530,113,83,230271,75882,154389
e8bf239963baa3f499b2f132ba2cbe86,31,21,15996,4496,11500,23,22,14921,5374,9547
01e6c84e0b181e322ed889b0b907e427,53,34,56887,14240,42647,41,36,33450,19043,14407
18e73eb1548db415086755e2e81620b0,24,15,6729,5141,1588,23,22,20359,3382,16977
104f5f16051a1af1a632ac93a9db734a,34,28,35103,14081,21022,37,26,35318,16454,18864
28645ac4bc98b4f799c15bed79dbe783,155,107,729573,121508,608065,217,153,782041,115839,666202
06113cd00d94841278e4c7e8341bff30,75,65,151692,43553,108139,71,53,137552,35221,102331
0643fa1aae2b56bb1e9292b099bce22d,140,101,435534,81116,354418,169,135,634196,110102,524094
4401911d5f5ba1b866f6f206502893ed,162,125,409545,77263,332282,105,82,252652,86523,166129
4c5e533f0c39b49946ae09bc7c27ffd8,127,102,410585,106050,304535,161,104,440686,78204,362482
e3983b0ded50932accd66388a9258353,120,97,322968,58498,264470,130,105,255941,58944,196997
cbb0a2ea36c32ffceaf12a76901a0dd0,135,120,329947,73602,256345,145,107,325571,66023,259548
a69a66e89e0eb552ea26f07c5c36206c,156,120,457105,67976,389129,117,95,270547,94694,175853
e4c638c3b4d13be9d416ea9708cf256b,173,140,851840,141824,710016,186,115,579265,112166,467099
070e8fb07e01161d0d5014b9f4cb7385,87,73,163895,36455,127440,69,52,108682,38435,70247
c31c231f8075479d313adb11d515ee42,130,97,482787,113597,369190,130,99,305792,124323,181469
81fd6bc68745f73e0f7e1b0644dba01d,62,36,68233,18135,50098,50,41,74899,17988,56911
d244c1e7c8b3aeae8026a504648927b5,27,20,21261,4287,16974,25,17,14506,6222,8284
e94f5988b0c622821fa621e6091ce99e,37,28,25456,9827,15629,35,28,18151,6000,12151
7fa000f125d0e6dc4a780d2becbd78a1,133,109,277444,66143,211301,71,66,160662,51201,109461
c98b94fde38f64b147a67084e3371973,28,24,11307,7145,4162,23,23,8641,5452,3189
c52068d01ac337bdfc52c849f430b5b3,41,37,52104,22307,29797,48,41,49211,19728,29483
5d647d8e77329797a27b24ed42778dab,107,85,201611,78381,123230,116,75,239360,49456,189904
61c85ba7d01f91bcacf14a9452e1423b,46,38,73220,16884,56336,52,47,59572,25865,33707
0ee72c05343db195177adabb2fa2685b,98,66,186622,74511,112111,104,78,210472,92657,117815
1cd1635fb8d498c63243b08b4db2ae93,29,25,12410,5066,7344,25,18,10497,5002,5495
edcd8c3403101f7bbf47fcad1c6ac9b9,62,50,54969,30316,24653,70,52,91350,18599,72751
465264fb32bcb7952a68b42069fa783d,111,87,200445,36908,163537,102,73,197829,38761,159068
de56f5ef64da93a54ca62b92831cd9ae,8,11,1134,1031,103,13,6,1326,1093,233
227c60fedcea017cc3c867cd7af56b2b,89,68,122985,35117,87868,102,82,136587,39631,96956
50ad8147dabc6c4c1cbc57fa9564a62f,25,21,19740,6235,13505,31,30,25043,7898,17145
bed324743cd00aee78d789c2dfd371ed,43,25,14887,6217,8670,27,22,13377,5320,8057
89b7e94272550ee7aebd191aa90e6871,70,64,134494,57099,77395,108,88,220797,38728,182069
550d65f3691b832f88d1e34930693f21,51,43,64508,15928,48580,64,47,71300,24775,46525
c6600d1704cccf4859b538d4526a1f2d,105,89,361739,90144,271595,155,132,461952,84421,377531
7e1d4216f586f60d74211c7a1ae9ac93,42,30,52018,12119,39899,56,44,47886,20070,27816
187e38b26509dd30a446eee2660744b4,150,88,766166,152913,613253,221,172,1126957,156185,970772
7a4ad9afb3a6868f4d9f740221c7b123,110,94,288149,61490,226659,105,80,201153,63876,137277
8eb802e4821912e7071a7520251a250d,146,130,366820,86807,280013,127,97,291545,75754,215791
e70f1a0288dfbf067e3adc70c59cd519,162,123,454226,103559,350667,124,113,396315,93328,302987
afae3064de86b80b2ba0c3cc9503020d,81,62,124375,25870,98505,83,61,180011,30379,149632
eeeca0453c31ca9be426d0cc0ec28c18,106,75,217109,39159,177950,122,111,215681,42767,172914
6d0d23beaf2d33d0262475f5b463283c,237,165,738255,188842,549413,214,167,989182,184304,804878
36845cb531c438c2a9112991788a671d,163,113,556549,107954,448595,168,122,578879,112532,466347
23c9fea22f8f0af6e631e97b081a8e54,65,45,80581,25536,55045,50,41,61875,26169,35706
db7433ee2d1b0e5d0d3a1687c8aa3d2d,145,106,369074,49891,319183,123,105,263970,59246,204724
f4ddaaecb4b4ea942ac69f6eb7576227,202,159,790739,175396,615343,177,130,1204859,220986,983873
a7de465a6795f7d5e9ca8d294b539696,166,117,436453,108957,327496,196,125,731751,116593,615158
11a2c7eec4bf8202e2d4271e80c6af7a,93,84,129757,38798,90959,93,71,137474,26132,111342
30401f8c23a294671b205227c05b06f1,92,57,167471,29506,137965,77,57,104306,33257,71049
5b7936d53895c1812722f0b6591fbf6f,132,106,384240,104879,279361,160,131,418374,82582,335792
628890b431fcc5ecbeed23dc546d1815,25,19,6591,2775,3816,21,13,3774,2213,1561
7b98b487a5c89fc19d0e31dfdb671f93,89,80,198676,75095,123581,109,73,200002,49094,150908
c1af70948a9e33f080777dafc3570209,36,30,28941,7901,21040,41,21,33566,9255,24311
ab5e349c8741949460e2583140dc5dae,28,28,18803,8181,10622,38,28,22700,8673,14027
f7e1e85e4b77ed1f14020e9a6168aba2,38,30,35054,15346,19708,38,33,32756,16500,16256
db143fcdfa6e42a3f5a676c07827f77c,117,82,219286,100435,118851,132,108,373527,103426,270101
0591c0b2f330996c8ac871d689707bc6,61,42,61124,22705,38419,47,39,57062,22570,34492
1d415cffa71eba15a07d0472271fe258,16,11,2824,1104,1720,8,9,2096,1674,422
641b99af85ae75a34365465e99e41484,5,3,546,229,317,1,3,135,251,-116
3a9ae8abc355bed28661f76e2c8e6e90,87,71,164264,36119,128145,85,81,143655,34875,108780
0c81ff690403393611f06360d9449677,75,64,140716,42982,97734,80,70,125386,51090,74296
d7c994549441b8cbc7bcbe33e05e60f9,41,28,40610,14117,26493,29,28,28768,14563,14205
63bc225f5e5245baa8e6ed474d859fd9,137,106,456430,135805,320625,177,128,542766,131369,411397
c64f065af95030bd334e3834172e3976,176,119,365536,72250,293286,108,77,248996,83183,165813
b37a1b41229e347b0c763ca7b3be15e1,131,106,257796,48496,209300,97,75,164277,69709,94568
7654858f64238a1b56a2f14c98fda127,24,18,9664,2768,6896,25,20,13540,4089,9451
ea95549a64974210d6bc7669d08d58d7,112,84,260868,54451,206417,127,114,236135,80710,155425
b80743731ad0e37795370b29d93716f0,58,42,77898,16955,60943,42,31,50835,16383,34452
a9d0b7325ff2353ddea0f9ccc0e0bbc3,109,87,176604,31888,144716,91,63,124561,28487,96074
2d7e07629b4be459c874210bcc6bd450,57,48,75610,30911,44699,72,48,93321,27775,65546
0ff23ed3c1a17f4c774821b8307898c3,30,22,13775,8609,5166,25,27,21893,6820,15073
224471a3dcbb7c3a56e438393fc41332,38,27,37221,12030,25191,30,31,25037,14900,10137
5cde39aeeaf9440fe3d1870b5fdbdeed,78,71,170125,63423,106702,53,50,89821,44578,45243
affab4fb48cc259f1bca978d3119fbf4,41,33,35720,14044,21676,46,33,41731,15209,26522
798930213d16c6c2f0eeb703743b2411,21,14,5686,2038,3648,20,14,4451,2089,2362
68b36f8707cd9a5d262f1d4105bf7816,32,21,35359,16366,18993,39,24,47484,14820,32664
4c566f707a7f8e349936c5d4e3deea0d,45,33,60272,17230,43042,43,30,45581,18441,27140
4bab2ea86f618911f1869b0de9aaf7a3,165,122,528713,81438,447275,142,125,370701,91236,279465
72576ae04ba7478336c2acad10d73b38,113,85,190463,63431,127032,123,102,224479,53028,171451
5d8d68ca3d8a59a85ed435da8a94629b,64,48,69068,20751,48317,69,56,101354,21281,80073
9e284cb71e94f1e74cdb183a05ce0991,122,84,286574,54895,231679,116,103,287249,56618,230631
4c2f29bc28dc07cf46a19b880adca3ab,91,71,217103,79956,137147,139,112,354809,98962,255847
5dc5ae801bcd0669924a01c815ba2218,63,53,86379,37419,48960,71,63,113065,28827,84238
7dda84d6717c5a23264e1ba8ec731b00,146,108,683026,137683,545343,160,107,509489,134308,375181
9a565b501d06914ff1185c91d240a528,10,8,1553,536,1017,11,3,1806,199,1607
b1555407dbe9add39a8f4d3e03610bad,190,144,828993,157014,671979,183,121,632417,152831,479586
0cbdb9a150319f688d1c173acbfbfc83,50,47,117544,41301,76243,53,45,80323,30925,49398
29556aa9b24c488076bb1048bb4790de,135,111,357132,64807,292325,144,126,387632,89515,298117
4de63e7ecec84b439c7f091f2f82a219,149,118,472553,139804,332749,160,133,485448,116495,368953
7e80a15454b1a3ab7573fcbbd5e830da,189,160,710128,97111,613017,142,93,449402,100297,349105
efa527c4724145779a2c9e898c978466,143,119,444488,140531,303957,158,120,438781,95316,343465
e88cd35737778d84168ac7c337bd106d,118,93,285371,80564,204807,175,104,471067,74529,396538
72589ebe9a760c0cb32d7ff17094864e,129,101,312762,76818,235944,151,107,357245,56595,300650
1e82bd2b8492662d3e8395d0d5cf40ae,125,104,377498,98867,278631,134,115,321539,104978,216561
cbf08f56271b079769d6ddf98256f149,126,90,181668,44955,136713,117,94,210850,49852,160998
82f5540d2dd874b1b79d1d44b6130eff,22,18,7459,2503,4956,22,17,6871,2509,4362
0cbdbd0dc59764c651311aadd229ae2f,105,78,238544,99871,138673,122,104,345061,105043,240018
3167a6f585d19fe5da7583c9aa9ee786,193,142,745361,177591,567770,204,132,971112,146426,824686
1f819c223d6c5e7b38e1230071c2cff2,149,118,339019,67708,271311,135,99,322599,62429,260170
491d6320a701f0afda72bb15d1165e02,62,64,113317,36826,76491,122,85,168983,24877,144106
2e240c4ce84a0f5c0d668fe5ec150ab6,64,49,60105,23652,36453,50,46,64311,23778,40533
0fc868f09cb87d634fe1ced635ff4dd2,1,1,50,62,-12,2,2,77,65,12
a2847cc75295f3b2e0aefa2eeed86306,66,48,111874,34230,77644,58,38,71156,31521,39635
3730ce827bc145e24cd3eacba6f4d880,54,45,100133,51536,48597,87,65,178973,42178,136795
54acf0afd71065505d223f153c5f579c,128,101,271604,67209,204395,119,92,251313,54940,196373
e8b00dd08cbfd1512828914bc1312e1f,26,21,9852,4556,5296,24,25,11136,6736,4400
b119d61b36355e42627e3a8aa2531718,125,107,316570,54330,262240,117,88,206552,51491,155061
3f93783026c90a3b982be2e416950dfb,110,96,217682,38954,178728,102,78,139344,43827,95517
692f3b5e90c2f1cdf3ec7cf14d7c3fba,115,79,208832,42347,166485,91,69,174861,41905,132956
0292eb7f9995c917f7c367453154c59b,23,20,9474,4571,4903,29,18,9901,3518,6383
b49af46bb3caf1e97660be3494a34db3,31,23,16252,6014,10238,29,18,17139,4849,12290
1da47a30f20a6370c1256af52f9aaf1f,51,51,74230,32351,41879,56,49,63917,32407,31510
d92ab87451657006fc74b92c3e619f8f,174,121,506898,103880,403018,180,149,568596,154084,414512
3e8759441e3448bdb9ac92be1a67392a,189,123,531370,135113,396257,167,126,533671,130105,403566
62c05e89c7f91ae07f4e20242a806e79,116,96,229110,67793,161317,104,95,268203,63917,204286
d593ee8fe297696eb9c10d2498edd3d9,17,12,4245,2384,1861,16,8,3825,1876,1949
366a1bea36e1ee5f38eb08fefc4804f7,126,111,207845,60088,147757,82,71,117468,56352,61116
8e35a1637f8b907151ae190d1157cee8,19,17,3744,2085,1659,16,15,2643,1960,683
dc6c54e07085cb4786113a64ba1ee309,123,107,310444,88131,222313,167,119,378296,89505,288791
e07eac000834467898d992911ba87c2c,28,21,25263,10286,14977,25,22,22946,8614,14332
10bb42cece0ca0fbd30098905315e8a9,63,39,102985,20290,82695,96,75,120656,30576,90080
208bf82684a6435d5ba9ba1585e83e10,23,23,8231,4340,3891,35,18,14354,2746,11608
474eb8e04bd88649734de0d87b109df4,138,112,376989,59394,317595,119,103,237758,58176,179582
19b1fe5acf8d2d3adf0fcfab78b3096a,67,50,134605,39691,94914,63,45,115100,32616,82484
03e86e7f0d833383017179ef89b05ff9,21,19,8483,3149,5334,23,13,7205,1140,6065
786b7197e627fea8ad6e89a319c2e034,55,42,132335,29338,102997,55,45,83645,40274,43371
5678394fa3e0e9d16c50a4d571a0031e,170,129,468932,65298,403634,140,105,400467,71433,329034
908b9d2ad9a84e71b834d26d8105c01e,75,61,131238,31007,100231,71,56,86880,30274,56606
23b12873a2784cc46a5886895f49d6f2,51,38,53456,14802,38654,53,43,50073,20699,29374
5bda14aed88450af15ea52220506900c,37,29,23098,14857,8241,42,35,36172,9349,26823
9cbbc1f616cbe360670742df0e2eb12e,63,44,91844,23291,68553,60,53,71702,24638,47064
fca6b6f9d022febdc20ca2b2dac51680,131,93,423830,79509,344321,112,88,299969,78671,221298
1d50f748e38ef0b4311a5b2c5beb5d15,50,51,84496,28168,56328,62,47,80479,27730,52749
4a979b944aa24b18c3f8f98b3259dcd7,102,78,143954,40485,103469,76,71,130277,38546,91731
50da2b8a80a84b18dc6418bf402e7c1e,157,100,254148,80738,173410,123,96,249286,80152,169134
b7c942282807def16fb32d586d265ed5,83,69,134719,52563,82156,80,72,177369,37714,139655
343f50d53bc1be6539a5b77fcc3e0978,84,61,129350,33112,96238,71,69,86045,46476,39569
42852991c293564a1c541d4fa28b72a0,108,80,206988,53816,153172,143,119,290277,50204,240073
0255bb3a5fcd514fee4e5b6df791748c,111,65,237432,58725,178707,109,75,199743,65539,134204
5e925fa9278cee5930ea64120d7e5c4b,73,56,181900,51793,130107,79,61,155406,51456,103950
7c15fb4319d43135f6f376f8dd8d5953,28,23,30415,17669,12746,35,24,58390,10170,48220
0665d3051a4843b974299669d2970e5f,170,123,554289,88966,465323,153,121,751205,117395,633810
44bcf1f22d076abc7531fa8a3020bb3c,40,29,24181,13963,10218,34,26,42315,11297,31018
a873b2b101de08a4f7e972299a41cff6,100,80,167309,26454,140855,74,51,77855,21703,56152
9b57ff5be2863ad2a6e201ad24d0409a,20,18,7681,3722,3959,23,15,8980,2564,6416
0aeaffd45f5ed023b0089199e2f5bb03,26,21,11380,3963,7417,24,18,8314,5507,2807
0375de690e3f74b24d0f38015b76b183,47,32,49849,18380,31469,40,34,60522,23406,37116
098012b6edf66511692ea51f20dc29f6,186,144,663009,135080,527929,167,162,639018,130239,508779
c4968dbf7d8b612ed64f969e14af6df0,98,67,206132,61691,144441,128,106,280681,92660,188021
44eed2156b1e11e77167ea0851289f6d,109,71,355327,63833,291494,89,79,216513,81058,135455
366dedf44004214971442468d253ee2d,130,88,216917,40715,176202,81,62,106054,51454,54600
331fd781e3fa8b71f2d44b6e51584b00,37,28,20572,8764,11808,41,26,32758,6988,25770
60937f3d707bb65baf8296a644e6c34b,151,94,459007,94535,364472,165,129,545234,158651,386583
cbb7f3624ba7a12e8b1e193eed6914f7,174,123,515332,144483,370849,161,112,479429,111173,368256
98348c5c99aa056de32f7f1057204b72,159,113,640014,253041,386973,173,142,998284,201752,796532
38104e11528e791ef30fad9dde3d5141,102,77,210362,50913,159449,116,91,320004,64486,255518
6f94cbb0a58ec3721c7393a7a35f3e50,124,106,347580,112271,235309,123,91,392320,134553,257767
9b10536c06ab0e713e93a619359b93a0,77,55,133124,42380,90744,68,52,104153,44483,59670
9335d1fe4192e166680023814bbf6256,22,18,6309,1805,4504,23,16,4251,3994,257
d49a4f2a3fab26f7dba138509fe30a6f,142,120,388238,89520,298718,132,106,362434,72610,289824
a6fc2cb5a7957a543e32b22eade53f5f,164,101,585422,162594,422828,206,116,678242,149070,529172
6edeeaa11effccdae05c86fcb857d58c,74,52,125666,16733,108933,55,43,46111,24381,21730
f5b725b721c8cbc01bc65710ce219ddb,97,60,203634,59109,144525,104,86,178532,75840,102692
fae7e24284c4e6fa7f7a8f0188fdaf40,109,83,228117,48095,180022,104,79,211789,43647,168142
525ddbbd919226abf0aadcc7e559b901,61,60,108469,39987,68482,72,51,95952,38060,57892
011dc4e25b15d2619b0fef9d27b75cc8,69,48,75926,28459,47467,78,54,91542,20992,70550
e7ce7db8e5f3b20ed1566832c0eee783,25,21,13557,9525,4032,30,27,16494,8064,8430
5e8d91eb5b9742707a24e280d4b08dd0,58,51,66551,21513,45038,47,41,44119,19184,24935
c504c0fa4d771a3ffa16498793921cba,237,157,1060222,201411,858811,162,120,920653,174280,746373
9f63103c6d09e5f6ecf50b925824d8e4,96,76,195814,58012,137802,103,91,214415,53208,161207
2ee45c3f9977e3df8bbe73f7e5cfb6a6,157,137,601202,125050,476152,125,85,420277,91615,328662
129f32d9865d25435ac4263489fc259c,23,20,11814,3687,8127,29,18,13785,3811,9974
9ba8b7f3c1964429a3fc0d81c590299e,119,100,423641,97445,326196,145,125,457660,106608,351052
ec94c85f174d66cbceb9061e75075b6b,85,70,112902,26808,86094,83,65,107640,27635,80005
e95c32f7087b0f1cfaba256d5d4cef5b,191,159,770893,143715,627178,229,160,746324,110852,635472
b1f506a1ab1a67393afab9c138292aea,142,129,371176,79307,291869,108,91,248212,68992,179220
c6134e3042b21d554abbafb5de6f092e,49,28,35476,11798,23678,30,27,21374,10693,10681
d87af713a0a9e295e7e1098effbe3b33,58,39,47512,19203,28309,57,50,71051,17101,53950
6fb1f32a18f8bf24502b092c61dc0f85,44,29,44838,20034,24804,43,42,60762,22540,38222
727b3f6fae1423c537d46060b0e8e0be,95,81,149513,56448,93065,106,87,184397,41427,142970
2b237680b2fa091dc7cc2e44c292f31b,94,84,209401,43487,165914,76,61,130311,64315,65996
06788ddcf5c46e25d081d2ae83c1d4e4,34,30,60996,13204,47792,58,46,66790,23345,43445
4f7cd4bb6a45b9c3948c5813c6273309,152,119,782852,184928,597924,239,179,876293,210439,665854
27356dd7fbae85bcfd1ed09b230843c3,82,66,176464,47836,128628,128,104,223193,57400,165793
c306f44fd01f387f2cd1a870c9f9112a,113,89,187232,46604,140628,60,46,97535,41659,55876
f5030a5bac78289630f389182ea1f4a2,176,99,466036,80320,385716,156,124,489584,99426,390158
80aaf37991f62ab72473b23588e5c327,55,48,65958,17244,48714,56,52,52629,19952,32677
b4d43201b9932d2bfa65247239cfe894,153,95,706202,125655,580547,182,109,625346,163782,461564
ef2b5cb87ffcccb4fb82c9e8c1d7430a,203,166,833465,132892,700573,161,127,738130,98011,640119
b03fad0233726696672798d890c9f06b,95,70,157901,56073,101828,87,59,148801,42126,106675
363208fcfe9655e6025d1c28ce8c12da,122,105,231568,52462,179106,138,118,243078,48737,194341
abde3ec3980474079b73385c5f51a72f,133,98,322800,64700,258100,132,110,383248,83449,299799
c4de7679cf246191c0d0011412a56fe2,31,33,20703,10146,10557,34,23,20863,6606,14257
a0679c1248bafbe57bd0e744b5e4add7,33,27,28840,11175,17665,55,51,52260,17051,35209
146584ca76727ce5346dc977cafc31bb,183,123,550290,93463,456827,173,132,516465,126012,390453
45fd2e2271a714cdb810792f75173d41,128,81,268745,74927,193818,108,79,268567,91778,176789
7f1e87f7c3d8958692cf61085988c3a0,175,142,463184,109373,353811,165,137,541450,107347,434103
bd8c73caab98869c913a7dda2a08d2b7,57,52,82227,26187,56040,75,50,99903,26536,73367
209fca197e0e04dbe8be0a402f9a32c1,31,26,24820,7949,16871,35,29,14361,10020,4341
6e6cfc8e63d742cb211870e3bc9c91bb,172,139,492620,111800,380820,194,130,619138,116165,502973
e04b7dc0a10d4f0e708308869c542ad8,148,116,428538,87314,341224,179,149,516076,94412,421664
5ad654ee3cb5699adf6b1f9094c84d17,14,9,1695,1177,518,13,12,2066,1012,1054
e9884a13edfebbb7b0797b0ec2b64e7b,119,98,233964,56308,177656,85,56,149819,59376,90443
30da590e99c183af9bca785877490a85,168,99,532152,108102,424050,132,101,445214,113126,332088
ae618b1519e6fc5687b0fd58337867f2,133,95,250898,42034,208864,96,73,152170,38550,113620
8c5ce972b9ba138d014202fedcdd05ca,44,38,49796,15171,34625,44,32,41039,12182,28857
ed73aa73ac4b2f9b7a201da9c2de6bd0,102,78,290834,56877,233957,129,110,280606,88397,192209
0c0888b998c6512e0f485f7e12686b27,105,87,297410,61316,236094,131,81,309975,76600,233375
fd218fd497d2a4e2011663cd5b5d66d1,18,15,2494,1452,1042,22,19,3621,1229,2392
068fdb88c0a019ee7ab0143a1879c8b9,59,45,63702,18939,44763,57,56,53137,17914,35223
0ee16d23caf5a28c3ca28c965419c32e,25,22,11207,4449,6758,27,14,8811,5195,3616
3aba93385c73e28dc956df51d7d191e9,144,108,366770,62830,303940,147,96,390401,55597,334804
3b7e394f82f8e51c5fff31dbacfbadd5,139,113,311452,74072,237380,121,93,300704,63139,237565
ad83e2a6767030b2c2fceae8c1de95a8,123,81,229484,30179,199305,88,63,211447,30563,180884
bd5b324f06e0b0e02a6dbf4cd3a66764,10,8,1706,671,1035,8,9,1011,1156,-145
f1d8c642adfb7da2355626f9cbf55bc0,117,82,180132,42929,137203,94,67,124226,39796,84430
9b5f23770182951979a1662a2a9de862,19,15,3727,1903,1824,20,17,3499,1850,1649
7dc3288a4eb3b31cce5089221a0f6072,37,28,27478,11971,15507,48,31,48644,8543,40101
6dcaaf9e34aa639832cca1dfcb515ff8,70,65,112872,36559,76313,63,55,111816,32408,79408
a9a4ad7a2e1c2034a3925b59aaa348f3,68,57,100820,32302,68518,95,83,191169,38132,153037
578129751f52a259b5eefee163b7aa37,96,84,199889,54413,145476,94,80,193119,86952,106167
7b043423475e864360461f9db5a76ffa,159,130,496063,113786,382277,115,83,275018,83064,191954
3af622a77835c5b500ef87749e4ac569,60,44,77340,18759,58581,72,58,90641,24360,66281
93f9bd54d9f6577a5cd7f110fb882cb9,46,35,71966,21396,50570,49,38,48992,24541,24451
b6d3e1c3d4bbdea4bff899bad181e174,129,97,277387,82775,194612,101,77,203255,76540,126715
54ec51d0ad388cb0c5238e93f1e5633e,93,64,98359,32243,66116,82,75,124982,38197,86785
80c2330166b1176aac7cf07c777e5d9e,154,126,747574,174983,572591,198,151,755160,167224,587936
438754fc383b6f0cc4d88608d73fa29d,25,23,17526,6868,10658,27,21,20353,6398,13955
f6d731174ec5a61add454ad5e5a330a5,146,132,376799,76151,300648,107,79,279040,59144,219896
e4be707a035cb2853a8c9dc3bede0336,175,124,327398,77467,249931,121,79,232495,91845,140650
74e377b304035f7e2936e7655e73ec9d,156,125,456562,113545,343017,146,122,486732,91827,394905
ab590564e6608198f51c53c025e459d0,75,51,86784,20888,65896,61,45,55667,25119,30548
f488f3d3c6d892aa8a7b758a0933d996,57,47,71295,14648,56647,39,25,55492,12681,42811
ab4c7c4095aa2b8e87f5aa0907f5acbe,134,123,343696,79414,264282,116,84,289423,47909,241514
6a5690f7eb3da8af5fc591934d06cef0,92,64,170513,38441,132072,90,63,124500,45684,78816
ff652f51109de538525267f2331d72d0,45,34,36932,10149,26783,35,27,34558,9153,25405
9f5e63249197fb63d8a4bd63f2eb3501,23,16,5843,2368,3475,18,14,4051,1982,2069
cb5522e4b64421892dbed4784dd6078b,128,105,366625,67907,298718,137,111,375430,45898,329532
0d9c5583cbf4a6f21f37a406b728a320,103,90,218850,64059,154791,127,103,338340,67658,270682
6344cf043c17c4edf1965c231d0b2a72,24,16,7407,2332,5075,26,20,7352,3206,4146
c42248d146f254bb11ed69d6b6cc1efc,132,95,208592,35345,173247,104,102,199672,51049,148623
0d2cc86584955dd0d5b752eb8fa52299,73,50,100706,23063,77643,40,31,48290,13356,34934
f1a3192a0011b8999b879a1833806f89,80,62,118377,33064,85313,112,96,119610,45644,73966
76886dfbfe807984313f29f41d30926a,54,36,76205,16435,59770,43,37,47450,18584,28866
08568acd542fcc3703548ebc9267d553,189,109,522285,98546,423739,157,114,490496,106144,384352
b1d5f2992f138ea625c49ffc7a67bb96,96,80,119890,36197,83693,69,52,126785,24814,101971
fd0d7fd827098b2c9a4b738068256913,73,61,96301,19505,76796,79,60,95707,29035,66672
3b97c9946c18990d944d9e0898a8e25f,22,15,7768,3224,4544,19,18,7422,3822,3600
ced53189a021807717deb89bf87870e8,87,72,147379,39953,107426,70,52,98059,45377,52682
e6f0babac772f362a4d63118928e09a1,86,67,200966,47463,153503,84,70,165362,61462,103900
24e4c0a2d229aaa0dec3fd761e997fef,104,99,315992,91613,224379,134,108,443236,66319,376917
e19c51a9f311a7d98ce6f4a375547170,134,93,436360,113372,322988,177,152,621812,124961,496851
f6f36ac232e9104d78aca072fe1779d1,25,23,14787,5881,8906,28,21,13772,6726,7046
5330419365a3370082a816414e8fab0b,70,58,124707,28410,96297,53,39,83406,24564,58842
0e8bf6dba9a258bf12ac794e73b3f9ac,40,34,56126,18170,37956,59,59,72820,24856,47964
5fcec57824cf25fda883057109aa060f,30,26,18709,6774,11935,34,31,21691,5219,16472
c0c22529720df67509d5757200bfdaba,132,91,298572,76302,222270,139,117,376994,91944,285050
d9beb134abaf00f1d7ccc2a8628dea5b,71,52,73789,22877,50912,73,57,85552,22984,62568
410feb9aec108702298e8805ccae7b7e,130,105,450957,89548,361409,162,113,455816,98375,357441
378211ecb57e7a95fa00077811b1dad2,164,122,482699,128899,353800,122,79,392984,128157,264827
ea0a079f1d485e104d3438a6e7545dd2,99,75,166109,45969,120140,83,67,149218,44260,104958
e89c27df6db7ff075d2f92364400334e,64,60,99743,37815,61928,75,64,125138,35091,90047
44e4a5121b8c1daa59a1774baa222fa7,73,58,146776,28464,118312,94,71,127627,26125,101502
6b42afa325a57c3c91546296b44eb63d,42,31,42064,14821,27243,47,36,47337,13997,33340
e8266144f92e9a4f8749f2fcae96bd53,148,130,487909,141093,346816,133,105,530296,90566,439730
be50d02dd0ee74f65236d1ae2e8b2ca7,51,38,55015,17020,37995,42,29,47224,17875,29349
20df83598b2d9374026672db45dcc9ab,103,92,221917,84919,136998,89,76,295804,75160,220644
2995a94ea4859c121fa7bc92184b6f28,96,60,161559,35897,125662,104,74,157366,41640,115726
62c4b2ee17942a89df909c240b5fcdd0,24,21,6214,2522,3692,25,19,9003,1897,7106
e59b25d5a4cd6bb544214fc63141077b,69,55,108747,32565,76182,59,49,87675,28113,59562
ed22ba4602072bad0588df8418a554c1,94,88,226818,67356,159462,151,119,325790,65005,260785
a12f78373ce5e19850c04d38ab760c2c,119,84,235100,52976,182124,148,116,343027,49885,293142
ed6184c93a18e557df4098f6585f361f,82,72,140308,56655,83653,128,98,257619,55245,202374
fffeb99cb05fea90d18bf86f019fc39b,53,35,47895,16644,31251,41,33,41801,18569,23232
26085edfb5eb9c739dfa553c106f5659,134,87,478290,82167,396123,171,133,592345,99240,493105
8fd851a63b8d9e4eb74078e8ad402e9a,142,114,378250,85640,292610,151,103,391856,67706,324150
02149ac04eabd569d94b154694d1e0d4,30,25,16862,6021,10841,34,21,14977,5010,9967
1194f629247b8c3b2b0899bfb9d56c43,160,121,502638,64612,438026,172,142,536692,87422,449270
f27a2a8d68d5c3a74986871566d21da1,108,96,195949,55578,140371,119,80,259031,39364,219667
4f2372633bdb49b8dbd9b87ab7172e97,28,19,13608,5100,8508,25,22,11621,5191,6430
33f724d7070e10b0e0d7580ff23ba580,33,25,23264,7640,15624,25,22,17069,7731,9338
5032a9005876870be657a7245cc1d23f,40,30,46393,17668,28725,32,25,42807,14250,28557
74e32fc7a760b0da23d724e8e8783c53,72,57,97923,25519,72404,91,79,119304,30539,88765
88eeec605f38ecf7bb7a2f5781c0ff51,78,78,270057,118387,151670,119,82,323925,87247,236678
8938be0efd50690394cb61657e9aee70,196,132,786459,169482,616977,191,119,705692,139850,565842
b2997b218d327e98f793d39aecdfd103,218,138,570158,70086,500072,157,140,446089,73638,372451
7884596448c11affbb67547c1cb87d36,142,113,354641,67983,286658,131,124,325171,106564,218607
bb5e21b179b997670e25ad6805af88e7,90,76,198530,51527,147003,137,127,295906,58779,237127
b4fcea244bb35e17df39fa15547274d7,34,26,24134,10808,13326,32,30,24921,9870,15051
137c7614e2e253370c6b851b934a0f9f,8,5,2943,439,2504,12,9,2273,441,1832
7866b51c4c5096f7f45f1493c0a62a6a,121,76,224226,44989,179237,111,96,240786,72608,168178
95ec760276311e7df162563c768814db,105,91,229389,49656,179733,97,80,172574,58764,113810
779749a489fc5901670553ae232f157f,118,87,271146,61941,209205,151,120,447966,74901,373065
f173568ae53467cbab56ec182bf84a17,89,55,86004,13865,72139,68,66,81801,25776,56025
244c22e2c9de7b21609a9d182e5efc85,78,53,117557,33645,83912,93,65,134724,37379,97345
04a9fd344e7654c85f95beff3ebe441f,101,75,200252,89473,110779,164,135,351363,84593,266770
542d96a9e4cc2edbffe7e248ceae8659,22,21,6536,3226,3310,20,18,5411,3045,2366
5437d075460348ca96cdc6539a6c8836,95,54,153513,46891,106622,119,74,174428,45620,128808
c10bcbb496b6febfdb32d25b183591a8,123,87,309925,63666,246259,102,69,227639,76682,150957
4c26f3d55a6d1f047e4d780b7f86cde2,129,86,277543,59458,218085,124,95,234472,62477,171995
b6d2a37e56f9c75048975c7097d8e72d,57,48,82931,33613,49318,68,59,103043,41876,61167
c237fc62f2bcc8982cbb07f97f723181,84,74,231684,83020,148664,106,83,330855,89908,240947
036cdad2a352d91a9443f99507c35a61,51,36,42117,19992,22125,56,55,73660,24121,49539
1b241fbaaa69d9b123344320ca695403,117,72,316424,109986,206438,150,104,451637,107803,343834
3ba853f85df95561e272a1ab26876c1f,149,119,486428,129232,357196,164,135,829155,130262,698893
afba0104ccef3a2baec07c105c52d2b1,127,85,211941,60363,151578,123,95,249163,41828,207335
dad76d07fc9525c7634c88c8abbef81e,76,70,146424,26787,119637,72,51,86565,22136,64429
7dd1a8bec9a6bfd26caa86b8ba22c6d1,11,8,1552,1077,475,13,9,2116,421,1695
e88693f53095ccd0c44b8ef225eabe7b,145,102,526952,94531,432421,152,121,479665,132585,347080
ba3b25e74e63db8dfd8bddefa897d991,75,58,135671,44322,91349,90,73,145248,54316,90932
6508a42e722cb04c6cd3253af11d2868,109,85,255748,62822,192926,127,100,324219,43290,280929
0e48319bca21cf97cf93f8cb93a1b80e,61,54,53201,19327,33874,58,37,74362,17790,56572
b00a62cdeaaad878e2d03cf87b4a3e93,115,93,232235,98435,133800,107,80,306903,67955,238948
b3cd6291f08ab5e501954fbefd6b7899,135,87,448003,81874,366129,201,160,653024,122792,530232
abccf05689741bcdf00b93c3ed1e41a4,147,121,409612,94683,314929,124,120,370133,98717,271416
2f5698873e4d2bf1830066ab776e324e,56,38,73341,21074,52267,69,49,83664,19126,64538
260ed06578fa97f2d53c2fdfabc4e372,33,22,37293,14307,22986,38,27,37119,14026,23093
6f05eedcbe030f0abde043f89303c02a,37,30,34245,10947,23298,36,32,15776,10622,5154
f04db19c8d0efde1b94cca31608c0eb3,58,36,50843,19227,31616,52,46,60241,18676,41565
5ea797c8dc9eeb9da29afcb0dd25a250,196,125,708999,149899,559100,224,174,848966,161679,687287
e6e6e242ff1cf57bf2c9ad2db5d2815f,15,11,5534,1019,4515,16,14,4934,2517,2417
356a480d014b42ab0af7ee982d183051,182,151,800761,158383,642378,178,142,773749,137038,636711
f4fee9d87173cc76490b82cd199a0b62,70,56,82703,38354,44349,65,54,108838,32539,76299
e53b658dbe715aefeaa08a5cb4868d31,40,39,46583,17730,28853,50,43,43932,16089,27843
80aa2e1ccd2c17ef708ea02c36d07d4e,127,98,297930,82712,215218,102,84,238660,86325,152335
5783e2fd8d38f278dcaf0a86378c3f5d,33,30,16990,5395,11595,25,16,11744,2814,8930
f99007878acd878ce09bebad7a77d9d0,111,90,223719,49561,174158,68,52,108680,43904,64776
9289eaa444dd58df96a4d65ddcf44326,36,25,18612,9008,9604,36,33,21175,8740,12435
a7d8867f985004125554810ad02bfeff,209,126,500003,70601,429402,148,111,363469,80204,283265
bcda0c9424ff85d0fd8d01c9b7c08567,21,19,6907,4626,2281,25,18,13182,2786,10396
3f5494fc49a91e4125dd5f08bc0ab69e,25,25,14915,5645,9270,23,23,9361,5518,3843
8e877df522bcef951d2aa62803cdf06a,92,73,122445,40367,82078,125,93,214840,33305,181535
781817dd05e9a1d39f9302d4f378ea0b,100,78,288010,100335,187675,118,90,310333,73286,237047
aa6496ac1fca8904aad24b3a486210f2,148,92,590190,109476,480714,182,133,557395,81926,475469
39ecd753079f8226aa7186a6078d2dd0,0,0,0,0,0,0,0,0,0,0
47850672a5dbe39bb88236ae6471331a,122,89,274846,92901,181945,138,99,464444,144776,319668
510214c7e749b52666ec68c74bf79863,41,35,49052,11481,37571,41,34,46324,12939,33385
00afcc30ffc24fe03e483bc09da7984f,46,30,48282,14144,34138,36,31,48383,16275,32108
a463a6e85b827629c4c7fe4a7ac37952,116,102,351898,72909,278989,123,106,339980,58736,281244
60ffc80b6dbf861c1dc719384685c9cb,66,39,150227,37949,112278,112,71,191041,50553,140488
78f414c0f20a5bf27eb3b2e83851c894,72,61,105825,23300,82525,74,60,95947,20596,75351
037cef9ef3389aad2325d671429acd98,57,45,100094,37052,63042,56,45,97577,27991,69586
4061ad0ef1bce91d8209bd89adff9b67,34,24,46337,12308,34029,35,26,29256,16837,12419
d6ad2a8761d0b6d54a35c25a87d656fa,27,18,12934,3752,9182,26,24,9520,6091,3429
144feeba5da7ef1dfca3e9d31fe93619,54,46,60758,23647,37111,69,46,105999,24794,81205
757c6ffcdfb61a128155494faa8ecf76,52,42,54575,19733,34842,49,27,61909,15730,46179
5776cbfdf86e17f0b7b09ea4e647a64d,184,126,599908,115784,484124,161,114,499369,129622,369747
4c6b5e94605c0598896fd89a6957e8d2,48,30,27642,10947,16695,35,25,26383,5537,20846
2286661d1ba6a5d5eda1be1617c33746,26,17,9086,4190,4896,30,25,15889,5856,10033
76c73900e5b3a75859009fa9b4080b67,50,25,61938,6714,55224,18,33,7321,18926,-11605
0930b55d10d2b1e8888c62b4ff5a41bf,191,155,885510,208121,677389,165,130,616254,115076,501178
0d245ed639331fcce11cd38138b23c5e,116,95,209641,87775,121866,137,74,289281,47914,241367
c6278aa7e660ef2a5c2b79c03207ec86,60,48,93705,18342,75363,49,35,63049,26158,36891
66db9bed51ede735101d3f52a99de03d,15,15,1860,1316,544,14,7,3019,471,2548
aa20f885856f84413e434b77ea4e7d0e,59,32,65878,18139,47739,45,35,58668,25009,33659
578628a17ad233c4473f65fa497b3d8d,148,105,256768,41409,215359,94,80,135629,47074,88555
0bbb80a138bfc9969473f9c88fe8018b,106,83,183738,59748,123990,87,69,130702,37240,93462
4f7fc3028b58f1e75bbe9b9d077593e9,142,92,263442,72898,190544,124,106,275518,90145,185373
075d532bf539b7496060e52137c3cd24,52,37,32725,15547,17178,42,36,52079,15886,36193
391862529e1ff5cfd71fa78a04c98893,185,137,403214,56032,347182,145,118,370085,45065,325020
e46f4de5178c3d78c6db19675c05ea47,23,16,6656,2466,4190,21,16,6027,2564,3463
932dc38d84da36ec2204af9ee18598fd,89,61,164398,37393,127005,90,78,252738,53525,199213
0d73bd5782c5e55885ab46c017e5a7f2,19,12,4623,1604,3019,14,14,2494,1979,515
5dd2a263cefa06481838a6f9a6e69ffd,106,74,220193,53280,166913,120,90,310788,52203,258585
5bfba1cd83408001b983cd08f1e177d9,42,36,61717,19123,42594,36,26,43005,12775,30230
fb6fcbf4917b65734e4dfe95f792c303,65,40,76675,15988,60687,48,30,61656,13796,47860
7cacbad0462e64910211a295194fa2ec,50,42,78150,23572,54578,92,71,135325,33981,101344
53c9b4838422d223397193b23afb80cb,118,96,292422,80316,212106,102,81,206561,78770,127791
00692195d91981d7bc45176704eff44d,29,30,36320,15787,20533,47,32,46448,17868,28580
1d8f550bbe850c2b056e30f7fb4d5b28,92,73,148156,35131,113025,60,46,91359,31885,59474
11b57b5acd2e5e350262da3e1c0761de,156,117,400021,103935,296086,191,131,636654,95197,541457
538e3a265370297f0adb69b761309cdb,107,91,198486,62780,135706,106,83,204445,48455,155990
1fb5f9e78101059b74d4664b5d1011ff,86,81,206643,56857,149786,119,107,282601,69053,213548
4a540b0502e6843fbdcd06ecc07ba1f4,208,152,855061,185816,669245,177,119,852603,149847,702756
83e929ac02d79dc5fbeb29c4db2e33da,42,30,25646,9237,16409,35,26,24908,11489,13419
fe62cc0f09cb9abf94fd72a696bc14c4,49,38,91786,23100,68686,37,25,48505,17151,31354
30cb93ba37354edc50e76ca092b1046e,75,63,141486,31996,109490,49,39,80032,26286,53746
3e48d43e084fbdf460dfc5b150e62511,65,53,82663,29144,53519,62,47,85270,23189,62081
269038240177d3e4094886499ea81f56,120,103,188246,54966,133280,133,105,279494,57141,222353
ab65ac5f5ecf835ef6554ab85991e9a8,70,50,142107,27598,114509,55,43,75071,20051,55020
df8d047041807b6d4e4583e874942cab,18,10,2927,1281,1646,16,10,1909,1533,376
a2436f5d96027e2dba0e4f7c74e91603,172,137,726213,187943,538270,149,116,621359,135432,485927
1e91dc3ca830c4648594684cf852bc79,112,70,193790,42757,151033,84,64,180134,57453,122681
1e72ca3d9439265c51cf1aab8a442172,111,90,230736,54015,176721,135,113,294129,61750,232379
ff0cab77f04b29f3cc7a4311ed35e1a0,37,26,32328,13699,18629,40,31,52401,11987,40414
11361c2ed794385c7029c581e1547802,138,112,445766,145136,300630,146,119,441800,169056,272744
d055b035d8dbfaf88b3ff5a72216e6f7,117,91,266135,63160,202975,129,88,320811,62811,258000
37c9c2b26537f7685e9e206a732be1de,145,126,473861,98206,375655,203,153,749940,125618,624322
ba36665a2f02f8dfe75514c6f14fb124,75,61,127055,45080,81975,82,79,130252,45085,85167
01ae021a8392afb995bbda894cd26ebc,100,90,219834,55946,163888,104,85,195161,67753,127408
85875e2c908bdc31898318f70d01b18e,60,49,44319,15211,29108,62,43,71369,18735,52634
7e6ae5b6d66270cb332610accef6f7f7,69,54,80885,28032,52853,87,52,101227,24557,76670
a8808dbfa8bd1ad104cd23114303a9e3,97,66,225904,50091,175813,102,87,232279,53390,178889
c49db1aab61ab51528dcdca47f61a861,134,83,264533,71712,192821,151,110,404530,57642,346888
2673890884ae4b77c6f47302cc753438,32,29,20484,8551,11933,35,28,33104,8722,24382
3d0cb0d9037cebaea7ca1865d5c9638b,89,56,210370,34664,175706,71,53,124795,30120,94675
15b4dbe84a7554c5938e096277c476be,194,142,828214,113240,714974,237,155,698839,116972,581867
d72f46069e3d10302b5eda3f63cb5910,27,21,17786,8520,9266,42,26,41559,5742,35817
8ade53794687b30a52136387d7ca99c9,72,54,186032,31867,154165,80,72,147408,72299,75109
d0c2e0cf45e1d57260c7ff3e05ea3e8c,18,10,4409,806,3603,19,13,2855,1479,1376
fc40d5b99259d24f7d201b0a468e5d50,164,125,417397,61201,356196,88,81,258212,77977,180235
7e0b753d1fa992c17cae3daff4cdc335,81,60,167434,31223,136211,97,75,137886,37818,100068
c5f8bfd9ee68a2648199dd85eebafc11,24,18,9382,5732,3650,24,17,10271,3726,6545
55bd4d0fb937dafe283dfcea69b2bd24,94,76,217108,87085,130023,107,82,289247,101609,187638
3c2583cd764f96c36bd36c698e34ac9a,104,73,150723,34496,116227,93,66,129890,41170,88720
bfb664b890889465516ff43680951dd1,160,125,398332,98959,299373,130,107,353252,62662,290590
119f12e370a8970dd1e4dc168b747871,53,41,63276,25413,37863,59,53,95008,23187,71821
28c69595d7ce054170df429f24a2fefd,70,56,103666,34238,69428,89,65,139405,34782,104623
700460241c38cf94ecafda85891d19dc,155,109,419627,85696,333931,168,104,354459,66870,287589
fe44dd36ee63ae70d6eb43926e81ffd0,71,65,75647,30644,45003,58,38,71186,24667,46519
2b73e5c0afe041bdedaa1f3be62cc3d7,76,62,119345,31943,87402,60,46,81139,36049,45090
ca831410b9e94243f761f05b177b3110,32,26,17763,8956,8807,41,26,24447,6732,17715
a5e970c4af850165d7f79caa8b16dd48,107,83,158200,40341,117859,65,46,114737,25929,88808
8745f4cc74495872fd38f39d6e1905d2,52,42,68612,26345,42267,85,49,179027,22919,156108
8836ec4f54d151cd9de0847d435a68a3,34,27,25314,8429,16885,31,19,21756,9463,12293
3e7721f03c41886362064fdb97bc9db4,62,41,53362,10554,42808,38,37,33020,10219,22801
ebee85aa45f18d90a97be5d97f2d0ec6,31,16,28719,4606,24113,31,29,30342,11611,18731
7b3adee611de14c855366ef32b4f72ce,164,130,499837,111890,387947,148,122,564338,121172,443166
0eac7e280803e133c67a6139cb5b2f08,27,20,18531,7399,11132,35,22,28586,8329,20257
f89a57b6a0eef9676ac73ebc118b88a6,30,24,23378,12986,10392,31,27,24091,11015,13076
d59ce37361684caadd838664bfd5d9b5,137,105,301224,61950,239274,100,71,206213,62401,143812
1c8b6f1c5a24d44ac1a26ef1ccb3844c,120,100,306575,81742,224833,140,113,356251,132517,223734
a05e26a6bbe501d4a802ac225c6a5e97,97,91,193778,62818,130960,97,78,148906,46884,102022
f532a4dee5e143916ccb7a6ef8caed37,121,73,188985,64209,124776,132,98,295912,74610,221302
38e75a28afbc6ec62dfa6e14abf8def2,93,76,235425,52752,182673,104,89,203933,69109,134824
89ceb789ac62cebd5061e1c5152c98b2,87,67,192320,39993,152327,134,116,285677,80268,205409
47b596908c7f3c96d43c04dbf140c294,9,3,1533,271,1262,6,3,634,412,222
5062cad10681f7bb5c764e1c9f849394,48,39,35542,9383,26159,29,28,28139,12793,15346
b8f303eaf1c869dd783cc531a91ce0dd,206,150,688923,111961,576962,185,121,606462,126702,479760
bc3b58b7cf628f99b9165982d9731c36,56,35,72500,31994,40506,50,43,77644,25832,51812
676e363c25b9d8c313fe3a7e031ece6c,176,97,546778,90788,455990,199,148,489097,150504,338593
cc618cfd35945703001d10471685fdca,150,96,273720,62983,210737,200,112,448839,95004,353835
c19d39a746cbeaac226d9311dda16598,118,96,248120,56136,191984,139,102,262647,60207,202440
68faca1be21036dad6396ed38e8fc499,48,35,71490,18899,52591,61,47,54952,24317,30635
2e30833ead506f0c3578c05502a1907d,19,19,4681,2684,1997,21,12,4912,2626,2286
098c60fa8013beb93a831ac09eb2ee5d,108,87,255013,46412,208601,128,85,260467,48652,211815
931137224a8cb4a471cc05e1aae9aa16,149,88,217353,53028,164325,92,69,160459,59748,100711
f9e6bcb5f83c6ab898b4bbdcd19e0031,119,87,321963,48622,273341,127,100,264231,56959,207272
bd48aec1cc34386134c81bca73647181,52,44,96952,30135,66817,69,63,108687,41027,67660
0cb007a464738b6706e023849c2a0bbe,66,51,99522,32816,66706,98,84,191093,37190,153903
79ca5702e4fa55d7da574ba59613851d,156,132,466446,71251,395195,149,126,385565,70624,314941
e957fbdd7aa8c142f27d7fa41c0397f6,38,27,34535,12168,22367,32,32,35125,16106,19019
c5514a9496f78f61dd9f3940ebd63cdf,113,87,256111,51323,204788,106,71,224458,46343,178115
5edc10b2ed1cb667524a2cbbeb7d8bed,140,124,525042,178244,346798,182,151,671525,147319,524206
884c2de9cde282cc5e0ea4e75dc7fcd6,25,19,6567,2919,3648,27,21,12356,4304,8052
8de59e07440f4d49b457bad5c4e0b6a6,16,17,2770,1864,906,17,12,4330,1239,3091
185ef805e608743fc846c17a93af79eb,143,107,346052,68084,277968,184,122,419701,87771,331930
d88dc26e853c4bed704d478425546853,136,101,431715,107373,324342,185,151,600683,127354,473329
6e872e5b404bd53766990349f489e63a,101,94,193870,62652,131218,107,80,173867,47657,126210
22efe3d2bece4e3c81d1e9e810fc35d8,129,103,227496,56199,171297,107,92,197990,61695,136295
163a11979822be44cb3283b49151eeed,127,95,307608,59000,248608,115,97,275545,71583,203962
2799d3c8993646a72df153a600338c0e,46,30,44743,13733,31010,38,35,42042,18371,23671
645b6aa85cd38db35646bae47830f89c,26,17,14172,5918,8254,26,20,12777,6057,6720
0f2cd7da0f7331ed272d6e1161e049c3,115,89,222676,57664,165012,116,94,225355,58659,166696
8eb58ea9ad2386ac7b786515d69f47f8,136,114,299782,96376,203406,144,108,346153,88788,257365
cc8f3ffd695438c17dc10d104ec11bea,111,84,241079,52422,188657,110,93,192558,47358,145200
54499b4fdc0492302d255f80d874cc24,26,19,12914,4437,8477,26,22,11080,2968,8112
5bb7d6fff192fe1c39a995cc636ba0e1,80,65,190628,37369,153259,73,61,119543,39380,80163
105dcb53f4421992f8dd004a7adc7b5f,42,39,65803,21841,43962,50,39,63662,23527,40135
29191d591e145aa8cd3e3e3632ce01de,194,139,772372,155105,617267,197,141,720114,182660,537454
9fb875d61f22c963fe698d4dfc94ca75,69,59,120044,29640,90404,64,58,121924,35423,86501
02c93ffec89a404407043e0974e3f29e,72,60,104432,29921,74511,58,49,116443,23572,92871
18fc3b985c91b39fbf313c4dd3c3be75,61,50,107703,20164,87539,57,48,59540,23721,35819
51098172e5a4927acb1d60fec95e37d7,12,9,1861,501,1360,11,8,1359,388,971
a303df12bf30f02d7eae0032c24ea4cf,26,22,9499,4898,4601,28,20,8971,4081,4890
e24668cb0b9ea4d6b14896d01a445ae0,98,68,157976,37181,120795,96,65,151396,34406,116990
0d5850ad7972fe53127795b03a7bcd69,164,102,287626,51773,235853,115,98,238121,74887,163234
f10a336d3564e8b8fee8483fa0078583,38,31,24311,7218,17093,36,27,22458,7662,14796
3022b18c1a60542c7e5fbe1934b5c9c4,54,39,61223,20480,40743,57,42,79084,25295,53789
88298d4d00744c204b1ab9081b8de98d,79,62,104668,28478,76190,53,47,46677,34680,11997
e32998df93b8d1832a2c0d6d89f36c1b,56,45,37997,16400,21597,53,46,51539,16514,35025
6ef13b5c4cfe6258a9330c268a13fa02,199,156,831112,142156,688956,124,85,541503,114174,427329
7709ecc687ed5f18ec39749b643714a5,73,54,127553,39636,87917,89,73,158864,46413,112451
4ca11ac6fbcc0ea198e16b23edaba5dc,21,16,7659,2838,4821,16,15,6292,3567,2725
cd9804ddd8f5eff03c53c7d13c7c63df,193,121,620478,199430,421048,151,116,540720,157277,383443
51915351f0eade1a8f61379a5f074a00,161,130,482971,111220,371751,160,129,527541,91089,436452
f826b16f339512f70491fb525af94adc,66,58,81940,18228,63712,48,33,47140,12769,34371
dac4d034a2793abf9dad44df18906595,108,89,236733,66161,170572,114,83,203122,47202,155920
dc14da7484e204e6edcbaf5bedc1ff13,128,101,332561,81434,251127,164,144,518489,87439,431050
de5a39691aa7df6a8df97af0855e6968,130,89,697624,123661,573963,167,149,813938,196076,617862
3adc6c5e38038167c259f258edc24369,57,60,89281,27934,61347,49,39,77477,19659,57818
eb049920535c965a56d22380c3c3318a,14,16,2339,2093,246,21,12,4187,1281,2906
7588e03497e40fa874c224fdb8ad6c11,103,66,180737,56771,123966,114,76,197361,65826,131535
0e0c5b7e91e5270d134ded8eac817a4b,47,32,64237,18557,45680,63,56,67495,28774,38721
76883b2d396bf10d5234dfcd65a32014,183,120,498133,88265,409868,164,103,413651,90816,322835
d3fe2e5c704dfd3c19d41887b3d7d1e4,23,21,15066,5133,9933,17,24,7043,7080,-37
ecf54035eac67ab045fa22e1abe0ddf3,105,79,233298,48535,184763,139,112,289000,65720,223280
d1fe66661db0602c6cef7453393cae15,65,47,60995,21562,39433,48,32,56744,26509,30235
4d472ae6f51e9c0ad88a3a33303253b3,0,0,0,0,0,0,0,0,0,0
72988894cd2e2e43d131abd2782883d3,98,79,215445,44303,171142,119,92,258599,52299,206300
69dd7772c4abfae7a82c1cfd4e0d71cf,33,28,24485,8413,16072,30,30,23281,8670,14611
5317134205fbce9e2730a64655410dd2,125,114,403301,85407,317894,123,97,365686,74097,291589
ce566a2d691db96d1534e3d2f9c025f1,91,79,150558,40973,109585,110,73,171059,53186,117873
6cc13d9cfb2e97f78dac3f5289446548,153,118,780747,159349,621398,188,134,911406,168101,743305
bcbf0f032c58ad896668c833dec24b50,132,115,571349,121366,449983,160,104,502368,107410,394958
07215937998431b4008d8d0892560464,33,23,16691,3497,13194,31,22,11978,6029,5949
302d02bb7e2d1e18d8f861c947e1a3ae,74,42,95425,38344,57081,67,53,100561,31792,68769
d2ffed9f79a8818c52804ce72d5cd5f7,20,12,5856,1003,4853,14,14,4997,2120,2877
2521be9a2221c500e6d7f16fee6fc524,58,43,105258,28825,76433,60,42,79061,26987,52074
f6996e9a7d5069b8a5180cbf97f2a055,76,53,104186,29575,74611,78,62,103849,29922,73927
59341d11557d4df1bae699b076f61308,176,129,567240,107417,459823,109,94,309323,97411,211912
5cf5a5c03df4bc4bac5e97731106f307,106,75,222707,66927,155780,111,75,244351,49405,194946
8ad8079350bdd2ec6f733e84c412cf96,32,26,16707,6690,10017,31,25,11812,8281,3531
daa9ec6ea8a975ac2595552a1a2125d8,18,15,3986,2382,1604,18,19,4080,2918,1162
e1531e460191b4b964f017929ed14528,152,109,715866,99367,616499,134,92,359044,102378,256666
4961e5874d3ac109ee30e801397f0080,78,58,125887,28109,97778,78,68,121322,37214,84108
84b7144486e6e9614238db20d62ba296,88,76,135086,39376,95710,87,70,99413,40257,59156
01052afaeb22ef28e77994f5eaf14118,36,19,13241,7423,5818,31,21,18167,5228,12939
accdcdcaa63f663439de2eea09515e26,111,89,375376,100487,274889,154,102,551419,109679,441740
db5f33155d10d4c4613e34418490b411,45,35,65285,16705,48580,63,44,48898,20014,28884
aa41f76e05108f567b5fa11d14fb23e4,26,24,22283,6701,15582,27,22,18526,4903,13623
5bb52fa569a9257bc57056fdb830604a,80,65,118047,34739,83308,97,72,123029,33425,89604
1b4cfc05910b07cdc9d8b5019e29aec2,106,95,224586,63597,160989,127,91,307016,41341,265675
2b4eb001d14398ee30746000c85bbaa1,176,137,605105,91138,513967,192,142,479285,140533,338752
337ed04ee053e586d005e061ae8f3763,82,47,168743,25207,143536,75,57,94926,30128,64798
563f492d21abcf8c55ed7d9e469c4bcb,191,144,663895,90245,573650,151,115,451824,92353,359471
851be5a65daeb2879fb5d6cfe174160b,176,121,633948,155523,478425,188,117,556637,118626,438011
17a9cde8132ba3bb42e5a310330ecb21,44,29,173165,23105,150060,62,48,142378,30762,111616
9e002c528393fa10a9802b4bae263459,172,128,727480,200115,527365,156,129,750437,151318,599119
7cbbe990f6aeec43238f0671a2ff699e,119,87,208715,53720,154995,127,105,307076,67319,239757
845506216a7c3d3fe0b959a51e8eac28,157,126,411311,69166,342145,155,118,397578,74628,322950
507cd94e20ba29d5e666dce2f9e92f07,104,90,217206,63057,154149,81,56,156177,42419,113758
2914a8d762c0edae78d2a831b9b23a01,151,104,481592,120250,361342,149,133,490155,157109,333046
c4bc96f6fdd251a1cb87a7bdc6a9a1cb,102,69,234997,81933,153064,84,78,194950,86668,108282
6ac57bcc3004caf915c18b70b7ceca57,109,72,201402,30611,170791,97,83,113780,69289,44491
e674207a46d5fa9b49202f5cedbff9c4,29,25,16950,11720,5230,38,38,31217,10706,20511
3eb93fbd9056ebdb52ffff84e6c3664a,45,36,36728,11096,25632,51,34,44618,11599,33019
b1847b4c7e37e83231e86bcf22da2c15,170,128,684780,130520,554260,181,129,679381,87574,591807
6faf6db211d0a26f7c67f8d01dc0ddd7,80,62,139722,40685,99037,45,35,89492,22058,67434
72ccd3290552545952724a5985f9fe26,40,23,41080,9014,32066,33,22,29601,10953,18648
86b4ed12fe59a60b32f5739bb27e8136,168,131,639379,123252,516127,186,149,658728,128722,530006
a3503001d4bc9231ea2bbd48a2cd9243,62,48,69790,22548,47242,62,49,73063,19771,53292
114a901dcc938f4b4efc408aa59367df,93,69,169716,45934,123782,101,63,137047,39305,97742
becd58c349c25b4b282b842649546f75,68,57,80995,22944,58051,53,45,61361,21246,40115
4cc05872065f3c8f113839596b826149,88,81,186225,36040,150185,76,64,127065,38497,88568
463b1405c036b34d8c8beb81ccd7c74d,79,62,127008,28171,98837,67,49,81188,29514,51674
615de72c1de0bfd04db067f54c881971,128,72,224466,50722,173744,132,93,214124,60345,153779
4997a82c9a6f6b85462541f98066aab7,53,46,87448,28800,58648,59,44,109802,22963,86839
7c12b03607f01af8cdf13774f7c4fe83,31,23,25726,12888,12838,41,28,54070,13825,40245
8fd6556dbbde57455a83564b6dd45e64,68,58,121797,42662,79135,58,47,92699,39343,53356
17abffd32a5023a1684869b352002722,193,139,574612,125105,449507,168,132,613132,130636,482496
cd8674f8e9480d19b1a141a4af35ba6d,157,118,431955,60773,371182,135,110,329049,98332,230717
10f81d4917b7b4b6a028250392d2e50a,124,91,469350,133034,336316,187,151,789097,166123,622974
d0f1ec65672e710dab20702275a00aad,55,45,70909,37766,33143,59,44,85795,33071,52724
2dab65311c92c11c7920310035cbb2a6,60,45,104477,36823,67654,45,43,72217,44007,28210
b6dd28e07868cf27b786eacf1ef69b05,102,82,249396,72424,176972,118,90,299538,89706,209832
7fbef80c1fe45b58db601be7d3cb0b9c,118,110,282250,43278,238972,87,66,180160,51714,128446
6018627adedbcb2004a5256b39054bf4,77,64,154971,42208,112763,108,88,183777,48817,134960
64d89f247fb27469221fd0b5775c30c8,29,22,21666,13344,8322,26,21,24351,9707,14644
dee4e08e22727c306ed2f4a391f1753e,95,81,177566,45167,132399,85,69,113458,44578,68880
8f85c593f031a54010f9b46ca7bbdae5,35,28,30247,18908,11339,60,32,85476,11923,73553
041c60f19a7c20dfe970f5cb292d6aac,206,161,866522,207968,658554,214,132,838547,201137,637410
7419355acfe2dd81f5d687db641c9792,123,80,215640,43868,171772,125,91,228524,60082,168442
c504fc285532a1a71fd5907071be90ae,74,54,115885,50440,65445,142,101,235957,63277,172680
f4807739b0a26b126c95fe4d436dff0d,130,99,335806,71884,263922,150,113,414759,72566,342193
30013f1851db927b92f986454dc9f6d4,142,106,396227,74235,321992,143,113,351852,125665,226187
ecd313d6371ef47a7d90225b8ac421fb,139,125,375531,103133,272398,131,110,259806,61873,197933
63aff2f21b42bb586d57fab75586faa7,153,121,631925,125901,506024,186,134,785922,105430,680492
6e2615db2bd8b15c2ce93190cb702e30,56,38,102164,23998,78166,53,40,63976,27525,36451
a6c39a1a8a04a27063e84a84d78e25a6,95,58,148409,60051,88358,97,64,180559,64542,116017
dd84ca1f909f00d4b2ba2d85e2c8d60f,29,24,23610,7393,16217,31,22,20074,6820,13254
7ded7a64d8aa0445185feddee35a4acf,43,33,38552,19657,18895,54,41,61070,19937,41133
ccea95a89e9b6362bdf26f80e86eafcd,203,128,519111,96721,422390,174,127,510711,121209,389502
cdde6493c513e883818666e804469ef1,36,32,35393,16857,18536,50,32,44617,14859,29758
ba5b59798e45ba4a3501cd24746d6144,45,37,44843,21023,23820,43,24,59516,14964,44552
161061f2758df7f737eb3ce7bdb0eb9d,103,88,194291,77941,116350,119,84,266020,58211,207809
25cd2f327959a6dc0169e877cc541ded,157,105,459705,105279,354426,153,109,459869,105341,354528
d97879042e6045c7f64d25bfb48441a9,100,65,175199,37339,137860,116,79,191132,40670,150462
b5d81ff4d08b1afbe214b48f854503af,142,107,382239,90308,291931,182,129,380394,78543,301851
c0736be2b95f7ab33b81f437d437771a,91,66,254655,60861,193794,125,92,255922,88668,167254
40bc9a2bcb57cbd7beb9d8b4605405df,68,62,85833,30785,55048,86,64,88826,25246,63580
d06a5fbf6be00c2180a1471a4974564d,53,44,63033,17063,45970,38,34,54115,21211,32904
726080678140500e270c8393fcd5b759,151,124,710072,143723,566349,201,150,790829,137504,653325
e8fbfddafe123b34649a39fde939f7fd,47,37,51436,21081,30355,64,55,75618,22810,52808
338ee641f334f56a8c7905b928a56f6d,105,78,233054,38986,194068,99,71,178085,45028,133057
297bea2ac5f2ba0ca7ead785e15fa014,150,110,453102,140831,312271,175,116,547472,122182,425290
58ce4a3aff1363d0e4e8434620856bf2,95,67,170211,34701,135510,117,94,206970,43178,163792
728011e9c6937f77c059bb6c7ed949c1,195,116,565271,136826,428445,157,121,426970,142949,284021
267c08b21f1d9c18322601c261b0f318,193,145,672982,185808,487174,171,130,654370,161100,493270
fe0f125868bb495058c3551d6c907991,27,22,15785,7027,8758,34,31,28020,8640,19380
cae01d4f98cdd0073aec61db0a031552,109,86,261098,56491,204607,94,86,155228,63375,91853
8fcc5696f3dd369af13562d85bb8bb41,18,19,10904,2783,8121,27,16,11846,6509,5337
8609e366659dd7f21acdc65a29acf8b3,32,25,19672,7468,12204,40,21,33095,6871,26224
cb3fb05131484c402e96fa44117d3163,2,2,102,217,-115,2,2,217,102,115
5a8bad916031ec0ef2b4dcfcd2ca40c8,49,40,49400,20618,28782,52,35,64213,17659,46554
7c8d28c1ffe64670805454f0abe03e4d,115,101,355549,125224,230325,150,128,462822,82578,380244
c5e5c853c0bf8e025fba29a1062f3e30,75,60,128398,34222,94176,103,76,135445,41478,93967
18143cd9c72cddfe266b2989f780881b,164,123,568115,131101,437014,162,141,544568,118948,425620
a3d3da63d5e1bb2c4d385f1392a1e8de,16,11,2543,1881,662,17,18,4208,1738,2470
aee7a53da65fc34d5e85f26dcd221320,26,21,12474,3165,9309,25,24,10819,4460,6359
456dfdb3853186316315a2f6b238e7a6,61,34,68011,29362,38649,63,50,96585,41601,54984
d2cd2f90d8a5ef37bf37df62e5a54870,153,105,408745,128892,279853,200,152,602501,128958,473543
069c244e50f28ce24300d20d88d91b50,139,110,329526,71671,257855,184,126,421498,70372,351126
fcf14011dc4c3eb8fde48a86edce9f35,31,21,12548,6396,6152,25,26,11293,7012,4281
5cbbaa97fc1f744e81f3b83538a16d74,30,29,23246,8321,14925,34,23,19597,11617,7980
920f13148ca0e9254041b9976b0427cd,19,21,5824,3018,2806,17,18,5446,1640,3806
55b0b71a8d250bfc35fb3586d9a26fb7,39,25,26116,12740,13376,35,31,36331,10421,25910
01939c0e3c44dcdd11eb38fd89ceeba9,169,122,788458,154495,633963,174,136,689124,151941,537183
0ab1cf9b666b00035b4098a480d58d12,81,58,217142,51659,165483,104,85,214652,70520,144132
4d2636be4ad9f65ba71f578ddd00dd44,34,29,27802,9939,17863,32,31,24068,11138,12930
a49bb0c3197e4f77556faa25df1b9a06,125,80,296368,106541,189827,172,96,387032,110367,276665
a7c42e54fce187c2790c7311ec9ceb7a,65,55,66376,21003,45373,59,46,68977,18367,50610
3a3437499f526b8565b938331c10ec2d,32,26,20864,8628,12236,33,30,27769,11398,16371
5820f346d480258895342bf186549495,119,93,208075,43657,164418,104,73,185737,45001,140736
e25987eca4a2978150e5fa2acb795115,158,108,364326,62563,301763,144,103,320630,62237,258393
7bf4984f6a8099e6d2a2d320afea81bf,102,89,307700,88741,218959,142,122,407723,92720,315003
cf94f41d93d10a8be8f6b5269eabfd68,78,57,122163,41735,80428,103,85,172252,43515,128737
4b76215b157bc00b21fde5db16f1e845,145,116,328139,59856,268283,97,84,257691,74380,183311
b301d955ac8fdb0930dcfe40fd73876f,172,134,504919,105732,399187,201,159,568874,134357,434517
51d0d205ca867c824708fe153bdb95a5,174,123,729094,108981,620113,223,176,643633,127087,516546
2aa5678a7a14e73115dffe71aa4c85c5,152,112,456247,94099,362148,125,111,391915,113445,278470
bd9951381b3c94c65e9acf2c470872dd,17,16,4811,2026,2785,21,15,4127,2406,1721
ac86ce4d2ca7754ad3586dd042c47aab,80,49,96933,25135,71798,53,29,87427,22578,64849
67f2f985a032d0b6554ffe1115c4b689,66,51,99281,22340,76941,70,56,80890,25311,55579
20b5d6c3dd7c776db0bd07454c9c94da,84,71,150853,32539,118314,73,55,86388,26443,59945
1f848b5de636d3a5fa8340ff71a7b548,27,24,13631,6672,6959,31,23,11775,5881,5894
13a7183faad5c73f73afa799804e25c9,46,30,40586,18064,22522,44,34,53009,19086,33923
fd5141a43bbe83fb67c92f24fe87114b,120,84,212777,41877,170900,129,98,255968,43878,212090
15f952b3c3ecd06726810f7c53ede74f,138,119,398607,90473,308134,141,101,415709,73734,341975
07bb1a263b9b53d3551b61f325120e5f,58,50,59122,15464,43658,62,46,47218,17792,29426
7b6cca79bdf90588a493984427c5e096,129,94,285805,65508,220297,187,131,436529,58357,378172
121ed68d094cd8332d2d1cce7d8da723,72,39,85111,18824,66287,68,49,86483,27980,58503
89089db4c4ad59498405295e66c8a3fa,83,65,145777,38487,107290,124,100,233400,44434,188966
5871e240004b2c514163f1594c2c56c9,82,66,139120,77108,62012,149,110,307889,41407,266482
e2cf62f0f0c4801cc800ee63e9c4b81d,155,105,356431,49637,306794,113,94,186273,54277,131996
907b3d2708325a32a43a81364ef99ae3,40,29,32755,11931,20824,36,28,20082,8741,11341
2ce6d422272da8be8a943008e7221e91,118,99,217749,54882,162867,93,59,166680,59262,107418
24f8d30e800fc8ebf0ac68976db926c7,30,23,15580,9159,6421,30,29,17516,8501,9015
365534ace5d54f4cf837f5b53310f478,14,11,3546,900,2646,13,8,2224,729,1495
cba722d12c228b8439f8cf31f937bcd3,65,46,104948,25023,79925,68,51,103640,22678,80962
75c89ffa15658c49465d1b03e38b5a6b,62,55,151724,39077,112647,129,103,319663,66644,253019
cfe8f529ae2c5f17991b3decc63c6bf9,53,40,66467,20258,46209,47,35,59002,21123,37879
082ebaf2536f45bfc46344814b3f3df0,61,48,90288,23945,66343,46,36,63273,27470,35803
6582f6c4ddc15aa80e9bb5a2aa0a3110,65,58,93051,29571,63480,79,51,94080,23655,70425
a623ebdfafdb61098970e09772dbbade,27,26,14232,7579,6653,35,23,19210,7724,11486
a99d93c0c698658631e09833bf355717,203,142,1073466,197159,876307,212,148,985556,213999,771557
900a1f39df72000edc5944fa13f10800,83,64,125510,32265,93245,77,57,93655,25792,67863
36b9f6649e95918676ec7ec5d51393fd,107,90,366873,127633,239240,123,100,379949,136046,243903
37d98a72438a374a3f57f66867c6ba2d,132,96,314612,59491,255121,111,86,248068,59924,188144
8df64c668e6a50ff24890a92a671c7ac,162,95,512339,70405,441934,189,160,611665,91085,520580
56f77d0189b3a8d2cb007b37b233a65d,74,49,97469,32783,64686,72,65,112101,36097,76004
93b0061b2f3122cbfa25927ca79e2825,74,68,145076,41348,103728,84,75,175465,36115,139350
60795049c1091efb015087402a666af6,112,92,244795,68978,175817,130,109,269079,65967,203112
5eeb194810b5f0b0d4285b4cb7f08175,109,72,213075,69841,143234,142,118,383698,58455,325243
c89457fd1089318df76be1f349417df5,140,90,308125,81790,226335,165,118,438133,77512,360621
02dc0ab44cf001a2002029edc02992a6,23,16,8972,3065,5907,26,18,10551,2570,7981
b9a4a38a46d600b11f57c447bd2aefd9,177,142,891318,158549,732769,215,156,928665,105637,823028
9691663e67519aad08dfe7a3f8551a54,38,33,39654,12928,26726,56,42,63030,16084,46946
f028c9a027a056c924ed10d0552f3c20,119,78,206617,47030,159587,145,111,296160,58093,238067
f30b6aae71e93d7140aec23e289dac31,16,12,1686,984,702,21,13,2726,956,1770
8b366b9da932f28afa088f8d99021c4c,29,17,17973,3580,14393,17,19,11265,2614,8651
dcf4beb135d29811db722bc13637b128,75,61,124561,55142,69419,89,68,127523,48300,79223
b82a2a1c2e1aeb872d4986e6c339188e,191,129,527411,140600,386811,198,170,819342,210933,608409
d3e4e44658a6d991bfb6129708be3854,121,93,320105,95213,224892,123,87,339538,82090,257448
19cd8d82198685f5a718eb7c1b7aabd7,65,59,81047,21120,59927,68,54,56553,29168,27385
28955a48cee7dbc41a29b540da2be1ee,110,93,234322,38223,196099,81,59,124145,54175,69970
848ab7b99aa6900ce29c1ff355fe9038,116,95,356787,110690,246097,133,109,365137,94304,270833
057f618b25eb34438fd17e4d57d6ecf8,168,100,488222,92647,395575,124,98,382522,122356,260166
9278810bc97d39a072dfd702968b5b64,51,51,75476,25027,50449,44,33,33030,25986,7044
104cc130ecb0e24b068b2f71085669ae,42,31,26718,13113,13605,36,35,31037,9414,21623
01110d465997fedaf6238d685e62fcc3,176,154,644520,112711,531809,145,116,438536,92076,346460
9f3e015fcf489fba6adc768ea1031b44,152,109,398957,114506,284451,125,119,416030,114284,301746
d97946b44b7ad30763dc438c7ecfbca5,207,123,1299053,205497,1093556,194,136,1860207,221197,1639010
79d8ab41366741a86155c714276e8db4,81,70,119730,38376,81354,83,68,151130,42130,109000
eada56657c1bee2d45944b2de9c03978,43,37,38995,18056,20939,36,25,39012,8338,30674
bb4d8a024acc0ec174194673625d0184,39,26,32748,12300,20448,37,28,35022,12935,22087
951bb7990ef6807e2475c21d1cc5b2bd,53,34,76003,25601,50402,56,47,72437,27383,45054
9d91eed3b6fee7aa8e1d715529c9ad9b,96,70,162017,31285,130732,61,50,130057,35603,94454
1a5165804bff37d44beb040886acbb8b,73,69,99463,27261,72202,64,49,105076,22923,82153
1147847bc0df35235878258e8665b03c,50,45,56408,14956,41452,31,23,25805,9605,16200
c3a66cd6a19ae762de94bd054a032d7c,141,95,384611,66995,317616,110,78,256100,55577,200523
a79be1e112ed35cd54eb2f8d4cfac330,161,112,511984,110177,401807,173,125,464988,141708,323280
600daf5c06625d0324c700b3eb327330,73,70,124502,67532,56970,120,97,257917,55636,202281
6ceba97516c8226bc29094c197039ca3,120,87,239507,41569,197938,141,124,259679,48005,211674
45fa0de937bbd83186850141bf1fe9dd,144,107,274571,78241,196330,126,103,349835,78097,271738
74065672129a42ad00ec1b84e3a94ed8,154,127,469046,106081,362965,139,112,520880,146379,374501
8b2e5db57f45fcd44dacd37f02e80af5,46,31,49524,12064,37460,51,32,49707,6918,42789
0fca0c174c975ab5d711457e1e13489c,135,101,486743,149269,337474,169,142,470961,113985,356976
34404060dca479b304322d6e76d4d28b,6,3,1178,126,1052,3,4,126,1002,-876
8f9b6a6be6e753419c91ecf8e4435bb8,175,134,468095,63735,404360,135,99,351301,68356,282945
1c6c6e17c501520388a1234a911ba462,81,60,84013,37131,46882,97,58,145013,30167,114846
370939b613d84c04cd2037c1da583656,46,38,61298,17843,43455,38,30,35698,8834,26864
de9ab8211ed536aff7e6b488b797bba4,53,45,46872,15264,31608,45,36,27748,14511,13237
d64ffebd5c97b84b13fc3cf3558a3cae,53,39,47228,17270,29958,49,48,57200,20711,36489
ff341833986f699175f4a2b99e291bb8,59,52,87117,21737,65380,41,41,32249,17180,15069
d6a46276496311c1e0d57f796a0a214c,174,116,609610,114581,495029,166,139,622946,136890,486056
ec67f562dbe76612b62fc866aa1d7ea0,179,148,707181,166760,540421,143,127,545542,149370,396172
d84b2eea01e7c1d920e84c1925fdbe57,44,33,71421,24220,47201,67,51,151523,22521,129002
fb311eccd3c61ad86d88853d8b84ba56,119,98,271155,81412,189743,129,85,342256,57139,285117
605e4c0710040858c0559c7a973bf1c4,48,35,60388,20185,40203,57,38,60356,21403,38953
bae268c30c0cb0aa2a8ff34c7b53df90,53,48,61297,17900,43397,47,38,35384,15086,20298
3fddbe5fb6861efa54becac3efd627fc,175,155,712209,147854,564355,159,126,531784,132462,399322
30b987a73ac37fda287d4777e8f809c7,168,141,793411,155621,637790,205,115,779906,113963,665943
99f8316997d70c26252bf1f2298952f2,38,34,46423,20336,26087,60,36,71642,20886,50756
7332fb6cf897824ed0c69c81e61175b3,44,40,49783,17717,32066,39,30,37505,19029,18476
8ad016cd86bba45cec468fde60dec2e0,75,56,87650,23833,63817,73,64,102820,30231,72589
11a88aa2429565285f255390898285c0,24,19,11461,5319,6142,24,19,14301,4006,10295
c3478a75b0ed48a1c519e12a9e93cd99,28,23,31165,13904,17261,32,28,34490,14641,19849
7b88cc313141e6edd9b5d4d100f5cd15,132,105,489245,165583,323662,176,155,740885,169111,571774
97be2c086194f50eddfaf175cae2867a,156,100,516850,112644,404206,158,117,629631,130401,499230
cbf7acd2a57dec6ff247a0a8012e5ef1,13,10,2114,640,1474,10,10,997,1129,-132
513802af4c8b105eddbdf7e39f7a5156,107,69,183994,50811,133183,148,94,260018,43509,216509
fe2d7f93fe30b32da7206dca0503ff8d,56,57,118358,37040,81318,60,44,107057,32766,74291
f398a060f804e19a053ab4842c737b78,224,147,881077,200545,680532,231,147,777054,148760,628294
a41325eb28be430aa778727b2e4b916e,191,136,573001,114772,458229,216,172,758432,112131,646301
252bcebd618741569442fe4d37a9803d,193,147,856620,109218,747402,189,158,751038,143856,607182
100185f588962b5a4f347689af38abc0,13,8,1239,1480,-241,10,12,2212,768,1444
9072f047768a5e7859e240ea515dbd86,196,131,883786,201012,682774,205,129,872517,148370,724147
6be55e7df37d16015b7782ca48269b7c,31,25,21333,6602,14731,40,31,24638,6464,18174
e5072808b63d90f3a96842f306323763,26,19,23018,6913,16105,25,22,21309,7710,13599
75fe162adc0cc4ea1ce007d4c9f9a6a7,92,82,118726,27848,90878,123,87,135782,30922,104860
39ec8e14fe352f28721ffe6db9507a3f,177,126,659280,119460,539820,193,140,821089,120065,701024
fd9cb59a47b6d2bd2d8520dfb95f2862,63,52,90393,27648,62745,88,58,134342,24770,109572
5e1c3685fa43cbb00e01b20d999005e4,55,43,71520,15541,55979,50,28,65644,15600,50044
088e7b08c52d32bc451d5bf26ce6036a,114,84,198416,28296,170120,113,102,227573,47420,180153
6b35cfd2449d79f792b6731f395ac7a1,39,32,46893,12309,34584,32,22,23385,13031,10354
5e4522ec96c12e339abdeff110cff7af,214,164,1142656,201564,941092,231,154,979634,203485,776149
33565b8299291ce4ce152d3517171ab7,43,39,45883,22041,23842,64,43,54187,15150,39037
c8cf589aa560dc585c2aa4604170bcc8,17,11,7413,1903,5510,20,15,3878,2892,986
29d6ea5cd4e339638cbb2ae2cc60db44,16,13,1696,921,775,16,10,2619,857,1762
45a844d1083485a8e78017e4985b5392,45,39,59352,21319,38033,60,33,51464,20746,30718
8af4ff1ec60f0fe321eb2a9055cfd4f2,44,26,35723,12383,23340,33,25,29514,7012,22502
f967a4fb040fb280e3cff92cb25f1b0d,21,18,5835,1802,4033,19,12,3811,1263,2548
1bee86686d89bc0cdf387f918785cd45,32,27,26646,9588,17058,29,21,13305,9476,3829
1285c98a4ac8fc744630de25999c3370,150,108,366935,60904,306031,114,87,233697,86644,147053
fd4957e7691420a57f767a8f7c208482,49,46,39572,19811,19761,58,49,63784,13632,50152
eaa753350cbb6b0f4aed444d2461a812,133,92,553358,128451,424907,212,172,804762,156039,648723
88b1ba65cd6222d5554ff0f92f546e41,173,150,608767,103232,505535,155,125,420374,115064,305310
d9086213f698264b97a532d22b486581,116,92,173599,37832,135767,90,65,129837,25351,104486
f810e04d6f33a2f81e1c358507a24ac2,69,47,112773,19195,93578,57,40,76932,28747,48185
e5c22838ff75db7d9249d12bc8617c9a,79,76,87890,46136,41754,96,73,191795,21455,170340
feb748df7d9d7c26b44348d369464764,48,39,63245,26798,36447,55,47,85393,17553,67840
29203e4cc773f74637717ea1feeab7b9,42,31,36411,10822,25589,51,42,41150,13750,27400
bc17d831a9b02dac3ec0c9aa73671821,68,50,73500,24722,48778,57,45,64952,25311,39641
99490c6a0909438003a320f50d7192f5,71,58,123252,54220,69032,94,75,156564,42459,114105
d9f15320cc6244bb61b19b721d2fd0d6,99,80,192800,41253,151547,134,98,195853,51625,144228
5e454a6c9580ea83a1bec94643902dda,102,57,258552,74184,184368,118,85,277924,85934,191990
c7ecfca9ae8764a558baa3d6d88f5ea9,63,56,72167,27114,45053,87,48,71771,21634,50137
80bd11690dc421970d29f5aaaeb1a575,168,114,399835,62302,337533,146,103,306126,63661,242465
f0b3936832163eb4e110f589804b898f,11,16,4271,2176,2095,17,13,3713,2193,1520
b2ceeb7b56e5369eccfd368d479ad06d,115,87,279555,61476,218079,99,68,250762,55973,194789
114b2632fd068a6adbef4db7cfa6d292,0,0,0,0,0,0,0,0,0,0
c0b4b69276eb1df316e0804e868c6ab5,147,101,440488,75925,364563,158,109,453360,85868,367492
148d78a56448c0aeb1a34de1357076cb,23,14,11605,2412,9193,19,18,6287,4001,2286
00c0529a9ff5be2c8dbbfd9e3dcdcb76,55,45,63379,27609,35770,57,33,48877,23076,25801
7eda439c06f567001cf782074b3c7555,189,131,637652,74400,563252,137,117,471391,111625,359766
2837dff522872016ef5e2df1a4a9b15e,25,18,12049,4835,7214,21,23,9715,4639,5076
7dd4e8f99fa33ad8856ffd1c1dcf3e18,126,102,231708,39099,192609,119,90,184533,41849,142684
56f31490dc913c44cbf83d4450882947,43,40,70373,35713,34660,53,45,83432,40849,42583
e1ed28b9e6814e773afdde605c5db49c,176,120,480344,119456,360888,223,141,748601,104362,644239
fca3c435efc894eebb94613aa3b105cd,58,47,93493,27264,66229,81,78,133518,33781,99737
7a5be2049c742d6a7506cb9b73a33acb,40,34,39587,17650,21937,59,54,58901,20271,38630
d463ffb64fadbcb9a52dfed57532c842,91,67,176112,44939,131173,105,65,194512,39488,155024
4df69fd4da642c1e03eaefbe7c5e4d05,118,86,276306,74561,201745,184,120,422482,69507,352975
088e06ef02cd4e8834e050d8797a741f,111,67,233844,67549,166295,160,147,417348,76519,340829
cd08ddfef730fbe3b1889f4c417c2acd,148,111,424730,115220,309510,197,127,585842,109705,476137
f47618e3dcad1aaeb806d5a415396f3c,119,70,211897,45259,166638,121,67,211469,41194,170275
f57b2ff855bb766efc21241b1794a481,125,110,305963,82930,223033,135,104,349505,115646,233859
5c92e8bc2c6d692b39f2904673ae03d3,178,127,574808,147970,426838,157,127,599428,135713,463715
65808bd0fbdbfd5deb0d2a9cdfff0f04,129,85,228465,47060,181405,106,88,172941,68857,104084
a5e360619ed7d20b081e330f2ee6ab7e,125,101,270684,38603,232081,123,105,217719,62409,155310
76f9c5121b3f1f7c1bb9238753258582,117,82,513676,108704,404972,217,150,744455,85959,658496
7ce113a04084edcbb14619fdbe3167b9,35,30,55959,18420,37539,41,31,88458,18926,69532
dadcf4bab3a490f3189b6240e1328bf3,149,97,358611,81840,276771,137,87,322957,64980,257977
eb5a8113b02e0f11dd5a2f171a55268e,39,29,52539,18695,33844,56,37,86314,22602,63712
ceaeb3e33bace2353baffb837d8780f4,91,58,139490,28513,110977,94,72,132338,37873,94465
8b1b88103929dd27c62903908843aaac,40,35,34405,15492,18913,43,40,39375,12656,26719
47a32674ef6a2daacb926d897ca243d8,56,43,66251,21686,44565,67,47,55512,21863,33649
68200717475b14a4a15d5733e9efbd5b,87,66,102795,23121,79674,66,43,62253,22006,40247
849206e13bfeab947796990cde42414d,125,97,374089,62690,311399,149,120,387542,74369,313173
ec1bf08c13fda9cb57dcfdbc22a7990d,70,47,112905,32615,80290,121,99,229386,36213,193173
ee44eebc09eaaf203a8d08d7bfd7b649,39,29,46683,13869,32814,56,42,66581,15284,51297
79df8cd559962070210827753f9c988b,53,35,121795,39744,82051,48,39,119895,46646,73249
01ec3de7433b171880a9598ed141cd0d,96,72,210914,48185,162729,72,63,128734,55352,73382
fcec911ba83b4cf575e24841a2443be6,147,105,261889,47979,213910,113,85,218528,43576,174952
bf6128c5c10e08479f77b17b932451b4,60,40,63558,14798,48760,47,31,54352,15796,38556
f7ba1a4f10731d33672c8859071c080a,53,45,63565,20975,42590,44,39,51192,20442,30750
007a38ddea8b228a10d606348e991943,98,73,174131,70671,103460,119,77,281868,58293,223575
2eef2967f2885ec367250e9df25409a0,120,94,213426,62741,150685,166,116,335301,59177,276124
f95b89daf39796e19174f1d3946d268b,148,106,555809,134763,421046,193,134,764710,172897,591813
c0f1270e86e6c67fe02697f6c254c25c,75,62,93665,22184,71481,61,52,96742,24219,72523
02e426d715e40c0e73726a258be0ed6d,87,65,178911,67281,111630,108,67,258925,43491,215434
5059ab6dca9084d7f69fd380c9f953c9,50,40,59177,21577,37600,71,61,117632,24079,93553
eee20a065a3ea845796947dd1bfb3baa,137,101,334068,83144,250924,131,102,337315,108484,228831
d1914e1eb7a6d8ed85547b008ffa990c,81,57,144507,28371,116136,49,49,88097,30056,58041
d284d8ac8e0bc15bdefb051c008c3420,96,61,160677,32211,128466,80,59,135518,38369,97149
19a7df9a3f7669b34a57d9c358251060,131,104,290162,85792,204370,107,86,217003,88948,128055
accbcaa46975a12d3773b26b0a552d59,39,28,66579,22077,44502,39,24,49151,22325,26826
87d1bc9c9630c6af4e602f7f46911aa1,62,49,81981,22875,59106,46,32,50572,22263,28309
4a01850e6c1b04c78bd91d9d7600aed0,5,6,910,737,173,6,5,737,910,-173
ef954c51626a61ca0dd1403ccce492c7,161,86,453875,104737,349138,172,125,546050,164412,381638
e5016418ec9369d0899607d25a1bc950,79,76,149535,42282,107253,120,93,225621,53460,172161
7aee1490cf20864595ed2d86b8402b87,91,75,250461,38262,212199,114,108,284482,72283,212199
7f3ebf0ec11b5ab1085970489573dd21,126,94,323260,92408,230852,173,136,483570,76976,406594
25b8d496371b9e6615df21d703f04cce,143,100,329575,48106,281469,109,82,194409,63431,130978
b6e8b562bc9efdd7602414b6bfd343aa,75,57,210148,42117,168031,142,101,337603,49263,288340
f7445a82be9460e855485f3bbbfe762e,140,111,493515,144086,349429,184,143,526340,115471,410869
ba31282d8ca9b8a4934c7ef8e0162e77,172,132,614571,98374,516197,179,124,523570,156469,367101
a83aaf09a6b66bb6b9af53506a7ac420,165,131,570031,108856,461175,153,82,449141,88094,361047
7f6402ba830c788c95b6a49b583e32e6,88,68,163153,42994,120159,109,96,272230,64437,207793
6692d411f452d349ef019fb93d81c704,162,123,577662,166215,411447,171,132,720544,146569,573975
d4b4def1a4f3cf9c57237cc8cbeeb308,4,5,1284,1439,-155,5,4,1439,1284,155
452551156ea689c532aaff8f30f7541c,144,119,410773,67775,342998,117,71,253884,57985,195899
3552109ffc9f1a213fb1b4ad95df8ab3,117,75,173073,60797,112276,70,62,125921,45052,80869
fbac9a2f322a080d08e0ba73aa6e63ba,123,93,232652,54182,178470,106,89,236513,61179,175334
6b24eac6188fe3d3ef3f5d19630df73f,102,73,193698,31232,162466,84,69,120373,39923,80450
0f2fd06d57fdfee948cffc6099fb6946,113,95,237650,46118,191532,88,75,153841,55462,98379
8f2041b845fb84ae180709d328233ec4,40,32,50585,16271,34314,41,33,45051,13406,31645
9c2103f3e13ee80f3eff811c523895eb,111,85,240544,78468,162076,140,93,361328,52557,308771
d28df33c24b95a5718c7c5b7a0bb7c8c,131,85,273577,44895,228682,139,92,237308,37412,199896
e5c4c56ce4908b48c18c85398b3229dc,217,132,599995,120330,479665,185,136,600737,122118,478619
575160f84407e23a3bf64e89cb995ee8,168,118,613045,159674,453371,179,149,700466,169598,530868
f04b9e196694162e3c8fc673691dcdb4,21,19,5532,4501,1031,27,17,12593,3584,9009
56bc9efaedb9b61b579b90ae4c2c34dd,143,103,512061,86956,425105,178,118,444840,104876,339964
e039d8eccdd2d6c4d8346e702b08d7f1,72,66,84878,38625,46253,69,61,99004,21996,77008
a759db054c55fc2a7611402082f19ac5,47,35,68987,13542,55445,38,28,35395,13538,21857
fc96f6fb6c96b20e4ecd8620a2922065,81,61,149671,41607,108064,76,57,159469,38192,121277
4182ec8931a31891586b1fd164245f48,71,57,121292,45313,75979,90,61,202078,53828,148250
2c9ec79981e0a4b630b4666de58ff506,31,24,36759,12920,23839,40,38,51796,15526,36270
dec905e31609bc54f2e0edf02f002436,4,7,816,1170,-354,7,4,1170,816,354
e574521dafaaadcce1c24d8339e5f8c2,34,24,29932,7787,22145,41,30,25099,9324,15775
424e048c05ae99bb0f96151f06d6b7f4,44,32,40307,8741,31566,39,35,49784,11229,38555
55c5dd49cd38d58039c6efe44c7be8d9,42,36,42568,17272,25296,47,29,50036,13023,37013
2f07ba6957b0036a835c3122aafdd7fe,26,21,11879,5681,6198,28,24,13025,6881,6144
67db5a1eb8beaebbb143e72f827b0f11,72,63,104728,26223,78505,57,38,58246,23501,34745
f8f8a69e909317d3fcddf8c09904fb00,24,20,10980,5634,5346,26,19,10086,5898,4188
463d877b4c47f17ad3a5061812c5408e,87,83,164633,31611,133022,110,90,212890,48529,164361
65b953006d840624fa5e4e34b15f5b97,65,64,137736,44493,93243,61,50,137269,39928,97341
29ccac2ebd32d4c6a0853ca71118220f,88,67,193013,36393,156620,77,64,138020,36097,101923
a5d1dbe66758b0be86b54554326b345c,38,21,23270,8404,14866,29,26,26885,9390,17495
c917b4eb8a45fc32085214995225d1d6,38,32,30660,13438,17222,43,27,41695,10956,30739
9c9a22d68f3d23b995c5e30ed29bc2c3,36,28,31334,8218,23116,38,31,28575,12592,15983
97e9da53e75d6eac21b2814e44717d82,97,73,165752,36009,129743,90,62,101603,23933,77670
68340d59e3fca104ea65880227d4c586,198,125,598530,107755,490775,144,119,504906,106926,397980
5641250e912cd5c65400c51796f468d8,51,42,47079,17906,29173,53,41,63786,13500,50286
a9b6c8f6c708044712f24b86628e43d1,71,59,145002,49498,95504,115,91,275885,74441,201444
c6d0980a399ca952198548b87b3dd127,59,40,73218,27290,45928,46,43,44571,28111,16460
bd9a539be491a6be7c1398093c8cb0f1,104,84,144289,28159,116130,78,65,113321,35717,77604
217eafb0585d86279f32edc22b349ebb,109,85,174572,46571,128001,106,76,211404,33781,177623
6e13ec784a0c38d353cbcc9212cfed32,99,63,161238,27405,133833,107,89,190449,36401,154048
ea9651a0661e11b312e899b0dab974ee,12,14,3343,3003,340,15,10,4403,2522,1881
81d73b6f1c96fbc4bdd0cb5e5ef42a45,63,52,99862,28707,71155,83,60,102780,32582,70198
4df2c6537ae803ca1c3c098323a7ed3e,117,95,253676,64830,188846,131,101,366416,41777,324639
e6615c86bf1c158121b310cb20b8541e,68,46,105197,18846,86351,64,47,65650,27353,38297
4c43fb745630fb1186bc151e4ad485ab,81,74,198555,37985,160570,93,62,122995,36774,86221
5154b21ec3bfbac74831b7b681531204,113,80,216123,71907,144216,131,104,335313,79177,256136
2d82d8e8ab4d6f8f7b852ed98c7233d7,79,60,132116,58919,73197,114,79,283891,35328,248563
787209cacb8941f8208fc73e13d600b5,130,94,241756,61558,180198,163,118,341917,62456,279461
61e9adde3a8efe127919b7a180d87959,97,76,164815,35429,129386,102,90,183639,35446,148193
39b05fc1d8051041d03f126199a3a6e4,137,106,257440,82881,174559,118,77,192600,71061,121539
bca6da272b7a536b3c45e7b6485cc328,28,21,16404,7050,9354,37,29,14312,8048,6264
c7b26a49aef566894509c14de266105f,183,111,612255,108611,503644,139,106,498194,113064,385130
27b0078d70f5ccf0cb0c614e59d25955,86,70,253376,37099,216277,128,103,235797,56168,179629
459638ef16ce90e5efd1e4aed5e4ca1f,106,74,249397,60305,189092,86,70,172532,53282,119250
24ffa465285327a3e3d9845d018587d4,87,61,149083,36651,112432,87,72,157056,44620,112436
da6c9b63e8ec08bc5ab30f197b340fc3,188,159,848876,172328,676548,206,147,759312,121969,637343
0c0682f6162d3a13a06e75e32a2d498c,31,27,22095,8638,13457,31,23,24355,9243,15112
e692de4ddf76a0ebe1411029962ad00e,50,34,58098,25245,32853,49,41,73802,19572,54230
8419eaf0a0ddce787cdf729ad42ea611,43,30,39922,14824,25098,43,31,47218,16027,31191
d803336e655034c95ce0c6d95b1caa06,152,112,403154,70315,332839,92,74,222381,83553,138828
7e4c2e6a49b1711ec3791bd120ebfcb0,91,71,151923,60389,91534,104,88,233855,41127,192728
f55dc3f79bcafd81bc701f8bc9c88abf,24,21,9897,5127,4770,28,23,10166,5137,5029
eb26149471ba82023b3375837fd0ab5c,218,183,1068276,220793,847483,194,120,739061,152240,586821
01c106af6ddaf376d88bf2e63e3a8bcb,23,16,14544,4502,10042,26,20,9679,5801,3878
23b2a180830b8136ddad2bb5eac7df48,17,14,3274,2920,354,15,15,3637,2407,1230
8e25c93718dcc3a96d75b7e8344ab964,34,23,26942,11529,15413,29,23,26080,13235,12845
9cc3ffd045acc5ec6cd57f31317fc2fa,116,79,260502,86536,173966,146,84,319457,56229,263228
580a87ee7af1e00b1420744f21ca6bb1,135,103,348230,54516,293714,128,94,439855,65171,374684
a4627eff24cc8ef658f9bfbdd0d5c5a9,109,84,212484,59135,153349,84,44,138172,40282,97890
334e8ca571096a152dd9995318f56b6d,93,87,240294,66166,174128,105,87,277743,51866,225877
eaa8817e5b4caf4af5e6264b637492a4,100,77,159833,46870,112963,75,54,107214,33835,73379
e51b12a796648cabfe717fc1e05deac7,36,27,39431,7280,32151,41,29,33084,9762,23322
de6fbe8b96d57ef4701f078e9049c377,93,70,191223,44744,146479,90,80,175180,54692,120488
c3f592f1404d29dfb8ef6d46bd770c01,3,2,252,111,141,3,3,312,252,60
5828f68903c3a05aa47fd0b845e5c024,62,35,80918,24735,56183,47,46,83573,30666,52907
37e4bbd6ac7279d9de751bd8eb434a83,45,40,58088,41061,17027,129,95,239198,39689,199509
3a5cea4039f043cdf46da248fec8d490,40,30,21693,10405,11288,30,26,20562,9692,10870
181e51f353e84000855f0a0a2c5f52d7,54,55,53814,26837,26977,73,56,83395,32962,50433
c07d0b6b26890bfd83de2c2240682ebe,190,142,505788,85262,420526,114,79,373473,74213,299260
1f919912f7cfefe2e02dec6859dc9e76,129,119,428359,101386,326973,145,120,458761,88959,369802
fac4c2485b635778aab1fd2a78c388d1,55,49,94092,22363,71729,35,27,55085,9536,45549
4caf630d2795bf910d956a6ff032913e,16,14,4240,2358,1882,19,14,3565,2718,847
18a46b6eabe89c5aac65e6d5d21d400d,138,114,368898,68980,299918,134,99,287443,58890,228553
e4f90f1bdba09651909666c98e5136e2,12,16,3335,1460,1875,18,8,3730,1096,2634
86945821f37e357ec5fea14e222bc38b,28,30,22487,8346,14141,38,23,24404,8621,15783
6163d9d1132cbbb42d4f949031730624,133,97,296028,58820,237208,104,76,195639,51644,143995
bd3d602c8943f73525e185dbe7df0950,82,54,117642,34261,83381,82,63,151481,27450,124031
a71ac40d63d5bb66c344bf80b3261ca0,18,13,4999,1325,3674,15,12,3148,2765,383
11adabee27de9085baef636651ea70b3,21,16,8672,3613,5059,24,14,13543,3012,10531
c783af5bc543da1e5b33af4f9bb3f392,26,21,8377,4445,3932,27,23,8126,4116,4010
e8b9623fbeaafcd50c88e2b9d1130e85,99,83,219966,61324,158642,132,100,294183,66887,227296
c25084e7f6a63e8f0ee880dc4c947d51,23,21,6648,5006,1642,22,18,7451,3685,3766
51c1c4ebca74012757478dee1a97c86a,94,72,200914,37682,163232,99,89,173997,55521,118476
01dfa53772d31029c39e4b3a1412f338,44,37,39662,18426,21236,35,30,35001,13659,21342
dd49a18ef8089e4108419292e6937737,53,37,60705,18490,42215,74,54,98016,23447,74569
f6f3e20e03d3fe77feb64065b255a8af,29,26,15653,5175,10478,33,22,23391,5258,18133
241abfbbd251b78443bc4dec8e4a5489,53,42,67381,26861,40520,56,47,51706,25472,26234
0b37acdea22e99c9538ed07e38aad636,133,92,306370,55628,250742,130,91,260594,75329,185265
c98480ac4868a405dabde4e15d37c386,96,79,296728,92276,204452,79,54,237218,70973,166245
6a35209e5f9a2e2a6aec2469bfd9ba54,47,33,73093,15177,57916,28,24,41481,12226,29255
cd9e4eeaf3c9190259726b07e96c9009,16,15,7416,3093,4323,23,19,10718,2183,8535
0b35446c927bdbe71c17df971916e67f,114,86,282377,66684,215693,153,117,362579,72921,289658
2c8caa18721eec2da7fd2a6e2a760019,47,34,65388,22489,42899,56,52,72006,20441,51565
c517fe2e2a63775fa7848d66546aba79,42,29,50839,24335,26504,52,35,52637,17463,35174
7687b41ae534b9734a69da3c89619890,199,132,659634,161348,498286,160,98,764443,185435,579008
9b2dfbdd13fee22d2c3b98149e325a1a,64,40,47761,11260,36501,62,46,68400,12749,55651
346c741713ce9ebbfd5e4e7def0988b4,78,53,112758,31586,81172,96,71,140561,30985,109576
d773a6911d9710e97a3691998ffc2050,190,116,564020,96640,467380,186,143,717486,110436,607050
da24d8e6d1fe4d3022899a4bc052a8a5,79,63,89163,39625,49538,96,80,162701,27422,135279
7c6cb4e44f391323be4ef6f6a0b9f7a6,74,62,98637,39394,59243,68,68,147920,34429,113491
04be361cd082d4f4bd73b48e109a50b9,61,38,70668,19785,50883,70,45,92700,22069,70631
e9c7aabf8685825bff92da251c7ac562,37,28,29811,7487,22324,33,28,34072,7696,26376
47d08e7a258e588ee340dca4824dedcf,134,102,336434,90801,245633,184,139,548076,79687,468389
4c56e0b148bbc0a99c18abb054e4f332,64,59,126709,57054,69655,119,81,209095,36688,172407
01552a096aedf5630de6e29da5ae4000,124,94,207921,58842,149079,132,102,223044,68741,154303
1754635767d8fb53e19ed1628a32729b,102,77,154411,35364,119047,98,77,159211,33980,125231
90ef216b200ec4d3d7266e6df1f9c9cb,75,55,75189,24883,50306,60,58,69756,20262,49494
e7c057c466fc2d8a7ee782675a8972f3,35,20,27434,10688,16746,30,30,29168,11205,17963
e1072ee657d8d886295db94028dee0e3,129,106,235086,52077,183009,117,76,174386,45792,128594
93e5667c4f73246ed7245cda93289c2e,102,74,179474,82721,96753,138,114,341942,80848,261094
8683a1d20da8b44634a3acc2f8f75975,84,43,95822,28392,67430,91,50,103090,33916,69174
7e4ba8c98eb7ead4a5ba610b39c3c8cd,70,53,102649,30589,72060,84,63,141377,18138,123239
402873c3b0e8aed14c222630eeef9b5b,23,19,11219,6075,5144,29,17,13993,4465,9528
46522db9bad5f4c89ee4924776d5b7a0,38,32,44629,17277,27352,43,31,46226,19381,26845
365254331f8ef24c066cb8024f22d2ee,51,48,60891,29227,31664,64,35,72597,18466,54131
0c29c41dc0f457045506c5f0566010ef,75,55,116604,38663,77941,64,55,102687,36548,66139
faf5e89c4bffe6fda4029be0b89078ef,77,66,121604,31956,89648,126,105,194254,37365,156889
1b31f1c45db7d223b1a2cd2c7336cdd7,110,81,211714,32657,179057,78,78,149800,37591,112209
747c2d90371b91a1f0bb1ff9b8723c79,139,110,339731,77984,261747,166,120,431703,69436,362267
85147939bbf8228e959761aa3f4f06c4,3,3,406,190,216,3,3,190,406,-216
3e01d6c3dcc8f579c8da58b739bd83f7,100,88,277898,53264,224634,143,115,309088,60771,248317
9e891a55596926596a0cfa18fb1b61df,25,20,12575,7162,5413,23,17,12108,5889,6219
4e08c64f47367b3d7385b220ed572c72,42,35,84361,16975,67386,39,30,42539,12147,30392
1913bda90f0fbb9a91542fa13d38c317,71,68,150974,60833,90141,124,94,274293,65516,208777
2b5148a1f529390bbeb434f5ea0184e8,192,153,635183,135237,499946,154,115,742194,120542,621652
eda069ba6273ccb2fe28245f3ba41107,23,18,6061,3412,2649,23,16,5034,3415,1619
52f5358abd549f7278fd36a0680e3e9b,78,66,110726,29499,81227,90,78,137018,40553,96465
4e5f6426d5f087e28cd42e2c3ec21030,44,32,44042,14644,29398,49,34,32668,15237,17431
0cd2528c21418bee737b32485f3c00a3,68,49,53021,20018,33003,52,33,50660,22392,28268
eebb948c99a273197d33a1dce5d302c7,142,107,343852,84690,259162,128,96,317052,116099,200953
4b594e600eff9ae1a3a9205ef022c4d8,36,24,33621,11970,21651,37,31,28573,11922,16651
f602783578abed321e5fdfb0bf41f7ab,160,128,424412,81862,342550,148,101,452318,75592,376726
493dca08464c491d8f7b90500787fc89,28,21,26112,9127,16985,32,25,45425,9614,35811
c43b3b4f1619f9bfdf32d3bbc55c6f56,71,55,116694,26530,90164,60,45,84624,27064,57560
b55faa1bc98925c8939c7e6a527fc3cb,30,21,14596,4343,10253,31,21,13708,6484,7224
48d8ba3a60ed56ce2f470cc64bea22e6,94,79,195709,45652,150057,83,73,151111,42506,108605
adee683344cb232ec6c7dc0b6b73ecee,23,16,7256,3062,4194,22,18,5129,3663,1466
15c3d6615352abf3bf091f1882bfabb1,197,139,590169,169925,420244,184,121,916960,132401,784559
3eb014e58dc05ebb18526f83879e7a56,67,54,109062,20724,88338,73,59,111889,30556,81333
2fe66baeeb1b9cb6292e92fecb86d856,107,94,241471,81947,159524,87,81,234877,68708,166169
b4cf2d86ae8e10ac7a81ba975194a5dc,157,122,503849,105056,398793,188,141,719246,88549,630697
bce28c2fb75decb0043195724b01fe08,110,83,229618,67518,162100,135,100,333109,60233,272876
daeb4f6d32f7c0bb9ae2cc594253c518,84,68,137343,29297,108046,70,45,93176,19911,73265
ce54a1bf6cc7111e563b051f4fcc5d25,170,123,671557,134394,537163,183,143,599744,136217,463527
d1b1b0d8d7b5e28f93da5f67eec3549f,33,25,23098,5286,17812,24,22,12072,7985,4087
f19b3148af57721d9cc8942515dfee31,36,33,44538,14153,30385,38,28,40389,10299,30090
a1610dbee21b9c3d199833ac7be2c7c8,142,106,455548,167992,287556,165,123,509504,152215,357289
d50383e343708e589fd25a2a63a53c6c,29,25,21218,10714,10504,33,23,26800,10888,15912
0f64d937c89fb415e2ba8b4283e03e9e,150,103,395652,73920,321732,146,91,291279,97430,193849
f0559684a519de52595d811c6cd7774c,114,81,469878,132724,337154,197,130,527210,128474,398736
c4f7c96825a13f3d2f5ee8baac89eb55,99,90,261014,77039,183975,134,120,346112,62537,283575
5675b52e7625d0b0498e3fc4f6b32a0b,38,28,25250,7505,17745,33,27,21392,8437,12955
0a76f2fcd3e92173f98266704f6d2a00,65,52,89479,37597,51882,73,54,145573,30255,115318
d008a8189ccc4bb7aa07dea12d0d1e2c,26,21,24160,8627,15533,23,20,22878,12280,10598
9699ac992330b1a8a528f72819fcc633,164,117,710652,117829,592823,186,132,620801,110360,510441
0199b59e2970f5e6c2b366a87cde3a78,88,66,135127,32466,102661,59,49,103904,34101,69803
d8641ec1c181fb56114d3bffc788b88d,89,54,129175,39500,89675,99,81,172926,35543,137383
6f73efecfc478d3e141c5326eadc7204,79,64,99900,33638,66262,84,67,116465,28355,88110
bd4a0d7042ceef8a3b69e9122d3aeeb9,85,69,109154,26614,82540,55,48,71717,20318,51399
2c18410da62b785347652e0bd34258be,92,69,142843,42935,99908,89,57,131623,47511,84112
9dcdf8c41806452c261b5949b1a5518c,195,131,443247,125254,317993,151,114,471281,101018,370263
a0674ee2b905cb6d0515e3cf3b776a88,124,67,236483,44370,192113,54,45,112994,56342,56652
5e8afde19af0d70359155a4524dd5cfd,190,156,872190,198606,673584,224,149,883204,164066,719138
2d67e083c36f2cac7bf82336d6a56777,61,42,81148,20478,60670,60,45,58896,22338,36558
20f214a801868bbb8622c4b4d5d51b0e,137,114,610098,105840,504258,208,135,700881,92219,608662
da00326de49e677f207c3b985a509ebc,115,93,308088,80655,227433,124,89,390240,78959,311281
5db85a57443a232c6bc9b379761e7b22,58,41,88958,17144,71814,43,27,36541,15322,21219
26ad637b4f6e6a68fda44496aeb851e1,111,67,195339,35438,159901,103,81,197931,53502,144429
cf54ba1da90c9bebc2c4518b6a9bc48d,104,94,276833,59580,217253,105,94,207472,69895,137577
70e286143a5e5e5e3a40ef889de43397,82,68,198667,36279,162388,107,93,185358,55665,129693
8ae33950621583a8627b77459885e2c5,91,76,397613,116077,281536,78,60,345593,111104,234489
92ae1d0b89158fbca5669a233dd6a3f7,90,82,303748,65731,238017,125,93,241896,71051,170845
e0f7431ec7d9de24ac64cadd28b59aad,33,25,22673,8569,14104,26,24,20419,8181,12238
0b366363d8127aae70b9c706b96c45e7,113,73,271361,70639,200722,100,78,204455,60034,144421
07c1c37daee2491077dc4698f12580b7,82,68,133837,43549,90288,130,102,203707,51017,152690
103e64bdd39356c0e48c9fffb1eb7fc8,28,24,14104,8607,5497,33,21,21078,6271,14807
59f10a818bc7e22e3017a827e388b75f,33,24,26913,7627,19286,36,32,38097,10803,27294
7416ba89c8e8dee373ef63dc6f893a90,33,26,22079,11658,10421,23,25,22343,9754,12589
0c10715adc58258b754fac56af4be901,112,93,268476,69274,199202,129,82,282659,56334,226325
deb70b5489a9a2502c1b7fee3865decf,138,96,326830,71076,255754,119,85,287222,82343,204879
f271f6cd328d79f75f356e493e74aeab,103,87,161854,38346,123508,106,89,172309,33142,139167
75501c09049364084232b05879370082,74,66,92043,45033,47010,92,79,166517,44698,121819
077bec5b525e5dad02c2d6ee8b907de5,141,119,311952,48742,263210,94,85,189169,50340,138829
363a9491463e6d4c2756b7647f7dd792,26,22,11415,7488,3927,27,24,17386,5874,11512
9791054a518a8c0593d6a9aa15ef187d,122,84,204502,50233,154269,130,89,266241,66133,200108
11f9981c4679f74ce6b7a9ea2d2f9c38,176,136,500325,108377,391948,152,98,436050,92084,343966
049974ebea2bf34cd5997109ea924937,124,106,420707,104086,316621,137,105,630168,106421,523747
9fca5bf1fecb80e9a84c72ab977ffc77,52,43,71425,12181,59244,42,33,32286,17636,14650
ea1acbe4b51f0e1fe56677ff865a9fd5,31,24,15606,5772,9834,23,21,13129,5484,7645
582216f3ad5658db43c5a102f0a7b43d,128,86,333068,98857,234211,167,140,512778,109287,403491
322c0eb96959fbbfa1f07035c946a7b8,126,101,428562,94399,334163,182,138,481143,69476,411667
a4e26ff8ed7f90846de3415f9b52e5dc,10,7,1265,586,679,5,8,539,1165,-626
2c4112cbd8b35f83b58d64ac7a78d1b4,17,14,4187,1363,2824,16,14,3193,2657,536
d2a186f17d3292ab795445f5aada72b6,38,35,33320,12046,21274,45,29,36970,11270,25700
8ddbb5fb88af66ced4fdf9bba514e1ba,133,105,393599,69281,324318,156,118,404889,65688,339201
8ecae71195b660fdb75bc74192e37258,114,95,314905,101893,213012,106,71,286314,87232,199082
99278bfc10f9fed276aebad6ffbed09b,130,103,324380,59472,264908,99,77,204389,62384,142005
de5ad3f77f984c132291365400126bcd,177,123,443367,108251,335116,140,131,374254,117523,256731
6eac3d28378c4a2596cdc79d51707204,96,67,107679,24498,83181,96,83,135615,40943,94672
3d7b6136167289a0b22047e9c2ed34c1,43,34,50014,12587,37427,40,33,49601,16139,33462
a623c956936938e22b1f9f69dd973b26,151,123,441837,116162,325675,155,118,388594,105986,282608
29fb0004c293911b51b762adfd93226f,43,39,26959,13220,13739,58,41,56574,12522,44052
0f1876840c38150694ba281ec928bb34,122,79,329942,60240,269702,121,95,253406,60765,192641
35f07dcc9cf19268a775676d724cf291,39,29,43854,17324,26530,33,26,28780,17123,11657
ce74f30ba41ca39b86b09d340f206707,83,71,223833,57885,165948,140,118,311802,74950,236852
8e6b2fe084efa177bcabde3e94a839ec,68,49,129398,31577,97821,55,46,85229,27359,57870
7b117479959bb51d34353233a267294d,31,19,14354,3797,10557,32,23,20490,7406,13084
572b37af3e9cfccfa288158a1c4ca9df,123,95,278231,39121,239110,132,100,259152,58064,201088
0a9bd481edc1c29405cc456a5c0bf476,65,54,97302,29932,67370,65,66,116566,26881,89685
7f5088e40ab54ec27945279e5a287498,107,82,198795,56143,142652,106,81,194997,50684,144313
9da1468d0512181bd65becc0b2e1f6c0,61,49,51098,22581,28517,56,43,63483,23014,40469
4f84e7ace1b7a4a3b9d596a6e3e17137,55,39,47479,13787,33692,46,32,35690,13340,22350
68d65ed594a6d0f49088afc611b9c27e,21,17,8139,3084,5055,19,16,6537,2914,3623
8c604d92f575074c367eb7705bb70fb9,68,53,91768,35675,56093,88,75,136075,35981,100094
b12eb70138efc136316fca6548d2189c,54,44,94499,31075,63424,63,53,87708,37809,49899
3d0fd826ecb4416ae808ab0208e1dd83,16,10,2733,1421,1312,17,10,2162,991,1171
cfa6ec8ce9a01a8c61655ceea6cb9956,168,145,534662,145984,388678,203,156,952098,147530,804568
9e3c9bbec77832279f0cd278e68de820,166,130,453059,115508,337551,137,98,424958,88947,336011
a35c66e596526f59189d4b727320909c,114,87,227441,79712,147729,130,93,328831,60352,268479
cf5c84e2842bb24ad274d5d06dd97571,180,142,634345,112969,521376,167,123,559366,142364,417002
be773eb6189b73391b1e692c5061f5ea,33,22,17511,10625,6886,31,29,22556,8053,14503
fa69acd5ce2788f9a2de93e127ae88ff,124,103,301202,62520,238682,131,111,283647,65691,217956
1aced2b5322935c6a03f9a6be1643531,54,42,94162,25877,68285,59,50,88628,30517,58111
ae318e8b2cf4351a170d2578511f226f,35,30,26758,8371,18387,33,27,22288,10894,11394
4b52d473dd7911c1ad116ef5b36b493e,135,112,420149,93525,326624,127,96,320013,78734,241279
6e333d47d1158b11ab6704df9037d480,114,107,324208,77318,246890,134,101,282692,56078,226614
e8b15e00b45e04a1a073ebeba3c477ec,21,16,7440,2827,4613,14,15,6368,3713,2655
4705fc8610474b38c2f2eb5b59fcec94,108,85,327954,118852,209102,111,76,404958,98249,306709
f246c5f8f4a7117a71605a2c2170fe38,81,56,163924,34939,128985,81,60,153085,54075,99010
70504b5b4b057831da731b9721bff676,91,63,144170,27774,116396,88,69,117612,31675,85937
c0ba3739869c3ca9a9433bb82481c326,38,36,39020,19358,19662,39,29,45648,16231,29417
725d8421f4d7b38fd0999416c825aa95,99,74,173748,64875,108873,82,65,123176,50000,73176
13511e4f54659264a285342bf50ca02c,147,95,663878,135055,528823,169,119,714928,105055,609873
f926932b4a3173cb50bee6a8fce123ea,43,26,30342,7412,22930,43,39,52893,10665,42228
f61b46143a26cf7c0489a6f87c6dc6c0,6,6,887,330,557,8,6,1039,632,407
e1d73201bb6cc7c326ad94a7998b5367,36,24,16782,6572,10210,27,29,22807,6875,15932
3ef03ca2202a439203be12fc2a93aee4,183,137,1045280,191742,853538,161,106,931185,158150,773035
75513e8eb813254879c9087886aadb62,192,158,811511,147565,663946,214,182,860495,152626,707869
597c88c711f89c6174db790e549dfc02,58,54,74240,34856,39384,70,39,75338,20300,55038
ad90995258cf7080c30bca94ec3948c7,88,63,145135,27906,117229,90,50,148987,35609,113378
6747f3e8114b3403ce9dda1603cf0ed9,139,108,363278,120886,242392,114,78,321412,90020,231392
51c0080818de5a79576c36bddc2d819b,138,83,250575,35035,215540,111,91,242274,49215,193059
ee9c087f9e43ab0df941aed3b9474fce,198,130,492363,56062,436301,146,96,330897,104301,226596
2490d3eb7e28816547cab94041a02151,202,120,553862,63893,489969,156,121,321585,79211,242374
a40a9f87e65b50b72eab8d80eb2a3dd1,122,95,362125,63121,299004,110,66,268163,59423,208740
13f1539d08f7cfddbd20396c91d4c658,120,88,255686,71516,184170,109,78,199138,64602,134536
1e09986238ff6feb9315daa50e31fb6d,123,93,268976,61208,207768,125,86,327620,60425,267195
3333ca08d0a838e61709c99007e531c5,61,46,63483,14873,48610,74,49,105386,18144,87242
8225eb5b95aae15f5778e5b69f4cacc9,54,44,71528,21815,49713,54,48,82155,28792,53363
382d4082b497d21d5951afb17ac3a682,140,95,352337,63138,289199,124,84,318310,83198,235112
060db939f4879461381275f517949954,90,69,157414,28327,129087,61,53,91107,33761,57346
f9e4f0440a4ec998ed8226b73fee65d2,110,83,243199,66675,176524,122,102,271305,68978,202327
d00a4fa67cd08b3e380fb1bd3927b75b,159,127,385679,62523,323156,132,89,269290,59942,209348
d56e4e6a4e210c639470c8fd10862506,57,42,70002,20608,49394,55,45,93363,20904,72459
82508b0b1d6c0edcc70e040ed291d66c,24,21,12775,7089,5686,30,19,22417,5654,16763
8c52ae97611f60f304615a97155f607d,68,50,78824,28631,50193,57,46,77858,25005,52853
45d4159d591604dce285b5e75f56a850,127,114,345306,92242,253064,89,64,201037,54751,146286
84650f34e2ddf119a3ae1c5f2305400c,167,131,649075,164281,484794,163,134,582520,158108,424412
dd8f76abffc79096ca18cf65c7b8ed68,91,57,138027,45171,92856,108,87,179511,38576,140935
c385e48fe0ffa0edd670d5cb84b710f8,129,107,351820,87098,264722,154,129,455347,67401,387946
e94eb4fe0681277fc15ee7a53b6333a8,155,106,335549,76259,259290,157,137,409134,90031,319103
25c344e9166a787fc0f4d5fe517711b8,54,40,48025,13468,34557,43,29,25821,11566,14255
7d5a8c730552dc7b9ac6c778d075b102,38,35,22829,10207,12622,35,31,25424,8137,17287
5eb70b08cbb8296330051881be63c2ad,221,140,902869,184825,718044,220,147,1171223,140299,1030924
472b21e4f536c06bac396241b48634e3,133,105,344247,107770,236477,80,68,218791,85410,133381
8912b5a6ab0e96945d46b16719fae624,194,142,805621,135892,669729,202,164,668287,154316,513971
727313eb8fb28b03d7f42d1fe12497b1,145,109,665627,180996,484631,175,126,846220,180813,665407
8d1df704807ce7a5f2a97b7490912b71,97,71,190232,57499,132733,116,88,289860,42159,247701
321ae16681413e8f9d2edbaa138b7b8e,99,74,250996,48117,202879,156,128,354110,61054,293056
e2c6aad819f56da524ae70c100e55232,93,72,146151,41580,104571,69,48,109045,37531,71514
ac3541028e4d92d910659cafdc60ef09,26,25,15033,7319,7714,30,20,18064,6730,11334
e954a88fae690d05e789b8aeacb11481,130,128,319476,115805,203671,132,83,274566,63114,211452
693aa34d5a0794f9066e4aa85ecec36d,71,47,101576,17054,84522,70,47,78627,25335,53292
78e9bb645f11460adfd8a8db94c96def,83,72,111944,27291,84653,89,70,141892,46162,95730
f0d8b0b10a688ea8e5d3b7c2ec1213dd,84,63,107644,33829,73815,79,54,97513,37844,59669
27d10bcfcecea937e920f9863d3e363b,93,62,181597,61321,120276,126,93,194158,56801,137357
1ee6d25935aa418ec8ffe7c7c7878dac,1,1,38,39,-1,1,1,39,38,1
8b4d3126826d414429baad0f2128e21a,116,87,296167,57143,239024,106,89,255518,82187,173331
f65280190bb26dce99e3eba2ddcf637e,89,65,126971,26853,100118,68,51,82056,36074,45982
8df30b3e17a41232e546a00dfeee14a7,72,68,220391,55405,164986,192,154,433054,73941,359113
cfe6e57532337c31a0f1d87c98ef8a23,174,139,995224,159375,835849,198,165,1185783,165387,1020396
a3ff63516e7633e7fa7b385b6bbc8ff2,62,48,79610,27382,52228,65,54,100139,25169,74970
eaf6a6bb520f738b25c0d285e8afb59c,40,37,73587,18458,55129,30,26,30760,18274,12486
b59b5c41cd5437ed968298d3aca45133,59,48,109235,43551,65684,49,42,97641,33824,63817
654cc50c57a897cb409e819b212e16b7,171,110,413382,80526,332856,164,131,469185,87725,381460
457b9d26408cf46b62ee111942c357b6,31,30,20818,6456,14362,26,16,21272,6140,15132
e0ddfbac4bcaa9e19edb84bef1478012,96,72,126146,52505,73641,96,81,184913,50353,134560
c36018e9622fd1c044444c8124c49d12,168,143,462598,79881,382717,141,130,376982,81587,295395
31bc03c265f08b64eb6f00673be9bfe7,158,106,450550,56687,393863,156,113,416212,97976,318236
69c3a3af3ae053b116ae69a4915ab397,106,70,147397,38825,108572,90,52,136252,29263,106989
38a6340360d903e763e94a0178c4c840,138,118,288680,75471,213209,112,85,206824,66283,140541
f9c12ad4e51d0bed884ef176858c5254,99,80,329898,102618,227280,147,119,412621,80629,331992
0ede8ab71be537d1273cdc6d9a72c4aa,72,67,94376,32538,61838,72,56,117905,25735,92170
626d1b17f9c1921b9ecd4cb732ccd7ae,83,67,124906,27530,97376,109,66,138239,27553,110686
671bcb894bc37cbab09bbe2a17b99873,97,83,220165,77911,142254,140,92,292514,73327,219187
ad3f39bf07c272e840bd5c8279a05867,57,38,70782,16746,54036,39,32,42322,13710,28612
aae87fccd06a8e300f8923718ac18132,22,18,7976,5045,2931,28,22,11707,5029,6678
e2c580884072510de38989470cdec7ab,27,18,17521,4204,13317,25,19,13147,4998,8149
4a69a93a627f5a1fec2ddaaf7fb598da,14,8,2921,1069,1852,11,9,2433,1947,486
6e894bcbe51fb2dfca139f4b738e04dc,120,95,272857,55571,217286,119,101,246063,59601,186462
afb2fbb177afed492fbd231de8223700,103,87,172827,43134,129693,57,53,77043,40694,36349
b1a23a2646dfdfa31259643d1b8c172d,98,73,175544,38343,137201,75,59,94851,40357,54494
95ff9270030f7366e2669f131f7d991b,31,25,22269,5338,16931,34,24,21691,4606,17085
1c7e3dfa1d892bd4d9587fe857b392eb,57,54,66218,23412,42806,67,49,71480,18448,53032
705ce31aad0f9a7bc2458e7cd941d68a,26,21,12003,5977,6026,30,25,14047,7027,7020
940cdc4dd27baa0328d68241be4a1b3b,115,88,248176,47166,201010,98,77,175066,35666,139400
7717166c8146919557ca5f1715fb0cb3,58,49,55523,18852,36671,47,40,61464,15447,46017
a399c4f8c4b6a4a1fb0d28f892b3332c,174,127,586210,132925,453285,147,105,502809,100424,402385
d97739007ae81a20a65d35d0c528dd33,31,24,18181,5580,12601,44,28,22780,6739,16041
dd1cf05c207a651db03b65dda9fc1321,189,138,492906,99005,393901,145,118,425022,122041,302981
80d92bb54a469bdb546c0b42c45974c1,54,42,59053,21866,37187,51,33,63894,17899,45995
6d7f131b3f03e9f31adbba4c0dfafee3,135,113,363161,82840,280321,145,97,288934,46184,242750
26943b2b4c7494e93be3fa74e4a3a980,64,43,73616,17249,56367,48,37,50385,24837,25548
5e141a38223fb57f28c6488eb7110322,40,28,39638,12629,27009,35,30,24209,15618,8591
2a60d548b6d1d3988aa361806ff45cb1,20,22,9601,4847,4754,30,18,11790,4412,7378
3a19649181e558f6ee33a020274ab590,161,121,670605,136673,533932,202,149,691641,130931,560710
65981380dfaaf08b9e3b390cb9c5976f,73,61,71353,34510,36843,75,68,83814,30485,53329
e034221e0d24ff4d5c7539ea5d2fb2f8,52,38,47485,15275,32210,42,34,40071,19895,20176
34129b68c48bee81797bd04cf154aba4,79,60,138495,25875,112620,105,100,177285,45196,132089
92044642372ca9f89688829e3be52849,68,57,83890,27743,56147,48,40,62719,19186,43533
f337c41e7b7aed6208254725ada5b665,78,51,116963,23674,93289,66,50,76138,22568,53570
71428ccebaebbee31f63efb381979411,49,42,68595,14412,54183,48,43,52929,18803,34126
2008184187fbde25d69966a618673da0,99,69,216950,95200,121750,144,108,431336,71333,360003
0abfee39ef87b3b0e6d93c50f76561d0,173,143,616136,98470,517666,166,124,559874,133431,426443
54ba5d0389fcf45c602eb4aa9da4f67c,146,117,455529,121758,333771,153,119,562642,131198,431444
d0d014100f69c9e1bfd85fb8f94cc313,28,21,16732,5055,11677,24,24,18607,7209,11398
9b7cd96a0e2be74154c5109e7e6ed2df,174,100,450188,81933,368255,181,145,594630,135529,459101
b5e366450c509c9320ed4afb10e681d0,136,88,558495,131526,426969,203,114,586454,112206,474248
a5f4d304014a7bbade382505fc8a1514,115,79,266413,82009,184404,113,80,334179,71677,262502
6207e54864c659be75f89ff2b7a7053e,143,110,389299,64910,324389,103,86,198858,88092,110766
0eddbe75d1bc1a0350bf48bb701b8199,59,51,73528,23463,50065,82,63,108065,28031,80034
f5469b71bcdd59c00760d1f7cd086d23,85,69,129495,23666,105829,92,77,94457,20877,73580
4b34e4e7cc0af89bd260e5371a3b4723,121,91,253549,61608,191941,123,100,277130,48928,228202
07f77a90a0575bbe895ebd06ac84e2cf,56,41,59830,19311,40519,46,40,52030,18481,33549
7ba1686cff7610fdd18f64d27376b39a,157,130,481396,110070,371326,191,146,502039,89853,412186
65ab2759587717a6dd83a9e22e48aa22,24,22,18544,5753,12791,23,20,11901,6109,5792
29ed50b24aef6a73fe414170eee8cc14,29,22,16729,8342,8387,30,21,20795,7520,13275
495a444ae38180dbe33567dda8ec5dee,111,87,188298,33394,154904,74,58,83870,55418,28452
a486a9fd4df0c2b3f189707ddf64e81f,76,52,96395,18927,77468,69,57,113939,31285,82654
0fcbc478ee225364a1aecc8f9d97a6ca,159,134,632564,100562,532002,144,112,507146,83129,424017
08766f90e9cc780e9e8d663c3f742aec,102,68,214206,75474,138732,138,88,313973,99172,214801
87f686bf653c022bd7e30569ede6c143,35,33,47931,25982,21949,43,32,56168,23988,32180
3adccde86158b5af620b0a4f17a402fb,57,42,94149,41112,53037,69,47,131728,42118,89610
287f25f6fa60e58ee82c1fa9454521de,58,37,53840,17863,35977,74,43,63324,16555,46769
77898899db6d2f1c335f7accb8f6a229,121,84,280389,61735,218654,114,100,271251,78490,192761
e56c48dc0259ed81d34753a1a67cbe54,28,27,16226,7730,8496,36,27,16637,7842,8795
90e798529d8c297260d81a98a3c775ec,25,20,9699,5571,4128,23,16,10157,3064,7093
2d255663090d2004dca20005c2bdebb6,22,11,3630,2114,1516,21,18,4812,1785,3027
dcbeba34ebad35dd2ede7250ddd75ede,223,163,1076361,245072,831289,202,175,1338608,261044,1077564
89e15a5dd49221ba47354c698edf18b7,21,5,3827,1042,2785,11,8,2551,1640,911
426b0fb06f9890b55b893bbe7e526453,31,25,27364,13673,13691,36,29,39688,12157,27531
973e3915a11da2b6e5d009fb0b9f185b,42,20,21213,6972,14241,28,27,13825,7485,6340
625105214c8dddb8c3a5682821609587,89,70,152899,32542,120357,94,76,144845,47324,97521
c7d22096aa9c1ef61df876ec280a6734,111,79,233570,37561,196009,72,48,125164,38823,86341
331103bc277b562b7711394a2035bb17,44,37,81739,18711,63028,46,34,44956,26134,18822
c43f37ac759a5f4959e03f380646fe2b,115,99,291954,42336,249618,133,106,270997,51616,219381
533f2774d9b791bf45ca2377be206115,114,88,241210,60479,180731,94,73,216771,45983,170788
5d0d7cfd0b75039eb3761abecd6e0701,38,27,24214,7491,16723,45,32,43441,7735,35706
fadac479febc768735432e59bdd9fdfb,99,75,266471,123494,142977,166,132,526710,96088,430622
72b89e6f5128b6c580a3a898e68fab7d,23,16,8719,2989,5730,22,21,5876,4625,1251
7b115067ae67fdc223bd80766e58cf53,128,91,188060,43877,144183,142,86,257202,41653,215549
86b979adcb1fbef69b2f83de8391aa04,26,26,16698,7313,9385,31,21,24121,7114,17007
20b95afe6fd0e5d8872feb7495c0486c,57,38,71344,14577,56767,59,45,39841,24495,15346
54adbd1f8dd03275180e2aab3b4412c4,70,45,130955,39480,91475,80,71,106923,38132,68791
e880da03598515fdce57f876703d5a9b,22,16,9523,3139,6384,25,18,5079,2956,2123
31d4f17999df031c8de34c57986cf43b,27,19,14597,4674,9923,31,22,13868,4773,9095
d7dde7e7dd3bd8cd760485433da737e2,179,142,466839,87294,379545,160,115,444227,80788,363439
7a866f258b52ec566d289ca9b2c40475,35,36,34957,15844,19113,42,36,36174,17361,18813
e94f04e1a723ad70434d39b9f3709760,71,54,110723,46648,64075,80,70,133778,34784,98994
5eb90cbaa22bff4457de743b116a7b98,0,2,0,131,-131,2,0,131,0,131
d039dec9cc064d8211728e93627ebe31,91,73,164883,35753,129130,81,62,149084,34879,114205
3935a0d511966004fca083ebb0634c33,82,59,159487,36320,123167,92,72,129684,59704,69980
ff05f20508c29458422fcfb9ba52ed99,110,80,298173,54303,243870,152,124,337470,55989,281481
6f963f09032dee3e52a7a04db2d1f6d7,85,67,107478,40411,67067,123,92,155867,40253,115614
bb189790ec17b9ada041319553bcbcd8,46,43,59523,22878,36645,51,42,58594,20690,37904
979be1d4637b09212aab2964c0da234e,115,97,412457,123504,288953,200,120,540349,86791,453558
1fd69c5459c19bc903616aa677fbaa5a,133,117,219809,80599,139210,145,110,323600,55740,267860
306f2e080fd331c293ea94b41933f853,113,84,254432,52650,201782,126,104,296255,53956,242299
82f0e000cd71047b4fc7d20a40708456,32,27,25201,8569,16632,28,25,17123,7752,9371
07b654032a01666bee0ebdb4fc739df1,99,70,144973,32134,112839,73,60,119437,33491,85946
6f611cf49227eb6f2c47b0dd9fede2b3,70,47,114875,41781,73094,89,51,115577,41158,74419
3bf5cc849d4330d86f7e3b5086d46694,64,57,107697,40000,67697,80,59,133024,27714,105310
b7d9bbb33274b6644c84f8ca14666f44,23,21,8291,4952,3339,22,19,10231,5522,4709
5e7ee24c397187a781871e41448b8401,236,158,1502728,446546,1056182,178,138,1236295,277726,958569
728824d96a538db712692b7fdaf8d2d2,0,0,0,0,0,0,0,0,0,0
73a89bb0e7f4c4414b467716fda61311,161,121,562057,100182,461875,146,126,541044,116136,424908
987b48ee7ad8d2f9aa73e0c1e14fb602,115,92,268912,51761,217151,114,94,252199,62740,189459
ee24ea4812ad4a57915699a9e26e1586,2,1,97,43,54,6,1,338,38,300
600ead72d236bead535f4154ffc77eb7,161,125,672913,140238,532675,175,137,579199,117476,461723
c8d82e6799bd5279ab9c728d8c43587f,23,19,9044,1851,7193,23,17,6678,2746,3932
0474b6577379a8ae2e5a5a1a3d80f5fc,96,71,147363,34240,113123,115,82,164818,31401,133417
cf2ae67186a81c6245c9fd987ca16bad,182,132,610862,145490,465372,178,152,778941,213084,565857
0fc88adbc68bcec506d5ba4a58079025,161,132,539963,92045,447918,167,146,560395,103438,456957
cee4ef7f574f713e36570a568c747987,213,142,650606,156569,494037,153,119,510055,160687,349368
4495ecb9d3db4076c1854b8d45069e77,62,46,86028,29216,56812,62,58,72165,44976,27189
9351b19e133651bec14fa96d271dd25b,41,29,45164,13551,31613,37,26,34542,14777,19765
e9b7c4f830afd819150fb9fe16abb57d,162,112,563493,147575,415918,250,158,777396,126088,651308
6b2b35da959a3f55b0098ee3491770c6,67,53,107624,30046,77578,67,50,108235,23883,84352
9eedb6fd807efe2835e1baef4d15b203,29,23,19103,6448,12655,25,20,8759,6715,2044
b29fddb948318e520e995a9bd496953d,19,18,3678,2508,1170,22,14,5227,2187,3040
7dcd79579f8678530b3d5c7038d6d65b,117,76,194535,36833,157702,93,56,143896,28941,114955
dfaaf74d22f0693353a5daa5843f8b6a,139,98,415449,119251,296198,139,106,425182,174087,251095
63907f925fda9c13b46e6add730c4d11,67,53,128283,34318,93965,77,68,98905,42123,56782
fe743526df2ff915baae52dc4d7d12ee,109,87,256734,69363,187371,145,124,325554,76236,249318
741afbd593c54dcf2007bf99fae72929,77,53,116333,28781,87552,80,69,108802,29137,79665
760d70a8d8bdc4e50571ebcbab8ee657,87,61,185002,36834,148168,65,45,73064,46120,26944
47f0db8ae88b6e35a245f2d1d871b817,16,14,2274,1565,709,11,11,1689,921,768
dd59a10059c8b300cabc96d5dafb7400,86,73,185100,33832,151268,85,74,101487,34297,67190
51d6499d038b82c4778889c91912c7e5,104,68,165322,36320,129002,82,62,136729,35688,101041
a8b78f5247b3424c9f635160fc486c2d,43,31,35842,19219,16623,52,32,68564,15494,53070
c7fe8e63648d676af7d68b243c110022,91,68,236732,43446,193286,98,87,178525,44165,134360
aa78d65f583f3cafb7bc2d1ff2051591,144,134,377977,83704,294273,146,125,387638,96033,291605
38d3ba7cb12e5ea320b9cf610f5b7d91,67,43,60185,23083,37102,75,53,86628,31124,55504
b6432d58f9d6d59c38fd0c277063a277,145,124,633989,139468,494521,198,168,769795,141556,628239
4d3a5de4525a86f32d98b1003bf88edc,31,32,25377,8616,16761,33,28,19040,10278,8762
ca7c024b02745a0150d37cd582d700eb,94,70,153736,27849,125887,69,58,95606,42490,53116
31e9b3a67d6ba29fc93a94daf1165792,173,150,570540,87551,482989,165,139,494990,98590,396400
e5dac1c0a63eb8af29b84010bf31bd10,19,17,5388,2204,3184,17,14,4802,2254,2548
561b95fd7417cde9d01c2e9afc443f50,132,90,221721,62670,159051,82,63,179036,46797,132239
146b08e4ed2f4e1971698e03e1ae745d,88,71,129010,46319,82691,115,94,222291,40936,181355
4c04c4a8b2dedb0473bff16549c134db,97,84,238744,82552,156192,166,134,418921,70709,348212
b471fda7f6ed37caa6828af36797f73d,199,129,540590,74078,466512,129,91,327392,82941,244451
cd4af782c567952bb514fd9087682ae3,142,87,436144,122370,313774,124,79,270990,117466,153524
f09f7404e46eaa6e3c15749a2acd1d8a,143,129,593824,135819,458005,157,131,628271,133211,495060
683c5cae6702332e6e5c0bd55b10fbb1,26,24,21844,8009,13835,30,21,17646,9052,8594
b266ee8c4561056cb22d1d66e56bec24,52,41,54899,23008,31891,42,42,64576,28454,36122
b5a010146087d9a0f7d3fd6323caee4b,107,89,243235,61105,182130,106,80,254318,83256,171062
379dcb8b7dba9f5aa93e51c0f5d999a4,28,24,23889,9097,14792,35,25,25940,7475,18465
fa2a650413e6bb119670468bd1afdb37,153,112,346198,72813,273385,139,111,263662,64703,198959
05adc97857c56a7de3ac0a2531d93318,163,119,512503,121593,390910,138,109,534286,146659,387627
4391a252a69b1c94d108735b884c8dcd,65,50,137292,37697,99595,86,72,125918,48469,77449
e1bfe3d698ac1ec16f8bf875616cb40a,54,45,54274,12932,41342,50,45,43807,9258,34549
a1a92b161a2cae0d924a8b6ac0947691,175,123,469184,116756,352428,130,114,340366,117057,223309
a81ed3e91183d829c6e27efc143a0297,110,69,165013,33306,131707,108,79,185285,39754,145531
fa49688c458efa22868738ab76882a68,107,75,185891,38272,147619,73,59,113133,46538,66595
4681f8e6b4c075cbe2d52aef02112d72,53,43,57931,21890,36041,59,40,78056,16460,61596
8dea82c895aaef32344f5f9350f09e70,89,72,200485,45604,154881,96,72,142259,50677,91582
28883fd45aa41c771ca410dca4799e03,152,137,497612,169748,327864,201,146,625901,108676,517225
837e940465a9e14cd258f5f17fad8ab6,136,85,290389,77646,212743,126,69,265865,90946,174919
21bce7200ddf333e59b21ca1613636eb,198,146,844060,199544,644516,203,145,796465,165761,630704
5fb4d268c99286163c142d1d4cdd90c1,96,66,181138,29758,151380,57,47,83349,45134,38215
c5db31f69d889f7d016d41d5ad65b44b,120,105,316820,60159,256661,111,96,236783,56795,179988
cf2b8ed82a7773d90efa35d750206fd3,59,46,121414,33866,87548,74,59,87917,32075,55842
ef87572ff6ea24b663bd271e98b016ab,118,96,274046,57809,216237,109,98,240973,52357,188616
88964b54b4c5115d651d0d1e12c9b0eb,60,54,79301,33040,46261,51,38,50056,20516,29540
12af57e47ab50bf0616ed2fba2845432,41,33,39546,14093,25453,38,35,40607,14558,26049
efb5bd7f5ef82008281acb7d8d7697ca,38,23,30705,8080,22625,39,32,25196,10618,14578
bb53e58b5821cdd7a2ac78d3afc92a29,66,46,80232,26680,53552,53,42,65019,24058,40961
bff22d492c8913d1e2951c79033dc6dd,106,77,258222,129467,128755,104,74,275016,78536,196480
11415bccb7f3401db8bafc8d06a1a9fd,61,50,57043,17572,39471,58,60,73870,28341,45529
89477327507f365b150d4d58316a0e5a,174,136,582601,108643,473958,137,104,425518,99958,325560
8b57f20667dc189edf2a213a41a3b5a9,110,90,211565,57372,154193,113,78,301360,35769,265591
d9752c3a26db0e9541f07da1353c7bdd,93,76,186531,56130,130401,132,89,203767,51186,152581
9fd360c83c150c5a47734426b6c07f86,19,16,7046,3393,3653,25,14,7997,2801,5196
9c6132ac04f998c7d2bcb548001a3d95,164,125,487980,96925,391055,181,146,414741,106927,307814
062b9372dcb8277c0a7bbea2dd67328d,111,94,228118,41038,187080,115,83,182319,36383,145936
baf9c13ab25b1749c123b7b2e2d98240,46,40,48078,15414,32664,41,33,42387,15855,26532
3b1c397fc6ea3ba42a1531fa17d28586,193,142,1042241,191631,850610,200,148,819467,202619,616848
b31d914bca447855eee0ed44340b7b57,197,108,712868,160617,552251,196,165,813972,153334,660638
62393de8422ce55e3383c876518e50df,166,124,454473,77078,377395,161,105,347451,93556,253895
9426ffbb36eaaac510af8501299c9f9c,174,138,600510,104481,496029,203,135,664729,103233,561496
f5fb453de64e8c77b7fd30f9397c6e4e,52,46,46437,17423,29014,55,43,51409,13269,38140
efa95a92375ba0648c601db4ad69e1ec,22,17,8748,4607,4141,28,17,10286,3800,6486
bd011c06d347d22492bd7a507dfcd35c,232,177,1138400,175342,963058,140,92,705817,189781,516036
e82d1ae364e3cf5bb1e06013f113b01b,106,67,132222,21463,110759,58,45,55053,17164,37889
6a6d2a5235de75596d0171943c27b8f7,76,60,100339,37960,62379,63,51,95330,31137,64193
f08bca913f73e46192f893f328760cd9,189,148,740905,97072,643833,158,128,542488,113458,429030
00bc365169851bde3eceed200cba9d34,112,99,289408,88088,201320,95,77,217842,68045,149797
91a714891604b800efb1f54fdf201dbe,146,116,617601,81761,535840,155,121,542916,149692,393224
eecd1f1ce47ca28dd63ba5ff882bc57a,59,48,63167,32736,30431,58,46,98223,22758,75465
7986d0a56e8c88ccc25d108727935106,37,30,26142,11930,14212,27,30,18952,10637,8315
ab8b99671773eb3014d23b75a9b1fdf4,68,51,71499,23245,48254,65,57,67614,27677,39937
e68ca738e906479f44c8d5de95248a1d,42,31,41953,13263,28690,34,29,30751,12701,18050
1dde6e7c08d12095248d15eddab616da,128,100,346300,92168,254132,110,51,257391,84860,172531
076ec7eb9ac110abb9e7ade3e21950ec,52,46,70757,39690,31067,57,47,78177,32182,45995
97fdca4319aaa6d9213a1fabff641ea4,19,22,9995,7641,2354,27,18,15781,5708,10073
21a550a68206b97f87573ca272a7508d,30,23,19402,10038,9364,40,31,31535,9214,22321
29005feadd527e4533ea9a82e08dc86f,148,125,440113,96747,343366,145,125,347151,78220,268931
6ab1415a08d66db11149788661aef920,27,20,11601,3795,7806,29,20,11706,4257,7449
05f2a632a4a9662f35c9b21fa3fa999f,61,49,148486,59830,88656,76,61,141693,65686,76007
980599fa3e38b6e6694ef8bd280f4838,116,84,183717,76025,107692,113,69,169544,60609,108935
0e0b1b6efa86e63a109e1cdc1f4e9174,86,65,124592,47249,77343,88,71,167621,40913,126708
8db4351e772ec1120383064560eba5f5,73,64,126153,31959,94194,50,42,87252,27439,59813
affda2d00c37a33530930a047bccc0d2,60,47,58398,31441,26957,79,66,120153,31024,89129
859cda32b3e3fa50366f50d808ec3f07,124,100,237120,46107,191013,102,59,193542,57824,135718
008731d14830bbc80ef0873cd021eafb,147,115,324230,62889,261341,138,114,320645,61531,259114
fe1fb121fd9aca457459e6805e1422ad,125,104,442640,125486,317154,142,115,517539,117524,400015
9c52772d896cbbfb99884b2dd3054b19,134,105,321536,83996,237540,154,117,350039,74182,275857
9499708626181a7ec673ec0f5c9d0892,19,15,2982,1307,1675,15,13,2781,776,2005
305b6311cdc1cfeb137d2427acc4819d,123,91,229530,71453,158077,111,75,256927,46565,210362
c295a1d95a4fe950dfc57a13c5685066,47,37,65333,14594,50739,47,48,78493,27925,50568
c19d2ee5cab577fa4ae57936164d1a11,58,42,84083,30102,53981,91,77,159084,42855,116229
ef81829e281b975cec82b463ef91bd61,31,29,21086,15275,5811,45,32,51764,12544,39220
8ee91b60bb98e86fecd0a41413513d20,57,38,45802,49649,-3847,59,50,117147,35761,81386
31418152c6991983fe2375552af9d727,161,129,651242,136988,514254,181,130,794692,138648,656044
97f77730bf0305ec82ec7d3abf2fa9e4,63,43,110984,23549,87435,83,55,125470,26984,98486
457b83f4f80964786708bd6f4303373e,37,32,43923,17407,26516,53,42,54541,15908,38633
a030ad9233c7fc3b61a747c1bfff0616,41,34,36834,12964,23870,38,28,39966,11755,28211
c85c915d3151c9ae9e63b8d6273e8081,37,31,21492,12670,8822,46,34,38091,13083,25008
7409eb4aac7b138dadf62dfea07c4ca8,28,26,19257,8144,11113,27,20,16202,5310,10892
d46154c03f4a8effc2bedb0a31bd0f2b,161,95,333605,79683,253922,137,112,347465,108258,239207
8f09ca32b37d025397e1fbb282591cf8,143,123,471934,147383,324551,161,132,651418,117131,534287
d30de1891b345e5b6dd51a621c300554,83,70,135265,30711,104554,86,69,94553,36732,57821
40317c34210491d9d5d090d9f609bf66,160,111,442602,151324,291278,203,152,679431,166740,512691
46296e4e4a2476f9f46bbd3197282fe1,143,109,341363,77163,264200,170,139,486554,94710,391844
e59efd6e55c6c806b13849ec3f188186,111,87,245793,69322,176471,157,127,476609,87353,389256
5cb86a94eea3600aef8ce651b64bee56,73,67,123318,29157,94161,63,47,65219,26113,39106
d38e3d194427e75dacbb0b9ff7127fa6,105,76,227007,39013,187994,86,58,169502,37670,131832
ffefd648b42f335a32c5da4d85682e9b,103,79,187923,30427,157496,85,71,149851,34619,115232
075bfeda3a6c47c644c00aa4679812c3,117,83,321206,86923,234283,124,96,293841,98730,195111
c2174d34974deede27504076d8cb750b,113,99,306058,94863,211195,131,104,383675,102500,281175
d5504f2bc74acd813826d6c8f61e4229,47,36,35719,13582,22137,39,34,27393,16353,11040
c01016bba686f6425d00881f86518076,58,44,50313,13908,36405,47,30,27772,9050,18722
9f7078409c2378a5513ec40c01baa9a4,22,15,4790,2174,2616,14,10,3728,1820,1908
427c9774c94d8ebd1596508dfedd937a,176,122,579773,82743,497030,168,123,498142,107946,390196
c6194e3bfe33e3df964961673a4f7956,38,33,38633,15076,23557,41,28,31241,13679,17562
97e635ae971ebcca1ebedb54349dc9b4,78,59,110805,22904,87901,52,32,58875,21700,37175
09f37d282ef613cc59abb9df45fe4c60,56,37,57967,20732,37235,53,42,73193,18351,54842
875f9ec90d4233f6ad9e799d91a17edb,55,42,99131,32170,66961,52,44,67037,29318,37719
8fe2ddd46401e24c14a469eaa04e46f4,53,35,108899,15258,93641,26,22,38625,17749,20876
2f71ccbee44eecfb2a9c9caf03a1c855,112,96,250196,51794,198402,119,97,280848,63782,217066
98079ed3805431a113bf0993bd386a42,81,70,129152,26256,102896,79,68,104553,39735,64818
e987c7d009ef452d6ac82cc4982c39a9,35,28,27166,7377,19789,36,29,21875,8383,13492
01e661789bda826d42f2e9ca0e5547d9,39,26,20201,7555,12646,24,22,20457,8734,11723
04e0cdc3523e809831dd81a47bab7220,140,107,379218,76819,302399,173,141,484122,128735,355387
fd47f9b39df3896a05b61cf964c58096,61,41,70539,19938,50601,47,40,39651,19859,19792
3c6ce911e9c43b66e955dca62f401879,100,81,199723,40969,158754,76,63,107559,47920,59639
946a293749f13dc4ede81b15a2315297,22,24,10135,4837,5298,29,21,10402,3775,6627
50efd15095dfdab7143e55b0261dc864,53,49,100700,43662,57038,64,43,102000,33995,68005
f291cd722080d007ed5e4048815b24c5,164,123,377524,76469,301055,151,120,413031,68575,344456
2482f83e1e525f7c033cbfbaea5f5f2f,120,90,270712,40564,230148,93,66,151960,44047,107913
00e829fcb8b3f80583122cf9ab5fb7fb,145,86,362382,57009,305373,196,116,402584,75327,327257
a8949cbb9a5f01e3e5dbde741773968e,111,69,213572,52528,161044,113,74,220492,77026,143466
ffb3f4227175a37f9f3f810d6218cd3f,146,113,404264,79099,325165,186,144,499452,100750,398702
06d76c402e54adf2c987dc2dd866fe5d,39,26,56052,10183,45869,44,32,30735,15433,15302
4ca2d7e2461bd8fb453d1d7fee05021b,93,79,167112,29302,137810,113,85,201041,31964,169077
afb2b9d40f7571ff4b509f407fb7b668,25,20,17733,4536,13197,22,21,13395,4067,9328
3e04e071284d99e5222834172d10dee1,25,19,11334,3683,7651,22,20,9682,3138,6544
37cfe62d63a8730292bbc580bd282150,180,143,830895,118920,711975,193,144,1225421,124712,1100709
c361000325ccca602fbc42759f0fdbe3,128,92,389395,69358,320037,144,120,357173,88427,268746
146add3013c6a70acc44f5a30b960d7b,18,16,5023,4003,1020,23,18,6377,3343,3034
dda363c5182651c3ae580c82cccf95f4,47,35,45035,12637,32398,51,36,29530,12192,17338
a62e11ca7def7d6c2bf7d86f3866d8ee,53,32,48339,19859,28480,65,50,81112,20555,60557
405e014b8f4559d14f2565b0158ff1bb,111,93,279781,67869,211912,145,106,342610,69225,273385
4c4409d10edd88340d56117a1a07d519,44,32,46627,13844,32783,46,35,43403,17020,26383
4658e9eb9a3f4629c88f69ebad01759f,44,37,31222,15519,15703,55,36,65448,13270,52178
5eed126ae9989e4398f2b135c9fffda0,11,12,1247,1629,-382,9,8,1743,654,1089
e06fc43ff75b2dff3f45646e8c9a7132,105,78,229737,53912,175825,103,84,203251,56253,146998
1c3471a8ac285c235a20caff3f0aa378,14,15,4800,2115,2685,21,13,7510,2498,5012
83055e859192cacdddfc6aca180dd0bd,118,86,209992,41770,168222,122,101,277059,43434,233625
d6fd0d01414672d3aaec1ab5ce5ce634,56,47,77052,28615,48437,68,53,91515,26789,64726
a9bcb02dcf4273591bf1d86b84817c19,35,28,31665,10348,21317,47,29,27150,9185,17965
b269596cfcde5b0f2def58cdd7494eae,20,18,4992,3173,1819,20,19,4871,2635,2236
5359c427f21fb19899980f9a5cf60ab6,26,19,19210,5307,13903,36,30,15403,7274,8129
66848ff534270508a85e17394dec219e,65,53,117226,36377,80849,59,37,79007,33519,45488
130d5257960be9d81640fd83fd7b91a4,149,109,342481,91479,251002,149,110,388879,106418,282461
54e9d02dd4a1ead51b3e185126ee63b2,175,127,458791,68076,390715,162,127,385866,69647,316219
807270f0c97665745c2d60e3bb76e211,116,98,305001,71380,233621,185,148,517140,88822,428318
e19a5fdfb12cd5bb6bb40fd2bae42cde,45,31,33741,10888,22853,29,27,23013,7946,15067
d50d636d3288b1f3e4e646eac96b481c,57,36,61443,11758,49685,53,53,50649,18064,32585
5d31d3a123b24e24b37908cc9e376f87,27,17,16890,5770,11120,24,25,28151,5289,22862
9a15a1eceb4f04c3a7bfb9912469d804,5,3,392,137,255,3,6,161,463,-302
277c2e5a8e56f21e598ade5900f2a176,152,110,288765,71075,217690,147,109,269958,68054,201904
52a4043147b185286a9f038d378d8e66,103,68,153999,51632,102367,88,63,123165,44570,78595
cb4b111d8a7cab6f1fb6ca92be6d8f66,132,110,360440,94531,265909,154,122,406149,82506,323643
2001f944e8069bb2a7d554e122f4c425,50,42,45211,31718,13493,54,41,66139,18978,47161
837947830ee9d6e51e6fcc8a5d474e0b,112,88,253246,75439,177807,84,67,185005,84013,100992
3a66a23ab5c9baa6c4386bc2e79e7b2e,76,60,81151,29722,51429,63,52,91933,31119,60814
9ba301d205a66d0c38136ae250cdf030,88,70,136240,57094,79146,111,99,255507,68463,187044
7d95f9f3ebcb8bbae1d3b89c68ef08bb,137,114,366562,100381,266181,128,101,262418,91428,170990
668e91c7b412e2935ac125df7f51e7eb,3,4,835,757,78,4,3,757,835,-78
1b4304d639f65fdfcdceffbf3c291ada,97,84,157046,45490,111556,70,54,98988,26641,72347
682cdf2dd5f7a2604dbd8df290fd4020,96,70,90481,18456,72025,86,86,160501,30778,129723
da06b06f816a3d2665d12b8435691f64,15,14,1870,1776,94,18,13,3256,1139,2117
56116ee898f36c2170d7d2c6e816170c,139,101,325235,67772,257463,120,99,354450,74141,280309
0dd13cf4b6763c60d2b639821d005791,112,93,219511,52482,167029,64,50,120047,32571,87476
392a1edc453b3a79f184c0125b0adaee,92,71,182327,42049,140278,93,72,168479,33114,135365
59804438a266c8790f532c46e4154990,110,86,215428,43408,172020,110,72,248364,42587,205777
f0f9c7c19d5a1ddd8d0fa3171b143037,170,130,513129,108172,404957,160,134,827928,124589,703339
09cff0773f4d7d55c12b663325a5a104,166,127,498735,80750,417985,126,91,333357,67658,265699
6b2034d5044a3622d45c9f1fa36d62e1,73,62,131959,42623,89336,67,62,152795,43128,109667
17880d05a303b28978758fb2bba38853,27,20,10787,5333,5454,30,26,14124,4541,9583
8da7a32935cd3260fa2d03b5395903dc,76,62,117474,31954,85520,75,59,89082,31397,57685
7477441538e75dfd8d345371900f8c85,101,83,225651,43694,181957,118,97,203012,40551,162461
fda9274620434351b66a8d18c6e404a4,65,60,78710,25778,52932,61,40,70805,17815,52990
cf365ecb880d3b088a9ae758dc4818b5,92,72,145953,34583,111370,76,49,99571,25480,74091
6323a4628276039e180b1a9a7d4d4589,101,70,209562,55224,154338,91,70,169989,59505,110484
9588ef22d0edd71b45257e995aae1de8,79,70,143626,51470,92156,115,84,218088,50198,167890
a811cef79fce5b692ffd8fc3abd7e0b0,99,82,188797,52064,136733,110,74,202047,44065,157982
71d925e86f21207e3d3ebd4c5b424c98,73,46,75120,30873,44247,89,71,135992,29663,106329
94b598fec825161acfd7313886537013,25,20,20435,7111,13324,33,16,27592,5137,22455
321f90ef95202dabc3dd64299f20a897,26,21,19398,8694,10704,35,27,27372,10506,16866
795cf757e2c73553db54be81755456c3,34,27,36454,8159,28295,32,20,25110,9054,16056
c533d2fcd46a0f4ab033275848b22efa,72,60,121688,27721,93967,76,69,140483,33715,106768
48b0784b4f0d2c7c90bc6d6bb384528b,96,80,169043,45593,123450,95,84,202595,52989,149606
81a6a384a158c737ac5e81fe7639dd63,40,32,37315,9199,28116,31,26,21076,14911,6165
6c5809e66acdbe04b2f8429a4b1a2881,23,20,6490,3463,3027,22,19,6208,3359,2849
c26424b0f6c178f81660a0b4a7d7c9fe,24,18,7261,2292,4969,23,17,5837,2347,3490
04c9fbb569e7c35de53f20268937f1a9,30,23,19826,8587,11239,34,32,25752,11628,14124
cb6f2fceaf379fa77c9b35ab5e59248b,164,125,348099,90887,257212,143,123,319129,86458,232671
2ab7a1588b7711ae685c685f60ac38b2,3,2,264,10,254,1,0,52,0,52
a7f7e8b4589c152294f30115d5cb0fff,109,99,373506,118500,255006,98,82,285358,89512,195846
bf85736cb3cafd79074db884051197d4,73,52,118208,28718,89490,70,57,79096,37653,41443
aca9396b20576e49afabbc586162feea,34,28,24790,9212,15578,48,34,38042,8345,29697
f1b66db155fc0ab7a678212b04def89e,1,0,93,0,93,0,1,0,93,-93
e131705771794071c3245670489379a6,18,17,6208,2825,3383,24,20,6743,2613,4130
524c04739ea2317ec8d469809d9ddd91,169,129,469406,92455,376951,200,123,720313,80830,639483
4ef7641a37ba964a5abea6dbc24bd02d,50,41,85048,29821,55227,71,56,104356,30933,73423
21b1a464f3dcfef0e9beb7cd24119e66,30,16,14938,5078,9860,28,22,17315,5677,11638
b146de7718707cd7069dd8025bac22f2,154,115,494115,126084,368031,150,121,527771,103933,423838
beef17204720ba94322abd01d917292d,53,37,59639,15065,44574,53,44,43356,20371,22985
7fc8c3c06232ffb81089b482d61406bb,142,120,754224,113987,640237,165,127,725385,170397,554988
aa3a12768112d473d9d2d4a3b6be83b2,41,33,38296,14887,23409,41,35,37481,16622,20859
b86776541ad78d366615931e21e11f1a,37,31,43593,12620,30973,36,25,18188,14492,3696
c486b9992b2114bcdc0b14c48ae0aab4,20,13,7967,1915,6052,18,15,3999,1503,2496
9e20ce8f7ff0a6db297d0c48734a8aed,22,18,4073,1992,2081,20,16,3979,2094,1885
d92e50bd6307b0d5d0030d2ba9d24ef3,100,78,285678,79297,206381,153,116,385572,104119,281453
3922fdf0fccf8d9f53f1f0b741ef0643,53,27,54372,16744,37628,60,42,64154,17888,46266
ea6f7a4154d18473be2297ac5dac8194,202,162,913991,159344,754647,157,107,762471,177352,585119
63cae73b3783c090294ba9107045c680,243,185,964767,362757,602010,201,142,1970143,275232,1694911
dfd4d3b2907afb1497625bb503918638,125,102,331929,59438,272491,132,107,278460,56694,221766
e1c57401fa0f2af6fd3cb9a194457f72,110,86,213284,44577,168707,87,76,199795,39558,160237
89391a4ad3b0c477e3fad3e171d88664,110,98,324429,59898,264531,146,116,323369,56659,266710
30f0dc9fe0f2aff0e698aa88f48a3c8a,4,2,399,158,241,2,3,158,296,-138
a8b89ee517f20d7b675b10c4fd3a5d0d,108,91,171049,38402,132647,109,86,151099,43650,107449
5c34c745e162746a6181317b4c0239bd,30,18,26022,6861,19161,30,22,20720,10188,10532
b10006b1b7d4e0083086c72c681f6ad1,172,113,441240,53644,387596,97,58,286263,49184,237079
37d8bf902b96d16f138859963214e1d6,113,84,204088,37470,166618,131,101,251161,32187,218974
875f1a8afef7b05fb57a3652b03b0ee8,44,41,45136,18879,26257,43,33,58161,17404,40757
7f3318d89dc3455f05aada92de631d1f,122,88,329021,110830,218191,182,134,511444,113624,397820
094affc9e9c697d33cd96e8ff6f1930f,73,68,118425,31551,86874,73,50,106984,18154,88830
71f76dcb95dd90032e0ffc737ae4760d,116,89,193294,58241,135053,82,66,150538,43314,107224
271abb4792e89f92c5526eb349aef950,107,87,181754,51213,130541,73,65,132141,48332,83809
1f8d4a6e57fd619e78f85b9db9f683ea,61,41,80109,22441,57668,56,45,79061,20085,58976
d745b9eb35fd76e2f4dc47102f805a42,25,21,15925,10066,5859,27,21,28482,9482,19000
a2e3656dd7414de343a8e0ce6eaefd4a,97,80,169237,54812,114425,99,75,160874,42655,118219
2cbb7586e99ef2227be649684ca41ffd,46,34,68987,15192,53795,55,37,68410,22707,45703
e3451ccc4080a247f7f56317f3564742,23,23,6021,6507,-486,18,23,8511,5579,2932
a23abd332f1d0fe34502e0b7f14fb221,55,42,67683,25927,41756,92,66,131374,32240,99134
05eeeb8100260fcb88aeceadffe16cda,75,50,145066,24611,120455,50,41,80506,26981,53525
e066ae5196e712dd6a8f39bd40364204,61,48,93279,23980,69299,54,38,61873,22727,39146
16cddbcb928caaa73b28e1180a8da6fe,45,35,78826,21143,57683,58,46,104107,29754,74353
c9f20e64e04d547d07f909a0da2e73e6,20,17,7022,2888,4134,21,18,5043,2944,2099
c918ba142e28b6e53951a193e160893a,44,36,31543,16554,14989,37,28,30116,14217,15899
47c92d21939c25df0fecf84e90771751,29,31,17688,10282,7406,35,28,28165,8532,19633
453d8e559851d8dc5c1a6d706dead062,106,72,221824,55365,166459,133,111,299751,73806,225945
0c64799c37a86248c0ab2a029f0a0214,112,66,211139,55667,155472,103,87,196253,68591,127662
444bdec9971a7dd8ba44d9cf7151bc2c,33,29,27269,5920,21349,27,20,18913,5809,13104
104f248f52a062b8d3d4c6bac9d47d97,37,29,23723,8727,14996,35,34,27230,8300,18930
81ea1a4f6869a7683110388e7c7daf65,28,20,22068,5171,16897,32,24,29291,8013,21278
377493ffd19e72e27ea8dcb37a1b6b2e,177,129,562080,99268,462812,168,123,518616,99360,419256
58584751e66d49360bf24fa58c103450,137,89,480565,93791,386774,161,96,377200,100055,277145
e14a2aa9649ff37ad4acd863d6fbb255,84,73,135135,25108,110027,79,57,97909,30660,67249
4d0f514f7bfe6e69afa1f41b6575b7d3,87,72,184454,65224,119230,121,101,358295,60030,298265
c586209b6a6dcecd752e3f7f34dd3385,19,14,3639,1453,2186,20,17,4477,1944,2533
927e00a998011c87327916df7ee78e51,169,145,676462,137767,538695,201,157,583484,140404,443080
5a7022617d30887bb709ab29512e96a5,198,145,736783,142610,594173,169,126,910068,106504,803564
551add8a2f66e704b2df8b1b728641ee,160,99,352103,57278,294825,144,120,273380,83682,189698
ab39429cab870db5db2c47dc04a39157,119,100,269796,67815,201981,132,102,251802,54703,197099
f333c38fc6bd2f1324130af08ae70853,27,20,18923,5344,13579,20,19,15066,6067,8999
db3814dabd3f423ff6c0ea4bfd514093,29,21,15155,6977,8178,25,20,11379,6642,4737
df16fbad2287a92f20cd8b68905985c8,32,25,23751,4492,19259,25,24,14520,4832,9688
ad69143bf59a43ae09a8c041988ba09f,32,22,21819,7942,13877,25,23,16564,7828,8736
3b09d8e9055da207c42a752c491a3808,55,46,45531,22861,22670,56,44,45904,22832,23072
0126d62f59ada378b98aa27c6e7134bc,149,113,482671,89853,392818,146,112,451278,101828,349450
5c07d68c7918ebd8bd1bf42ceca21f62,44,25,35647,10650,24997,39,27,34254,12199,22055
638bc471c29bb0cf67d5538236c91c7e,70,61,146124,34979,111145,41,30,64187,30150,34037
5f3b2dcf78326b8393c584b6794903ce,88,68,145486,39045,106441,67,48,97072,33834,63238
bf7aaeeaea2091a9865d41176e97d2f8,78,66,122093,35771,86322,95,86,143336,49704,93632
7c0e42c94ee38c0e41a5295901b5d4fd,100,89,197248,41843,155405,101,80,262261,34558,227703
9d74c547122bab72fe84fd0085173f82,123,108,307672,86794,220878,174,114,442701,74309,368392
90329723070148a6b97c7e3c87ccbc12,53,42,63318,24846,38472,59,49,93390,24428,68962
23c3ee3f486aa12f1156a67776f4981e,22,17,5733,2597,3136,20,12,5438,1816,3622
7f391751513ee9b36ac9ade3618db52a,173,122,499865,102402,397463,97,86,355846,132345,223501
74d6e3b92c3660e7929f38c556a96c96,140,100,412646,69980,342666,145,114,398346,58435,339911
325c50886fe0a5edd079aa5ee2623b3d,129,83,227612,69446,158166,123,114,245735,99330,146405
bfb44ef07bdfdfa1656d1095a1b15d25,22,21,7143,3768,3375,23,15,11888,3374,8514
a48ad00a4c1244f9cfe7be6cb45f6d74,130,97,283027,65917,217110,103,86,278275,60830,217445
14195d01cbbda3cd91b39e0654f8feee,101,70,196380,57229,139151,107,97,266106,51208,214898
ac1405ac220ae8c8ee3926364cf276aa,73,53,119850,27472,92378,105,75,181527,41731,139796
c50025ab360452eb5e4604f79cca1cc8,24,19,16623,5113,11510,25,22,15483,4997,10486
04fe20780ab536969b634cf43bc1fb88,118,107,312676,89091,223585,144,79,307151,61541,245610
f6e9d6e84d6677b2a2ca9d623623afa1,144,114,413671,143510,270161,132,79,426822,106671,320151
29d8e46de54163456630a7107bde62e7,146,89,409123,125365,283758,146,114,399898,125330,274568
6a87077753f6b5919639b799c58d2e9d,119,85,300079,67376,232703,123,96,320500,75565,244935
5064e8ac006e911928fecd8b63c5b75e,76,60,117212,32300,84912,72,62,95589,42464,53125
bcd2edfbb15c21699ba3698067a8d799,130,90,322412,73730,248682,160,109,500513,53112,447401
bc1703306cf8b8b5a14de3405e87f61f,59,47,111691,26453,85238,49,40,72861,20537,52324
40a00b56dc1347ec61ed73e1e48f0f23,138,107,416583,84497,332086,147,106,378378,75808,302570
cffd82de05b21dd031e22794cc468f2b,49,34,78899,21122,57777,39,26,42382,14700,27682
e0694c0405c5f8d3eae204d510bb786d,27,23,14176,6761,7415,28,24,13217,7216,6001
28bef12b9ba595610db7201e38025a20,102,79,175820,29881,145939,95,70,180147,24086,156061
4305847374b39e118d296b992d135285,57,44,78168,45964,32204,83,61,156762,36301,120461
54974c4a856a633421bb640c4c36b6fd,55,38,62918,21584,41334,39,35,64373,15114,49259
23bd217e4619b5dd214baa777c147eeb,148,100,386679,87946,298733,143,122,407751,126239,281512
5d0984f415872b241cdbb1770cddc050,75,66,193775,56257,137518,148,103,303097,63915,239182
f497987aad78593d687314e7679e4ea9,69,60,85173,31133,54040,70,45,99436,20909,78527
e5e49d0cee384773be17fd37ffae19c7,169,127,574933,75112,499821,143,106,419097,103929,315168
92a3eddfffd06b3b0f9f73e2cac6f92c,80,63,93380,27546,65834,96,65,174993,26231,148762
e91da98230388f3220599ad0d6989ca2,39,32,38860,21755,17105,41,37,54605,17867,36738
96c97a665e2d98b604279b350e501706,187,131,762030,105113,656917,167,103,630590,94165,536425
c64a5c53bcea680052e308a09384346d,145,99,380900,97924,282976,109,94,260039,125762,134277
428c9e65e84ee1f8b8f27cfc72192018,131,80,395652,72526,323126,182,126,599405,118250,481155
cc10a5729f76a2d0df81fc8bbab28620,38,32,16736,7639,9097,31,24,19869,7125,12744
997be87d1069706ebc2344b0356ec36d,41,32,53285,17845,35440,31,36,41937,25005,16932
89ac152d6df20ba4468fd5da569e7ebe,60,47,77494,30295,47199,66,56,98132,39068,59064
07125441e5578da3ddd4938e10d648b9,205,155,670459,116665,553794,159,125,510896,115614,395282
3a9ed593bc2c1b2f0f827d678a96dad2,144,101,304115,126267,177848,151,101,395675,64713,330962
c8d4764875c19d1a83348bf778acb5f3,121,94,228525,48389,180136,104,78,161674,51487,110187
1d29a0433966adfab93592afe0ef5f34,138,109,564365,105254,459111,142,96,572874,85053,487821
eba1086c5e065cab9097f49f0ef06022,103,79,212903,63877,149026,85,74,118153,56020,62133
7da1464ff8d1980a4d6a1dc07313fb3a,83,65,180685,33764,146921,68,52,129908,35065,94843
afcf056d341312174075e06bd285fee8,176,115,474978,116285,358693,114,89,289335,114445,174890
653d69c8b60808add2d324af741e6965,186,138,605440,97699,507741,151,104,444013,89625,354388
51cf38720851d9b441f2bb7975d0b409,119,88,253213,45872,207341,106,83,247504,48312,199192
41be97fe79d5f05812112e93cf8056a7,28,25,25730,9419,16311,38,29,26669,9992,16677
59ab93034a061ee71a4c8b6ca0c3e1f3,88,65,137819,43676,94143,94,80,201329,59244,142085
bac935a99699e821e8c7206a98004c80,44,36,44778,15742,29036,40,34,62318,15621,46697
7154cf987d4e3d3acce8fef9a29f0f43,63,56,103997,48839,55158,70,62,128335,39320,89015
9004756afe6f47d8a206dacd45f44c92,125,104,262470,46997,215473,101,78,186136,60566,125570
d76acf6d24e26ab2b9215ad27b3dfce7,155,92,266937,73891,193046,168,98,321867,82975,238892
6eb01bc77aba6b7f183fbf0a5fb4e178,155,132,512041,94396,417645,150,113,429107,81616,347491
b193fd928525d63f0e79c1ddd622f208,163,126,476080,153781,322299,139,101,397425,112432,284993
b9e41f1d3fe5bdd71c7fa9978dda07e0,66,55,158921,63741,95180,55,44,127911,45981,81930
605b2d7af078cfc5d0ccd0c640fab316,43,34,58964,23298,35666,47,39,84891,20453,64438
4fd6bd52f5930161849623f7949f65ea,59,40,63282,18284,44998,45,35,62502,18998,43504
ba4499cb8286556b3a209d96cf657bb4,43,34,39970,14764,25206,53,39,39904,17834,22070
8a579161350ced9949b6a801bcd03e46,19,15,7504,2048,5456,22,17,4565,2501,2064
e8dd090c0846dc27e6ae8f286a14a8b7,167,122,502599,91677,410922,156,108,413896,76563,337333
62a62c76cad0307234cfe2a2a986c24e,108,92,231034,52861,178173,135,110,243068,73712,169356
9bbfec26cbfffdaa7b78d5b5485cdb40,136,97,375708,101300,274408,146,90,494465,65952,428513
87e2422e572a01f7e2385bc16c755f4d,42,32,42129,19950,22179,51,33,55342,10608,44734
b6d6f23b542af97aa34bcab3332dfb07,120,93,238340,47629,190711,159,131,372168,74848,297320
d595e4a01ed25e87cb86109d582bd8b2,90,82,193732,58750,134982,97,80,207949,64522,143427
ed75954f8e56134f1331c43a1cee3ab0,103,86,163433,69910,93523,99,79,276763,56670,220093
5a0aab408a8e6c1cd7c6c7122922d6b4,142,109,589608,140779,448829,141,123,527948,150454,377494
fe7705a3064f4bb04baf582f8b9296aa,155,118,452425,61136,391289,135,105,322904,73289,249615
ff97bbd875e82df66d2e79aa502307a4,4,4,594,738,-144,4,4,738,594,144
ca62795398f72128a6d45c2614306502,54,38,60052,23366,36686,46,42,47719,24259,23460
21a0f7fdfb6027f0f06775a47c6e90f1,10,9,1285,870,415,7,9,826,883,-57
df2e95ae4f08c4b29ffe6c3d12043ddb,180,132,688368,175515,512853,206,136,751163,156960,594203
f5912393c5df3eff3f200dff7c767835,119,99,401034,85786,315248,165,123,546196,88291,457905
2e1b003c35b71cc9d33b941f44fbe65e,71,58,98532,28626,69906,70,62,99792,29104,70688
dd966ae35b54a3a8d20149d7d8d7b15d,96,76,174095,46057,128038,90,78,220197,42188,178009
e50cd5ad1862a1b28799a0a07a306a32,178,123,522183,107977,414206,120,107,585542,138377,447165
6d5b080d97ef26dfb7599689a82e09ce,24,20,11603,3608,7995,26,21,15094,2991,12103
4bbef08350541b5a87e380c144391f59,142,104,409679,120921,288758,158,125,531528,129531,401997
f31e1e6d220c8ba36b9a0baf5cde25b6,84,53,101862,38070,63792,53,40,119891,31730,88161
c07aa275c9e3f949403cf18ac124dbbf,71,54,101297,33251,68046,83,57,111526,28229,83297
bc9ce36f2edf150638234111d7521c9b,160,121,534084,137476,396608,132,69,391717,108436,283281
17645c42d7965208c4a1314b2fbb0daf,38,49,18506,53495,-34989,83,69,143604,19319,124285
64748c601cc6490e6fcdd0f3f456c19e,34,28,30261,14957,15304,44,26,50567,12278,38289
9b2daac9d5e62a25fbf124519e2fb26c,98,77,213718,41543,172175,107,93,177154,51855,125299
3e5a343bb20305d5afa3c7f0360b4017,93,67,227063,79915,147148,99,70,277781,65588,212193
aa0eba812bfcaed0cd402d204ff62354,62,55,112830,32437,80393,69,47,97035,32271,64764
ff248702ff03cb202841c8806cd2a9d7,104,87,150264,32272,117992,77,56,152493,24954,127539
6d00585bbfd247b373283d4bba7f9292,106,74,191013,37611,153402,105,86,197637,36367,161270
ecef181f430f92dc6988dbd4f39e56ed,88,57,110727,52511,58216,118,96,231275,43138,188137
c3de8dc2c2269409608711eb50fba4f0,108,87,202626,44559,158067,87,76,184529,55351,129178
5c173421faa016016d3e3d4509deb6d8,112,84,204635,61781,142854,89,76,224818,56540,168278
18be246506f59fa6829da0ce165cc5ab,168,112,355806,73406,282400,130,97,256826,85469,171357
74d7792f88d54fc1c88a1b9bcbcce77f,37,34,33835,14474,19361,40,35,42570,12327,30243
21947cc36f6f14cf24f3fb7d1aa6b13c,43,37,75207,16291,58916,58,49,70521,22022,48499
0a3f26ee28fbe590f9d67dce0498bf92,71,61,90011,31498,58513,64,42,113812,20414,93398
b3da94bdde1a11fa1ad104d7699d64de,31,25,31032,9626,21406,21,20,11562,11370,192
acc6b6ddcacc96dc587911e87b674878,100,70,156642,28749,127893,135,96,221930,38615,183315
3d4af0c8cd59695b214a3359cf8f27f0,100,73,189214,31477,157737,132,96,216205,39097,177108
723ae52eefc6cd472bf8d01371ecf07b,93,66,160067,58677,101390,88,54,171085,45861,125224
5807cf4c868b80ce50deaf3f37a1a90f,87,70,183684,38917,144767,121,98,220611,46746,173865
ef2ab0f7ceff088d61d17fe6381eed02,95,80,171155,43467,127688,107,86,196788,54371,142417
a52cfd4f8a62d827f370cf83a9676535,184,146,729040,103997,625043,156,114,491641,91391,400250
e840eac5aa8a03f00aea9031528dc3a4,24,23,9043,3390,5653,22,19,5787,3727,2060
4052648ae19376866a2745a7d790b52e,44,41,47219,14360,32859,44,33,41828,13385,28443
f0b9e4eb6194c345c050e570a1aac2ab,40,37,43992,12458,31534,36,29,24565,16012,8553
0eda76ff14c0d9c8b9a7496c5a0e2769,116,85,253201,51637,201564,95,75,225070,49923,175147
1409f5a9885cb77148d4cd737a39b60c,143,99,327742,66698,261044,168,114,395208,59273,335935
67fd0e5e9a17a3090be8de3999d0e8a0,125,101,283372,37831,245541,111,95,214875,47579,167296
588faeae6218ca276a6bd49c1f499959,118,80,195148,32786,162362,82,66,105885,42907,62978
59c0b8a020800c3273efd18b47217a52,47,54,40080,19137,20943,43,39,40930,15195,25735
3bd32ce95c2fa33747c120e023a98b07,116,102,219565,75769,143796,140,125,278701,85567,193134
d5e62a01819fc6ad431013921fab2573,97,85,174505,59495,115010,96,73,196026,39993,156033
9af75246b52015fec01c81a04df1b417,207,122,541182,104019,437163,219,133,584936,92732,492204
9b2505cc2e70cbfce0421d26ec8f3b08,73,57,137951,33138,104813,78,53,136238,16164,120074
4d83b88b3747897657d13ad97e516dbb,2,2,117,466,-349,7,4,1373,413,960
cdd76b6894f675fbf4a370962ec1a61a,17,8,3588,1443,2145,16,8,4039,1700,2339
308dbbd862a2fc1912ed1028b479022d,36,29,29554,13198,16356,32,29,25374,11464,13910
d1f00bccbfbb6a9a8a5eb0a5ffd27253,61,48,53930,15951,37979,70,35,37805,14845,22960
9767b20d24baaa75fb5261fd4f5438d0,116,100,257750,91760,165990,123,87,270016,72891,197125
7f432160566aa3fe41ec52d65988a694,54,46,87009,32286,54723,61,57,106992,35019,71973
f6aa6b78cf030a0437df6a65b11b578a,178,105,558099,82639,475460,139,122,386445,94228,292217
6abd0a906fa6fc881613f179d35937b6,24,21,7222,5200,2022,28,21,14676,4605,10071
7f05781f01caa1beb32ab3790e297c4c,45,33,42737,11541,31196,38,33,23486,14357,9129
62a5e3f07ff37ffd74b6ef2a17ee3464,45,27,39085,9011,30074,38,30,32134,11095,21039
69e3399269e8f30926be9d20801dda48,93,81,170659,57425,113234,122,79,176028,39755,136273
8d1e5f8a54c91f744252a545fbaebb2c,67,55,78998,34706,44292,85,51,127100,23426,103674
73dc06a01205751cddf6d76ef7a46b17,182,121,789417,116308,673109,201,153,994490,170358,824132
d6c9220c97d209fcca48a4118bdc16aa,30,23,13105,4437,8668,41,28,17061,5598,11463
a7bfaad5587e30a4fc278c8292dd12e8,63,46,59094,15140,43954,58,48,45786,21659,24127
1bb79a5ba21c2a6b6759c2b960700241,181,112,567459,90151,477308,164,110,433845,122287,311558
0224fd58d63426c9862ce3b2812ecf2a,191,144,843108,139866,703242,202,166,1152635,223097,929538
041ee2641463ccf183a05043e53a7d05,151,107,552576,105378,447198,133,83,444469,123838,320631
0094ffa705aed0dce25614604892f30b,46,39,58916,23292,35624,45,31,72648,22935,49713
ddb0119c99684702a25d9b26afa2ddcc,121,107,314654,92454,222200,145,122,390477,87986,302491
3d61004c2050d6d8a3061c6349125204,101,86,162862,42024,120838,61,46,129392,37032,92360
9ec6f56fbca0395e12dc7f218e065ee2,88,76,230142,62488,167654,81,65,191175,62041,129134
2fafed4268841ed79b28623c6159be40,39,27,32894,9858,23036,63,50,85847,17518,68329
5c518da7f74b9332a201a3ea89cd0c1e,174,128,608965,133284,475681,170,126,472970,165960,307010
c66b5a64dc148e2f8ac191778eda1514,27,21,17649,12429,5220,36,23,31394,8014,23380
d3f72adf36a4f3d721a7c2ddb8dbc768,204,149,747728,126802,620926,175,132,842843,173687,669156
6dfaab5fdad725a07f144ccfd432f1fe,10,6,1932,418,1514,12,6,899,602,297
430d45018acdcf0da4800b22fe6e3712,61,55,82246,24207,58039,54,40,57561,17308,40253
66efb20baceba06cec97c254788e47ff,78,62,98085,32659,65426,75,69,110030,39347,70683
ecf6c7950878833c6eb1b759129b2ce8,59,46,90424,25481,64943,43,38,61792,24004,37788
46c8cab22375820b60d557243a88481d,74,51,89225,19624,69601,62,36,53556,13872,39684
75ce52804c3ba7e018a2f3010e368315,75,64,116418,38237,78181,112,86,221696,41158,180538
0f3c2e32e60a2130efe3ae8295b4f702,137,83,172139,55339,116800,121,66,136520,39099,97421
cbdf39c862e98ceda78f15f9487b7301,69,56,130604,65675,64929,92,84,217284,67315,149969
9dbea9df6f05e6e68e73804d3934d044,46,35,56722,21682,35040,48,38,63676,18642,45034
ea7294fc82ebec3cac11a500279217be,80,57,116135,28339,87796,68,61,90146,37168,52978
e548af386a7f828354b8dacb0dfa671c,151,117,501542,68058,433484,170,127,459557,85568,373989
cba61bcf794dfc83b25eac85214abaf3,70,47,104767,55713,49054,88,63,182609,40047,142562
a9b704237fdacb76a78f3f2427aac2d7,165,102,429115,78699,350416,166,135,431613,112908,318705
8deda76d214b02e39b49ddb8eb83c57c,43,29,26095,9651,16444,36,35,38779,9440,29339
743b255b3cf6898ff94f61d10f240fce,84,72,132989,30755,102234,94,65,171832,26679,145153
b860c93927429430859c5d9b78e73b63,68,57,91982,17682,74300,47,38,50963,22531,28432
1bb347c4257c2dbe353455bd9589f0da,104,69,177124,36279,140845,94,77,153694,36097,117597
df19a0fd2505d9eed077c88bd14b85c6,34,25,28003,9039,18964,33,24,20484,6494,13990
0eddeee271aa8312de6b557de83bdd58,114,94,300677,56623,244054,135,107,365349,61834,303515
cf6e37df3b4fcfcbdf26a8097ffea1bf,135,94,414928,64446,350482,106,95,244314,64003,180311
2a32c538075e19e477984bd521b46f66,59,44,81231,16820,64411,55,51,68083,18857,49226
af707c6930aa7393a129f91901c09cc2,45,45,54563,24978,29585,55,46,71449,25674,45775
fc6917cc11213f2e2e24c0fa9b1178ab,33,28,22636,11432,11204,28,23,32001,9879,22122
cc7d406da77575523bd59646ec180eaf,40,32,34203,12731,21472,42,32,31639,10072,21567
fa56b260796d479a3caa4fdc9c7a9dc5,89,59,141440,31870,109570,93,66,134120,35562,98558
3c102831fdc3fa188af6eec6eb019a35,149,93,282051,76924,205127,108,80,215933,77086,138847
8c6c536d3df6a4adc303cedc81063c7e,138,117,359025,90117,268908,119,91,341060,101735,239325
6a5e79554b5ccc89a241801cfd2ce994,160,111,633962,105414,528548,162,130,492860,119926,372934
6dcab5a1e603d8ed10d415f0e2b150ef,158,128,577096,120670,456426,141,109,464012,95022,368990
19d94a4d726710e5addc3eed32ba5a3c,73,54,210911,53019,157892,79,60,252302,50366,201936
2caf6239a58b1032ca220295cc32dc8d,113,83,233208,45643,187565,140,90,284885,54418,230467
4c19b0b84a29297d2312f79633a812b3,81,64,87927,31316,56611,84,74,111726,28751,82975
eae57590adf3de4b359659da25cf08fd,100,77,211447,52732,158715,137,99,246003,44237,201766
595df7a6a6460870c894df0d577e6a1f,33,27,21170,10516,10654,32,31,27683,8653,19030
73075e060d60080ad6f68a3517126a61,42,30,41820,14103,27717,44,31,35840,16556,19284
c3a607a414165102388dde77ccce105d,97,78,268252,73685,194567,142,119,355322,69180,286142
7618146a8008bda883f00a6062149885,69,53,103155,38776,64379,102,74,183064,32402,150662
3b381adee15c208e3128e3e574e01c1e,118,86,267354,58507,208847,92,70,154101,61510,92591
b1285e5ff5a69c76b3ad8cbd72896a25,67,57,114189,26143,88046,105,87,198561,39737,158824
a239338495072e559c749166483afaf0,76,68,111178,25697,85481,72,57,105267,29138,76129
aefe58958f75826b0703f84b5d65f7cc,120,95,218236,61380,156856,140,104,255679,49430,206249
65507b742f8d534ffea04790a8cb179f,118,100,278892,89784,189108,126,110,298866,76993,221873
d2e601dfa9f3e39acee7a8ad624c97c7,172,133,383739,97333,286406,104,74,255654,84334,171320
3efd1bac68bed56d9bd0b9c31d77d521,67,56,101977,31106,70871,91,68,134956,28988,105968
58e070332f814d36f070f2c292f1866a,75,56,82093,33132,48961,89,70,120353,25641,94712
09e11528b931724e30e2b2ddfa669c7d,25,22,14739,9310,5429,31,23,17700,9539,8161
e85308088ba7ed99abbd1b84c610bb62,165,134,498904,119503,379401,154,102,408325,99809,308516
d10b7e760bc9b148f900672f75df2eec,129,105,301772,72718,229054,134,96,354990,62155,292835
e03fe43ab0d2f1eb664795a371823bfd,136,102,371322,83265,288057,164,121,413808,77912,335896
03662635ba139076f59a7c8f2b16172e,73,51,90654,25629,65025,121,83,156203,25890,130313
efb0b9eab2b55aee793d6c35d625d6b7,126,103,336592,101602,234990,133,102,333489,112126,221363
751d0ca0e3dcd38f8c8928071735985f,84,56,120111,36136,83975,81,59,130739,30619,100120
cba9d83efd0ed5a2f54f6251435adabc,146,114,404563,142998,261565,120,98,332915,80818,252097
a5fe4b4e1a1e437f7e13fd1d973d79b7,54,41,65090,19032,46058,51,37,53086,17068,36018
b18e5cd4971a52f27266641eef03c7ab,32,22,11715,6691,5024,28,21,25710,4580,21130
e9ec952d8bbc2c47063983f68ebea7d6,78,68,92150,29216,62934,55,47,111082,26678,84404
77c09d7beaea3dbb8bafcd1949b5a0f6,43,30,41806,14307,27499,51,47,46040,19035,27005
dfcd61f8d83aa8d2a77a94409f14c984,116,82,238456,66776,171680,159,135,401276,78688,322588
53abd0848dfcdd9b592d56725583f144,134,104,414319,103647,310672,138,117,481731,105608,376123
76cd17ac00996b6c9b4c5508ba7b100d,46,30,66483,11440,55043,48,37,45792,21011,24781
fa16d1e66bd23f7736fdc5f62cee243f,145,132,327319,80692,246627,129,101,309143,71309,237834
2abc6a9872c9bbdbfcfd25dd1f46d748,75,63,125027,25045,99982,57,41,49905,28202,21703
501ecb39b21ccf8d7f15090450294556,128,97,569033,171514,397519,167,149,661458,184636,476822
e1212fcfe427dc18fe522d013211057d,34,24,16754,8449,8305,37,24,23120,5656,17464
47fdac23a7716dd98e097bb41da40e40,78,62,114741,26392,88349,65,54,73505,22918,50587
aa3a2d11de1b22039aefaf2aa8411487,81,61,103593,33524,70069,74,54,119209,29816,89393
f228e78bb40ed0b6c93f7e9f85b77a4c,44,34,51887,17161,34726,73,62,123324,20227,103097
76308506e4d91c6d14b4fea7ffce043f,55,36,58140,24309,33831,52,41,57839,22272,35567
df1e957bc1f4243d50fd12f71d194a47,116,105,297477,80545,216932,94,71,361016,52365,308651
c7009753d4e7b891e541243a1f8cd6aa,27,22,9216,5764,3452,27,24,10054,4231,5823
340da27b574626afae4eba9bb3e9b722,129,79,162033,36714,125319,96,80,138296,41144,97152
fcb79599704d4d5b5af48017d99bc4b0,40,31,51962,13461,38501,34,25,44021,12914,31107
3ca785fde9da0d99fad687b6bb26d40a,148,118,476771,93459,383312,119,97,380369,123845,256524
fd362f47f52a46d975cb076c23257236,114,78,220402,42567,177835,86,68,150228,55182,95046
1221f3ef0704392b7fec9c488c966599,11,3,1745,786,959,8,7,1635,671,964
7e016094f7905f6270d76bf7aa3629c6,158,116,373574,74244,299330,109,92,268420,64475,203945
48b16dcb8163773ccaa81b88e11149b8,201,129,457397,122628,334769,174,117,513809,104959,408850
f683d9d8fa7c0fbbbdfdbd7f4d345dc2,35,27,30967,8053,22914,30,21,16301,10156,6145
3c3db3a205b96d8e1c3f0fa5bf0ac6d5,34,24,21709,11923,9786,32,27,29570,9610,19960
be37b414dd3693ec1c500756cf28efa8,199,148,1155343,224966,930377,229,173,1354525,231645,1122880
e9e6b8c6a44c7260bebe6919fdedc3a3,106,86,285489,61653,223836,111,101,207361,67657,139704
e1407c72054e07e3f0f7a5afafdc08d9,84,66,179542,43094,136448,62,49,149790,38120,111670
dc390ec72a7c6e98424e95389e21af46,86,73,200400,58442,141958,134,98,305705,47281,258424
ecbcdfd4c1234d94d9622611e6f4fbdc,3,1,241,48,193,1,1,107,114,-7
dcfa4d4dec73efa9cece8d3d1fff745a,57,53,61658,20231,41427,57,51,100862,27155,73707
96c75fb2bdac009c4e91b33b8b23dad1,178,110,439987,57499,382488,156,126,360982,84728,276254
6325888afccee6349a52a70e0c97aabd,131,104,326873,73752,253121,113,79,225391,68209,157182
4e29140bea4518c13c977dde86bf14a2,46,34,71441,25550,45891,47,32,56069,21754,34315
39f97581a7408284ff950f59d6fdbbfb,147,112,335069,76318,258751,158,107,431657,79585,352072
341256af1d40f08d2550f8399e267928,108,95,255302,81185,174117,139,119,319600,55324,264276
15c5397c6420a160644a83831ed7bc7d,39,30,36314,16926,19388,42,30,42259,16376,25883
267c1b926c099e6f843270d82b102767,25,20,17221,7255,9966,31,26,25844,7153,18691
5948951f0c8fe2972258e7fe0ac8b866,32,34,25001,11945,13056,37,32,25507,11830,13677
440820d140438ecd6dd466ae3bf37248,113,84,221074,75791,145283,162,129,391045,72212,318833
a8fef7abcb0064126bc9735d2738e921,81,59,141628,53824,87804,99,70,198089,43111,154978
764626ad2c7098aadc22d0cf127b507e,67,61,80897,33375,47522,74,61,110790,29597,81193
4f909d990220eb90943002d25213b8a6,22,18,8509,4178,4331,19,17,5955,4251,1704
89d26b0db2d5b599e2af9905c740d4f8,121,96,320565,63401,257164,103,82,223705,54220,169485
42f36682fd3dd586fdbbbcf61bffb262,35,29,49411,12977,36434,43,32,30819,18024,12795
100509b185cd0c699cbd8611c2a27c9d,140,121,500803,161337,339466,214,158,712710,139657,573053
cc60f601a8c9ea4b4a0e94075b67c43e,42,31,61055,17610,43445,59,38,75067,19221,55846
b86f5f402c09e765afcea72991fe7f2b,166,125,584114,120684,463430,179,146,537052,96058,440994
8a02654dad191aa3d48d3b6f42ec848a,66,63,74303,28916,45387,63,41,61389,21038,40351
9c1a89824001ddfca7e0bdda617da140,42,30,47230,14461,32769,41,35,50339,15936,34403
daf5594e7cce6024e4d560356fbb57e2,19,14,3477,3185,292,17,16,4539,1913,2626
ae6b071ff19cccdbdc4e43f8b63b06ef,151,109,466716,108543,358173,191,145,630538,141513,489025
0a4b368ca9f7a290e5aa5b7f2f33e0d1,24,23,13076,5084,7992,33,26,15539,4912,10627
39384edc8fb8e28e3bb87ae8d99dbf85,70,49,69000,17828,51172,53,42,37326,17494,19832
261e21841c07a56412282dbaa3001983,38,25,22491,9391,13100,35,24,28017,10171,17846
5eaae8005d3f2bf99ba7d00841e820f4,60,46,86510,23674,62836,53,37,77361,23944,53417
42ce47ba08b93004d23a8c9fbbe79bd8,123,102,281376,55425,225951,99,73,225621,55003,170618
be2bc8258f12da0ff9d244a6c8b0e7bc,149,109,455293,115636,339657,164,129,403828,143033,260795
dff0e75a55f116a890f5c345ae96a03f,92,81,222316,68930,153386,103,82,254770,60279,194491
a3c6de39f6ba1ac614456c2c377fc79b,34,30,27457,7236,20221,38,28,43076,9568,33508
b5f82851b8f0019bf422216e3c9fd7e4,31,23,16949,8857,8092,31,27,17563,7254,10309
a4d9c6a7378fe04f935e0c02450b5bf7,68,43,76749,18710,58039,47,44,54314,23648,30666
3ab591c2417a34b9830481fcb97ff217,97,83,226952,58900,168052,153,123,474680,96333,378347
6daede16bc4e93b6f15f91b2a7e12469,44,33,79819,23055,56764,73,52,86853,26313,60540
02506591e78d65da1120269aad65fa7a,93,60,211169,65668,145501,68,59,169374,49157,120217
28fe62042809f082a688f32cf72f90d3,30,23,14776,5653,9123,30,19,16746,3077,13669
25fd5bfb53c6f326d85ae013bd70815e,27,27,21129,10868,10261,36,23,27744,9854,17890
40801fc21d70a9680d7cb20a57277631,115,90,306842,49130,257712,78,56,145831,45004,100827
ac4f64520a81eb1e497e31f6b3a05f74,38,32,19824,20126,-302,60,38,78400,16047,62353
73e456b26b20cc2181aaf8fe773d667a,156,134,529316,123135,406181,185,122,672871,83354,589517
daaed22a3163f1ac8105c311ac7c5d64,30,22,27246,8183,19063,29,26,22704,10377,12327
be0f137f5f36fe92538bb76e2ed684fb,71,69,134936,43000,91936,95,73,145936,35326,110610
590ce6968c523539a3ec9031451f6054,58,44,69192,19012,50180,40,33,48191,23371,24820
12cf6ce8a8b5514e65065db72845c7b1,143,118,443131,104908,338223,161,132,666399,93562,572837
3355db6c05a51597b81bbd58f00f6fe2,27,23,26896,12403,14493,35,20,36412,10067,26345
7d5e0ea65ddac1a0c57e67c7f9ffdddc,84,72,102831,45253,57578,101,72,174939,32155,142784
480816c5fa2ef23fddd9deadc0540d6d,172,143,798927,105511,693416,232,139,829677,100295,729382
31229d4c27a34cf03509a61984cc3799,27,21,26039,8459,17580,43,34,40332,10243,30089
f340f32185f9d7f665ee4447ffb5a0d8,161,124,587443,140302,447141,155,121,621343,133784,487559
47c74340014bde735c5674e46ac979d8,162,136,437156,140611,296545,166,132,507035,123297,383738
1046ced05c0f8b99b4a9546ba09e4a07,28,24,24416,5709,18707,35,25,24847,7717,17130
87143a0ebb0c5511fb1fd9d7ef66439a,112,88,276844,89540,187304,117,88,288575,110176,178399
427f133de80bbbbd29f5a60202efd0e6,31,29,28829,11204,17625,29,27,34917,12546,22371
6d898f8827bfd51bde697ffc19e42240,62,44,59950,12574,47376,58,43,37400,14016,23384
f844f9826d48141144c41d2fe54dcc23,28,24,23209,8730,14479,41,31,29125,13787,15338
cac2758005eba97c362800ebe9f87d90,27,20,13162,3754,9408,25,15,10979,3342,7637
07b3cd871fa15ce323a1bc52b64c74f0,106,90,237356,62522,174834,119,71,260835,42194,218641
abfcf26a262f6758fbf69a4ccbd09234,225,144,790427,152293,638134,195,144,787917,180720,607197
cb981378cf6c76dcb42359e601647744,55,43,91604,21009,70595,50,40,59385,30124,29261
390d730d01e526561b0ea93f0938f46c,145,111,354399,91712,262687,154,130,361519,105082,256437
e71db77472bb90e159b01977d6c5210c,187,110,565508,118920,446588,190,148,768234,166797,601437
d404837d45122b06a3faa3bbc116163f,18,14,5327,2752,2575,18,15,4687,3147,1540
a4ec95b00abc9277b4833f5fd2526972,31,29,26478,9875,16603,36,28,28612,14038,14574
9669c5688b4fbfae8c7dce69422e4f95,145,115,406971,99842,307129,179,137,418005,95454,322551
bf76eb33e64d024b6fcfe0c86885afbb,28,21,20581,7049,13532,34,24,23256,8440,14816
ae249ef1a8071a496fae81647063c9a1,183,139,618101,121349,496752,213,149,611827,137176,474651
87638b800190c8f8d2dd781a5540c1c3,4,3,519,323,196,2,3,154,369,-215
54811944810ac92cc7dcaf172c228e08,116,99,255970,50057,205913,86,77,156207,53860,102347
a17e777fde78ec2b740f9c13db396a9e,85,61,141097,45508,95589,84,75,172705,52844,119861
3131ac43a59247e4fb4bd5c2681dc791,123,73,213630,49202,164428,92,79,165088,64247,100841
52611eb434d22157cd9f66c6f5ca16a3,42,32,84292,26062,58230,84,50,161708,25336,136372
07e90905418d024dd98249afcaa80eb9,58,44,133373,54986,78387,91,70,237893,62917,174976
04b543db623937c65dc395bf16567aa4,48,46,47111,21484,25627,50,34,63266,9643,53623
a54fdd2c69404f864e3bb068ffcc121f,114,93,298430,94961,203469,130,106,265773,76095,189678
1701c6e503b425122fe2f23e91987917,59,48,90544,27666,62878,55,43,60263,29130,31133
0fe7572b28869cd1d4164ad9376aa154,209,168,781381,134012,647369,150,122,537591,165952,371639
48ef96292360c3e4ec47ae23b4e5b2a4,64,49,93477,25080,68397,61,49,53459,24074,29385
3ebfee1738beeef711f5c6d96a8c32a8,41,31,37801,10649,27152,42,30,33853,13789,20064
e20e5a3b4c9bc69a4fe6bddd47bfcf9d,126,94,253401,55854,197547,113,92,195104,76690,118414
5d3ab22a9decee5316f3a1e0ab28c4e4,102,76,187654,41453,146201,106,79,159943,56264,103679
2f31b88872449875206d0f1c3776d135,99,68,222334,76411,145923,111,92,308241,96750,211491
59ca938c688f4eca858966482d2389d9,26,23,17856,4095,13761,34,25,17383,4676,12707
41c1315b04515220fda77dc667ea92d5,36,29,45808,17959,27849,38,23,43638,14121,29517
09c5f97202236ff6bfaf1f3f6917ff33,115,82,154167,54850,99317,162,128,385753,34123,351630
fe9fccfefd3ff9d4218d8b764a8c10b6,77,66,142770,44845,97925,125,102,232321,58738,173583
728fccb8d134424b0848d9c3fc034ca0,161,135,477272,121695,355577,145,90,349687,63535,286152
5868a2764e2b8a30398c47f0cc8a2cc2,75,63,129947,37617,92330,74,62,146995,41641,105354
105a4ddb960418cd77fed59e3f2c111c,63,43,66841,17093,49748,45,31,66639,12673,53966
baec9543ad806820a18991a5f9050356,83,81,161672,63355,98317,124,105,250193,37788,212405
d7aa057d2956578b01809b79325141e8,117,86,182595,42586,140009,114,79,177448,47104,130344
5b7ed708060c8518c8c590fb30439311,187,148,919187,181297,737890,205,159,1057593,182111,875482
0234d655b4e24e8007637783d8f8fc4d,30,24,12004,3861,8143,31,27,8590,5497,3093
e204e52e7ccbebad672ee6c8716a9cda,31,27,28488,11558,16930,38,24,30606,10315,20291
61c61d8e9432b99e5ebff9dbbea01ce5,98,91,169627,34960,134667,96,73,152443,43889,108554
a3de228b24b2f0a48cc3d19d39c40fe5,68,62,108390,44618,63772,79,63,132332,42097,90235
4f6c6e04664659566171a749ee7bdd15,27,20,8426,5352,3074,21,21,9328,4278,5050
c4d63970c97b3e3e88cc002f9e5594fe,32,24,18129,5727,12402,37,24,20011,6887,13124
c6fe512f4a10540094117fb9022d8d6e,93,75,141032,34642,106390,65,53,95700,39757,55943
0a5e5982423b16578d5fe76b00bf86db,54,47,57700,20205,37495,52,42,79006,20492,58514
d9aeabc63a9aa029ee21bc391fd60493,20,17,11442,4588,6854,28,23,21768,4484,17284
18d7f8026f972e261fcbc99f2a7f7596,44,30,37494,12362,25132,38,33,21773,14113,7660
3169cb2f9b4e2708c5efdb5378446e29,154,124,463341,128865,334476,208,153,872055,101633,770422
09437acb5fa2ce8f0bfaa5b7811749cc,162,126,448315,54947,393368,137,110,429749,57640,372109
0faa47f8a44e3faafa8986487ea9ec0e,104,78,170082,49807,120275,76,59,142125,48522,93603
3e5bf4c18da10f9e6414c6b4ab17ce8f,147,131,381392,71259,310133,143,116,315582,50647,264935
3cd09ab517eae90d75e642ea2010a6b2,204,140,938545,155635,782910,204,144,850492,206589,643903
7081dc74b844f669cf56527b27cf8b74,16,10,4313,2479,1834,19,15,4190,2706,1484
e2cea7290e0198f56fc2b3c925936d16,78,60,148235,42897,105338,73,54,92467,45968,46499
46c2902d699791c0ceb06d7b468a8310,31,29,25873,7707,18166,25,24,18717,10842,7875
f049937388d8315a81a35d7ff9f45c18,24,20,10257,3857,6400,25,19,8293,4772,3521
1f47720a47398d87f33256529b36ae7d,136,124,354207,57796,296411,144,117,410236,43547,366689
09cf82c6adf9f486a497c0488bf0d98b,8,6,802,229,573,9,7,1112,642,470
675552bf4177b589507cb6684345d591,77,64,97699,26767,70932,61,49,99748,22832,76916
46e7e2792d484bd60b258312811c9bbc,22,20,12310,2726,9584,20,19,5098,3133,1965
8c2e885c815af681dc23b653f04cd842,91,77,159123,40271,118852,103,71,124912,44112,80800
cf02570b1378d994d8e005a02bb51f20,180,127,557872,105858,452014,177,133,533212,72224,460988
58952f962ad60ef544736da514afae89,88,64,136949,33250,103699,89,69,173342,41999,131343
6bbd74f8cfedbfc5be736ef0feea5bb7,55,48,45769,25527,20242,55,42,62938,20497,42441
5da1ddcb5f09a68cc5cab39419c0b477,119,78,250139,58813,191326,140,78,268242,42820,225422
7cc37cbf9cf114d2d816238be7468590,158,128,436909,99810,337099,140,101,329491,63082,266409
0cca896858c2f503643cb859b3445a38,108,98,219707,60728,158979,115,98,245465,40625,204840
9dc96a381dfdb4d3dd1732ba208bcb2f,15,9,2624,1005,1619,12,9,2354,1383,971
3b21e8a8ae41eae92065a50951cb0e79,79,63,95760,29500,66260,73,66,94597,31537,63060
2f5bfda6dcc576ab5ec3135de794c4e3,101,77,171825,28152,143673,84,72,154287,29141,125146
abd2d8649a70a0c113183120ad9f2282,133,101,232707,41310,191397,84,74,157747,36330,121417
31f7f56a10b10af8c3a356ce2e8accb6,264,157,1067147,157360,909787,201,143,780699,261112,519587
3cd709c0251f921a283d27c5a4e045d0,47,37,31910,11510,20400,27,23,24099,8542,15557
a5a8ee9d3954c1f7691e14c39ef6c156,92,86,144360,36622,107738,79,70,148782,49836,98946
dd0d1e1048295eefbec9f8f25d657280,11,14,2752,1423,1329,14,12,2206,1468,738
5c0744d8dc453a66ab432de42d67797d,186,146,506614,140032,366582,165,129,478677,99137,379540
128099d456001d698badbd6369fd75a3,38,27,33048,6757,26291,26,23,15045,6278,8767
4d8101569c9afebceaa53652093e673d,64,60,82029,36805,45224,69,56,102878,25403,77475
ee6ddefcd7803cff4cafdb427ccf1b30,140,118,547183,193709,353474,150,104,584057,164095,419962
881f785cb85563877cf289184fb7cc87,64,55,73468,16300,57168,75,63,55016,21889,33127
57745e8651cecbba95259bb4152eeecc,108,82,180946,52215,128731,100,74,155172,45885,109287
d5a31dd1cc83c21d6cb0d759ca4c4047,96,73,106875,23619,83256,116,72,150588,20356,130232
b3a2fc14a12200ab87f2067feb6ef076,24,18,10296,5745,4551,25,19,16710,4829,11881
f59f49c28f21f2f0d8b8353f3a79abd9,55,37,77476,9508,67968,52,47,40279,20463,19816
202195efc19ca5e8a70b61b2cc2936d4,39,32,54115,14847,39268,31,21,32979,10975,22004
5b2cb30ffa823df103736509ff6f9090,196,138,1109810,263189,846621,229,162,878535,202145,676390
62e6307df4d0906464ba3ad7deecfe4a,34,21,29406,8751,20655,26,27,23895,12244,11651
4823110d33d7d9321385c11e7fe339ad,46,30,74256,11094,63162,32,23,24538,15029,9509
95e281db5ce71ed069ec0f78562a35b6,27,24,13507,3327,10180,26,18,6601,2800,3801
77c3652d0ecfd9dd08c0d17191cd835f,42,33,28933,12561,16372,44,34,27954,12590,15364
184af821ef13359272a5c86bdf02c054,147,102,284906,66356,218550,132,92,287765,80035,207730
a46f63698001ecf43bbfc14b62d3d0d7,99,76,166880,42308,124572,94,72,183087,54077,129010
f05907184a72c7ca723a498ad6aff389,72,62,116885,44245,72640,66,49,91106,36922,54184
cf15b89a61823c746bcd1e72915d207d,0,0,0,0,0,0,0,0,0,0
615369fbf4a3feb966557b903c57ce98,139,117,303487,56460,247027,144,130,389122,71238,317884
581ac4bb93e7a02f5ee2340f6e2f38c2,127,95,315075,74736,240339,142,120,354852,98073,256779
7c5b4d08118e860eff69ced85d28401d,29,27,15754,10524,5230,40,32,33409,9016,24393
e184130d5ca432ad6cb6cbf8a2b765d4,33,26,19167,7090,12077,39,33,27201,8913,18288
2098fe374340d1ec9928f2024792a477,148,106,552151,163263,388888,195,147,1018806,141635,877171
1ec5f8d24b0f30bed0815a1658c89da6,24,23,16069,6801,9268,27,21,14158,5836,8322
e4767842031834e997ceb29cd7586d25,168,126,643049,194862,448187,189,130,782700,149655,633045
319c0fe096f4f00145ba12fcc10c5f31,23,21,11068,6569,4499,26,22,19503,5904,13599
62fa5d2cc13d30563e327a2e99228359,148,81,257127,50962,206165,169,129,361622,86749,274873
df1a4c97f3adbedfe077d2356e8c21d7,7,5,474,432,42,3,4,385,294,91
fe59ab559d455edcdd786bfca88657bf,146,120,454246,70538,383708,151,125,447357,152863,294494
9f2148dae31e2bf1f19e06e0a1a36d3a,76,46,126382,36205,90177,80,56,96439,33768,62671
eb838716bb9d5e677673ae091f611753,93,76,254330,77162,177168,112,90,218122,84076,134046
930f6d4b883b6b3f32028cf0cfbc4669,63,52,99959,27267,72692,69,44,83775,29181,54594
b1612ef25cc78bb4d1247e3ab61cf11c,41,27,28168,9630,18538,28,25,27968,12622,15346
a9cc1e0a554043a5143f22143ca703c3,155,110,363218,94718,268500,196,133,493299,74050,419249
586a12a3a96ae1f323ec3b8826023608,131,105,194433,40990,153443,109,73,163169,31075,132094
45a3780beb56c7c5ed0bc5f30c9b2621,119,83,201258,42676,158582,101,82,226002,67359,158643
dfbae52832d950891c4fcf41c828822f,126,89,414145,77633,336512,109,102,341459,90345,251114
76b33decac56f617b3f4146e1d6658c0,34,25,26535,7402,19133,28,24,20467,10603,9864
ea9e8f0e6aeab99e66ae02ab235858b9,103,84,248103,44402,203701,112,83,187275,42808,144467
8dd9744054138d02f40e790f03c439b2,111,72,194717,47034,147683,99,87,194593,60025,134568
4f841c82d595d8d308d464e31d95f995,73,55,104540,33299,71241,93,71,136616,31311,105305
d04d3bb4c621d606e54edf61a5ea798e,97,79,158317,57100,101217,94,65,176976,47320,129656
b03e6977c33c3e2dd9f248d5030e61e3,93,73,168776,37588,131188,58,46,83908,27059,56849
599dd73d15d6fe42479cba5a6c5d665e,28,22,12502,4055,8447,25,13,13674,1722,11952
e995ed1e356f272a4640035a9c9283db,29,29,23222,8668,14554,32,24,21551,9341,12210
ceb66836c0e433e190979fe7f67f146e,133,101,267936,48483,219453,82,58,155279,56781,98498
dab5589e253bb2287264552a6dbcd317,39,31,46168,14707,31461,55,41,46599,19626,26973
98525f32f417fdf7526bec21a7719099,121,88,188984,48504,140480,123,101,263452,56896,206556
0450d8b3bc372acf9d1e963671418c14,95,74,264814,41034,223780,97,80,243716,68885,174831
8ce2a036b062186dd73024701ce34108,59,47,83105,36105,47000,54,45,75219,40297,34922
97b68d2bbf993a138ff03497d5826e68,23,21,11857,3982,7875,25,18,6582,3113,3469
270a09b95232ea720f4ad6f9165b39c3,90,70,175988,61669,114319,119,92,245165,59228,185937
933170ba1af0b272a7d55e59655972c9,223,154,1506029,187775,1318254,278,210,1331645,280924,1050721
9d49928346b3451e53f32786fb95cd0b,148,114,495505,79018,416487,145,123,329969,97358,232611
75f42bc251b8c7937c2efe88a155925e,157,107,474723,49505,425218,130,97,243506,95582,147924
99bc5fa289d34256cc78dc109300f86a,68,59,103685,24468,79217,98,69,162384,29855,132529
35404e0faaa182535a6c288d8e5ba0d2,127,95,311550,86579,224971,116,84,283200,88295,194905
01831ac91fbbda4b45cb0037a8991f42,54,35,50772,20209,30563,49,39,74027,25583,48444
cb637eb9bbf59202597f0d7eccc7064e,48,35,66545,19884,46661,49,44,62629,23480,39149
c77b7ef8245e4d076bea52f0c23831bf,134,82,340115,84072,256043,138,106,382074,107888,274186
bf574d5c932cec342f19d544deae8a07,41,37,21799,11471,10328,32,25,26763,7667,19096
0334b93da9267695304afea974f1cbdd,124,95,343250,95781,247469,114,102,359491,89941,269550
fbef77022a5594c62a541a0f0c2180c2,56,37,76408,12337,64071,65,39,77803,14611,63192
da1f9f688f5c2d58f275bc0be0ea92f4,178,129,545703,113603,432100,154,119,637005,96200,540805
e3278103908b0c809c8ed9ab3a28f73d,68,51,111942,34544,77398,91,82,166195,34573,131622
ca2b6596af4b968c333c088ad0bdeaf3,16,17,6420,3084,3336,19,17,6524,3558,2966
e724964e6d8de52bf52d8819a377a7d6,192,125,666906,152241,514665,255,182,843445,145398,698047
ab1da7424d75326630b8adaa72319324,144,103,325389,80209,245180,127,88,309487,64453,245034
ea64c2ae8a1e98bb0e11dc14bed599cf,45,42,49219,35013,14206,53,36,66555,17676,48879
305f1eb8d06ccab9674d03f077ef80fa,33,20,43879,9195,34684,38,30,40295,15736,24559
90d0fd52fe6cc6c4819712fbce70038a,166,104,413373,56620,356753,134,114,371997,76118,295879
9b64857324a1126cb8cf5a8db51bb816,177,120,486332,69587,416745,141,102,373625,87309,286316
5cc11cef3b588d1e686a9f8a2c45b2e5,89,79,210295,66907,143388,111,84,207592,53451,154141
2608683d981e8048855c8e3273ca5ce9,42,29,34256,11325,22931,43,36,48186,12871,35315
fb9528749ebd4b6a56b12defe8f3710f,54,47,65373,20327,45046,48,37,56873,21858,35015
ff1c41fd3483394a7795e4559ba4acdb,142,117,347906,84986,262920,128,86,323896,69598,254298
ff7e97785b22af78d97aaadc261767cd,22,18,12629,2806,9823,23,17,12652,2817,9835
75092c6e30735d022355c588972be1c7,150,121,408818,101434,307384,168,120,506398,86795,419603
924200fa9f942bae2647ae5c18bc3a15,69,54,69760,22240,47520,73,58,62849,24094,38755
ef262f2608bb1b5e433a83b8904766bf,144,106,398155,79408,318747,141,112,337189,77637,259552
0fcfde7eb289d0b7b710ab3ea464a5c8,78,73,152334,42396,109938,77,55,131259,52496,78763
bc95eee3334ed04a3223720be4340501,106,87,253806,54033,199773,111,87,185202,60675,124527
28fdec3d72adb5826fb6fa2b53418500,17,14,4464,2506,1958,25,14,5828,1571,4257
46413e73debf136a1ed648c8bc02630d,81,63,171192,33896,137296,105,83,151594,34333,117261
51e39170c34b48618f96014637146aa4,133,92,299739,76105,223634,89,61,228309,67010,161299
d63b719a93ffd211be5ab082f071c4fb,70,64,126012,42610,83402,85,57,119930,37573,82357
581420355dc89b4b2e6f886cfc0183cc,128,105,255005,56635,198370,131,107,306125,52768,253357
6d24246869557a3c02f87bc49b53f01e,108,83,164977,47095,117882,132,79,184227,31796,152431
bbb0e9b0120869313ff433415e1cbd93,29,24,12053,8028,4025,33,24,22202,7630,14572
3180e96801ecb3f9b458f393978bb9e4,93,66,152028,39671,112357,119,77,173687,35854,137833
2cfbf32934d72ae17c9dea487007c21a,119,92,267509,34828,232681,126,98,224689,41878,182811
a5104f1270bc8c4deb25fa06ac6a0cc0,155,118,331994,60730,271264,124,102,220414,62569,157845
f03c9d7e55192f6b3e06ec75ee420b6e,86,64,191979,86504,105475,139,82,348713,67114,281599
8714160ef2f8c07d0d1ede37bef67112,88,78,181576,39076,142500,79,55,112284,42009,70275
4f630f024311450d2d471e4f45deb8ff,106,93,218912,55839,163073,121,114,219659,61802,157857
c66cf845b6f889b3d878a74926b922f1,157,142,453587,130808,322779,154,119,460464,109883,350581
4651ef87934b9137fc2357edb8cfe884,44,40,51229,18863,32366,40,36,45646,21483,24163
a073f935ae0616745b45007d393234cc,33,32,34223,15941,18282,52,46,75297,23987,51310
38e97ddcac18d4c5da0c04656827d80c,168,113,532150,102861,429289,156,124,616733,129063,487670
a67936ca15898ed9d2b935f494810888,9,9,1319,1668,-349,14,8,2954,532,2422
67b306c2e19cf1dc7bf24be8e565d1d3,122,106,279162,67788,211374,106,82,316920,68044,248876
2c17244a90c3b075ab9681cb4d2b7b76,58,47,105024,20465,84559,75,57,75416,20800,54616
96cce26135279a3f26afaccbc94e901a,135,104,220758,53893,166865,115,72,163094,40954,122140
47760845cba9539fb5d91e7de07d119e,166,135,703326,143809,559517,146,126,574550,115415,459135
20a42fdf6aac7051297649fc67b83c4d,57,44,53814,17001,36813,59,42,68592,19133,49459
fe3506da8d90c8e755d21cb4ec5d018d,104,95,264214,90947,173267,113,99,270578,70837,199741
b8fe6431b3168798773991f64eee9002,146,119,575883,81408,494475,151,127,625937,121424,504513
dab0146a65e4888e68d4b007c1e9fe7b,49,39,52090,16262,35828,44,36,33773,15523,18250
da9ed2d4dc6b4283a7568bb71935e1a5,90,72,168225,51013,117212,105,88,196868,51131,145737
c34ed5defc68d275f5cf256e909df961,121,93,250210,65869,184341,115,93,269952,67037,202915
6c9add7dc5a8606f06b995cdfe777c2d,151,103,472463,112814,359649,192,125,561756,103306,458450
71f5ae18bccdb1e1eddf9048476c051c,162,112,395448,65350,330098,126,93,262862,79546,183316
a826e078c5c8cf1319d622919a7e82f2,25,21,11445,4589,6856,24,19,7206,4484,2722
4dc6e3da2a44bd84f180610c636bfe8b,1,3,89,133,-44,3,2,133,101,32
cbd2cf809b57b4a100d0a570774c5761,87,75,157358,46544,110814,169,106,280726,41388,239338
4bb6dd99f3c068b34b98de121be38230,70,54,69137,17554,51583,40,33,41198,19645,21553
12a8699d369fa1595f27e9b99eddfd8c,94,71,165384,39745,125639,114,100,174915,53339,121576
d9cf0a69c630468e890ed2b89a05e2da,47,29,61109,16928,44181,36,34,35366,22343,13023
e5a83d77e5c98663abbe292b6421f2c0,130,78,266896,40060,226836,96,65,228718,52284,176434
06107e2b50fbb14a7d57daed0953635b,171,140,632774,140375,492399,149,110,448403,129553,318850
27b3677a9b00ddcae23043ce8e33347a,42,35,21284,11935,9349,38,32,24637,12746,11891
38d8f0b5f93eb3e66206310ad62b8f89,30,20,15239,9646,5593,29,19,17995,6371,11624
16e5774a5345455993caf67cc7f1e060,50,39,89038,21789,67249,39,31,48609,16537,32072
258e9d31265bf7835f63f8f3eb72eee0,52,39,79631,30646,48985,44,43,85971,33194,52777
6af304591b838ce5d13279e236675478,169,122,427079,90079,337000,171,128,449693,73336,376357
9bbfcc77428c4a9f815abe94af9b304a,131,80,492238,155787,336451,183,155,568182,180700,387482
fb0287c0a0d061cd6f45f459f8e3e8c9,55,54,73746,35587,38159,61,49,81635,29982,51653
0622b775613315b59ed40ff7259c0370,25,27,17492,7773,9719,43,28,17406,8460,8946
23a863a7191b02c2f7fd9f6e46db8414,157,134,687379,147340,540039,198,150,717813,218547,499266
3f25d2e43d4aba319ebb059fac1bad14,144,104,577981,137196,440785,212,146,770221,153678,616543
9e1f70f783d3aa6a53e7f1314fb87c57,84,68,154750,45673,109077,107,88,212587,56959,155628
e53ef7461c0f16e256c9acce888fd685,60,49,90708,31621,59087,95,81,140725,36587,104138
d6f1fd9e43b7d37ed887bbaa16688fa3,106,77,276142,83432,192710,150,114,411872,129419,282453
f1f85338faa5f97e450ac357584a6eb1,13,8,2944,1631,1313,13,10,2274,2484,-210
368570d66b7fb9b6ffb1baa18a39f0b5,130,78,300112,50225,249887,114,82,216814,74152,142662
c1786043872f28f5287f1066ae063ce9,51,42,43891,19763,24128,47,39,59518,16751,42767
f70a59fa28a4a260aa09acbc31188fd9,75,54,83680,25843,57837,66,55,88820,28491,60329
1002a2b9608c109978ac423e45d173d0,150,98,366695,70794,295901,159,99,315963,80720,235243
c93f746764587e4457dd26a4bf6ded91,24,21,10036,3559,6477,24,21,7042,3662,3380
8d5e49812f3223624e4b39ee6df113d8,53,38,45620,15368,30252,53,36,39795,16293,23502
46d627cb2f481e7dadb7e26dd3907886,42,27,30050,12672,17378,52,42,42214,12885,29329
7b9352257ed69e9ea47e463a328c35a0,111,96,151354,35064,116290,119,102,212023,35226,176797
49863b239abea0b2aae5fb64cac90ab6,88,70,163403,44788,118615,78,50,131854,34918,96936
3515a13b8cf0d33629f2d0fa0169e998,1,3,236,190,46,3,1,190,236,-46
82256110f49d0cc9c10eb397dd9ee98c,48,35,50936,23750,27186,71,64,89773,32294,57479
10320d17731808eee575f283ce903ed9,31,26,17194,4096,13098,28,22,8927,5342,3585
91ebb02ec950b43acf8593f2456c28d8,220,163,703139,235902,467237,253,155,1001221,194158,807063
ae0fa53aea7c711ff6ae03d56ca2056c,145,90,344305,105656,238649,142,112,487145,93157,393988
8d8137a39a7e60e4bbc6feafada4325b,176,139,611666,130099,481567,183,142,731230,119028,612202
a28a050b5eb738f8fe795fa64622b758,22,19,6155,2868,3287,19,15,6149,2860,3289
30565cf9c976ae63deaa548328299c04,76,72,156074,54986,101088,92,87,231275,35559,195716
b006e3093d585f3598a6418c506ca4f5,169,120,519054,86072,432982,180,115,528424,95484,432940
f38caacaedd6efa0a1f3ea3e83e6d1b0,44,34,28772,9222,19550,44,31,43768,6402,37366
d5ab0d19cb9a13a9f048da7726cf2a6e,151,102,571193,153689,417504,187,148,757846,142799,615047
6b5492e0fb07319bc46e5bbf9a729006,100,83,234510,67671,166839,81,58,149217,59344,89873
702baa5f384e7092b3d6579d302a916c,48,38,40515,19884,20631,50,41,61928,19618,42310
13e76f0895cd672224ac8867133bcbb9,138,104,271193,35897,235296,117,90,223767,42334,181433
02463fe2ce077d6d2978fe8d78195eef,159,127,569411,92624,476787,151,111,458818,117760,341058
2033b30867b4bf4b35ed9178af597c29,61,45,61679,25130,36549,86,69,97159,35258,61901
8f965add26599a2bd082d169b4f8b40a,94,77,315091,48977,266114,76,62,146277,48942,97335
6b791d531526ccc078e24877fca1238a,181,128,524137,140115,384022,160,117,831266,142598,688668
b0ad5fe7dc119125459f7524b5124acf,47,35,53929,11619,42310,49,38,52029,16138,35891
30dd76d44fd393b8487436223c2866bd,160,121,580654,124761,455893,156,90,502275,153179,349096
9ba493be838c966fbbca747bfefe349d,69,53,88174,38102,50072,97,80,215115,42687,172428
70d13680c173712506da43ebb4146122,68,56,78429,31456,46973,71,59,88123,25624,62499
3397cee7a231bafa353bbe8b952ba843,102,80,181001,42627,138374,65,56,104208,43078,61130
f6dabec9b28bd38e080d627de150077d,90,68,207868,53779,154089,129,91,376337,55794,320543
627970b3c2f74e8583cfa476169f844d,129,97,258453,53616,204837,93,69,198160,44616,153544
3120e514530b13a7db364b60e71da8cc,23,18,5999,3166,2833,23,13,8304,2200,6104
9ce45ae4cf28098d339270a07a1a7dad,101,85,202102,52405,149697,96,79,235774,54306,181468
3ac30f17ccaf463418d900226e5cf5b8,113,109,231763,63441,168322,87,70,152138,55118,97020
a745f728e06e4e22fd3642bbc599636a,164,94,388339,133397,254942,171,144,484929,130966,353963
05c601dbe8c0385d5776e81e42677a6b,118,76,376476,50615,325861,140,104,280014,61176,218838
cfb183c816b5221588b82b6da2b4f723,139,116,356208,45097,311111,142,116,290977,59538,231439
803c7de1fb8eb3280de6937b6305ae5d,117,93,190874,40716,150158,123,96,265421,32462,232959
3eca17cde97a651e2647d9b254ed6a2c,5,2,393,144,249,4,4,302,178,124
5a28cc7ffc15aa6de95e3b1cd51a3e90,133,106,451678,95330,356348,160,110,447553,83109,364444
df0e00eda5557c76c76bd9f68dcfbdc0,47,36,56947,21471,35476,65,52,87777,26167,61610
fffb0d9f57cd32d13f022b17f2d6837b,175,145,684025,113568,570457,189,144,887046,112160,774886
b424c09f44b8c915d8590e6864a61144,38,33,55616,14046,41570,70,50,95426,20401,75025
78b14c6f3b6083622bf8b211a509e1cc,127,115,304392,56620,247772,120,96,255459,63803,191656
1564de6459fbe95272deacb6c474551c,97,81,166605,38403,128202,86,75,144673,39980,104693
8eee993be0ca17cf5cf691f0aeb8f13b,51,31,59611,13314,46297,44,38,61206,19963,41243
d569b5fcdc5e1743e53f39b05fe721a5,95,65,193152,52076,141076,123,91,239415,57454,181961
4137525a847c832a1c553a0dbeb7da3a,125,106,420036,116970,303066,134,110,423516,89968,333548
b90e1703bc2b03b87447b6a02ad1e4ba,35,24,15859,8888,6971,28,24,17242,8074,9168
164671601cbda7741aab34420ad79c71,148,103,507631,105843,401788,129,86,437803,83402,354401
465f09398c3a3d7dd1c7ba2eba8dbdc6,127,102,284093,69226,214867,150,120,406970,73845,333125
168e2fed7173c86eb6e5e3ecd00e6972,36,34,25875,10776,15099,40,32,21389,10462,10927
02ff570bdfde7f210adfd8968332f3cc,20,16,7022,4488,2534,17,17,9553,3447,6106
aa54e34a552c9f28399a9d22244e626e,40,30,22224,13960,8264,42,39,35121,10319,24802
9cd93db74ef9f09d393c4fef32e9e9d6,54,43,93887,24577,69310,71,58,92675,33005,59670
31b7f4f7b1abc326a3fe9281180462ef,187,140,564231,134517,429714,154,121,438444,117550,320894
f7ecfe9c1645c583d4e9cc811cdcd640,65,50,78698,25712,52986,59,52,53191,25346,27845
6cfea979c91b54dac4fa67027f70ad16,121,87,312600,86732,225868,153,109,434940,66203,368737
b40e6053e08ec9afa8b7776945cccb41,94,72,150516,29553,120963,61,54,85285,33601,51684
1bb4908214a158589e703fe67bd826bf,20,15,5343,1409,3934,13,13,2846,1264,1582
10fa2b7a263bc200a5102afd4a9f40b6,22,15,9592,4589,5003,25,21,9330,4886,4444
994b3772e00017a29fa8eab1bc689c7b,67,45,119049,27360,91689,59,44,111119,33757,77362
2db1030092a202df27a9b64a7bbabfe9,45,30,45508,11300,34208,55,41,65476,14078,51398
c871d5538bd0309226cbccd753965ef9,24,21,14648,5289,9359,27,18,12526,5888,6638
05be2ab693e93787b13d56a0276cccab,106,63,183919,49185,134734,120,75,228382,46267,182115
4274c9876dc63d1627dce8ce56f21274,137,101,477427,108249,369178,171,122,526194,122386,403808
04ba9aa4ffddc20bfdeccc00ad241771,73,67,147729,33891,113838,70,59,124918,36344,88574
e1e9314af81d8623acf69654d61bda1a,116,81,256283,65629,190654,160,128,413388,80655,332733
6ec225b8f863ab6bbceb281871999f29,169,126,378566,41395,337171,141,105,319001,66840,252161
5d21ee3720ddf83cec1013e7d8ec5d1a,26,24,16881,6455,10426,29,16,12924,4239,8685
f820813de05714eddca6f65d7b71fad3,98,64,175141,30665,144476,84,63,141538,42482,99056
34d5b781699aff669bf39a7db004787f,167,96,413612,93674,319938,142,103,381822,128161,253661
7c0ed1c59974a91c6113e69654daf370,52,43,60445,32462,27983,57,47,90611,30102,60509
35fea7af67f8cdd430833e9842fa491d,91,64,111201,43558,67643,81,65,160678,43362,117316
1e14df0398686f94bf97cb6752cce7f3,96,76,194248,78396,115852,144,115,310224,68198,242026
0a67899ff493ab983815f185e55818a1,120,89,327152,60713,266439,123,107,308803,55144,253659
61628aa32605b9240cdf06993a082476,154,106,464120,99287,364833,159,107,522469,113343,409126
e07faf80fcb73f6dbc8213609b140401,31,25,21108,10520,10588,35,29,22752,9356,13396
d4199704704aea4ae5843f926e1c24a2,25,18,6475,2495,3980,24,14,9007,1913,7094
295db84bb6d3f95e0940734ee8962e2d,210,160,1041748,229502,812246,227,177,1475641,191379,1284262
874873957c75345bd88219bf6e6d3da8,71,58,108272,29060,79212,51,40,60559,25461,35098
e505d6139b65dd0891e24ce710b44211,36,34,22496,10543,11953,40,28,31907,8968,22939
b65d32dfd646bf0e98fec7c336910f2a,46,37,41720,12862,28858,61,51,63401,19753,43648
85015b836532e835bde79f627183c9aa,133,101,387067,92702,294365,119,101,363962,83378,280584
d76387622db3c5c07969cbc81bbb026b,87,68,156984,57329,99655,96,85,185876,69641,116235
c942e0b8eb29e03d130ce650b368451d,5,4,1664,1063,601,4,4,1063,756,307
7e9d6d220f12ab64e7cbdd35616e448f,106,88,222070,38828,183242,125,72,175043,45210,129833
d8ba8303a357abb105400fb43880c563,22,19,7037,4700,2337,22,23,8274,3650,4624
a261e08dcfeaf15c817b4b18123ad89a,134,108,334250,89578,244672,146,112,411912,77907,334005
e65b7e815ef5381698582481b8334ec4,196,141,884220,181188,703032,194,131,667893,130724,537169
3580ef4c31da3b82069c0a3f056ea20e,25,23,7976,6301,1675,29,18,16426,4053,12373
0921166aa9b7b4c0761302a2ae3678b0,181,144,762623,95891,666732,115,96,423624,97833,325791
9b7de84153516fff632d0a46745084e8,75,48,77471,20502,56969,72,58,100971,29517,71454
9304bdac9c3272a05f1ad6cf5a4fb5e2,33,25,28540,8721,19819,42,28,18665,13708,4957
9f5ae045e2f79fbcf7f2962488c37502,22,20,16933,3954,12979,32,26,18915,6057,12858
0210e5e8e7c45d56a346a3ec4562b696,25,18,14239,3042,11197,26,17,8836,6700,2136
b0254856741012e9b6459591c5a5ce5e,73,43,121038,17150,103888,64,53,101830,25460,76370
26dbefb8042a2b27c74c6a60d93e05f3,92,75,166531,45433,121098,86,67,159946,50884,109062
95e63ed88fd535abe11a5f89922e1d45,62,59,92012,36990,55022,71,52,108905,29513,79392
14711dbdd14f2a0d80655d79777fe5e6,136,82,201421,22503,178918,100,87,135526,37884,97642
81aee4c91865a475dc216106db031f77,60,55,78564,22793,55771,56,37,73512,19477,54035
c17a4c1035efdcdf28dbc0351bcc864b,31,25,31485,12677,18808,44,32,39216,14460,24756
d9aa156282ae781a9218a5beb44cc9ef,66,51,85073,24831,60242,86,63,140867,24977,115890
2033946451fa063472195d692c8d6520,22,20,6129,2583,3546,22,15,5142,2689,2453
2952d52f5e0ddfcb6d56f8e941e41c5e,138,110,273094,75611,197483,127,99,293144,80912,212232
e3f1bd1507604457e5ff8d038a0a7efe,136,86,279455,53667,225788,125,77,233381,45578,187803
18800b9c4c342064d465c6eccd9db38c,27,21,13058,3389,9669,19,18,8491,3771,4720
6c9e8fdabbc71cb04ed390146480244b,162,126,406888,144447,262441,119,88,419092,85596,333496
1d416a08cc63761a2645edf1b33b13c0,89,72,157973,52008,105965,125,101,281200,61228,219972
6bfc5e8901213f1ce1a351c4a04b7274,69,54,144044,33063,110981,54,41,95525,38553,56972
aaa2b523142b1d36f19d14a66ea15a48,132,98,300980,62583,238397,82,72,200677,68548,132129
99f68c7d863fb07f24b994c43000689d,113,112,281858,68538,213320,79,62,158020,60014,98006
4e1906c4a164fd884395fe1a23cb6138,64,52,95220,29113,66107,58,43,79370,26403,52967
346526fb4f15f13770c121f1a8a0b634,30,22,12943,3675,9268,19,18,7450,6173,1277
b5f11ebf8300719af168b47d4a37f0e2,159,107,731356,111438,619918,119,91,382736,111131,271605
87e3f7e16fca3c0297cc86473d033800,93,82,143339,50226,93113,77,67,120750,56807,63943
488496edf4460115b6d167530250b45e,82,66,105486,38054,67432,101,73,168269,40998,127271
d735439b4aaa890dd95de455f5661ae9,121,111,243959,88173,155786,94,80,263885,66887,196998
e3b40c6e4dd361806d25d77b93e01eec,140,94,318183,76958,241225,152,121,471201,88780,382421
54f4b9467322cd7e2d203e1e951daf35,108,95,326637,93220,233417,119,83,310062,72964,237098
2b0f903742dfbede830089fb3bd1797d,32,27,19453,9753,9700,37,32,25700,10730,14970
4f46d548ea5b5368659b832bd3b8e815,82,64,108289,30770,77519,82,81,148347,44665,103682
e59e35d6cff7aa70d443654ea7b74b42,42,30,56244,21154,35090,37,37,54034,22110,31924
8ea6c69064d42c5da7bac9571e271ec7,27,23,16265,4452,11813,26,24,10980,7917,3063
d03cce906915acf7635e56dc9722c343,93,74,181920,40480,141440,76,62,113865,34928,78937
43e36518d515b2c3f11890264cf48b35,32,23,35499,7919,27580,29,24,19826,11289,8537
4e972c7da7058adc969f9444f7f292b4,107,83,371912,57187,314725,137,103,363671,74842,288829
1c64579e9698a99e8bccd33f2e1ef83e,71,44,118341,22789,95552,46,38,67469,22690,44779
41c3040a01efda9e2ffb877547f2501d,174,129,410458,86167,324291,91,70,291823,72083,219740
5401c37fdcaf0d46c34a9b3ee70173d1,78,63,158059,53786,104273,108,92,241836,45697,196139
b27987cebf34709e0e3fc318c4aea4d7,86,80,129944,66635,63309,71,60,143431,54288,89143
db5054bcd49d4aa99c20cb5427430b15,82,59,139029,38624,100405,77,64,112173,35613,76560
a91603fdfb4c51dba791a963f0c8b291,28,21,14296,3387,10909,31,17,8917,2445,6472
8f98f8800d375549f189a8845f05aa12,117,88,317385,96495,220890,172,120,453152,88919,364233
4a20bffbf52ac0ebb633e44ac85a981c,62,30,60491,12686,47805,59,52,76121,14276,61845
2ebcb25253525a94f9140c60957a3187,61,47,75871,30346,45525,95,61,117201,24693,92508
591ba97f649fd224810ac82255b1223c,99,84,186738,47458,139280,61,53,100080,44471,55609
6ac9b2b81015c354e209c1510eb54cbf,48,34,52345,24605,27740,36,35,42795,25654,17141
67019c495900111d0d7bea38c75275a5,51,43,55291,32965,22326,65,50,116891,28630,88261
2e2afd366051eb26ad61719804021b6c,114,93,212942,37523,175419,104,75,151265,41536,109729
76d5cef1ec1e88dd231c84d4ae801846,95,77,163283,35236,128047,52,45,101956,30324,71632
0ef7787aca21970e23a82797a8a55ce3,21,19,17915,2879,15036,28,25,9885,5409,4476
a6fe4169ef5f57e8505b224b619ffd1d,101,69,152327,55939,96388,140,96,232989,46022,186967
52a9eb568514d3a2436a3ff7ec6dfb52,31,29,27451,11440,16011,37,27,40566,9430,31136
0a9014571cac8c8f86c346e88486dbde,24,20,11885,3574,8311,28,20,8512,5127,3385
f507995ebedae327ba6eb6c795acd1c3,196,139,628533,115932,512601,158,123,477997,104052,373945
aca16e30e0b16da811b280d07787c56b,5,2,719,371,348,4,5,1581,719,862
1bbb80c2ad724a14cc1263033a79d624,168,117,356256,71628,284628,164,114,328125,84796,243329
396dff7bb531b99c818ad61479d29ca8,52,52,53278,19968,33310,43,28,50394,8275,42119
040135acee4afac53e33d4c151c76a13,96,78,124959,69819,55140,104,59,178625,56485,122140
cc0a1fa8477c58e54a9294501938e1cc,132,101,276413,61297,215116,131,119,305116,50434,254682
4d23097edbdbc72d115fdfe82563ccd5,31,21,20122,5699,14423,24,18,15971,6040,9931
a9cc3605d9ce702762909f4c79561f36,50,36,56329,14297,42032,42,31,40946,14572,26374
76df2e88812a7bc1182d024131a28cbe,183,122,649883,184152,465731,204,150,819958,150223,669735
7d01e4525f7378452b878dbe37ad96c4,76,47,142786,30754,112032,61,55,84304,42204,42100
bfb600447d8091f8f679cf3650e85437,123,102,289117,63052,226065,108,83,238522,58381,180141
1c697661d3ec25c34a66a310048cb96f,104,77,223664,77089,146575,153,117,366506,77608,288898
4eed12c5e037472b2cd651cec555a609,71,49,109229,23092,86137,77,54,113268,23341,89927
2cc09c33f0ea3e4e4b942170201ab411,21,17,9361,3434,5927,22,22,11366,3181,8185
43ae91c520f900c39e95917bd425be77,52,42,59728,19008,40720,56,49,50318,25561,24757
a8d5ab743380910bbb84d8b73431b09c,100,84,189842,40185,149657,112,77,169541,29688,139853
9dd2334350f81c29c04965a3d26b16c1,15,11,3635,1535,2100,14,11,4176,1195,2981
485a9bf02a0803ec91e58f12629f298b,55,51,73800,25020,48780,74,61,120914,28813,92101
541ef57967c66e13a9ebb5d219ea341f,76,72,139796,33699,106097,74,41,85678,19681,65997
11b2ec91d9c8fca57f15b4f9939bc57f,71,65,123025,37389,85636,80,66,143997,28110,115887
c79624fb655573372b9c5f10ad94fad5,159,97,408580,111575,297005,136,91,387216,120686,266530
cd385b7472e1eab60461e0d43ce0abd8,143,101,345329,91610,253719,157,99,354058,68619,285439
480a0c20ce9020116a517255b9a98bd4,124,98,248030,43515,204515,143,124,338106,72760,265346
2513c09a05de969f97ec7e66ee739b41,46,37,51821,21219,30602,50,42,64038,22207,41831
1026410e91664f15f0a3b84e129742e2,130,98,340410,52253,288157,122,98,248276,61700,186576
dee4e4a35170511e53c277895b412359,110,72,197621,54592,143029,139,87,218916,61869,157047
5f9f9bc0644e9ebe2ee6b87c0231e93a,50,36,54523,11512,43011,33,31,32574,10988,21586
fc39115b307f54758547303fe414e420,77,62,88572,34389,54183,92,79,136058,43235,92823
f34d4753cd2a08df65c3888c6f754229,110,91,262323,41598,220725,90,65,171795,47740,124055
584d155108f60ef0272360f4837cfca7,109,83,232524,45223,187301,144,117,403498,61371,342127
55516de252eb3d489ef48a77b02f3af0,29,24,19739,5061,14678,19,16,9692,5607,4085
46823217d8bb2acd203b415d71f757a3,131,99,288673,40580,248093,135,117,189302,62588,126714
ef3733b04209847bda9313880628aef5,180,149,804922,125330,679592,183,140,612112,127318,484794
e960bd2c90de22e8c0987dd3be4b34f5,127,96,430302,140057,290245,164,117,554138,106060,448078
cc050a40891e45baf3d6c79897ae569f,96,77,204718,56528,148190,124,104,297307,58403,238904
a37890d73f2d624290a1a71819ae0028,216,122,591534,180195,411339,185,141,756527,143944,612583
b8408e8aca07ca0c2b06cbdba352d8df,11,9,1555,1382,173,10,10,2211,968,1243
d58a7476eec949cc971f39cf4e94b14f,45,37,61645,20610,41035,40,30,52028,20720,31308
190b3885084b3724ac70c1fee59bb8a4,20,21,5324,2522,2802,24,13,4528,2470,2058
7b9815b2c5f0772f64f7fc6c986a0e79,116,95,313714,53912,259802,138,99,308400,59818,248582
beadccb851912908775475987efb91d6,75,67,94421,39954,54467,64,49,108572,44182,64390
f5ec6930783f56ea4f935641e7a2f83f,44,40,65329,17564,47765,54,30,64035,13056,50979
899d1108195d232779661ca4e04fd76d,179,137,612465,110572,501893,130,81,419427,117992,301435
6bab1501ca66c1e29de3d259ce9cd9ef,33,25,34764,17568,17196,44,29,44283,13399,30884
71b8401e73f0a6f7ff46dce717c273af,140,121,372624,78749,293875,149,122,383421,61760,321661
2e8cb5ff6aa47cf616b9c633f1324f94,223,177,2315183,334543,1980640,245,185,1424153,280663,1143490
ea1cd4adcd8d42f8f98a676ba329e8d8,102,74,133418,23223,110195,78,57,119204,31436,87768
75905d580e4fd0ac1bc786a1d32aa33e,130,107,385718,74009,311709,172,130,368188,82601,285587
7654e44048369f5643e86e77527e9403,78,73,168411,61760,106651,117,104,191446,56237,135209
b4cbdd4831457ca39e413759ac6ee2f8,93,67,177484,35710,141774,104,88,202004,48519,153485
414f339c960a72fd478f95c46eecb6af,97,83,194239,36344,157895,105,90,179594,34572,145022
d2c9d4583515dd007ded2b643bb28136,30,24,13046,5801,7245,26,21,12201,4483,7718
4104bb83f4ecfed4beb868ad25a59efa,126,97,314061,69329,244732,120,99,344157,88419,255738
52df831c95300f9f4221acfb05694f17,101,68,145536,50469,95067,104,63,182295,30414,151881
164946c7a31a141a1bb2ad44a221d349,73,59,94528,33603,60925,119,84,176002,44371,131631
723008c42de2c2625a1b70b2ea111edc,79,63,116103,39241,76862,99,74,174065,27611,146454
d45dc34fb3b726dd3da0f0932473ad85,98,81,172845,27957,144888,33,28,42296,12698,29598
a42b265acdaf273e60dad58bf082cadb,58,49,87844,43553,44291,97,78,180334,33306,147028
bdf71e749c8b92e9f35a9ba9513f570f,2,3,199,93,106,3,2,172,156,16
202a9e4cab3a1cbe00d62a1ae5fe1457,58,57,67860,43977,23883,61,56,103932,40318,63614
8db482d55de014945b5073912d8815bd,132,102,402334,109892,292442,163,114,479188,80674,398514
1785cfc9956e786a9ec1afcb530831d2,102,77,172574,68392,104182,130,105,325736,76364,249372
9594618ccee8140c0a58f5b843bdf89a,130,83,268489,54524,213965,142,90,321147,41498,279649
a4b03adfdee524186da44bc6224ee0bc,108,82,246183,55839,190344,87,83,173312,67818,105494
e3545c3206dacd85af47f8b066f7f9db,150,126,343667,53764,289903,91,81,167458,83783,83675
7f86b90648a84295d3f3a21e4bda1ac2,69,60,90844,21493,69351,87,74,117667,29761,87906
3b13bb3cdc8fe20f29d615ff93b8ea36,34,26,20210,9717,10493,28,20,14414,9328,5086
e8852e2335df4e1cf435542c412f0252,83,60,215402,43706,171696,103,92,197428,67810,129618
a9b520d2c1e021f451d2e6a789b5d804,74,50,129323,42789,86534,106,86,251375,47740,203635
8327e132e92d2c1c1ced2a3e5fca601d,86,72,127846,39329,88517,77,52,118743,35617,83126
a06b0c5a53e2f5d686006da3c036855c,106,88,242274,100517,141757,145,115,416350,72787,343563
61db7d3616e614fd63d7b25695030309,156,119,711521,133589,577932,185,132,700015,126940,573075
48ef863750f2e16b54c7a425657f409d,52,44,61990,21433,40557,54,33,60957,18319,42638
68a8d56d3fd1b970efbc40b9588ffdf4,111,79,172021,55505,116516,103,84,209645,49095,160550
b5a997d348a0cfdbf959327ae562124a,136,92,252569,51310,201259,121,88,230198,59880,170318
bfd3c8fb3fd980d0e61657c670583852,153,125,484814,100940,383874,114,91,295014,101773,193241
09235f7355ba62b916a16a62e84c81bd,111,74,368097,95743,272354,150,103,461927,94598,367329
3d7c2d3b83eecf33bff312d129630110,65,46,51304,28851,22453,70,58,114608,18111,96497
1f9df840df9aa4dcc7f6d1b31361fc75,184,138,716096,118304,597792,175,149,607719,137515,470204
fbab9d4dcc2b2180533f738a99a93919,73,63,230137,79810,150327,177,125,427619,104172,323447
969a6cc5dc92a91ccb346d5146b11808,203,148,846250,173022,673228,209,162,931031,139565,791466
89c23528c585e80d6401224a388c3b6f,98,76,212452,45714,166738,74,69,122601,33123,89478
cc3b0b8111e29c1f9145f5d488d81fa7,22,16,6179,2106,4073,24,16,7770,2542,5228
5493e9cfa622980c3442c62a713486fe,130,106,276747,58387,218360,102,76,178254,59319,118935
87fe44b79fc95dd2fbc9165e6a719019,156,111,487243,106499,380744,156,128,532429,120008,412421
24275b7ecddd78175652347dc6e61165,24,14,8552,3754,4798,21,17,7763,3071,4692
af640c3ec913d85ff173a6dee3a1e27d,70,54,97744,36050,61694,75,48,108429,34960,73469
722f91d85df1e4edc67afa5176d384fa,50,38,61871,18275,43596,49,42,48187,21681,26506
21592d082aa413261239f59a5f9d59bb,195,163,832388,177491,654897,195,142,778050,106083,671967
7b7281ee9c15e318537a93de4ad9ecf8,48,34,45732,15831,29901,40,36,51764,14581,37183
b32c48bde4cb5fa95ca613917c0f17d9,207,107,655970,109232,546738,208,142,679543,142695,536848
4b2a997705612563eb3bdd11802b7ea9,45,34,33996,10083,23913,50,38,33187,12137,21050
5750421c44b9f20ddeb3f6cfa75a7e45,110,80,195924,30890,165034,112,89,186510,37643,148867
2e7a3eb0a57a54c625a2fb68224fe19e,103,82,211043,63549,147494,119,86,191082,46948,144134
467ebc876a318a3d6df3ecce591b3d3f,83,73,164287,40453,123834,94,90,180555,54014,126541
9114308336e702974dbf4d40abf70d26,83,76,110197,35231,74966,55,43,64781,23967,40814
20139c5eb99d69ad6cc00137669183d9,48,30,54606,16637,37969,59,36,96201,20064,76137
342ecf216c15046466475e8eba1662b1,50,40,49349,11662,37687,56,47,47021,17421,29600
f12d0790cb7a1c64891e700b9fab1c41,74,54,129150,36358,92792,108,97,197692,39800,157892
772c546fafefea20639e1aa557122965,112,91,262091,74765,187326,145,111,394541,77896,316645
1e4aeae0c55cb7f6d2b80b69e5cb924c,112,95,303240,56947,246293,92,68,204227,65734,138493
9ccfdbcb7d9692e2b3ab0be9f9ea80df,79,76,150186,50064,100122,93,71,173252,31287,141965
708f376395b325ec1d9c4d6f17c8fb1b,44,36,32844,12625,20219,63,49,27487,14157,13330
89db2659ed37871f61993e922aae9ce8,148,97,422074,68832,353242,177,137,489438,85368,404070
44d674435c2ebdd8a1a258aa620e920f,105,93,324885,148291,176594,150,108,468589,133210,335379
dece776cf8083c90fb4f540288f304bb,32,24,24206,13980,10226,48,41,72009,13743,58266
024082704e4a8d7d8d2da81cf26af00e,46,29,23971,10183,13788,37,25,30056,7781,22275
8ff55e7267c9d46c0a92f945d9e8cb2c,169,112,419888,73845,346043,132,88,436613,82328,354285
28a5e7816f5a28b33cdaed3c04939301,106,76,403017,108116,294901,178,134,570966,94597,476369
869d45cfe662a065f7f1a86a81e1d846,139,94,404870,116526,288344,169,126,421986,148271,273715
6357012bdab55873e7e9a1a899b8a7f8,128,104,307105,89910,217195,132,82,296342,68564,227778
cc5067351834c64c55144894f4f83d64,93,78,188424,43929,144495,123,81,232662,57428,175234
ecc2395287ccd8b6cbb0398a0084d1f6,30,23,14107,5597,8510,30,24,14565,7834,6731
d5ca90bf7b4f4a3b839210c4d4dfeedc,25,20,12223,7886,4337,33,30,34395,8046,26349
3443b0a6eee1af3cfb5c5f84c9a43374,89,50,86724,29127,57597,75,70,91129,29422,61707
ba4465002fdda0bc8f155fcdd9914371,97,78,196115,53281,142834,93,80,193332,39563,153769
ae28e20af53916295d8498ee78813230,153,113,307842,94881,212961,114,86,289139,88444,200695
cc17af4261826d476675396be3771167,122,82,260693,62990,197703,91,70,168366,58833,109533
5d5e71c87f69f5f1913f2eb474260092,127,97,333981,76282,257699,114,94,264393,66275,198118
7b55b72d412bc178c3cafe20ddbe8167,125,97,291240,110099,181141,173,105,385162,85582,299580
06f01e14b8067e55249ed6a0e143d1e0,134,105,417034,98321,318713,132,106,402122,121899,280223
33d6a3869dfbb74b2dce40645a0771bf,118,84,398524,113662,284862,175,143,517103,121352,395751
9dcf1e532486f60b70463f2bae3f3561,44,35,50765,20001,30764,46,36,43657,21259,22398
8d96baabe63c67a7f42024e230dba078,69,47,129642,31216,98426,77,64,104908,36105,68803
14606fb4b4bf60486bf80e46047650bf,66,49,104735,33385,71350,74,63,122162,33635,88527
7385f80e77c53d6416246571565c3bb8,42,36,32504,14014,18490,45,34,43479,14422,29057
8f28c5ce601acec6abd7b3c71f5af808,59,49,87253,29478,57775,48,36,79221,20820,58401
2a5eb2e69de29aac15ced7cb7f7ff2e0,103,82,203627,55447,148180,109,83,290375,40888,249487
198dfdbef22c316d4bf84f9fbacef416,97,78,133952,28293,105659,76,58,95285,34846,60439
b994eefe5083d429b4d16d6b251948f9,3,3,864,183,681,4,3,300,864,-564
bf260133cd569f89ec8d18aa9c75f0b2,117,97,357907,101555,256352,156,106,453736,89015,364721
382bb7d408c70ed670a7c14a64714b1c,106,65,160870,40723,120147,134,98,242010,36721,205289
b2a6e8af345b13fe73215678f828e50b,58,40,79292,22464,56828,50,31,46794,13475,33319
e2341748589553c203a2e515b80182ac,39,36,37088,19224,17864,42,40,40516,19037,21479
b8bc007eece2e7f3a2a88627bb4bae96,138,88,299465,84995,214470,140,93,322780,48249,274531
8381f92843181fd545cf0a4a7a5c923b,25,21,5847,3985,1862,28,22,8917,2779,6138
141ea9aaa528ff40135f7e9c8213870e,87,64,125763,37437,88326,102,100,207749,52037,155712
6221dcdcf84a0761346404a4ba76f097,77,70,183169,62082,121087,74,63,101862,56734,45128
bb85ae334235bcc05f2e205487f3fe74,165,107,380456,71240,309216,148,97,350313,47875,302438
56f99c1bd40ad563a38057df72f0b015,138,106,357557,59760,297797,169,119,462966,69287,393679
f100833078910666487791e193a29325,88,61,225015,82555,142460,139,111,385164,86135,299029
558b360d136ce3fb99184ad3eb50f38a,12,9,2598,1714,884,15,10,2779,1973,806
d49d2c787af921de72d07813e123ef75,187,121,482024,111918,370106,146,108,414727,95198,319529
40b1aa35b51d2e7fdefee7dd9da80f22,100,74,141373,40183,101190,118,105,298598,51212,247386
09b96cb7f9f05a16477a67d61ed1ee9a,119,98,248082,70872,177210,116,80,224816,73758,151058
c54ef161dd185a1866c12c0c5c9f3d5d,115,85,149910,40740,109170,101,78,169864,27737,142127
d2eee26a5510b36caee739122cc7bd4c,72,59,103847,43122,60725,76,54,139585,22466,117119
6175e1d92ad9af95dec99b0db7d82ce6,32,25,31176,16564,14612,38,31,38527,16286,22241
297be4e74a8babeb22f27f7947ce55ca,92,73,194556,81436,113120,142,100,268791,75682,193109
ce2f98fcaf3c4950aff8f5fdca84afbc,101,73,200405,39370,161035,85,64,150650,48552,102098
096366dc7cde4ab7679831d4f6047279,58,48,88617,22401,66216,70,60,98465,25620,72845
dae225e0f6766adf29766e51595acd61,73,66,143080,40093,102987,57,44,99102,32345,66757
4cfe7554c7355c3aa2d94a8239155c38,29,21,16194,5863,10331,32,27,20208,5664,14544
280b16fa83e26414df33dbb9a3d01f8c,143,105,274126,60821,213305,146,109,327009,57889,269120
acc0d092a890f2b9ae1428cb0e319999,98,78,173642,53511,120131,119,86,227416,42437,184979
a3d5112b7367863478d41713bb6e8221,32,25,27781,11709,16072,31,27,24293,11032,13261
a27066401d448ff4a3ff1db976055bde,88,75,205112,57830,147282,99,96,206463,63835,142628
b1079e12580a8c1255f4ac55dcdc5195,65,57,105774,30504,75270,58,47,85592,28048,57544
4987740d20c61439c21f945215c5b4bb,45,45,55888,27176,28712,65,50,108478,23358,85120
691e5a3c0dcac0ced8758115b38d28b3,90,78,170089,33840,136249,78,59,112823,29482,83341
458c3b4949098f451e3579e9a7ad248c,82,57,133767,33419,100348,68,62,153893,44936,108957
0dc772b22a596a4ba8fcdaa787c69e11,98,70,165901,30552,135349,98,67,139026,35702,103324
4bbddcb6a8f45bd6b9e3654941498765,29,21,32684,8320,24364,30,25,19138,9415,9723
b2d4724fe820edcc8ffa61bd39e392fa,143,126,446444,104902,341542,123,104,357467,83873,273594
4ba20d9062005f1eab813ff45422dad7,125,84,596474,120004,476470,129,102,401993,139550,262443
ca7a1858c5bfeedd6cc09375cce33587,115,83,212713,54746,157967,108,81,255420,57991,197429
9255988ec058d35b83a7b5e3f6522f1e,30,22,20192,9613,10579,25,26,17072,9986,7086
52418e14fe417151e5e447d1ffaf60d0,222,156,1041887,172350,869537,191,156,725317,138290,587027
c26fb8d923dccbfe876978e3ee470917,45,37,40434,14028,26406,40,30,23926,15951,7975
4db0b538b50359d2d3847bb94172da75,67,45,83261,20611,62650,46,39,39395,27272,12123
3dd3dc38aa7cada9bcd908252a924adf,89,63,91870,25794,66076,89,69,126937,21437,105500
801069d3ae9df2be1afddac0b93c97aa,122,94,297311,80179,217132,98,66,295271,74741,220530
c195976650eb22fed29920582ec4ad2d,38,30,29694,12657,17037,49,38,27264,11641,15623
8b42662fdd97df6ed98800cdf9d96b6a,107,93,190130,48772,141358,81,62,132114,53331,78783
c082b0ca1b04ab9f86aa9fe1abba3945,49,41,54245,21649,32596,61,45,71414,24539,46875
20cf54f5029180c5d6d7b69aaba9381a,124,92,303545,48117,255428,161,130,452112,58028,394084
328783d5ab7cc34194e89399d55d85fc,29,21,20087,7038,13049,29,23,20176,8792,11384
ab11ad26c1624672a2365bd54dae8974,33,28,24176,10210,13966,33,27,25146,9965,15181
f80782f9cbf0b34879f03d1e80761329,84,70,159802,35603,124199,81,69,128761,40670,88091
961a21686110215d0e70f87d1732f715,52,44,66782,15904,50878,50,32,52646,16206,36440
c5b123fab443686c4c6d517ec0839c85,189,132,658024,77932,580092,167,131,631897,101061,530836
04fd54c9420f7f10f6e3858ebcd761db,149,110,462203,99474,362729,145,118,420093,126902,293191
7fecc77ddd469402a3ed939145837aa3,173,137,539876,88096,451780,144,108,464570,55336,409234
aa504b32bbaa6a3ea3d628908de21d0c,38,35,38371,11382,26989,48,36,30904,12045,18859
ac32c3c8550306b099863c92745f3ad9,194,158,1047109,337704,709405,192,136,1207004,188232,1018772
135ffc906c82b041735260232c8ce210,34,26,20008,5772,14236,31,29,15592,8894,6698
aef5a1c7f3a1b7a0633e82a6fb6458aa,152,107,463800,91139,372661,198,140,576751,110091,466660
ac13c5640826ef11bd80d309855cc9b5,151,125,439225,79051,360174,157,106,335242,58427,276815
545fc128a606f4d0469730fae6bee01b,104,62,188942,24119,164823,111,76,217424,31385,186039
b90459202c40b8c9886351d684d04714,113,77,153559,55553,98006,118,95,268215,54693,213522
d040c4d82c205438ac2f34f256e2bcff,26,22,16436,4919,11517,28,15,9615,4573,5042
8548df1cc6e80c75c8f76d7f6ebf6696,31,25,41114,11075,30039,34,30,30456,16064,14392
2eb2ce35ed3dc6249b32082d052cb9dc,186,126,507666,141759,365907,144,112,414662,97770,316892
b9ef8521136b193ba418373a7901d7bb,61,48,97912,29068,68844,71,55,116725,35191,81534
43191449f3f7d77c047bcdc8cb1f5b82,51,41,67788,21318,46470,50,41,58037,23210,34827
b397bd7a7167198582d8be96cafb9908,108,95,224396,46579,177817,135,100,283591,40167,243424
0a92cf5c7a0c5bb667fc827d0ec44bc6,118,93,348165,62798,285367,161,117,442251,60131,382120
9677c48a00868d12d46bfc6f1d66b2e6,43,35,49043,21297,27746,40,34,48596,18366,30230
2d4598e1d4a13febfe0444d3b0dc1662,50,42,66268,31262,35006,49,36,62008,27576,34432
cef34f97c32c78a11769cb1ea1208f47,3,4,359,463,-104,4,3,463,359,104
a9911333dceda8212b5c0e1c9858e1bb,128,109,325046,67771,257275,107,86,233907,70187,163720
fd6196f1bae1521db8367bb879831ab8,99,65,164275,56132,108143,86,57,115253,53371,61882
b644987758d84c333a4e2b9b66b82058,146,103,381565,72696,308869,135,113,404495,112641,291854
9196fb6a36cd69e5dd7c77b29e76e633,24,14,17074,4320,12754,25,19,10671,4305,6366
c566292cf3e27b8dd4f353f80521ced1,95,86,190584,37371,153213,76,57,84232,34533,49699
c48ae91a70f02566d932405aa1f9df72,184,117,503397,112960,390437,142,106,360479,136535,223944
7fb39ebb5c105d76654668efe80f9376,59,37,105230,28219,77011,46,42,74460,30501,43959
bb01981bb2a946cc2e38693b399576d4,76,61,141485,40270,101215,82,63,126961,47958,79003
83a8c59f78b98d8ce50e76f011207bcb,33,28,23562,14487,9075,45,37,47225,15286,31939
75793b7ce6b1b2dffefbc090d280e7e1,147,87,349458,55697,293761,137,113,380491,86559,293932
e33b35f23aa4a8066098f15570be7951,113,90,237928,52983,184945,91,70,182278,43556,138722
b0873c4cfd0ba90a1f004872ec33aa1a,41,31,60002,21357,38645,51,39,70942,24632,46310
9da873ab189e4bf9c0639814b1aa9038,112,73,175096,58342,116754,154,112,381628,79882,301746
be618917e44e8c2172fa0e7d99ba864f,186,135,742662,172016,570646,196,126,764750,134091,630659
d4bab162e1f9ab7d829759d4b13938a0,144,120,326210,62088,264122,123,99,292239,61924,230315
4494a6cd3e230a080f2c52752b045f2f,81,69,156247,35748,120499,80,69,155466,38608,116858
b753fd6d59056bc899705731bc1dfe7d,36,26,23089,7560,15529,31,24,19365,9306,10059
4dd056a95221c4cab7b7710855dcc5e5,24,18,8317,3454,4863,20,21,8394,3653,4741
bdb796386881a627e6c3f74e3687f808,26,21,10760,6394,4366,28,24,12949,6761,6188
5f351dccb4ec6572336bc45c2c4d3a46,142,90,297995,70974,227021,161,119,344289,68440,275849
1f743227f8b4d4f69108499a05061c1c,97,74,213766,56770,156996,121,101,337735,92286,245449
1860f9b49ff1f20ae580c9f65e8f6021,71,46,106983,32168,74815,75,54,103022,46439,56583
451c4db2d1ff23862f45dff34c0b3a68,55,38,55665,21535,34130,60,48,83851,20565,63286
ab8188d79587fc84102fd8e9b6ede872,79,58,100435,34869,65566,66,64,117491,28844,88647
e38240d31b0249dda8b96013fe5c7d79,63,66,84060,29331,54729,74,62,119548,28044,91504
e5f3407b9d71453c4c94efecad9b284f,63,57,136878,75796,61082,105,69,259496,59688,199808
5115df0da1219f123a309a14ad3c3412,157,100,462406,92187,370219,126,100,350491,95212,255279
0f2a7ec19b86238cd49e40e056579bb2,167,120,485309,117655,367654,163,136,449725,108885,340840
308a0af6455abfa4a06144f4d3959ebd,118,90,268691,50638,218053,123,101,287605,52899,234706
d58fb7f33942c34a3161e47c4ea82de4,130,115,496132,102983,393149,160,133,667977,82079,585898
3f30e9075a6f0ee9a7885470e63b1372,34,24,35320,11417,23903,31,23,29224,12210,17014
a65925935fb2fa3118fd8ae950139f5d,8,9,1462,851,611,8,7,1170,685,485
db5d9cb64603e1455fcc14a387e421e5,78,60,141622,30819,110803,77,62,109297,39303,69994
944c743b76ed61e54066b6c18599c189,66,47,106597,22297,84300,68,61,91092,27161,63931
795594c60ad507f3723c79b3223f8b3e,101,79,194437,55447,138990,110,88,199179,52179,147000
fa09bf48de59d8998e912aef190aebcb,80,52,137081,24274,112807,84,61,126873,38853,88020
007f29af40ba84d8a0d32f95b133a3e0,173,118,389813,63150,326663,89,74,230942,67400,163542
3f3f8985c156c87861778522cb23b152,140,119,389416,103558,285858,166,134,524957,109177,415780
817044e1cb78ab0d1107c7c76c3be4c3,51,42,49607,17765,31842,40,28,39623,14958,24665
5f3b1308767a6ee3849cab9564b3d2d9,163,105,534558,191237,343321,181,145,733025,125830,607195
2f09e812e1ff9519de6885a1e79684be,38,29,47946,13134,34812,47,37,54035,19894,34141
75adc6f57c4dd432d95cc903e5e5a177,215,170,725298,112259,613039,136,94,382990,96380,286610
d3896eec37594ecb95707d590986ff97,125,110,346551,100098,246453,167,131,461357,140146,321211
637d118614945c9f0fe7069ed12e6d96,84,73,143060,41415,101645,109,94,245184,35183,210001
19254982f4a121f282ddfd6c08ff3d6b,68,65,159686,44701,114985,116,76,170971,41726,129245
a6906e7c2e5b82fade1901fe124d974e,18,11,4359,1898,2461,18,14,5664,1499,4165
5d90f8d3a739c1b54211cd29dd9e2018,164,133,523509,91293,432216,140,118,489146,73368,415778
aacda5913ffc3fb8c80759b5e6c9ca00,187,140,516573,113333,403240,163,112,478986,131208,347778
a35306bb91a82b22eb1817814e698aee,41,27,43938,18868,25070,36,28,48045,15633,32412
088ae131fee18bf1fae7477755945bd5,48,38,66275,19857,46418,58,37,70111,24001,46110
6a3b0f77267a049a0b03d050ac9a1c8a,120,96,313512,83625,229887,94,79,194910,65275,129635
58e0c2241a3d89feb029af5f1c47727f,124,91,288283,41937,246346,110,91,207483,50750,156733
eff36a90739bd9b0bba98b35dde6e5a2,157,90,248222,48280,199942,131,100,235332,67272,168060
7bc84272fe6fdeb4c27a358efec7140d,48,36,69573,10448,59125,43,35,41389,20736,20653
34ebcc153dcfa6bc39d83550577fd2bf,97,61,188509,48780,139729,114,86,217450,48688,168762
7d8aedd5eec22941aa9de05722771564,101,69,169496,25725,143771,102,84,169213,37061,132152
44d14afc7edb200613199c04e84317a5,44,33,39766,17140,22626,48,30,43026,16187,26839
496809b9ac4a5f745a17b29ae921cdd0,28,23,13651,5457,8194,23,20,12699,6555,6144
e5f36a4c26a4bf1525cd9d44092d1dd6,69,64,106698,44699,61999,62,46,95971,34506,61465
9ee7f3e018924889572a1fc5122307d5,36,33,27714,14942,12772,41,31,31254,12837,18417
254f2460846b448fe4a45d4f304ab972,144,108,484880,108483,376397,184,132,580158,114976,465182
c1a2660387b0eb679639895abfd62c2c,197,122,742628,136658,605970,200,136,657639,145915,511724
fa59e74f5683130b4d75eab067c487c3,83,68,129325,38039,91286,65,42,73028,23926,49102
8191f0a80bc08cfc48e83f74389dd656,176,137,1080640,198645,881995,254,143,864157,241748,622409
3917624865025d38f07f9754a0a35684,86,71,125373,30949,94424,52,42,71667,28193,43474
1d09bacd5a720f7ee5d90da62bbb3bf5,90,70,143754,37858,105896,77,59,144614,34076,110538
2b42976cdf5b621eda302737109bed80,112,68,228286,47042,181244,126,83,270465,62133,208332
0f4ce38e2c6f87d9962e89d2512268f9,116,95,302902,54699,248203,115,96,227207,70919,156288
adc23ead5d54e8cf6a1ccb3bc5b09dd6,42,33,72250,25379,46871,48,47,75471,25011,50460
1226650c4a054de1c889eeaba3bdeecb,42,39,38853,12697,26156,38,30,37304,15311,21993
8816a2d1fa495afbf29a6d255f7d14f2,19,15,4931,4487,444,25,19,7247,2568,4679
47070e5790f1605c0a2a82e5a9d0ba5d,133,110,364745,128590,236155,198,146,472967,101261,371706
ffa3cf601ed37c2bf1cf84a4ad4e079e,36,23,26515,7335,19180,51,41,41840,9179,32661
2113d9d8bf24bca6caa1d2d0ae8329db,56,54,76956,26048,50908,53,39,63737,17392,46345
cc829a8ae2d853fa8dca922de460c946,62,43,98524,23527,74997,54,45,60199,26228,33971
97cb3fffe974b1e1f51d57012d1efaf3,115,95,224931,52290,172641,121,99,215644,56375,159269
489fb7c6dec692bed590a60df1073332,101,75,180318,65681,114637,114,88,210878,71558,139320
f372855ad792877afe3e3d0d027888dd,17,16,6603,3447,3156,20,18,5998,3978,2020
bd44d7161c62134a7ee563e6cfc1b796,144,120,470096,101755,368341,118,91,397951,95266,302685
0231fdcae2ed0e3032d57d4d2c1e79fd,90,56,121734,27272,94462,52,39,62615,26378,36237
4b219b56cf3a48af99e27a1c5b140c9d,87,67,154056,37126,116930,102,73,158923,44020,114903
bb77fb8b001a75eb73badb43d85e8744,29,24,10291,6858,3433,32,25,13679,6021,7658
be493d7110089e53b429e86d68533cbf,42,43,33005,16543,16462,49,35,52253,12283,39970
f2d00938699bc39033f8fe2c3ef9f12b,141,108,531151,130760,400391,175,146,620111,131798,488313
cfa0a0dc8aeb4fdca878535df37eb3e2,30,25,32334,18411,13923,31,23,50414,15768,34646
943a340412e6c1738dca13a8bc6b7fa7,27,21,28087,7589,20498,35,42,35046,11235,23811
1cfff209942e6e43552f2761ffb5d681,88,65,159389,42623,116766,120,84,182845,47381,135464
71c45b8f00f0d805566dc37661b7073b,98,74,178029,60127,117902,125,87,246787,46497,200290
84412c495a725c163d0083cdc2388f85,95,72,180625,62241,118384,113,79,290311,63958,226353
b5bd5809f588ddc663cfc0abf1cf98f5,187,133,507453,77995,429458,174,125,617368,73218,544150
3742c81bf642e9ce3921bbdc0f9029ea,26,18,6384,2127,4257,27,20,9503,3498,6005
8d15022249d16e272b01385bb84f9902,210,135,520296,139382,380914,197,140,736552,120839,615713
12384146e193b741c32f3a468a17a00d,46,40,64069,27928,36141,44,31,37949,27267,10682
2fc60612bf64c02542de3487a2b3422c,82,73,166464,64300,102164,81,70,179002,43714,135288
87281a19dd7c942cc3fa0d1a3800f420,124,101,313654,77505,236149,116,94,299261,68681,230580
ecbc51e7c4e2e97dc21f23e3d83fa931,24,13,4079,1871,2208,27,19,6278,2378,3900
5d046ea70673c7458795e8eb9f3d4ac7,82,70,181292,48261,133031,91,64,161665,59231,102434
b24ec55479a166e57cb0e35598347962,41,33,34339,10879,23460,32,27,25291,9617,15674
ca7090e16f7cf00adad97948d47f1e48,137,90,366950,76489,290461,169,102,393032,62204,330828
e15714a3952c2a201b44c45c6ff5ebee,125,87,317207,62783,254424,99,88,272427,85485,186942
6fd84260c0989e351d0ec28ae420e283,192,118,966773,176071,790702,233,155,1053499,164475,889024
65e662196dc640d7bb4b88101510d310,51,29,92694,27746,64948,78,57,127931,26215,101716
cfec5058180c8485005673cd50439e2a,151,111,552712,130195,422517,160,131,534273,123420,410853
ccba8feedb9a24e970b3275e3e7e4f30,110,91,373293,98686,274607,143,119,438110,105965,332145
e23872ed7454e6a890ecb24a1574422e,182,139,599809,150939,448870,186,136,574066,143175,430891
3173647687026c6e5ffaa93b67383405,93,70,155421,27134,128287,76,67,120842,42739,78103
9f5c83c0f8b59df207215163bacbc309,29,23,14729,5273,9456,23,24,13255,8626,4629
07081fd3b2927c05347a5398b550d261,29,22,14861,5971,8890,27,24,12697,6348,6349
c6753fed550b7cdfc781dc392de90980,70,40,99214,31165,68049,88,65,232731,33812,198919
c3bb45e991deb3729f71171637457c0d,40,42,26748,16537,10211,59,44,79568,14378,65190
962682ffc9ffbd150d52adff6ebc101e,103,86,210138,55555,154583,113,97,226923,66225,160698
f876b3377092fc72370226f69766b58a,150,127,444216,88219,355997,185,130,548065,112226,435839
9724a273d18ad9cf01460cf2cf198c7f,109,74,239848,85014,154834,150,120,390702,62139,328563
22cba8615d0378242bb5375d3807bb90,1,1,365,42,323,1,1,42,365,-323
306c0b68b55755d6635f13b32f0e7415,35,26,24941,6633,18308,48,27,46365,8301,38064
fae0b4fc62b8cb8ad1aff2c8f661c5cd,94,69,202990,61706,141284,116,94,271513,83640,187873
24ca6a1677e8919ad56d9b8e8c9ac0b5,20,13,3847,2016,1831,17,14,2691,2787,-96
3408949620d3103793cae6650dd8a8b4,128,97,388361,91400,296961,156,127,446060,121152,324908
ab33cfcbdb10ded8ee06fb01b9dd534d,146,119,334993,77920,257073,155,113,355177,78760,276417
48bce0074432ff0145eab34757027551,120,91,233806,39549,194257,122,106,259242,37471,221771
f1f93436bcd669f16fb234551d55d52b,92,79,163913,47771,116142,84,76,140831,58751,82080
3e99c421f364a3f1374c4c2ddd1fa4b3,96,61,177693,44783,132910,71,53,111808,39918,71890
0a943d10a5bb6038c1c7c66a4e76547f,106,98,233553,56437,177116,124,94,333370,75869,257501
a5941078efaca2021f0eccb6b74f6f3b,121,92,336034,101851,234183,161,135,376437,95470,280967
22ad3ba8212b20f742668934c9624173,48,39,101765,31559,70206,45,35,132984,26068,106916
537b9d70bb48a8f542a5e9995e9030c5,52,41,83488,32667,50821,84,64,149548,25026,124522
3377d7217f4f4771fe1747a0818bd1ff,168,136,739024,155226,583798,164,137,715933,148173,567760
9a00b37c858ff512f6ef47e7390d4dc1,115,91,247667,62782,184885,147,115,408236,59797,348439
e79c1b0ba179001ac9797b08cc40eaa2,41,31,50065,21770,28295,42,32,45915,20744,25171
d733f1726c462ca169f7b77675dd8bbd,31,26,20754,8828,11926,29,22,22684,8481,14203
2c5c891975b40f13e5d8ae4cdf562d74,157,119,743331,217032,526299,182,139,812579,167742,644837
cd73dce95f6b9af00697be9d75a2ec2d,149,98,538611,100951,437660,178,104,592404,118563,473841
562eb80454aa85bec3d7e9a7479cfdea,109,93,198255,44762,153493,118,94,203103,48461,154642
3d3096b5c04bc8645ccf748f03a4fd1a,102,80,201688,46354,155334,75,54,163813,42199,121614
15f3ef750f9dd9adb5b9eab1f35ae3ee,10,8,770,1210,-440,10,7,1394,473,921
4551bcfa09322cf4832e9cac3e74127b,44,38,51898,22479,29419,65,48,65164,18897,46267
f1475adefbf95051a209103e193655df,112,92,327216,67546,259670,156,141,337765,84829,252936
3e05a9009188d977e969c45868b1c67b,106,81,175503,69925,105578,83,71,186669,56044,130625
a629b112b1d76816148bb5c6e0e4a08e,103,84,241635,39506,202129,80,75,149647,49521,100126
3728d22dea9c6d2b1fe10896a3ca4357,101,84,184765,39672,145093,84,67,142735,42863,99872
2874f6b8348d0d4562a032344252487f,78,56,127700,36326,91374,82,70,110528,31127,79401
83420257ce6a1eec505071f8e0ae74ea,34,29,29964,10917,19047,32,25,28724,11773,16951
8b278ec57fbc01d7dc8f1ad50e41950c,0,0,0,0,0,1,1,20,20,0
d7de356af63b4eb8462f1f580023dd64,123,104,230024,43912,186112,103,82,202556,49555,153001
9d5dd1842676b9e2c77a75d855b4c3d1,184,136,697964,185528,512436,173,141,766602,150111,616491
b6be3b59145f831e8768daea6542e829,163,127,717829,147955,569874,157,142,557586,161921,395665
968ad738eb9d59f3148bf8515968b9f4,57,37,67391,21525,45866,42,36,59654,19043,40611
53d4af884f4442dacfb5953a49eb0236,107,88,213507,57362,156145,136,111,348365,58485,289880
149efdc5e74944af295ec6ab055cef91,68,45,81337,23641,57696,62,50,79088,27077,52011
9b05f5bda7643ab87a8f058a50843c01,52,45,46801,16100,30701,51,44,50585,16165,34420
fa4f867914ea5117f0f785b73f1f3ca6,63,47,63729,19104,44625,68,54,79653,14991,64662
413aa641b47d717348926eb991c091c5,103,87,206629,52780,153849,111,93,209646,36176,173470
c54dcc2fbeb756ecd0dcce7689f0dcd7,102,84,253788,62151,191637,124,102,340552,85652,254900
492e44bc4a4c2c25816f9d2d3ed527eb,136,100,350031,79315,270716,130,96,322662,76956,245706
5c3219194a7b3a161db7f4976407d253,67,46,88874,31222,57652,60,52,88664,32896,55768
24c6d6f417dfbbb75dffe66573426afd,122,107,302770,92393,210377,158,120,321635,85120,236515
bbf931d6f2543a97495eabce417f1ef7,57,48,80396,27090,53306,74,61,147014,25531,121483
771247ec23c9fae2ad75a7faaaa79361,145,82,340171,69226,270945,146,113,419444,59671,359773
b2e06e8530739f15905dca14e76c280a,54,39,45928,12500,33428,51,29,32345,11693,20652
0c561e8828461206606feb281308038f,55,42,67341,21210,46131,42,35,47288,18707,28581
d0bfd08bd5560e2431afd366b7d8b518,159,93,348911,87808,261103,128,97,275806,80618,195188
a104c0df2f52529b1e8a66e8279d07bb,183,127,814532,134291,680241,187,157,911705,196321,715384
27587504145ce90773524708a3935bda,51,32,44054,14157,29897,69,63,54184,19287,34897
89a1f6d09142e2356dee8d8fd08d478d,120,82,205044,53662,151382,98,77,180288,63743,116545
26a4045ee1f11f0c9ed403c6d0e9db63,126,96,308141,66395,241746,122,88,230806,59932,170874
41c104e8cb4275b1e7ee1b6b4856c52f,50,36,56664,28281,28383,76,57,107953,33142,74811
883259627eb3ab80002936672d3c2b53,137,96,366342,80861,285481,130,86,298644,89631,209013
66dc7a38f9e380cb2e3ec5ad908732da,183,134,923872,199683,724189,223,154,999003,226438,772565
25c028dc0ccb0d7480390e24de70bf02,129,92,331031,68845,262186,147,123,497391,68560,428831
d77d93d5f4268b495614fc3f486c37cf,85,65,153951,31599,122352,84,70,102012,37037,64975
257d2d9a98a55805b4a676320a652940,125,102,300633,64503,236130,130,85,261524,61611,199913
6bd35173e8d87505d1678cacc4b2c113,108,84,206083,78706,127377,108,89,259660,59168,200492
acc19c00969a538f86ae50e0d76aac2f,61,52,89122,26368,62754,59,50,83467,22201,61266
2ce30e7b481052407ec63055179deb4d,162,103,319207,47217,271990,149,119,326559,46712,279847
375c158c7c6f22f98b4abce92fc38cf2,71,50,116981,41426,75555,113,90,210968,37323,173645
1b703d187d2c26f24fb73306fb4d84f2,82,64,226856,56052,170804,116,99,335599,55687,279912
cac665e79c20ecbb188c14d8666630b1,159,125,501992,108386,393606,143,112,414904,110260,304644
6a1919812d59e3ea01830bdfa34c2d9b,8,9,1015,738,277,13,7,1322,280,1042
3c607bafbb3d91842b1152fbca67967e,91,67,241568,75126,166442,131,74,262046,58223,203823
89eb1797a191262b2bee3d1296fded29,151,111,430479,98320,332159,156,126,497628,90611,407017
493bf56a554c3baa64bc1a4e95d2a39a,152,104,300006,53082,246924,152,120,391431,72205,319226
bb5d3777c3c3b717be9dacee3f30addb,158,113,399323,72164,327159,121,98,382414,101552,280862
802f5881e14973e50f6eb53967ff83b5,156,114,357264,63564,293700,138,93,317811,77456,240355
9d1a6a22ef5b17285c4385481b81d750,198,142,801192,130882,670310,222,178,983831,199823,784008
f85f0af9cb44aa478a2d92c95afa99f0,97,72,171793,39520,132273,98,59,141191,30614,110577
494321fd091f98c422a26e44fc8a747b,109,95,250031,43357,206674,136,115,314526,51381,263145
383a223d813aab7a00111157a8b22ef2,109,88,218267,67521,150746,139,116,390942,57462,333480
e984c21cde9fe65788dbf323cf123b48,24,17,8604,3271,5333,26,20,6204,3433,2771
8c754ba378aa6b65e38a1de04ef22d04,101,90,157883,53390,104493,87,71,180349,45166,135183
628fde3971df13cdbbe43e872c43df98,30,19,23770,7143,16627,45,36,32712,8694,24018
5035eecf5d779bf4b650e835caa83325,129,121,419135,93854,325281,154,130,440079,108621,331458
db161f3fbfd2311a4e663a60a0d38ff7,80,63,147276,36504,110772,90,72,167888,43533,124355
f00b03c9166e872f6340a1c228a352ff,29,19,15102,8312,6790,25,22,15224,8283,6941
e059d26a3cecd6e03846ad2ef3e49983,34,30,28340,12344,15996,35,29,22758,11922,10836
96c949f1424a254b77810790603f6860,48,34,47999,15886,32113,50,41,52831,12712,40119
258f3f3f5a7bf2d2de45495f67619df8,56,52,98244,33034,65210,78,73,119176,45818,73358
e8a40ecc3e3e3bd58ff65a3532a853f9,77,61,136696,26861,109835,56,42,70917,30298,40619
c2e4b175ef8b4f2bfcc03ebe416b0113,65,36,65867,13443,52424,38,31,42452,15023,27429
55d99b94194bfc2afc595c9b1378b3f6,136,94,306749,51298,255451,136,115,280810,73362,207448
3e6ad5b94c32989c49c7791ada037fa3,56,47,70536,30017,40519,56,52,81946,38851,43095
df9476838d8f39e6e3fd96e3784b5b8d,139,117,397524,93293,304231,140,115,359608,82528,277080
a70b64670b7142722afae1692a3dbc67,58,46,78235,25642,52593,54,44,79358,28573,50785
3657ef1fbc79bda817ca34463d5c72ed,47,42,103416,23534,79882,67,48,85405,29646,55759
de26d2ebcb58908128a551b9219d9f35,94,77,134817,34831,99986,119,91,174355,32835,141520
e982daaf9aa8e15921a5f113b4ee9657,38,27,23763,11027,12736,43,38,35162,11974,23188
9a9a4b58d60c12c7a7e31c9ee143bba5,93,65,153497,43909,109588,102,59,139920,44805,95115
5625739b2fb0a8f9f39ef8071a85186a,62,49,60221,25505,34716,52,44,57722,23209,34513
95b31b2213d6c9e5f64ba054adb86275,187,104,556174,100278,455896,152,121,478216,101166,377050
b833ccc4f2db970d758ff70355244777,90,72,213083,49792,163291,86,58,157945,39651,118294
b0b1ce6f1086fd4178a5992cd2ce1a39,146,100,560560,113367,447193,147,112,496205,95382,400823
36ac5f087b01522bacdfc394edf0cb70,15,9,2588,608,1980,12,13,2025,1121,904
73747e48d15f7598eeb4784e70f2941a,125,110,312257,60882,251375,109,94,204379,52401,151978
1e681cd0ba789ad01faadfce916f0c35,77,66,138584,42873,95711,86,74,149470,31512,117958
5355cc33d123a9984cf3001da7afb4ea,93,74,163563,48742,114821,64,53,96835,35142,61693
ac790ef7ebee0cafdf2bb6c9ca0e96fb,24,14,9137,4334,4803,26,23,9371,4850,4521
6a6e1a306de4c5ea4f3ed970318a7934,44,27,42151,8029,34122,55,34,58457,10861,47596
43f97f8c59c983388724ccf9ab16c4cb,63,62,79216,25567,53649,52,38,52967,14555,38412
50523c618448f2337954869903ba3321,188,155,617215,116918,500297,199,155,547224,134313,412911
b39e7fb9b02ac5d592c9575d55ed39c8,22,20,15494,9320,6174,24,19,25284,7289,17995
11bf3bc9e1f646494fe92d1b04c75823,56,48,103570,44070,59500,112,70,218207,31149,187058
13c20f18bc74e7600da271b524740157,3,1,372,200,172,2,4,239,204,35
e0ba87af5490817ef1dc043d4522bc31,52,35,55644,11979,43665,39,36,45310,19686,25624
54ccd844c7102cada01a9ead0eaa2104,164,94,408280,63128,345152,160,111,410449,63964,346485
9226079913789817461e62e6f4369c4e,215,148,655743,135151,520592,162,106,714618,128859,585759
304c2a2e351f332d4445dfd84c0be09d,82,61,114680,25750,88930,75,51,119283,18187,101096
2a43d7f0611bd90cc780c090734722b4,182,106,587660,122607,465053,224,152,761740,89547,672193
40a9524950f9bff18244b2f71f57f4f5,106,81,195716,46053,149663,89,71,161670,64559,97111
b3e46a56b6ed1aa7b2710e5ff98fee3f,153,104,560333,128345,431988,189,152,564173,122482,441691
f0a862f1834c4074ae337f894fcb15f5,123,80,235774,78253,157521,137,102,327253,79007,248246
ac019ba197bfae93ca4482921e2fc4bb,75,56,92700,25057,67643,46,41,55129,34756,20373
ef2ca1057055e00c799670725c58e74e,109,82,220957,43271,177686,129,105,222688,48984,173704
d2d2d30bbca4fa8c724b7028f6cc00bb,39,28,23457,11549,11908,36,34,33038,11854,21184
bc9027c78151fb0fb8606c13bf841dc7,46,28,43241,15554,27687,46,33,46386,13439,32947
51325cb8a5f864248d6a4b9927ffbb48,35,25,27440,10244,17196,36,27,28332,11432,16900
caede5bf53b2a1084113659b39e8650a,35,28,20958,10620,10338,37,27,24222,9209,15013
ab110868c15e305dc1fcc45e9b1b95f3,57,45,71398,17120,54278,72,54,78824,23118,55706
47cfe6afab64d7245dcd66b6306d83ab,53,43,70355,23464,46891,47,41,49453,19604,29849
4bf589284a0d9eeb216662564c9187db,76,56,188684,56806,131878,113,81,224125,45925,178200
574e78f7770663bccaaf2a447998b153,11,15,1975,2320,-345,12,12,2182,1975,207
28224c7514dc114b6147698957ad2ff6,109,71,243119,74866,168253,157,94,325884,45362,280522
a5a01b306a8bf4b52f5072fcc5efabc7,131,107,254226,50657,203569,106,81,229065,59277,169788
486bb3dd801f7498e100fc4000639edb,62,55,86246,21725,64521,42,33,53105,15148,37957
17ffa416edd744415c9cee9194252cd5,50,45,60466,23556,36910,76,50,125345,21217,104128
da6faf1779aecc435f863d95a42f7cd0,86,70,164172,23371,140801,98,82,136764,36283,100481
d25d72ba8593b3f1ea2684bf70daa7e8,144,110,349921,70960,278961,142,95,333992,71133,262859
68672d293ebf0cc05626e2c671b1cbdc,90,72,114983,35794,79189,95,72,165288,29493,135795
d3c98d2436d63f0e15cd4a4ee0213a58,75,61,116368,26091,90277,57,56,74443,28001,46442
2f9cc2ee3ad1d0bedc8ba49d44a14e63,4,2,944,372,572,2,3,244,812,-568
b55774d93766444cdda0b71ef8a80172,83,57,201536,92821,108715,158,130,415124,71178,343946
304de977da7c71e970b61f2c2eebd1c4,99,81,182617,40797,141820,71,61,109641,29036,80605
88b55bdadb38312edbaf604c8bbd8a2e,158,108,610350,195809,414541,190,138,751547,175794,575753
bd9237de0a168ac9f649084fdab3df9b,38,35,21905,8739,13166,30,22,15147,4124,11023
39db13a245cb4998f3746bc481a2e120,162,139,520441,122414,398027,149,120,447786,113839,333947
a9f52c509957fd4bdcd76b68257b2bc3,52,39,41100,15848,25252,71,51,95855,21004,74851
6f1a389bd8b17064b2b7384c2234b2b1,58,43,76012,24847,51165,94,64,147401,23543,123858
c5d441415682f23d4c5b025f5257e976,151,115,401417,83945,317472,136,97,544372,69069,475303
fc928dcff9cdaf33e33fa7d24533773f,42,32,41323,13155,28168,46,38,55407,16929,38478
06f8343e155a949fcdcb4bf19dff5c75,33,23,25319,8797,16522,30,24,21542,8841,12701
c19837f0e0c6125ef9bebad4a33468e2,129,82,279043,77068,201975,161,95,323310,65854,257456
5d2f2edcf2c29bf7324b8b35af79c1d1,28,22,15044,5458,9586,23,21,10156,5635,4521
4c365d8b1f74a4a11f93531911b08e79,116,86,337696,81217,256479,135,120,440597,85875,354722
e76245996f3e5fac31bc568a17898c95,27,20,10083,3190,6893,36,29,19964,6168,13796
9ae3bb6b2db1a610e82fd004d364941d,120,92,234706,45163,189543,107,87,185027,46206,138821
7bfa6ba0ffd131fe41fd4310b8e0ff96,42,30,41901,15948,25953,60,49,115363,16152,99211
9f2b3949a1cb5cb45acb4569d8740a07,135,91,289582,99164,190418,136,99,514259,92565,421694
567bf68c94d787d247ae76a40f1a6fa8,34,29,33811,10819,22992,39,36,25429,13285,12144
5dea409a1553bd3d9cde823301e0fe9c,112,86,172267,53004,119263,105,77,228454,36139,192315
b3ce3a85fc555a3670eebe91c86dbb0f,6,7,816,558,258,10,3,1352,364,988
e0d3fc0e904dd3b23ecef800bab54fa2,110,77,394977,67272,327705,93,72,275508,71381,204127
4606c17a573255a2b775ee97d4de96d3,181,133,743599,137772,605827,162,120,640600,143903,496697
a5840b3b3993a4d81f23b68e6f5e829f,97,71,145783,50751,95032,110,75,200267,31014,169253
350f6f7e962040ad38e69bcea3691e6a,154,133,567587,103440,464147,124,111,483069,128390,354679
97cb9bd2baa770cb7f25135329d90324,100,92,257050,91591,165459,111,80,290354,83116,207238
e9628e472958315b9719cc1e33d75658,151,133,440797,111862,328935,191,145,699849,81829,618020
572c9574cea96679ee10e71b68b191a6,32,20,13391,4953,8438,23,24,12905,4802,8103
f7e283220c10d86cfbad0017a658835b,70,59,121746,37504,84242,50,35,62771,30511,32260
3e5e80d303268084331b8e19e05a0b4d,188,144,612403,159805,452598,235,151,812861,219908,592953
afaa28918fb7a85b8e4a9bebb186f713,147,116,381029,47359,333670,134,127,392092,73101,318991
49537e66037ee1a5c51857320158c6e9,26,21,17504,8729,8775,37,29,26426,9817,16609
7ef9018184a07ef0f5636f2fdecda7c3,42,29,37355,21139,16216,44,39,48809,17070,31739
4cbc02d087b06229b00f20df4a9bf9d5,148,127,654192,160990,493202,201,135,1006714,167006,839708
c2e9ea05d679ed3feedbe1ae27d62b4d,52,38,40090,13489,26601,51,35,43765,13660,30105
0bdfba732d085beb4097bb7cdc4b01c6,85,62,108982,24456,84526,55,45,75697,27462,48235
bc864e8e3b80283142129ffeb5a5017b,35,26,41954,16463,25491,39,27,37867,15067,22800
dbd832f5f35be86dff65dd7132dfd32f,37,25,31532,8162,23370,41,33,31905,9853,22052
11a1f4e500204338424aca8acae397b1,109,86,291000,75606,215394,163,123,372847,74057,298790
d1ca9952c344325eec98aa94d4ff419a,41,29,33105,14393,18712,45,35,49088,16885,32203
543c0588777fa96f28a5f719aaf95ac7,23,13,10121,3504,6617,18,17,11595,4301,7294
6dc25aab1e4d3f077a920c08fb5f0ba6,72,62,103953,41862,62091,94,79,163570,30745,132825
ea8d373f6606aa04b031781d446019c2,82,68,300739,90680,210059,82,70,226343,88046,138297
1952a90f4d36ca1f16b2a1cd85476b31,183,146,738702,241014,497688,168,124,694753,173642,521111
c8565e5c7c9c7382f7d2fb1efea98624,24,19,5312,2128,3184,24,15,4636,2600,2036
913dc14ee9ca5b12a04851db199c647e,130,72,262757,47037,215720,124,98,292706,54054,238652
c5c6f0f7044243f6b7d5df7a5100d04d,195,150,527100,153315,373785,175,116,471160,145568,325592
419dca05e9b65d3a955a8f3f2dc11118,172,108,523786,96947,426839,201,128,665564,90677,574887
6bebfb61e4646ca3552a0df0926f2484,61,38,71933,11257,60676,52,46,47074,26476,20598
a25ce26ea91662ba9c4221f13e96edd8,35,28,30346,9107,21239,47,37,36925,13473,23452
e163af2d05ea74f268d96a2571bf8648,52,43,75522,14168,61354,39,34,28769,17970,10799
77bb6a78362869e43e4237e27d72177b,131,90,261781,84756,177025,175,113,431332,76943,354389
aa52617612c31560eed290fd458f8526,29,22,26223,8642,17581,28,23,22823,10484,12339
c01c9c060725d4add19e40e6a6dc884e,120,80,181514,36167,145347,140,113,132414,42172,90242
9e480530b9c0b81bc2283edcfc782621,33,25,15770,7896,7874,30,34,15397,10013,5384
7428a251bb4b654de310cda219e8ddfc,58,44,86229,23456,62773,61,50,84470,27157,57313
f38e90a8f20fe0cb4e2d384147e3d87d,23,21,10778,7146,3632,30,26,15348,7172,8176
652aee261d0915096682ff67d594129d,76,56,160790,40798,119992,87,76,183605,52767,130838
275a769a9c2eedc8a0949aac55f279de,15,16,2493,1170,1323,14,12,1375,1407,-32
ad0f581defad994a66ecdc010c3f54e7,35,34,34931,10104,24827,36,31,22199,13671,8528
1abb02f504f00b64d06f8f8cd3c8aaa4,81,53,110542,22655,87887,101,82,131182,39208,91974
830731896770023433d8b7f798d4f3f9,127,87,242366,43755,198611,100,61,219836,52918,166918
aebce9e6c611ee445b0886cb8e82a02c,148,89,232923,63839,169084,127,85,251377,56031,195346
2c3e66e6c0a240cab5566294d6b87d6a,65,55,70126,28450,41676,57,43,69259,25078,44181
d92f89b2dfd19f26189c2638034d2bb2,156,113,444505,122739,321766,189,156,490985,137434,353551
e46add4e8cf3f8477db4082efd067d58,204,153,660746,186023,474723,207,147,615349,126290,489059
e4b87defe98b255e545bc37f6feaa0cf,108,89,214332,48652,165680,92,73,174539,58646,115893
47e7b1cd9505074b7d2680111d24a3c2,19,15,4833,2130,2703,23,18,5088,2366,2722
c9293a3187330cffee0363a1373a6779,136,108,367149,108305,258844,126,114,313740,70921,242819
540152d7b7c77db5bb14a7cfc4fc94a6,130,103,285514,58899,226615,128,99,267114,75422,191692
ebcec202587726d255c03155b659eaf3,102,94,225007,73081,151926,157,105,368254,38040,330214
28480e4286f2099f51635f6183ab2a1d,95,77,238422,58583,179839,135,87,236807,56192,180615
b59410d9ca52f10c020f0a1dc3a90033,174,137,680833,134732,546101,174,145,582784,114327,468457
608d0376c8b15e0c4af8fc1aebd16f33,6,3,1454,509,945,4,7,595,832,-237
f00b9e4c95ffe467bd9ed7755190bb7c,93,68,112439,38788,73651,94,77,178913,45510,133403
93bccb4a902a5b6ed486d597149c6619,150,125,597562,110944,486618,166,143,616037,154681,461356
130fbae7df251de1c0ef814085c3df07,182,104,519611,66029,453582,192,153,563123,127380,435743
6a1dfca38983114c936094b90c91ee98,108,101,304225,94150,210075,153,108,402596,60526,342070
28aa3f31aa4b4970759114537644e701,1,1,16,16,0,0,0,0,0,0
f5c9cfa0f5c2acb8e5cb0f7fea9e176c,103,81,222218,59014,163204,101,86,246718,61110,185608
8f63556b3cd61632f96685463164676d,94,83,215672,86000,129672,118,87,276538,72668,203870
fcafc36e916a4fc1f8380d6b98030c40,49,44,64346,20598,43748,58,44,69225,22088,47137
240475f72731b14034425b374a0d5394,54,37,65489,17188,48301,55,37,50286,24646,25640
456d9d28d1c5f215a496335b931c758f,90,74,156519,47116,109403,111,94,195787,68384,127403
7476fafe638ee2a1ab41aacb34632b0c,51,40,92160,26498,65662,65,59,82935,33256,49679
c3b1ae2aad5b07ce951d872c74dfcada,85,74,160667,25581,135086,78,59,80426,26697,53729
2b3d29ed95572be10bcb8396bdb4ad88,96,80,142058,38382,103676,131,90,215187,30005,185182
37600eb1cc2ac05f12e9b7e94f3c79dd,109,81,213653,88675,124978,114,94,282142,77833,204309
97507f8f59954a07b21ebc47cb6209ea,47,41,65344,18528,46816,48,30,44355,15534,28821
f6ecbb264bbaedb2b0a753115b937d2c,159,118,509779,174776,335003,177,127,618191,138798,479393
68882db2bd3e2d5da1682bd953613d72,137,81,377717,87648,290069,188,135,505594,87803,417791
a0b5f4c42510b82ce90682f0b9c7f487,27,23,17118,8554,8564,30,26,16002,9326,6676
6641abbaf13e812b7e3d1c00384afd26,196,163,713627,136589,577038,162,119,462367,99617,362750
d1d25ff395d14fc8a740846e6c2d3604,24,21,11731,6929,4802,24,23,11545,6420,5125
f207522964d47396b51a1e132bb2e0a3,171,125,671022,115664,555358,180,125,926833,146790,780043
6527ff54834dcfecc7db61c6f0f7dc1c,53,38,66080,23106,42974,50,48,78807,24893,53914
86d8733bcaabe026e0fab6bfad5b7712,95,69,155475,38600,116875,74,63,127147,49248,77899
d87d65d1606a6f2e48140be55463730e,155,118,394067,90189,303878,164,141,533321,83790,449531
f1c5795f1e93e6237ec91969946aa0f0,72,53,112510,27736,84774,81,62,120551,24165,96386
6ebf95d91e69436d3e715d747dbc51dc,100,77,154012,57899,96113,93,89,187489,54967,132522
cdf8b0cd18dc6bfd066375f1cb9f6960,86,66,125350,32566,92784,66,53,76327,34552,41775
acfb69426e58670019cfcc3b40c04af1,126,93,272097,53317,218780,138,122,290692,76461,214231
e6182a17417b3ce8a1b7930578a83072,45,26,42103,13039,29064,40,24,55921,12747,43174
aff5c9874b2de8973866fb6060573649,89,50,172710,17949,154761,54,50,76195,40512,35683
f026a874c5a5039019e0a7bc79a7e0ac,82,64,160603,75600,85003,134,112,337669,79527,258142
e633ec0b892317de68f7f55828fa6b36,59,35,61474,16846,44628,43,34,46067,17355,28712
3feeb9a8deb354dc7d2ee6ef2896da7a,133,90,227139,41605,185534,111,92,171930,43042,128888
9480be3952097263a89039ebf73b4472,138,96,335283,71985,263298,146,114,373173,109678,263495
a642c694e071269a68002ec7e092a3da,5,4,476,361,115,5,4,415,334,81
989dc2179a7426e559d11311e6a2d4d1,94,75,146186,27363,118823,109,95,193929,40559,153370
8bf84b2487c2b9cc653b436372abdeed,88,54,131954,45249,86705,115,76,187641,43444,144197
7b7ee7cc7d6926d5105a89f4850f8be1,220,163,757231,166838,590393,234,152,1032047,180539,851508
eb0bec2530a5dd898cf810ae58a77ec2,16,15,3920,1190,2730,22,12,5772,1978,3794
167c3bf414128e1359ba55100de70fb6,110,79,360288,77183,283105,150,117,307459,93913,213546
f58a3168803862257245cff4505c6512,193,98,475963,92223,383740,175,108,447698,105217,342481
5b3b1b1f263e3f546d0f2dab9f64aa28,23,15,5166,2195,2971,20,18,4789,1992,2797
d2436d32ac3e3049c13abd29ad03c698,37,24,33629,10612,23017,35,23,27188,10330,16858
969bfd7591bb5818c6873dffb19b49d4,123,92,293057,47659,245398,145,115,315885,57166,258719
858c3f814279e14c7718f9b3bbd964e9,37,30,30040,11205,18835,34,32,29304,5525,23779
ca3c09faba5cd65641ac77873b5dd1c3,122,102,257197,83412,173785,136,90,291347,63659,227688
d62f26f09b050fe2c00b23aa6678c609,197,143,638069,113244,524825,185,154,554028,132940,421088
a53ebc2ad8845d28ba5a94042052702a,88,55,148832,47041,101791,161,99,289598,43471,246127
206700d560b9acd60de644d3fb385dac,69,53,112616,21523,91093,57,44,64387,16952,47435
aa542eda579ef541a0c1c9acbf21f3bd,22,17,10377,4727,5650,19,18,6999,4839,2160
f5934c9c9e5ac96d9b968844729328cc,28,19,14631,4747,9884,23,18,14247,5338,8909
dd1f7c1df5231909856ec4b1791a506e,140,115,354518,85860,268658,152,114,417857,74797,343060
e30b2fa9939406fa119af010668bd5d0,154,108,397067,78477,318590,112,71,212676,46517,166159
865fffaa1975e299063e690ea23e6aa6,109,68,169381,45049,124332,102,77,141861,47450,94411
28852e965f54da9aa3aea5f26cba3d72,155,99,402027,114238,287789,137,103,520374,100225,420149
8af3cdf0a270027e85112ccb6b46b956,94,82,196459,67117,129342,105,77,229292,72659,156633
835062b527756c00230ed3de41d396a2,67,49,99974,41527,58447,82,55,163260,32957,130303
993850e4c5bfe04f35c63c7c6c9c792e,48,34,43202,11522,31680,35,28,34239,11413,22826
2ad125c268bccb0d173a2e273caf95be,129,120,440986,152391,288595,138,104,463078,102459,360619
c5c77d6c434c2da73a3e0ecc851aff18,148,114,464536,121715,342821,159,138,527165,86928,440237
0969b7b8509d24246b10af9f451a0788,102,89,164881,69310,95571,123,103,261782,57780,204002
ddbd4fc11f9698f384bbed415e13e593,80,59,102138,27247,74891,81,68,117207,39750,77457
a8ed69273a5cda4f6a8b3ee81fb358fd,125,107,400944,89821,311123,141,102,412129,83767,328362
b54065ffefc969b41852957f996daee7,112,90,279691,74597,205094,121,96,250541,71858,178683
12cb9ed16b191c50a14e203688ee4987,63,55,62097,22974,39123,59,46,82538,19152,63386
e2ef3f27a84951c301ddb87d56948c36,29,24,37582,9112,28470,33,25,20939,11116,9823
03c2987ab0358fda8ff89748adda2afc,34,27,21680,7966,13714,35,30,19317,9308,10009
b75ccc4ee13f5dcd2bf49b9abeda54a5,179,127,423860,129342,294518,147,114,430414,71958,358456
c1d139f7354279fcfc93211830cc1343,96,76,144804,47315,97489,84,74,142416,46653,95763
8e7d4f7343c1bd3fe947dbe6ffb4b0a8,19,14,7280,3645,3635,17,18,5410,5430,-20
4dc014ace4f589d858ac081a537f16df,47,36,70182,20850,49332,54,50,58113,24312,33801
1bbb5b76906c8ab1d77ad67c12bbb45c,128,111,492347,71444,420903,132,110,320588,104512,216076
5fa2cf38fbebc59fe0fe4950820dacf6,109,84,315518,61773,253745,128,99,364153,64498,299655
80794680c9ad6ec18f0dfa047c1a070a,31,23,25960,10886,15074,35,29,36479,8569,27910
a4803da2538f59d157f3683cbfced4d0,47,39,36257,13857,22400,48,41,32063,10200,21863
c4aa6f381d341543d2b0e387f78d01c1,170,118,491380,80413,410967,161,137,357531,82437,275094
bf716ababb37da29b76215446a24de51,84,52,114234,19712,94522,66,51,65089,23162,41927
a60d7b1c00eef2fca0e2005473b1e0f4,173,127,735839,134287,601552,229,158,806523,218010,588513
0c167ccdbac8972c440ecaf9af93b9a0,32,29,18929,9975,8954,38,31,41119,9765,31354
a078a24946754c7060820bed9a4de005,77,56,148120,57300,90820,103,85,208146,53508,154638
83619a59093fb74bfed7e6e5bad181c7,100,64,179254,27521,151733,61,50,70276,25908,44368
1350ae89b4fca333a05d2bc9b7a6f6c5,55,49,46028,14445,31583,39,36,30792,16864,13928
d0f9539957a67d41cabdf1eb61afc5a6,26,22,15026,10522,4504,35,22,21861,7124,14737
b4c6a0730859ff5cbad0716a7c23cc55,25,18,12397,3500,8897,28,18,15526,1974,13552
daa8db8788988ef539bec6e6d648318f,113,89,309852,56044,253808,101,83,218298,55291,163007
9a0f11e2d168a4979141f8b5fc3889aa,104,65,169857,49059,120798,98,72,188770,62058,126712
066eee76ca646e2f82dd74f32c211eb4,162,127,488550,92231,396319,198,146,681277,69140,612137
eb3a782554a2ff2f600ed035df946110,22,13,6588,2000,4588,19,13,6499,1774,4725
e0b55dc332e578fe53b80856604806ab,135,117,372945,84840,288105,117,101,205851,68560,137291
acb80e813d9b50c013232c92f554402f,63,53,111698,48281,63417,84,54,131652,40318,91334
7af947eb056a43447291af0e6f31435e,54,34,65941,25328,40613,73,49,73478,23194,50284
7332119dd0db26a91c5065b73f5c1ae5,99,74,142994,45819,97175,81,63,162886,41404,121482
95167bddeb6c05d145abd2551e96b6b9,25,21,10786,6316,4470,29,22,18576,3680,14896
2cf5e7496548d4b38a49ddff27300784,130,100,302736,63850,238886,148,119,347544,61771,285773
62ada44979a9542cae40bbda020219e5,23,19,11193,5519,5674,34,31,20650,7008,13642
571a39f7456f9915aaf8f930e59ca1a3,55,53,71879,16217,55662,58,48,39345,19962,19383
184efa1b8f30095ea219af0191826c84,114,108,386615,110420,276195,143,95,340287,98033,242254
716e03ca8549a3e7e6ca13b8fef6c4d5,133,119,340570,77469,263101,146,90,325793,36905,288888
e3586c6aee870345ba9cae565659e2d3,25,20,16117,6196,9921,25,21,18398,5718,12680
673148d0e82397c183a32b0d31b6e657,99,91,186223,41478,144745,66,56,107060,39583,67477
c55abb782800bbdc4d96bc85c2b63b85,39,29,26484,9116,17368,41,31,24870,8095,16775
387c251a674fb83d0c931a571fffb482,55,48,73098,16094,57004,54,44,55263,19710,35553
f445b3b902f80741a5f7b3c525fea0cf,104,64,184660,44584,140076,98,76,172821,56203,116618
eb68547250faf515b88db9156224e438,40,31,29193,18116,11077,36,29,50604,12499,38105
6e6cb4b9e4f88e280be16ccd70380575,194,142,1292130,191901,1100229,150,88,815848,140863,674985
cd3a64c7b3f36abe18deca905e7c5d36,12,8,2757,1428,1329,11,12,2039,1155,884
e9f74d4bac442f7ff4b49c83a06854ed,40,30,45593,16271,29322,36,30,36778,14227,22551
3f9f41152fe74bc9d13e965b0d7a0346,28,23,18451,6867,11584,25,22,16348,8604,7744
b8103b2daac36e98ac3d3331ddf42458,143,115,506309,105543,400766,177,157,587037,142910,444127
c98c5e6b17709d28d15a02655d2f4026,160,119,408838,100990,307848,208,156,504021,126232,377789
106062804dc2a0f3b29cbb43c58e1c89,42,34,36574,15144,21430,40,39,44005,17420,26585
9e965c6aa1bb74422c5a7b841ed5c36e,145,123,342252,72276,269976,133,100,335520,65678,269842
b4715a40efb3af0cc2380b94d125b738,154,116,496987,70170,426817,155,119,456945,63099,393846
1f6ea548b03db550894b06f4a46e34c1,113,89,183344,54445,128899,104,82,196006,53170,142836
5fc7b44cb83166825d9c525c5e45e0de,64,49,101402,26153,75249,61,60,98876,27175,71701
f62b57b445510040d5c0c8cf2082d55c,159,86,269726,39191,230535,102,88,156044,70826,85218
62bdf217662174567d27e8d6c89dc7be,93,87,151006,38810,112196,75,57,104453,27507,76946
96dd7dfa06736ead0c59bb2f9f5f3ebf,57,43,72547,21991,50556,69,52,91852,26594,65258
543b9a44e8f6bdb30c3bf441ba74a09a,141,109,444046,152559,291487,178,136,652758,117058,535700
c0c87efd03c60a235b69e520f8298472,26,24,17068,8901,8167,41,32,38390,11976,26414
b96df44da51ba479806f6989a73c4fef,51,38,67089,14089,53000,42,36,35104,18478,16626
ebb9ca6ce94c3c45df4fa9c2965b1732,38,29,32165,12342,19823,32,27,28684,10853,17831
a325f355304b2fc882e7be5220325b34,113,97,215961,50522,165439,124,98,246347,51926,194421
3d4b2bd982187b7b58dec475462b1935,26,17,11664,6158,5506,24,23,14259,9244,5015
35c8b19ab2fc677d83b18aa87dcd1afe,0,0,0,0,0,0,0,0,0,0
281977a7c895ad45e6a88a9e01214d9c,122,104,306102,72128,233974,113,86,271593,55450,216143
b6be86b245945defb750e51444ac92be,200,156,576827,118940,457887,179,141,707695,147309,560386
6633913650b421ece3463cce546aa2cd,120,90,321445,91939,229506,154,129,500754,91127,409627
33f849ea9c20c98454f55f382a09d63a,139,106,380490,88449,292041,121,92,269202,89960,179242
3020054a775d7870cc2106a33f8544cb,136,97,305426,96109,209317,117,94,353293,71403,281890
546083b9db7650809648b506f849154e,152,109,368580,61793,306787,172,132,443044,68914,374130
7bc4331672a5cfda22aa05934dc07b2b,82,65,78782,33975,44807,73,60,70906,28931,41975
c4d1808eb4c9f2ee275d09a589c23fb5,82,66,155307,27293,128014,65,45,105859,33864,71995
f6777516f4d974dc13f3d4d790a176bb,172,118,474142,103907,370235,114,102,305378,132908,172470
cc505b1861422bc46392524e74f569bd,53,42,66853,23272,43581,45,33,52033,17160,34873
d1234ca7c8754826a11f61718e3f5f9e,174,117,494567,86689,407878,141,100,370453,65448,305005
55ca63358ad838fa2e33100b85f58355,37,33,26766,10682,16084,30,27,16582,7976,8606
16f201df268c2c9dfc481598d4266cca,46,35,55570,25078,30492,42,29,57534,21302,36232
fdca73d282bbfb825c6bc7f76ef14f31,13,9,2240,556,1684,14,11,1837,715,1122
76d33f494a0f52cd6a732a399d729a69,130,98,448981,85102,363879,139,117,488256,96547,391709
812ca22e8d30e387fdd370c45440b700,24,22,7779,7168,611,20,18,10998,4304,6694
108b44c44fb66762f6542addc2a928f2,88,49,128643,28133,100510,27,24,57591,11539,46052
e06efda3b63515b4efbeb0de174aeb7d,67,45,89327,23377,65950,95,79,156982,28650,128332
efb38b3799416fd0b5c6ad29cdea0e05,119,96,210846,62455,148391,130,99,327201,72364,254837
a2ea945ac85ee79c078e75298c617d38,90,79,222782,55488,167294,98,78,186317,66521,119796
d13b9992056e8823b6b21003bfe970ee,64,51,97765,29239,68526,77,62,94089,36823,57266
1163d7936a92bf77a48e7c7b547db8be,38,28,48409,12801,35608,46,42,64879,14615,50264
4af1234230093ead4e8bd542ae7f4a51,145,94,265340,40103,225237,108,95,168318,56699,111619
7d10f39cfc947e437ea5f2eab517143f,105,74,168138,42451,125687,110,90,190847,64970,125877
61a0feac1d10a30c488e4955788f7eb3,139,108,454835,108177,346658,147,107,453204,105476,347728
e7734bd310917bc3e04dd75139121842,157,118,757234,128688,628546,155,133,1164315,101995,1062320
f07519dc79ae4622867616494eaf5f4b,114,82,248804,57737,191067,134,99,323107,65550,257557
c0ef05de52012290ca23c749ffbd9644,70,64,137450,46393,91057,81,59,124513,33837,90676
17b7aa71efd9ac9594110776667d3780,95,67,167867,46402,121465,71,55,103412,50053,53359
e472bed937b90cd29e533563df0e7c54,140,118,488512,97274,391238,236,143,587412,129478,457934
dfe980daa55031148ba36bd6e90eeefa,175,131,436715,92454,344261,145,113,364222,119854,244368
ba8c22fc6d7a3d74b2b7c8bcb105a4f6,78,48,114723,43591,71132,81,64,191231,31550,159681
b390b201b938654cc3338b2f7b5bb079,32,21,8779,4346,4433,27,22,10370,4448,5922
c044753f1df3a6a5f2ad8e8adad628d9,2,6,322,547,-225,4,2,524,322,202
74f3224d824d41043b8b6dfca6160811,126,94,283491,96315,187176,116,81,265593,82061,183532
7a28ba32ea691eeeb6098e4ad509c95d,45,33,65855,21140,44715,49,40,43199,21839,21360
4f633371fd9c29d6806b456428ccd21f,98,71,219327,60712,158615,86,70,144028,50791,93237
29df9f21178055a9dfa5e3b377348eef,131,100,353489,83944,269545,168,107,404962,84337,320625
5c005e5f5e28efdde9cdf3b29fa51533,0,0,0,0,0,0,0,0,0,0
19657f4f7e15cc260c7b2f41dca74bd1,37,24,28007,9875,18132,37,30,28907,10271,18636
cbdaebe0c2013b1d5d172b205045e022,33,25,19963,9499,10464,33,23,16968,9122,7846
edb07fa22db61c707e8f224aa36d4f13,165,118,487865,119329,368536,199,148,557088,103564,453524
2aae889f1507c1fa2f3e8804c2633946,81,69,104742,44679,60063,79,61,125455,33524,91931
2d9a3302fd8f1a448dca8fb750fdeec2,94,76,166204,38615,127589,123,83,179238,42084,137154
cef57cd3a6906083a7d5d2817f8fac0b,20,19,14066,5356,8710,31,24,13499,6040,7459
9570a8ccb89303e3b3905c2dbc0d6e20,48,48,54507,24128,30379,38,31,26667,15361,11306
fb9186cd42ebf6f56d57aef6509ca73a,105,80,210872,32731,178141,80,70,148672,42985,105687
c37ae4fa79c18bf44e49c3cfbedaa375,52,38,63786,17299,46487,57,37,66514,16299,50215
c85d3c5388eceb47c4a8aba334e4c320,83,57,164262,59270,104992,166,132,330039,67420,262619
cc174ce92b24338f7bc8eda64cdd5be1,138,115,597395,166469,430926,177,130,719575,151838,567737
f3853d387c2b6a1f6313b9e03d161b44,125,74,354404,78541,275863,140,104,385687,93274,292413
5d12f1cc1d30f2e36c51061925b67e4a,26,19,9024,2467,6557,27,23,9980,4342,5638
7bd3c002aa8cbc64e4d600686151e332,31,22,18000,10902,7098,25,24,33311,8589,24722
47796a7ffc9ee12442fc4c0ea43d6b4d,65,57,142145,30602,111543,69,64,77124,54195,22929
ece17b1f19518979feb2c5b960e2923f,52,46,64311,20024,44287,65,49,84417,18723,65694
a399f991dca441473e8cb6a61744084b,94,73,214370,41410,172960,138,122,348221,69987,278234
f985f6858a4fb18fcbb0d8093d00e65b,26,19,12279,7744,4535,27,21,12291,7907,4384
73a88c3de6e18d3529963e02c52554e9,192,127,723495,97483,626012,138,117,472266,130347,341919
5020dd5d6d17b984cdfc45a84ce2e4f2,55,38,62487,21751,40736,77,59,95216,22850,72366
920676701f8a9105dc3cccd129cbf20b,145,101,249082,46980,202102,116,86,215140,50631,164509
87cc1112a82450a2799383ab05226c08,6,4,561,484,77,9,7,1017,556,461
22b77bb801e4fb39e6c850535ecd8afa,31,22,17543,8377,9166,30,25,21722,12072,9650
d04592ae43814cd2fd8ec1bcacb33e1c,134,119,290521,71969,218552,142,126,357389,104349,253040
0b2b4d9f1b2b57d7419d57f98292083c,90,63,147051,30350,116701,87,76,146895,35176,111719
4a85b2c79db128566650ef97d13df3a4,128,89,273867,64283,209584,139,112,396547,99873,296674
891213861b98a370058a417a2d560d72,100,73,133369,59085,74284,111,89,175269,59427,115842
be787b91d54932a0a5b0bb31408aff78,35,29,32472,16636,15836,35,25,30612,13034,17578
b386bdb1f57a40bece40e0916e8ca2bf,32,24,22275,7771,14504,36,27,34685,9356,25329
40617cea3383483ddcb791f11001f323,43,33,73379,19236,54143,50,42,102909,25374,77535
f6f11c9aaf32aeb2cb43981e6755d07f,62,54,79617,34965,44652,55,49,82855,29588,53267
dafc5ec6f6e872cc000eed3a678e148c,58,49,84074,22567,61507,42,31,63935,20467,43468
e5c35d88a5b1fc2743bd0d0e697ad597,117,102,331180,133863,197317,115,89,313701,96271,217430
4f7af9bd8c0e00d945c8664aa161deca,123,82,182836,32401,150435,128,83,227238,33254,193984
e4674e8c499ba1950eae7f35a74cfe7f,121,87,335375,73972,261403,104,89,260083,91569,168514
0c58168c2db4bc65f75727ed1d28697e,61,49,78547,22647,55900,76,70,87214,23978,63236
e36e6e88947655320e17763ac674d6d1,85,64,252439,103371,149068,122,96,321966,83498,238468
9190ddfaf79a9cbbaf67eba19329f9e0,128,97,261349,45140,216209,79,53,125308,64196,61112
d05c9b0052ff36e38e851036d4b63e17,89,67,110107,32098,78009,67,61,80336,31512,48824
3439fb37fd5b3bad7eda11612586f667,121,100,234536,42330,192206,98,70,137228,35083,102145
2ecceca6569628f9c8fbcd486c80556d,47,40,43210,15774,27436,56,36,56769,14339,42430
3c45ce65f790815e1f59f8a3dc12a28f,65,47,86662,26424,60238,76,61,65526,29055,36471
83b3e8db201ea704312da7168dca2317,117,89,348139,65210,282929,185,151,638826,95271,543555
8494b8df48a18f0eed1ab00f86c7b2f2,141,121,285157,55662,229495,66,57,115842,41227,74615
fd27e760c90a0ae8bd74e55436c11256,26,20,14688,7055,7633,24,21,14781,7132,7649
97469b0943a0fec878bef2c1b357deab,53,45,72358,16471,55887,48,34,45243,13637,31606
3b9a07f53bb344a60b9d1275fd7ba8d2,29,23,18686,10830,7856,35,32,26053,12327,13726
9a4141df289e24afb332bb87486659fb,154,103,366545,56094,310451,124,89,362545,73584,288961
0b6b46d66d1fcae81452f94c480e63be,129,84,366528,109372,257156,147,105,338859,132487,206372
9779fccb28ad45834251d07fdd37d611,50,40,82979,18305,64674,74,69,103640,33618,70022
e62b25a66f38b850b46361510080cccd,34,31,41084,17734,23350,41,28,38802,17049,21753
87824a48594c5a2113c1addaad2ee0dc,29,25,24029,6182,17847,28,29,14761,7791,6970
08335b5a1d3c4ac81bef6a2dbb7d6095,48,37,67603,23436,44167,58,39,68830,26492,42338
617baf20d2b620ddda3a8ec586c364d7,161,118,521398,72687,448711,161,142,433030,110249,322781
554dfffb617f082183053c46765e897b,131,86,302040,68076,233964,108,93,311237,105346,205891
18071ffbf918181b787e82fafa8495ab,100,86,208342,38129,170213,104,78,177560,44971,132589
2e2834d8a4c6b1bc97814b9cbd056c3f,74,47,99562,31528,68034,84,63,106050,34357,71693
0eee5ffeffbe50a4af4da1f8aaca662d,20,16,4280,2734,1546,17,18,4838,2220,2618
245c16ec79e44bb0b7d0ea0be9d45f0f,25,16,9874,5295,4579,28,24,17508,4639,12869
fa24f47a1eb2c76c6cea756b6eee7122,116,90,310534,50035,260499,77,61,204979,40510,164469
d79fff5de354d7e71f9abff597883a68,118,89,236628,50596,186032,145,111,324027,48983,275044
0bae55218adf7e5173b58b5160db892a,68,60,104856,41714,63142,47,41,91589,43700,47889
f4e3fb2cf8174ab6e3c84c3fb3bf3932,92,75,140134,38846,101288,77,57,111475,36001,75474
c215102d6837c4f36077a60431cf840f,128,99,301343,77384,223959,144,98,426788,61653,365135
1e1cc497b676b525190b976e92b03d21,93,62,138017,20902,117115,86,71,121566,27367,94199
88dbd34928a75de55ba1f53cca1525ba,41,36,44243,20140,24103,59,37,131406,17819,113587
3365ec913dc7144881b76f2a73d92536,125,110,396254,110442,285812,125,105,355146,109780,245366
616bb6a188e77169a93241b12cb5087e,198,146,836970,193975,642995,137,109,757412,215757,541655
37e42db707798c807cf5d37a89681477,168,104,500952,100349,400603,162,109,434606,91867,342739
431951a10423010109fd88f8dc46bbce,109,84,307354,111132,196222,121,96,304365,118759,185606
3cd1b8d36870613ebefa09c09aae656d,169,127,681965,231641,450324,141,114,504764,261072,243692
dbc17678c2b31b70abf994895109d5e5,80,50,147468,43800,103668,96,66,168160,40123,128037
efcbf0820a87a0740689bb45ef3f748e,21,13,6428,2808,3620,18,18,4951,2772,2179
c2e5ba5879fe01cd8f86f1a783e6dcb4,155,118,366982,68749,298233,146,120,316066,61642,254424
828db4be9c66c07dc3dd330a668f3a67,31,23,25069,7820,17249,35,30,27525,10304,17221
0eea565011984863639d08f7742c5f65,98,79,132691,34481,98210,76,60,91558,35450,56108
e1a2e6b19560c7d7815bd1161f9b107b,72,56,88170,24215,63955,79,71,116432,23410,93022
ee57172d283ae9092906dd5191af1cd8,27,18,9160,3334,5826,19,17,6055,3774,2281
3715aea9c19de88b6204a266a8b9f6f6,146,121,416428,86264,330164,218,149,396004,96705,299299
991931e7aafa6f88a88e26ee8859574b,27,25,20414,11517,8897,32,25,18891,10225,8666
18fd550df6184ab76dfefae7f744a63e,125,91,447541,107164,340377,155,102,396070,111853,284217
5e25103ad2dd910dc1167ba490e40cb8,46,37,68265,22064,46201,43,29,42377,20297,22080
50878e5e67357c67e669f600322354fa,42,27,23969,8433,15536,33,34,16947,10353,6594
61b46ff750886417aa58780271dcbb0e,135,99,303352,95236,208116,78,65,192372,58931,133441
511b0de9f8007b780a0be1fb1467bba3,37,26,32615,11575,21040,50,42,56981,17999,38982
9d5371188e39b4e47944663fa296850a,20,13,4141,1054,3087,19,18,3844,2100,1744
f6e73af4e3cc84d294fab5d21871884c,39,32,35872,7144,28728,45,31,35047,9288,25759
1d2992a8586d607fc6cc0ba71b9a91da,31,24,11779,6269,5510,28,19,14475,4670,9805
4f441af9b1525c04c95b0c95f965f706,59,53,66586,21666,44920,57,49,61381,24303,37078
2f005b286b81fe61f94e597c57bdd31d,158,120,449376,107050,342326,108,83,297736,108709,189027
a66def3316746a8909af670674ef09dc,177,122,349904,67385,282519,106,93,232564,55698,176866
ddc2a0b6dee1aca196b3161671d051e6,38,28,25827,11162,14665,36,30,23867,10620,13247
be16591003348ef77da5a123c0941cc8,24,18,11566,1961,9605,25,16,9334,3698,5636
033467b1aa769e892a51429f519e8ab8,49,42,63218,21214,42004,65,49,106430,31196,75234
f1fe362daed8625b4783e8f2992d71c6,160,123,476924,102596,374328,140,107,429118,95041,334077
2b5122a8249cfc526c3d8c551174a766,36,25,30361,16913,13448,37,29,35362,13232,22130
886c74605f7e1e1a64985e38727de618,60,47,56651,28899,27752,73,66,88676,20900,67776
0f8deda02a10a50adff29ab361f152b3,138,107,239983,42145,197838,97,86,161224,43475,117749
c5dea64d3a633b0a8cf54b938aae5e9e,44,30,39073,12660,26413,33,27,34356,11630,22726
2b186a6cd145e222f4005edcc9fde7cf,64,45,55113,18611,36502,59,37,62169,15053,47116
3bd958ce70010b40fd63677515214fad,37,32,44451,19522,24929,47,36,53004,23276,29728
beb690da0a3f03cf94dbb0a0b5f54381,49,36,81631,22338,59293,47,43,64412,24378,40034
94c42639a3fa3c791c722746c0b4723b,1,3,122,759,-637,3,1,759,122,637
6e82e4745b4cb6e4c2afcf8fd4a35bab,182,143,859601,222341,637260,193,151,932672,205119,727553
3e5c952347cb2f2dfbb088a2f8274ddb,54,34,95209,27335,67874,87,56,114193,23475,90718
f26344102537f23a4dada630e8423bc7,37,31,58187,20144,38043,42,33,53679,19666,34013
edc8f023068498c69891c6fdc0b4c090,174,121,518588,103529,415059,192,137,641015,101632,539383
63b3a14ff092010d10ab05e55fff9aab,95,81,185436,40074,145362,114,69,203747,27124,176623
6e30dd2721627f949f37c62f9dcf11bb,22,18,9096,3303,5793,26,18,9162,3874,5288
06136c51aa8933731b5a7b42db8fd1ab,136,118,454241,104748,349493,136,112,370616,78650,291966
074843268f5e5a5556166a1f508e5dd2,97,85,170950,45863,125087,105,77,200424,51336,149088
60264030081a2e42a68be911897511d9,82,68,142616,33373,109243,74,55,115316,36821,78495
953355ec0456fe217d44741f3cac7902,173,138,663899,140068,523831,162,110,535189,126770,408419
502ed1b25683c02a12430ff7303cc0d5,131,115,305045,90478,214567,171,122,454617,65239,389378
875b15b5f49f1a85307835c96346fa71,83,59,115301,23784,91517,89,70,149865,32589,117276
41da0f8e9274a7777aaa735632742a95,118,96,325091,82841,242250,151,104,301508,63898,237610
6508ee523a8cc2495d502482dc3308b9,104,78,183150,35499,147651,95,65,143081,40553,102528
7234c86f63bacf7ff73692ff7d874f04,43,31,36544,15802,20742,45,37,48574,13601,34973
5e1de18ec3769cef3b9e5d7a1d15b7ce,60,43,82765,16495,66270,48,44,51862,12319,39543
2cb7f02d9ee1ee2c05d75cf7ab0a5239,63,51,84539,28185,56354,59,50,68880,27868,41012
121821126f91af079420e1137e006881,50,42,89341,24842,64499,45,37,65445,23825,41620
eed2040aac63d45ece9a2c3aa6184b29,52,52,101205,28598,72607,59,49,85013,28416,56597
c6d5a8e7b92d71ff77ef739b761ced99,124,99,376562,116048,260514,133,82,388895,93833,295062
1a30dabe05967690fb632a305d56d7ff,31,20,16371,4326,12045,22,19,12841,3659,9182
8f402f12a6813c3dfa6c4bda8415d5f9,75,61,102447,24905,77542,47,46,52811,28058,24753
13f723c1ab3c55eaed6242ae5e571a4b,129,110,312619,44118,268501,104,93,256924,63678,193246
aec98eeaa3e81e027e50f0fbfb2cef41,132,97,283628,67697,215931,122,93,246038,55181,190857
53956a0f76d0a9380d3daaf08dbe59e5,75,68,136594,43908,92686,66,55,98747,36167,62580
fa0c3d327af2ea86aa17e0710d7f2955,10,7,1699,629,1070,10,3,1263,489,774
5a1607eab7d1e92a60d8314fd6501fe6,20,13,8078,1743,6335,25,17,6152,2641,3511
252a1f8ad8ebea770df9ef5388e7531d,164,124,352702,71321,281381,120,91,256373,74904,181469
c5ed554182eacdf8bd387922b1b956ff,127,104,271063,53101,217962,100,88,309788,46902,262886
c4882e6064fbc6fda7f5109c7893c5d8,32,23,22291,9367,12924,37,31,36366,9341,27025
732b37803b646b5c5c74a87129b3e009,63,43,86687,20978,65709,54,47,55826,24641,31185
b3d34f059b62fd603406c7910f3f6187,54,43,51791,26543,25248,65,51,87498,20037,67461
100937ed2ccdb6929f987ddfea720d2c,156,102,362683,68953,293730,167,115,364479,65306,299173
29a4ba2d2026c83e300d0ce6b0bb47e7,33,29,25372,12996,12376,26,28,20818,11859,8959
48eb89227ee480a17fa257f6ddf19a5f,127,103,368544,58404,310140,111,94,338024,54273,283751
7f34ce0ff63600c7d9faaacddfef4393,122,104,252483,47128,205355,145,95,257992,48747,209245
eb36edc2a6d67850847aeaf034ef366d,222,120,782004,96027,685977,160,119,503713,146032,357681
a49fbe4080cacd98f86eaa9ae84017a5,98,79,200981,37983,162998,104,72,225006,31773,193233
69b5a9a885dad2ba9c5ff8a3cde600d1,95,64,145135,36282,108853,95,72,183339,33942,149397
119f393ec41f7313a8e4aee32b0a2510,69,51,93627,26876,66751,43,41,38882,41308,-2426
69d3d068c27efb27293f1e34ceaac217,43,33,29134,10249,18885,34,27,17992,10106,7886
cc0a979d12d986d00af3954cc11dde2e,129,98,323057,65873,257184,120,106,293113,58307,234806
5401f5af5cb78a3f265c6f2f63d60eff,25,21,10307,4656,5651,23,20,11342,5366,5976
b9068a00e706bc75eb95be0c5f8d564e,75,52,139423,38626,100797,100,86,266427,46490,219937
9cc031fd80a6069ac70500c610d56d60,90,71,159763,56357,103406,90,86,156666,61537,95129
1879465d3eee2086b5a6253691835638,153,116,528425,171413,357012,144,112,461664,139976,321688
9421673be4d527334062c27018015f46,61,59,142021,48856,93165,85,68,107888,38080,69808
d5980299620adbc678a2eff3d7377954,165,124,426605,75652,350953,168,117,435841,78701,357140
0b2f005f47962f27b77d141f17b3ccd2,86,76,261710,57347,204363,147,107,373139,72808,300331
af8e4e890b5c5cc17a8aed1b40c2b3d0,116,77,194271,44373,149898,142,95,256653,56034,200619
04826587f247da241546922148e7e63e,63,48,94654,32197,62457,53,42,77304,27660,49644
7e180f7accbb2b90aeb63a4a2604c791,234,170,729769,115076,614693,189,154,573793,108839,464954
28fa6715c62e07f33b5c27bcb11a45b4,157,116,347976,68331,279645,102,90,221694,84038,137656
8af45257b737c026fbb32eb80ce668ec,29,27,24897,12012,12885,49,27,51211,7320,43891
64f32f71536b01d36aa638d25191e05b,65,56,75493,30659,44834,88,67,125954,24980,100974
2347e64ac109613856e7de88c3e29713,125,93,187150,46603,140547,127,84,169302,34458,134844
3bb56412a2978d28035b0f83db2dd558,105,83,418544,109647,308897,145,106,465979,93074,372905
53f9d31cf3d6c625d3fec39443b6109f,121,100,346136,68179,277957,144,97,273399,65277,208122
8ff645ebe17e1ad23483180da523a745,47,41,86994,38922,48072,95,70,164772,54269,110503
e9a2ab7b3612c457fa3ffe30300b3d1e,111,93,266643,48900,217743,109,87,199558,55435,144123
ab7bee07b4e8ae5da130fc78091c0f11,28,20,14602,5160,9442,31,24,11864,6163,5701
b2c8c33199caead72cbf545ede2157d4,180,135,522888,147672,375216,179,123,554114,137308,416806
89cdb3d8841e31c5f56823ef29909cbe,80,56,146057,35000,111057,106,83,213794,62053,151741
ea837ff7c767ba35835e731f665871b3,40,29,46331,10573,35758,40,35,48522,13891,34631
41a3a907610dfda2364797fa1b5d914b,46,41,52112,16148,35964,44,32,29516,16826,12690
cb4e0433db7b379234b781ef7ca429f0,57,46,62081,18880,43201,83,61,89187,22763,66424
cd15f67e50362e1f54deb9982deef2e9,228,148,1104554,164801,939753,232,147,1202114,147823,1054291
006f98750a054cb450f6a8a447f194b4,36,34,34963,19366,15597,44,40,51067,16979,34088
5aa12b97f94370731daf9dd4de4946b3,128,111,328545,83706,244839,146,120,400779,80390,320389
7c2d3361c6f343ef0f92edc49a2df303,74,60,89906,38582,51324,91,90,175928,41210,134718
d2d889b619508bd8a75f7116f25e6eeb,85,56,145359,49633,95726,110,101,217693,56510,161183
10dd90f293fa515f31dd1fd73e72bb44,25,21,23964,8284,15680,26,19,23222,7016,16206
2cb321565663204804e9dd966693ee70,40,42,42516,15802,26714,37,30,27567,8732,18835
31f0173bc58a2a18c606846e981a29c4,105,72,193994,61345,132649,141,89,305763,38007,267756
c2a05acd77542bc59c43ebe50b71e5e0,22,18,13097,3926,9171,35,30,34001,4730,29271
9ff348e43897a12f25997dff1c9048ae,108,76,183668,45567,138101,85,70,108695,53185,55510
30cc32f067fbc02a4cd1aaac4983f802,109,86,265194,67892,197302,109,88,279069,70520,208549
224906b2a46ac3c3252cdeb76748a722,60,56,72937,43386,29551,96,61,153903,26228,127675
19c6addb69a7670670ab97910fee258a,79,64,192258,69802,122456,137,91,414375,51572,362803
6b3de6731277bba4c4e5d828223057fc,143,98,276578,40444,236134,97,71,164492,43743,120749
a4fc515c178126f88c949382fdff4363,95,69,139083,29437,109646,96,84,139165,43300,95865
1a40df8687f94d481efeac9db25f60c9,29,26,14062,9722,4340,34,27,16675,8430,8245
b05d0f25987beb1b77674f21bc75457e,143,104,340894,104792,236102,140,96,368763,67443,301320
9f128ba557d7369cdc5476f98385ce17,27,25,13599,6496,7103,27,25,11547,5082,6465
0c1521eae41a23b67d34eaef043f6b34,116,90,294357,61085,233272,119,87,274410,51006,223404
29dd38d784862ab41d6ecf52e5974357,144,92,290874,78935,211939,169,119,400110,76001,324109
a5af7876b7481d9826d207c92f65e61f,50,40,56045,18933,37112,42,32,43625,18437,25188
1646837041a1e6e2b6806e6e748cf0be,98,71,155650,32231,123419,109,73,178918,26459,152459
a43bd3de386cd01d63764002228260c2,99,71,158957,54188,104769,99,75,176522,37526,138996
86822a84319b073a87739be6f817face,0,0,0,0,0,0,0,0,0,0
91f506d1a685fe36fe8949b3ea817ea4,107,76,176690,45319,131371,87,62,127334,52300,75034
2a5a92554effee3fceb46d1cd77e1622,137,102,247993,65109,182884,102,81,287358,57134,230224
495656dd1fc032fd37ea6cc8c2531f95,47,40,38741,9978,28763,48,37,40813,8892,31921
f12bc1b9ebaaf3ac1bfea85f054cb490,102,77,209745,31823,177922,120,102,216333,53437,162896
062f64b8f27a4937d504be8b4f67030b,108,93,288034,59055,228979,120,96,318695,70913,247782
8b4cfa2eaecd18681db341e61b1674fb,137,103,374806,104919,269887,188,146,574287,86378,487909
636ced5f5e50020a480d57d2553b23eb,114,90,349294,105359,243935,163,110,352227,100047,252180
ceeca58db90a455334d8fec2868fc605,61,40,49897,16488,33409,54,38,64360,19472,44888
8ee0e73a44c8a197aa5983a03eff68ef,182,145,590265,124165,466100,174,145,565806,110417,455389
52781a2b5b4efab10166703e2c272763,130,88,262710,44762,217948,114,92,224765,63903,160862
5f4e1bc908c08c1f533874948a12ec1b,138,103,295737,65869,229868,135,98,370109,56956,313153
1f94019966a709940b65c8798f9e3c77,69,61,139071,53568,85503,109,84,218137,42183,175954
1b4a32c4a9c63be1a321715db8fa3051,21,14,4252,1836,2416,19,13,4772,1033,3739
9b0327f03f75c90286d6c6f16e02c2e3,136,106,330929,83365,247564,148,105,305841,69081,236760
db2855cc208926555704621a92ec9457,145,112,291705,59696,232009,138,101,311866,56838,255028
6fb789d12d96a743be465228b3b32485,139,99,422193,109468,312725,167,116,385015,90136,294879
779439294d1df2fa99f7f6d251fcf151,33,30,24001,11892,12109,53,39,63707,12405,51302
6a78cb0fb7cd48f09be2f485c1f3fd95,48,38,58245,16137,42108,34,23,31515,7420,24095
fd2ac8abba49d86497ef5696f1bb727e,30,20,10158,6551,3607,29,23,17892,4435,13457
68203bd7bdf0f974c47aa1a5ca858c90,165,121,539426,137972,401454,127,95,373852,139162,234690
b98bdbf4cc3a6c74b37be154b4108eb9,110,92,253803,70140,183663,146,111,353361,58277,295084
3751319e77e70b213c52b15d29ecab1e,202,148,557847,90500,467347,145,97,330388,71897,258491
25e892fdcf7afc979ef3604557b4f796,128,98,352395,77700,274695,183,133,437301,59070,378231
ce71374dc31f883316b1e77d45b696eb,165,92,395728,138650,257078,152,91,430564,153278,277286
5047ed1ae6742ee8c8afac900ae2c5ee,132,98,331353,67275,264078,130,89,240231,61552,178679
32bc09cc673dcf56d70e8836ad782758,35,30,30476,9521,20955,39,23,24946,7411,17535
6f6b641a848cfe52269cd1b3f6c4fa4b,155,121,332298,79750,252548,141,125,303967,63546,240421
db009f5bfabdb34d634b24a67c25ef5a,12,3,970,267,703,4,8,976,433,543
998dedb5c1c688a495d02823d7fe4e20,93,75,208237,67404,140833,108,94,218691,69754,148937
ade638caa94ba6224f0dd46fd64ad6db,60,48,115568,25833,89735,50,43,80311,29881,50430
462c3245301bf0178ddbd7c7bb152314,110,95,208428,52172,156256,100,78,256455,42421,214034
b05c4513aa5bbdec46de8fed558195b8,51,38,64034,15793,48241,43,32,38671,17117,21554
19542cb082e8f461c83edbca45e2c43e,159,93,386370,164105,222265,154,116,419775,100290,319485
296ca2e380fa98231f1cc962c8d027bf,109,80,188257,38355,149902,75,61,136527,40087,96440
c34e093503ff25eab612759f681d37a1,155,110,374655,48045,326610,144,104,307280,51687,255593
96f9adfb1ad65e147754fdbffa8105ed,67,42,95052,35748,59304,61,48,93330,28739,64591
ab2309f4b4c7beb226b41f3f27348f4b,123,98,233617,63652,169965,96,79,166126,71942,94184
f8da05ce3132ba3f5a64587822ba4332,117,97,409616,84246,325370,175,121,416978,106258,310720
d6c8f4c6ab635da30c160d94fdac5b1a,128,90,325580,63853,261727,176,133,473224,66223,407001
54ee17c0e65cf8b988df63aab6de0332,181,117,565278,98908,466370,144,107,468841,119733,349108
c6bf4b300932ac5df16847743848af04,68,45,85106,35821,49285,58,46,85404,41709,43695
ac01799a94006164b421ed32cfbcf9ab,76,55,124584,17801,106783,89,73,81709,30453,51256
bfee3f7e57dafa60bb83611c13b79821,23,19,4512,3386,1126,20,20,6623,3209,3414
231b29ce86c7a549068ced0ec8138358,173,118,465918,158093,307825,166,124,526959,102488,424471
7e243564c9048c0702731932e251d1f5,23,19,11022,2986,8036,22,15,7214,2480,4734
50325bce0b27efcf7e720e0672d006ef,120,98,261588,74080,187508,139,104,301766,53789,247977
88944b3e051a73df48d53236a5aa377e,176,134,561119,104569,456550,165,135,524126,124828,399298
e67c85f84effad97487adba6d3b7a8cd,137,110,367723,80667,287056,122,94,438252,57843,380409
b99dcd2f716faf5e32ee66baae9485eb,17,11,3511,464,3047,11,12,1234,1490,-256
395c2262031fd94fdcb0ac2640c761a7,141,93,297753,105662,192091,138,98,330136,94995,235141
9a68ba58d8512b2ae4407f569e400d17,244,184,1048013,153955,894058,143,104,666331,136107,530224
460585b817808ef6745548568be4bf58,97,66,154792,36101,118691,96,74,151046,38416,112630
6f2bee0880b99330d0578d5398e81ee8,150,114,307926,46886,261040,125,91,216853,54529,162324
00a984f5e1c21e38cd81ca65fdde359e,67,41,67049,19714,47335,78,56,96535,20822,75713
d2a445f2053df416305a69e6c5e99bd6,22,15,7708,2340,5368,19,15,5814,2646,3168
8b0c130e9df636b9065d868444c892fd,1,0,166,0,166,0,1,0,166,-166
17330d0b00bba4523d9e6cf9ece92d16,3,2,183,136,47,2,3,136,183,-47
6ab2cf7d6069ea0f3e4bfd017da9f511,109,89,225018,61910,163108,89,70,182615,32566,150049
a8eac348b8faa0ec4840e247c6701af3,110,78,316960,117327,199633,174,145,497288,108732,388556
013303775d24c2855516936380764c5c,74,64,286467,68463,218004,116,95,284713,92428,192285
d80dcd60d54b6755ce033d125c411ff4,41,31,33711,7890,25821,39,27,23386,11559,11827
fb75a73b1b4825a701e46f98b01d8f04,144,124,371956,120214,251742,172,132,496056,114489,381567
c8f41054a3e241121033160551d02096,207,149,1121562,144274,977288,204,150,842729,201529,641200
fae90322827d300c38db2027bed54b82,126,104,268300,48430,219870,83,67,154878,51075,103803
ebb903b3daa70096a8198fe28600bbf9,87,56,119555,33316,86239,76,66,114417,38031,76386
4d0880738893695e3cdc5ac6a8561ad4,71,68,106669,38568,68101,76,67,113584,39119,74465
d8e1d5ab436fa208f73aa44ea7ff926f,135,100,439895,86730,353165,178,127,577601,83568,494033
b74fae5fc661aa6c3ef7a12a44aab6eb,51,37,80056,50964,29092,114,69,163195,53996,109199
dc639a147e0839cde02cffc393684f57,104,67,200242,45022,155220,111,95,232388,67055,165333
a25bbcf53b1616524d4bab1932dbdae3,85,63,166317,40215,126102,86,64,126679,50260,76419
901111e496de65be1cd9694b6ecd42f6,139,99,531999,108433,423566,156,102,424318,144520,279798
78114c9a3efdb9d8b5a9e79c47a542b8,37,24,24955,14247,10708,27,23,27513,10147,17366
dab007a4aa28fd3495bcfe530a44b8a7,148,114,646695,90749,555946,125,104,671237,155945,515292
95876fe86a71c8f600a130d565ef2a32,228,123,591182,118062,473120,164,124,620990,154951,466039
26647554d12661f15b8885f416976bf9,122,103,287899,78418,209481,141,106,380238,64301,315937
fb8a8c7188238a00e5db2e6aaa8baf08,86,68,124875,34249,90626,78,61,98500,24439,74061
c94829872d0ea9bc40e316d6fc8788b9,51,41,54344,13570,40774,42,32,29869,14904,14965
fa675789485ead2b0e4c5fb1212ada98,36,29,58185,22048,36137,40,28,50503,18795,31708
397dc571529a4cc2ec59d30819a06382,88,77,175480,35921,139559,69,57,145109,33112,111997
89ebae16fd6b7a7af96b991df464f2a4,133,111,380919,63956,316963,128,108,306380,69334,237046
19d26913d660109b99c74f101c56eb25,46,35,52220,21329,30891,41,33,57704,21011,36693
02a0ce07f39bb334af8171d7dd09c313,67,60,84931,23675,61256,48,32,67257,20117,47140
eff256eb08b5e3b8ec31fad3ce255f12,52,38,78835,24636,54199,68,53,138752,23280,115472
888867ea003adf22c5732ee988ba5bc4,164,131,500052,87912,412140,140,112,420935,99664,321271
f4f08b9b4bffa8065ed05febdff6e1fe,136,97,303882,76993,226889,131,97,335305,73387,261918
39e1b25d13ca6a677e45cc424906b6f6,109,95,297713,83985,213728,163,119,336019,73703,262316
5654fde1bf137ad7d5da53f63f2d4938,46,46,72737,23649,49088,71,57,76694,29537,47157
a27b2282ad529d9cead2050386f0b3b0,148,118,454294,64237,390057,134,100,331978,78302,253676
1901a0bbe2f28d8f3c8bfe98ba780065,106,83,192072,32386,159686,91,74,178084,46050,132034
e6dfcfe5586a6fcc4812bea3c4d18c5a,178,136,664946,141661,523285,171,130,783347,124794,658553
0e38ac2ab0ca40d10c2fe35bc4478d6a,172,119,703153,144383,558770,223,171,967222,154739,812483
c8e42b280682d126b3e3216a1acec573,123,77,278501,43740,234761,122,75,216991,30471,186520
1e3536d11bf2a0c3df2585db5c30e070,49,43,62224,22417,39807,62,52,64024,25554,38470
7ecc35b74af535169d1fb2fe5bf270b1,147,118,447880,81764,366116,107,87,333067,97416,235651
bd849833c48cc75f2e631f85622ee9d6,53,48,61170,22369,38801,47,37,41026,19601,21425
d103ecbb505f5f885ffe39f80e319996,42,32,36370,4985,31385,34,35,33098,8394,24704
142b1b6d2222ce71410091a7cd644b13,106,85,179860,50130,129730,107,91,177044,48904,128140
cbd33869f4fe5e730edde5cf59cd71b0,23,26,4732,3870,862,22,19,4310,3011,1299
865ec9f1d0c631aa0228be4121881c7c,25,20,14377,3844,10533,29,21,11938,6083,5855
8d0d85ee6402df1ff7ec786b70125b8a,88,70,150877,54019,96858,94,63,174457,48206,126251
0c9fea5d95415a8eaf46922cf9463848,82,65,95250,30186,65064,96,65,132214,28781,103433
f38bc6223e7d6d87f4825f18f6e2c973,78,61,119216,21241,97975,60,52,87939,35318,52621
99c493b68df3c726df7254681ba4c1df,152,104,309204,35988,273216,112,84,243580,59297,184283
f6cd7fe2964e580995dbba195f1ff031,129,98,329872,68953,260919,115,89,280975,59767,221208
c0a134151aad799bc20c67dbb7283ecb,33,17,21065,2359,18706,23,15,7922,4420,3502
5568b1f4ef4cc7b020403ffb8271cf88,142,112,312468,75688,236780,154,104,349007,70552,278455
63cd5b50002da0ac34bb2e8da2a00606,0,5,0,217,-217,4,1,234,78,156
82e72d19eedc428e8bcbc05bdf30ad63,140,117,309021,70981,238040,133,103,269050,73615,195435
15f932173ef008088cf8162205682523,96,79,159022,73673,85349,143,110,310137,45265,264872
89633b2763d602f07399b95a241f1914,62,57,66317,27661,38656,57,59,85894,32045,53849
25588b5f14e1a78aa5e33fd37499cd21,108,86,259108,62188,196920,102,90,180321,68943,111378
b0af254b0192448d6fe5ee0b88dd12df,151,113,327644,67561,260083,122,82,218811,51676,167135
c9a7d0c9829d8ad457cb29e490c7be3b,75,60,106864,37032,69832,65,44,96987,20875,76112
1b8b5d314bbd3738f04508048ce14e62,107,77,267188,68297,198891,76,65,213839,71850,141989
510de40c8707e664c18c938bcc54b76a,187,143,537390,102128,435262,161,124,615367,144434,470933
32528d68d62178c150f307e264553206,102,80,181399,41430,139969,67,52,112692,36762,75930
c0019805cd5ff592b6f94eddf41dea91,77,54,129797,36713,93084,78,64,144651,36559,108092
a1d24ba4a7139fead363fd67c6cfb5cb,45,27,44262,9912,34350,32,28,35715,16732,18983
519825d434bc45b9fb1c1d5b6b0828cb,139,105,369614,98947,270667,102,89,281959,94640,187319
413dfdd6e1b224113651365a41ed93de,31,26,31775,5630,26145,25,16,15092,6147,8945
89f51612c7179a8ea7e9977147200f2f,202,124,595634,71038,524596,167,124,445665,80633,365032
210dbcad5edfe568d7592d000d3e7c3c,136,100,328073,48883,279190,122,87,283345,44630,238715
f28705398a476be72b502886ebfb2ae6,64,52,97443,52355,45088,95,72,197213,45174,152039
ee3c416f4bf786501cc8f2b58c3bbc0d,97,64,179376,36896,142480,77,67,131071,54264,76807
74d3db4fb75f02026fb817a6d0929aba,9,11,1120,1138,-18,14,9,1566,1108,458
48ebcc5c737ff075c1ded66d0c2c0c7b,56,35,77460,15383,62077,42,32,49270,13352,35918
b7680181223219e35454b54836e728d7,40,24,26760,9927,16833,42,21,37779,10351,27428
019132349aff563f316ddd8c72acce0a,98,74,204690,32427,172263,75,69,115797,43700,72097
cfba16baa8979a4f80c7e1ee2ac75258,160,133,585347,98644,486703,166,136,467215,105645,361570
dc00f90a0df100747e7318c852858968,144,109,476166,74080,402086,190,152,537902,105811,432091
c161322bb243272aa89126628e0aae8d,123,106,334290,64694,269596,168,135,509346,61997,447349
d9a801d2b4a393006633b2ada9266e96,16,14,2480,1486,994,23,12,3069,1100,1969
ea281fb77f82dc8a4e34a69ca56b5de4,25,21,17722,6920,10802,34,26,19813,7269,12544
7e5deff5359252e153003cb1bccc3a11,28,27,21948,9210,12738,27,18,14448,7476,6972
0df2924cabf826fab3b01cc835401491,66,53,87217,30162,57055,63,49,84433,27822,56611
499d546673b68b6a9ac44223701dac29,163,115,463395,100464,362931,172,136,512372,121380,390992
9a7af9890a4b1c4a48e4ae01006ba40b,177,119,941775,154987,786788,195,126,823989,146376,677613
bf1253a2cf93aa9c99ab6bcde807ecc1,119,96,222259,51701,170558,110,89,263361,51313,212048
89ad4abd16fce63aca3d0bd07ba0f3c7,59,50,50091,25878,24213,36,33,64776,18409,46367
f10e0e3683a10ad44e05a25f110c4bae,148,111,406413,94392,312021,163,141,690898,123728,567170
2043222299b70236c08f8a5034d7dacb,123,102,317731,93512,224219,113,85,223613,64061,159552
d8427a4b8210bcd16de69bf14ee81f5f,33,24,33249,5518,27731,31,33,21509,9336,12173
bb56844d5f8fa55ac2bb34b0ada4bf17,54,41,56144,43763,12381,177,127,444117,45436,398681
648f35863b1e7c173066ed4f111e5308,31,26,25814,10772,15042,28,23,22997,8662,14335
50a642e53c4854244c1b9c996140d338,118,76,220496,49374,171122,102,88,173985,69110,104875
c8288b1995b5753b7bae19beb4c01c36,84,65,124947,18053,106894,38,38,37271,26378,10893
1fa44b9eb4bc2469395ef703788977b1,184,121,727774,195853,531921,237,160,705057,159587,545470
f9b4db6fdf16f6962f2c3c54d5bb8fe7,177,136,591728,92833,498895,182,133,519887,80256,439631
ee7b180070c4f41278251a05ecf5ec2f,73,52,101905,25989,75916,56,44,55825,25042,30783
556d4c280a0b76c8700fb1a01c6bab11,130,98,249619,47346,202273,112,94,207352,38674,168678
7472908b83b8fb7abcc33ff509d61096,25,23,19312,5960,13352,32,20,16756,7634,9122
51499173d7a8ff6a2b694af8f84c9d0d,121,96,257831,70466,187365,90,72,170212,67344,102868
0293e5d9bab15eeb4b5bd524a4f9f352,206,140,764940,150999,613941,213,162,951666,171435,780231
f3aa513fcab1a7db8ec70ee8c234fb63,143,97,358486,79127,279359,129,95,319827,66793,253034
cf6909d50c8ceaa65e3eff27b9f7fbe5,57,49,56602,19418,37184,60,32,76329,13522,62807
175988a101ec33668024f083eebdd869,224,136,1052538,250632,801906,218,163,947829,239537,708292
1bd4e0387fd9484a1ce3f767b63afae2,144,124,411725,70635,341090,152,95,317953,67216,250737
2709c3d68d3072abe3dccd44b1bd7c0b,106,84,269038,64838,204200,118,94,278199,42436,235763
83aa3b5bd22850797856b980c8770ad6,74,59,179375,33740,145635,72,63,86368,48315,38053
2bb6bc4745ad0fa7bbb09b13af68b047,55,34,50341,13022,37319,46,30,50450,12003,38447
777c5286a1c01810b66a6e0152b84111,102,86,213741,100079,113662,141,126,364400,100458,263942
ad002f4f202af42a94fcf13c9f59e201,92,63,144763,25438,119325,63,57,103820,39132,64688
d32145ebfcdc0ebc1d7dada4135f6424,35,26,17960,9317,8643,35,27,23649,6670,16979
3dd6fe2e3dc9711a5768eff76e115b81,160,138,420130,94241,325889,99,75,294658,74247,220411
f96dd7d25cab97aba655e355789f5d4f,132,75,183205,21090,162115,77,66,91682,38113,53569
6416a0d23d9edd9720f0fd4884fcd5ba,69,54,71756,32492,39264,57,49,95011,32308,62703
9c49d6b8f04fcafb267d655221b17084,96,80,206065,65036,141029,102,87,255610,57850,197760
4e5f9e1fd4a1655aaa15d9201da4b4ba,145,90,568351,122513,445838,205,133,900838,151772,749066
ec361ddb2e3910cfbf06f72f7e53e34a,25,15,8791,4171,4620,21,21,8074,5227,2847
887f9ff1a5aa5cb38fb4db8a10df6f17,25,15,5266,2076,3190,25,20,4981,2107,2874
ea949986a3617d04c30b2ca0ba3ccd60,78,58,118199,39230,78969,72,61,105766,38839,66927
13e8f95c300c84901a49222785c977ef,77,61,101451,35420,66031,73,61,109686,31589,78097
0e2cf7a4687c3db478ec043e12955e2a,58,47,66615,18689,47926,42,30,42036,20775,21261
b15e6b4676c14ee6b9821c5fba5191f7,123,99,324783,70776,254007,111,90,223565,82987,140578
037d4b18c3e9a3b5179f5aea5b2934da,74,62,135149,33141,102008,73,48,112024,29378,82646
2ee218f07b45d137a6b12fdab7938704,41,27,42546,11436,31110,43,31,49401,9517,39884
25b60e0ca446eefa359a10fb77749ab7,48,35,78296,20751,57545,47,38,48182,23843,24339
8a416b1124ca369f472bae572ef08766,36,27,38388,14121,24267,49,37,53056,11881,41175
209af9b702850ebe326f15f5f08dfd4b,78,65,70943,29811,41132,46,43,101081,20893,80188
c17c6436b1c916031adc7645506b7a36,32,25,30894,9662,21232,34,27,24945,8884,16061
40b05f3342c2ff681c4b8ae9d4bb0aa4,109,87,258329,49824,208505,144,102,309144,53272,255872
bcd391e415d0fae4683fedfb9a701a33,188,139,599480,161904,437576,125,106,424245,122689,301556
91273c8ab13bfc83279c0fe492b12305,73,58,114840,34478,80362,55,40,81401,30386,51015
6f56c6f5d59191ee3d9103bfd3ca7ef3,135,96,265378,47220,218158,131,96,289708,52502,237206
2fc580b273e8b3a08c6959f724bd2540,105,88,255758,40874,214884,120,106,246989,55521,191468
44efe2f9a478cd2580a663e1a521812d,208,129,957890,152951,804939,207,149,908571,132972,775599
d81e0c06e16e3112f60ed191217ce65f,97,92,149706,44147,105559,118,83,168063,42485,125578
5c5458e0b6fb6ddde8bd713a01ffe893,64,59,79423,27048,52375,59,45,73530,13032,60498
b5ee3cecbe9f6d475ea64b174da8f842,48,44,63201,20018,43183,39,26,43634,19164,24470
108a41d660f13acf02c5f5c51dc16a19,109,84,181243,39352,141891,74,64,144694,50050,94644
27804c194e18b808762de48d9628412a,81,66,135698,33258,102440,78,61,178872,38372,140500
cdd1bf0d73bd2506f2f3604d345b11fb,201,111,580844,66841,514003,95,78,276861,119996,156865
3d085dbb32fd63015a0aa3e88d355b28,130,97,279708,72198,207510,133,96,273569,60566,213003
344c1bf9c56922659d4eb04c8ffa47f8,193,156,682794,120739,562055,152,127,542971,132187,410784
3aab40da9fe1a2bfe6202628bc4fd7f6,129,93,344204,80310,263894,89,85,223132,110475,112657
cffde7400c9826d06dbcd29cc4224ece,147,113,294243,92265,201978,112,86,271753,67310,204443
32156cf566b61987a0704e14f49c1bd0,75,56,98337,23298,75039,49,42,75694,24685,51009
df21473a386ffefab990b1fdf4179ab7,74,57,134514,40886,93628,93,72,206134,40707,165427
8778ef8e88a20e80f2c2065b650fc642,57,51,89596,25002,64594,76,56,79229,21961,57268
8e377be613f6ccead7cac1b9ad239034,145,114,311399,69525,241874,133,97,301085,70006,231079
d12c8058194dd313caae1d0e1af37dbc,26,24,19422,8062,11360,25,23,21113,9433,11680
0401ddab36a45a7f698e05f091dadf30,201,133,580056,157962,422094,152,116,477860,150470,327390
5d66ad773e8a5d974de5bd0647452836,48,38,44478,20067,24411,63,52,85711,20396,65315
c00590696bf925b5a28a1028529752b4,52,39,76608,17128,59480,37,32,34360,18917,15443
93232094ab0b8d6b065bd4b9e5de0dab,77,71,114873,28743,86130,73,56,81671,32988,48683
898e605c9fe05e5aaca3120737a18701,50,37,58556,10587,47969,47,40,67305,14466,52839
9b31b70c17ad3722b1fdea8c0d872722,151,116,426051,115088,310963,136,112,412683,116667,296016
9194c2e1ea71b304ed46dfa1e8283e4a,175,128,576334,144078,432256,132,113,460671,130325,330346
ee12cfaa8d1cb391ec84e3656ea04925,154,96,327120,93606,233514,202,144,547564,75171,472393
d87e58dd49cb8dc372dc771e16280e57,115,85,227836,60533,167303,105,75,209344,40207,169137
614a78c549b86b8d4f6f9a1732719b6a,20,17,6345,3252,3093,25,19,8098,3755,4343
259bb0c07af0765c8b3a1e09cce9123d,174,130,440902,129152,311750,135,97,384788,130261,254527
eee834d5bc225cba3ea9ddbac747a352,46,39,72091,19654,52437,51,44,66589,18019,48570
633ef81ec5f7b5a4326dfd8a6eaa21f9,64,56,90066,27706,62360,60,38,76468,21320,55148
1ae1c0359ad0dfcdd9c8eaa4d6e1e484,60,43,54616,21537,33079,57,48,65331,16776,48555
a88557b8a21410d23e4267045d4e3d70,84,74,140243,59879,80364,115,89,230125,37716,192409
03863d0b2c9312413db8ddce0d6cb479,169,102,434375,86772,347603,174,106,503535,86193,417342
c041ea194c32d177e1fba6ad2a517ae1,93,69,172608,34325,138283,112,90,218103,55407,162696
c8cc10d99976aa36a36ebdb0b86c49cb,42,35,28438,10742,17696,23,18,16068,4647,11421
9f0d56efcd885706f4554116c2db53c3,108,80,188154,36928,151226,108,94,227118,37319,189799
fac02004a55bb7a0753cb6a53a983f5a,77,54,156267,47569,108698,99,79,220660,58542,162118
9153076113a55701e42cc0bbab0ae6a2,102,91,184017,54307,129710,121,97,213753,43687,170066
02fb48dda461c05250dd2a5d27585526,35,24,28414,10134,18280,41,29,34281,13104,21177
4882ee03c955c8ace206ff2692b3d2bf,33,28,25211,8146,17065,47,38,43339,9656,33683
c52b63ee76aa2b088937860e31bbf4ed,139,98,370057,107273,262784,156,126,341571,105930,235641
c3ac0a8b0d2d0967425d8a245d953b73,30,27,14272,6775,7497,33,29,14051,8388,5663
2841cda1d5e1f1651636880d1d7e25e2,119,101,347651,58318,289333,94,83,200294,49920,150374
e86592c48b337594151537908e819cbf,29,22,15120,5272,9848,21,23,11839,7186,4653
58e1c42b7f855c07a59d36fff5e8b39b,35,20,20477,7521,12956,33,25,24430,10105,14325
e17584f331b8a82ac10979779d5a8836,123,90,320202,58758,261444,107,85,271727,70264,201463
eb32812a7d01af034460d8234386bf9f,27,21,13457,4986,8471,30,21,9140,6426,2714
1a78c253e1f52d6fb4b5730171dafdc5,158,123,438443,122785,315658,147,119,518257,89650,428607
8ebd3511a02a8a0189e50b891e9a8dde,36,23,35823,13162,22661,36,28,27862,13174,14688
b6a4201eb591007e4cd279de2bdbef3d,64,53,98653,41153,57500,100,71,136972,45747,91225
2899cb5231f8a2f57779d14f0c9a2b34,111,82,155469,32928,122541,110,82,162885,34044,128841
1d0aacf778131ae22605819af286d99a,31,24,11475,6767,4708,30,20,13979,5323,8656
81618d5ad8f6973a32674a1cddc1db62,60,58,139980,46454,93526,94,73,157807,38169,119638
882d6dd16ed504c5c878a662bd19dbd8,195,134,442422,83109,359313,148,116,414419,120984,293435
97c993bbb6b8ef77b01219d778086438,133,111,420207,117185,303022,208,136,747001,116381,630620
6c3c1c849d1d9c3f4e5fad4fb77d26cc,47,47,55471,17736,37735,41,34,42232,16232,26000
6659d84f0ad5ab1421aabd9d16d193e2,57,41,65099,22977,42122,52,41,66863,33851,33012
dfcc9b02516d3eab58993ed4cda9b0fe,67,49,99215,27856,71359,115,67,150801,27380,123421
6a67b5d81ae7bcfba0ef9400543fbd63,123,105,315711,70197,245514,137,95,265727,73491,192236
58a433be8b303b335e45393b0f0022d2,88,77,205978,71955,134023,130,86,311679,51600,260079
132841e552aa41142577591a8fccedc0,57,47,66506,24598,41908,57,41,79829,16526,63303
d9e5eb8aa0fca579c128e96522ef01e4,43,34,41697,14605,27092,41,33,46789,15912,30877
0fad15c715b1d679fb55eb6bf52db64d,160,118,544437,125183,419254,218,147,715837,110147,605690
093e7ee3cd9a0e4fd1c8ee755be9ebe7,53,41,59465,23311,36154,48,39,69529,24602,44927
5d08494e50e12a796cc7e781567051f2,66,55,108083,24165,83918,81,55,101865,30092,71773
6db88546fa59f443502c39dfbcc0dbf6,135,109,359944,94108,265836,154,112,365411,78285,287126
0c35cf9f60c916b045fa2d1587bccefb,66,55,210659,80969,129690,136,117,436072,75373,360699
75537cad063d8fc4df2a82885dcfa678,29,19,19129,12042,7087,32,25,37719,11436,26283
28e158cdeccda7883fff23699ebb2d12,115,86,300925,79771,221154,165,129,621188,68112,553076
d0f729c576bdb8530e223287dbcd083a,84,58,131640,33374,98266,73,59,89635,39709,49926
11ea28d0d20819f31f44cb2979c7e0f6,85,71,132768,45027,87741,93,69,158239,49968,108271
7bd8db81a8a7217e3f5fd3bedb9325e8,58,36,95379,28524,66855,46,32,55823,33220,22603
23f3c945f9f7d11404f86e32df030e93,136,74,244490,67155,177335,103,78,206014,71816,134198
76c7e18f3f459d857940673333577ad5,27,17,12427,2798,9629,28,18,14287,4077,10210
4546a962113c31e2b2930fb8bab59793,68,45,73943,19639,54304,46,39,41149,10669,30480
9c511f5ed0424ca103cce2922cd93ee6,184,138,548468,96421,452047,136,114,383685,123346,260339
96513e957cffc2bbffb6f8992a84f2c2,182,123,505964,101428,404536,138,119,396319,109147,287172
c9a883931420eae239042173b8dd7f87,151,101,336856,84546,252310,161,128,512265,107542,404723
a29b6a7663fe8b4f2ceae19da32c798b,94,76,321266,127495,193771,192,146,558561,159573,398988
931343eb5a48df7550562dff52b33149,101,74,139495,30215,109280,98,85,158274,36007,122267
592e6170f56d1c10c00643dbaf43381d,32,23,12120,4946,7174,30,16,15470,2535,12935
6a4e670e0d0e15fd25651123eb8eec0b,41,36,33071,10832,22239,39,30,26839,13312,13527
60023cd6b9234c64059854cc104d265f,94,71,154604,58421,96183,106,77,208432,53711,154721
299c4d3395db4b2d2f2c5dfafcc437e8,57,42,75047,19968,55079,57,52,57946,20707,37239
c26a64e2774032879fc2e97443a52601,41,32,38282,15746,22536,43,33,48850,14095,34755
adf7445f674a878c56578e05dec72e21,4,4,575,278,297,3,1,464,370,94
b88ee23d68163b493d6e6bbd24f5d010,177,152,602888,138008,464880,186,136,728639,73665,654974
2233b6462d9eb588eb2270b851a8bd5e,51,37,55917,13936,41981,48,35,50313,15071,35242
80e016664509e4364d576a0b824faca0,113,80,251192,69555,181637,126,105,246445,72813,173632
ba005f08d253cb97d77fbf7a4442f511,88,57,116465,26002,90463,85,69,95957,27597,68360
e74dc04fb16f4c94130c77bd9174a600,30,25,23099,8211,14888,29,28,17959,9228,8731
dd665acf15eda5ff342dfeddf73246eb,80,65,121548,28631,92917,70,69,73178,34049,39129
ac87cc6e138a3f568c2be9ac39018311,62,52,110689,27394,83295,71,58,96019,28841,67178
ef962363a86fe2404e20a6136700f0a6,122,73,307816,92067,215749,137,122,449918,132193,317725
da273a86dc68c7c359cc8243e7f813ec,131,99,385975,81843,304132,139,111,329967,75952,254015
e0e256fb52e278ee2729d8ac794748fa,91,68,125943,34101,91842,67,66,140938,33234,107704
826e9f43ee2025f3f18c92520dfda9dc,170,132,513356,107931,405425,167,114,573518,105256,468262
bcdfb78ecbf207de358a8d7ba57ccc7d,75,60,90942,25399,65543,82,61,93851,27166,66685
7d82303973eaf50f43953933b2ae57d8,48,40,77970,18416,59554,43,30,45791,12307,33484
0b75272205c5948164816fe193d05a3d,113,83,200998,44945,156053,106,87,167347,49088,118259
542a56bbc67fe0527234931cc64df71b,104,71,220609,75190,145419,105,72,170160,58876,111284
82ec91de88230814c3339c0d2ff7c228,68,54,112998,32052,80946,73,63,100502,37976,62526
39250b66a1780887e6f61279a9019d7c,155,138,433489,121549,311940,111,97,413228,118817,294411
41b72f91e469bb2247b478e8129f0160,25,21,9335,4306,5029,22,18,9401,3936,5465
ad2bc1be6167d38bc8eff38b86c143aa,28,26,12591,6833,5758,32,21,18382,4682,13700
f83f98ce5e4e7c6184dba68b81725748,79,61,101497,35768,65729,49,43,86495,30645,55850
1b6009c78aad2031d5b7e7724f61d8d1,42,36,38340,20128,18212,38,30,45959,17788,28171
ea75ec55ebb8c1a9e5cdf3ee0f3f000b,10,3,1507,140,1367,8,4,542,266,276
e112fd653c9efcafc4e3cedf04b96e85,99,81,189350,55943,133407,115,97,248089,64071,184018
21fcbcf59468e6096b1e89b1adc7daf4,76,59,156240,33245,122995,61,46,135412,29727,105685
4051f0aa23df03d8c9130b0679d0d3ce,79,60,147081,40382,106699,66,53,95086,40623,54463
cd6d2c4aaf2877635c20205de0b9d227,61,47,75164,25995,49169,52,37,67400,26305,41095
3416303dca7d94e3cd13e930c2a6111b,80,58,123100,33162,89938,87,63,88196,41702,46494
d55a008396f892119c507a88b4164418,20,16,3668,1724,1944,23,17,4890,1874,3016
e156d56aaf7dd26d3295698dd78e02d6,55,43,104407,34223,70184,66,54,91366,35187,56179
2f456ed617ddc69810b2ec4a562ec4e5,50,34,84017,25950,58067,43,35,91345,26300,65045
02a0ec598196e740497c105459f6ff83,136,102,311688,71419,240269,115,90,300793,84352,216441
cc86d44ebfe3225fddcbdd4a38356126,65,62,90544,27539,63005,59,50,97240,23491,73749
89cf8c52f86f7a7b71a4c0525bc3befb,185,152,486937,125948,360989,133,94,365273,73174,292099
b1550908c012f69123a958a2855efbc3,133,79,206380,68025,138355,130,97,308272,66883,241389
15fef34a46cab0466b5ce8ac4302919d,25,20,11168,3836,7332,18,19,8415,4791,3624
5f0e57db09716b882a6e377f5f871b21,137,105,268112,26621,241491,124,86,246528,35577,210951
a58ab35e00e3f6343d3e6eb0046ccb5e,41,38,32479,11496,20983,38,25,28780,10771,18009
d37c67b07b9cf218bddb48c976ed5f9f,8,6,786,265,521,9,3,687,372,315
ee3cf503c0a87f6e49bd8c6456e1948a,172,117,790778,141433,649345,197,133,730924,189808,541116
300d6e64ee067b0d825f0897619b3346,46,32,27246,10894,16352,38,29,26557,8681,17876
9e151f8b4215163e4315a5159441a541,181,139,522233,97760,424473,126,90,388930,72330,316600
9acb516b10095922837d11dbb1a36386,120,101,358247,86501,271746,149,101,322560,80427,242133
61967d8519c50fcf71910a895eee0628,45,34,37488,11065,26423,36,27,31233,10643,20590
e0aece39bf32a9a3952b6be1d3d37918,119,95,250850,46447,204403,119,115,210920,54228,156692
a17da69ed72f58f92dcf485ef418ccb0,49,39,35856,17637,18219,46,38,45234,17190,28044
0735363b2fc1d918f051ae2fb4d6f232,38,26,40579,14298,26281,43,35,45238,16706,28532
6e2e7b8b957b491ec76df2f4247d8f99,33,28,21775,6180,15595,34,31,16254,6677,9577
2dbac17b8fc56f2d7fd79446559aec54,139,104,389512,97095,292417,159,103,389540,77029,312511
38dd1cba410ed03767af9e50195ce149,86,73,157281,44748,112533,74,66,143727,25637,118090
614f851ed9a39a96215575e9cc9e9915,83,52,209535,84984,124551,169,130,420102,98407,321695
09868020576d2cd10cf9fa918f01c9c9,63,50,118767,21756,97011,57,42,50988,20092,30896
2f82c47d9dfd97b743269041b937bdb3,120,89,285138,49904,235234,119,90,229781,47790,181991
a13e1a1d7e3e5074fd017fd9e04406ff,168,122,629675,107715,521960,198,130,518038,159554,358484
fc014655c970346a43b0ff827329f3f7,194,148,804858,152261,652597,173,137,540666,117443,423223
9db4aaf797268d2267fec072ccbe8eb1,123,85,284686,59963,224723,105,92,255715,56128,199587
84e2388b752c572c8ae473a3628aac79,18,17,9571,2337,7234,14,13,5660,2600,3060
45215b120b1195b01398ab1dbc3e550b,153,100,442904,89525,353379,174,141,592698,97837,494861
688b0c93daff09f4a1e6bd1d211acd62,96,66,184598,74197,110401,123,79,265912,78246,187666
d23e93959f51ecdc3e5b1eeeacbfc515,158,110,416463,101030,315433,115,76,351981,82694,269287
fcbf19cbe404646796da6d7147a96997,70,56,118736,26709,92027,47,41,65369,21028,44341
e171387799eab94dce85c82022e06ae3,150,121,397486,93033,304453,167,131,386429,82194,304235
889a8f81182aa5aadf8487f57fa2de42,48,39,80028,28631,51397,46,36,75398,20284,55114
7a053caee38c11252dc01d0f9bb8c971,133,110,269296,94565,174731,142,117,326061,57502,268559
5b58587aaa515031ae652a139a3c7de8,148,113,387793,69778,318015,164,128,360589,111308,249281
7507bae8e65b9e1eb416ac3bc93e73da,122,103,325318,73112,252206,71,55,173793,64024,109769
5c6da070030506cecf231593a0309921,122,97,322644,84899,237745,132,112,392666,81175,311491
54c591647054360df1e18bc2e0d83562,165,131,424301,114050,310251,151,125,465869,113304,352565
4a2a559e1ef990011b3dceb298a138bc,63,47,104937,24485,80452,74,55,98080,27988,70092
97512dc47f1869e2a695455d32480cd2,115,85,214188,37635,176553,69,56,102442,32763,69679
f4888317c29accce358b32e53f46bf73,75,66,127746,37188,90558,61,46,103037,33706,69331
d8ed7ad38c6c452a712479b85e8ca546,150,104,296653,45847,250806,142,78,220699,65810,154889
ab5d32d61060bb9c7515a19b93c32520,77,58,139195,43007,96188,72,60,148505,37331,111174
9a0a786894ff4ca681b8118fc8e368e2,17,12,1762,1479,283,11,12,1691,1190,501
5895ad665ac2432dcaaf394c2c24a05c,58,46,116265,32818,83447,73,54,109184,25625,83559
8c9d8e2c53a85b8bb09ae33639519ef5,68,61,101847,33506,68341,81,58,88723,38555,50168
523a85b950e9281e247a9473fe412fb2,43,33,45861,15160,30701,60,41,54188,15980,38208
5bbbebee7b0e62b5be3a3894b7c0fc2c,194,122,717577,149327,568250,160,106,700150,133974,566176
d1020f307aa4de59fa1ebbf490cc2773,2,5,111,427,-316,5,2,427,111,316
bfee43411fee90490dc3842a0c09ecd7,126,80,243209,39013,204196,126,95,247797,46968,200829
a236f8635f084e4db53b8b62ad620225,95,77,185354,35764,149590,78,58,125572,32859,92713
ceea8489a9385044534c71b7c5b67280,57,41,53637,16000,37637,67,42,53797,14585,39212
45327d8b03f48b032a3c0286de0e9bf6,38,33,47792,19429,28363,32,30,56627,22804,33823
7a724d4579aa53819c828cbf00e2636f,45,40,63154,22033,41121,56,45,76862,23393,53469
468fd4727630b32480e38a4c82fc43ed,49,33,77189,15674,61515,53,38,72678,19357,53321
7083721e265e4deee50a1c5e75f8fc3a,251,156,1254683,215758,1038925,197,130,1467460,152666,1314794
6d44d1000e5c19beea387de79c37ca28,49,37,50867,14767,36100,44,35,45438,15983,29455
8981f98e3c4971b6081be3ed2267dcc3,78,59,140589,32343,108246,71,56,149045,19789,129256
e27df4c5ab40cc800db3fe8606ba5af3,75,57,106606,23980,82626,66,58,92554,35086,57468
0556e1c5391ee0cda8c8f7e7ef44d0f2,53,49,70750,18419,52331,42,27,46565,8976,37589
419a10f3ceaf112ecc56095be3a8921b,59,47,49113,21110,28003,72,53,70132,25586,44546
01002f01955d9066010f92d5dc8902a2,64,41,65101,11939,53162,44,38,45355,16318,29037
fb1b37f7846adab1eaa23ac1864b842a,64,46,145085,36853,108232,97,89,183792,31447,152345
09833c651cfc1a5b064370f7cbcd9164,117,79,305590,69166,236424,184,148,549574,119255,430319
bba035916af7bdb980ea07d7ef827229,26,21,8821,4105,4716,22,17,8297,4203,4094
555e3a71fb2b8b378dd22b5bacb72d3b,67,54,97331,29538,67793,42,37,44630,28374,16256
f006d57d1ea096ce8c89a3e213e9a2d3,68,54,110157,42375,67782,82,71,195578,47172,148406
f74ee8af0ad7dacbe551a7b3be47bbd4,71,57,95485,20318,75167,56,47,58335,26156,32179
ea32121bb89ca9fab23ed45abf6c9780,241,140,866913,159444,707469,264,164,1276103,154688,1121415
751a12df660c544b56a06642a567eeec,50,46,73627,22020,51607,75,49,84536,28992,55544
94f3197044e3e32c593762122ae97b1e,15,13,2045,1630,415,16,12,3294,835,2459
9680fccb8187038e834fc567a8b5e57e,133,111,387375,101182,286193,165,137,492142,118844,373298
a071ebf3eef1eb38bba2a53ac538afb4,106,77,214162,41825,172337,95,74,144933,39316,105617
7ce8f895d55e0cdd6ecbbffdd27e2d4b,14,8,3272,778,2494,17,13,2909,702,2207
5e1216a35150d6792a02eb3388a1e3ae,34,24,44968,13537,31431,39,31,55070,17097,37973
ea31a44279cdaf610b9f78728c75bc8e,54,38,92357,20222,72135,74,61,117141,34035,83106
a4c1fa00c16169c2186bbdf93200cb2b,106,83,214917,63407,151510,99,77,200885,41577,159308
637577de431d8a810c0d38c6acfe6409,36,30,23870,12458,11412,28,28,27368,9735,17633
2cdb98c1d152d0f469ea7fc16c36b790,123,101,225902,70011,155891,136,101,325063,56915,268148
ce2ac29269dd1d31b8fb455be833443a,148,97,319059,41113,277946,129,114,248398,59165,189233
9d9656b84cdfa9de1a5df365ba7aadc7,97,83,259130,104089,155041,128,91,342826,76016,266810
6468356749cc6317402325426d7772a6,38,25,33863,10003,23860,28,26,39974,9440,30534
298585cc3231ecd462b4e027769db827,114,93,286864,50620,236244,107,93,229284,86252,143032
26648aabc546c6ec1413a604010e61d8,34,21,31844,4332,27512,39,25,30170,5619,24551
f92bac256ae3b26ab9eef7116343b434,87,77,257254,86955,170299,97,69,245528,71152,174376
99a1dfd50f7c543828b0604b2d0451f7,97,84,153765,38312,115453,92,71,114488,29720,84768
f5295a15de61b053408d559cb8ebcb6a,96,80,148907,43242,105665,66,57,142050,38030,104020
f054ae0e700bf7b7d65c2789679445e3,30,25,26711,8106,18605,31,23,17345,8299,9046
b6c2f94cf884af66dd6112422f7dc2ec,79,47,92422,18946,73476,106,100,145758,32705,113053
f3a888ace969a2a383215f70769718b4,165,121,506559,83779,422780,119,93,278441,79159,199282
0703c20b36a7fae8d353463a47aaf4f4,29,22,19582,5635,13947,35,30,24283,7908,16375
c6cf398f731431e65db2d6c4c8b15bb1,120,107,435600,144990,290610,191,147,596929,100620,496309
c836f3cf71079c1fd2f65c416101f6cc,21,17,6102,1529,4573,19,14,6738,2454,4284
8cf74ca7fc05185498d4d6623a43ad58,33,27,27718,9950,17768,28,22,20341,9539,10802
f16d7a8c4d30af56d11534873b4fde07,173,130,621935,179169,442766,140,121,746356,185651,560705
9ddf112e3dee6b92633d2c49bd241055,111,65,233084,78243,154841,126,97,309720,100490,209230
f42c904c8084137b654f83e2e43f2fc9,27,22,14505,9168,5337,30,30,25049,3991,21058
5077ba49c76e5bce00c02550aaffe127,36,25,25367,7813,17554,53,24,44924,6436,38488
bbbaf27a29da88ae7a00963d7870b250,24,17,5373,2435,2938,23,16,5959,2447,3512
053ba5a8ce0edf2f2f970a1274a1e872,93,70,192030,48839,143191,89,61,171174,54678,116496
a85c4c2a13cc59f786b6aaf6ec3c4c63,126,88,321745,45807,275938,130,100,302407,66914,235493
8eb52bc89c42606b9eff81fd34a0580a,66,39,111328,23575,87753,42,33,66988,36101,30887
4a937fd20e2b147ad7532c0a9ce420a6,93,53,119786,16950,102836,86,84,96809,37581,59228
8a2399daffdc44ba178b2b8507c02713,90,70,230107,62394,167713,163,132,407369,83094,324275
bbd29033ffaafeba0c0a2685dc19c2f0,153,90,360660,92623,268037,111,90,235637,106721,128916
4b46a25a43c2ba0b845d40731cffd51d,29,26,35856,7891,27965,39,35,33935,11937,21998
ad3dfaa0b438f885966e586792e46677,136,100,371528,118900,252628,128,86,314894,115571,199323
67fe461efc16f7c45447b7504e46a601,33,25,46704,18551,28153,43,33,60606,23436,37170
deb062aa812ed125384211d318d0f3b3,73,54,155349,51556,103793,97,75,189445,52537,136908
0933b0d1de6a4f5ff954dbdaf7554841,113,97,197207,45174,152033,127,97,240597,56145,184452
a55ce6ff16258ed61fabbb77133cdfbe,132,95,372895,63757,309138,147,97,296583,46338,250245
d53758769cfae14cacf13f0dc19f58f1,66,53,86851,23056,63795,72,53,80950,21523,59427
1041dbd65404da56a9e2ad614d1ccb67,34,30,25581,9564,16017,40,35,23183,9978,13205
8ad4d61375b4801f7dd528d724bc2f68,35,28,29663,12656,17007,57,48,61647,15551,46096
fe08a961cdfc03268598bbca4c29b981,54,34,59580,18672,40908,45,36,38486,21516,16970
9e1aa9bf32b2e185170e3ec5aaea7595,82,70,149532,30641,118891,81,64,96463,38714,57749
c71329248c3c1bda79c185ab9041f526,180,135,660598,154787,505811,209,149,864051,142208,721843
b5e0fdeb7029e40d443a237bd3b4f28f,82,77,136810,59058,77752,145,105,278243,53820,224423
7d7d1da4c1b40c8f942a45bc0d211009,82,61,141330,48106,93224,63,54,129288,44517,84771
f8515d95642d4be624de5404a4426ed0,52,41,66066,19071,46995,51,44,50766,24777,25989
e82a467856dd284b9323897a46fbaba2,41,32,31664,10853,20811,36,37,31053,13375,17678
a7a5ab0f85e32b9d91492598e1e395a1,49,43,98387,26289,72098,78,58,140810,32785,108025
b3835ee71ec92d7d1a5510a070e70b74,140,98,322697,84761,237936,120,104,326019,86024,239995
3ce1918ff81f9a388536239b03e1bae1,40,29,49809,15313,34496,29,26,23700,16998,6702
d566af81a1417ec3a739f39ccda068a3,185,129,785307,113150,672157,155,89,490909,152181,338728
7773bf0d6a729133b0dbd930ea8002c0,105,88,251750,45349,206401,87,69,174189,28320,145869
acc0d467ae97d3538fc32564b0a3f4ff,99,67,138309,44106,94203,99,52,177492,32890,144602
bb81d8231c5dbcf2291597c50fed9dba,117,115,358259,94713,263546,95,84,396751,94411,302340
187db5623cc9c657f477b244468546c5,44,42,60504,14352,46152,41,29,35637,14965,20672
e0320a5494d1ba79dff23b0b1c503eb0,78,61,93721,26416,67305,70,60,95886,29044,66842
b04c240eb5e91c69630764bb4ca79770,10,11,1262,501,761,12,7,1611,395,1216
8e973c5a13bd1388d1fac0d122693f1f,20,14,6148,1367,4781,20,17,6847,2444,4403
e5d1616add8b86fcbfc1bdebe56b465d,154,130,483843,81311,402532,135,114,356222,77959,278263
b084aa415127b25a8b5f555abbd6e0e5,63,57,102210,42779,59431,81,58,154419,33014,121405
b65f934378dbd76c4b946ae69e8bdd62,130,100,268953,47359,221594,100,86,169004,69315,99689
239c7fdc39218d525839294a8fb3e92d,189,141,940010,160290,779720,197,144,789009,158145,630864
017bbc9c8e4673efbebdbe485e57ed8a,68,47,126114,42042,84072,64,43,120218,29227,90991
b6f6929edaf9497c440f401f538f13d2,162,92,471709,71100,400609,151,111,366649,113187,253462
6757c53de80bb22478b8a085d10ff62d,30,21,10402,3711,6691,24,16,10953,2989,7964
4f599df96c8664d57c79dbac2625e3b3,70,64,120546,35324,85222,61,49,104416,32717,71699
993005f645a4e26f68f73db24efa4047,9,5,1212,528,684,4,8,378,1062,-684
e04f644bde60b91f5cfa5d5d38ffc087,82,69,212226,55920,156306,100,75,221901,67631,154270
2fadfb33b973d55a395c25fd517230b9,73,66,107546,23036,84510,62,46,83056,26705,56351
429ceee70d7bc7634b78dd5d5678f255,104,80,210600,41920,168680,87,58,136910,49001,87909
f23f096cd54986088472e79cc6d996b5,181,135,488849,116161,372688,164,112,582701,102972,479729
85d0398e563f6671f1354e26494f386e,57,38,63706,20718,42988,51,32,91122,19625,71497
e63478b1a4f5c414578051116a7e1cb3,92,69,259467,53587,205880,197,138,535851,68586,467265
1ed4c8ba2a9aef210db78b8f73fe5b95,86,75,100316,35445,64871,84,53,111083,34037,77046
b28562bf4f6a2c7c6b92fb8736995ee5,132,94,294296,83886,210410,102,83,239878,90275,149603
5080fcfad782644dcde82a911f1e00f7,94,74,147769,30364,117405,90,75,166655,29529,137126
0437255662905e67511e2b806d6041f1,81,53,117112,28424,88688,80,64,105929,37914,68015
c33f0795310807f0e0c5b14ae5880f13,34,32,27164,12489,14675,37,30,53565,12451,41114
4cf7cd92ee03856b40e62f7769a061ef,158,133,582552,79219,503333,145,116,525607,98404,427203
8bc75cc40f41662a349155a4ffc83893,63,51,59838,19586,40252,91,62,99740,18359,81381
5b694598f5c9640ef0b3a713155da31c,117,78,134691,28238,106453,86,70,194832,35965,158867
c5b85e0d0b43e579837991bbcd88bb7c,51,46,79061,41174,37887,65,45,110062,33109,76953
e29ef76bc0b1a7f21f5721cdd8491140,70,54,172639,32634,140005,88,50,140784,43553,97231
b6996d14303176bc55bfdb93b78538ca,125,89,243099,51384,191715,143,99,288881,61362,227519
e9fc198d1ae64d106c6c5eac5d55636f,24,20,13484,5026,8458,25,19,11174,6204,4970
a2665e70847f4d93e16cff24eb63d185,20,16,4320,1658,2662,18,11,3049,2806,243
8e8b22ca413f2c067d9c2c3b2655c270,94,74,148437,52416,96021,96,67,158068,45277,112791
84d3c57dec04e0b7ebb3c37552cc20c6,111,80,218607,41597,177010,93,79,153248,59074,94174
ccbe90fef206041288801a2bff9f72c4,154,123,453172,82705,370467,171,127,487333,71951,415382
d26b4b452d28e2ecc6ca9bd018aa7c28,67,48,112202,26617,85585,76,65,105924,31383,74541
2533e2e925b1ba2a144fc2395d25aaf3,40,27,33937,12646,21291,38,30,30334,14417,15917
ff018026688e22e66c185a17e54e1e2f,31,24,18475,6154,12321,21,21,8265,6099,2166
f713610567a94d9fd5e1b57edb103f85,25,17,13895,4397,9498,30,23,18272,4657,13615
35a70adfe3a7d9b5dde9022995bb7940,43,43,52864,14684,38180,41,28,38803,16446,22357
23a113cc2cb6de48edfd56cfde832525,26,18,8764,2994,5770,25,22,8278,3967,4311
e1f64fd3449b30fe3ddf44dfbfd99871,61,51,79110,27689,51421,79,67,74308,28902,45406
9ef5e9cdf21fa275f69090a8fb92b739,131,110,368845,65524,303321,122,80,278804,64071,214733
04d8b324cb3fe9295d804b971c820365,42,33,50464,13933,36531,39,30,30597,23697,6900
48e0926cd417a8dc4ea940b4d15389ba,64,50,103201,33489,69712,75,58,111415,29617,81798
3d6f1af88a2f54859c665fc9ef385222,29,30,19763,7464,12299,28,24,19074,8497,10577
1222674f0a698d95e91a8749db81170f,32,25,24739,11621,13118,33,28,29904,12167,17737
dd196523ca83807f60910b9ce2f2a8e8,35,28,27982,9919,18063,34,26,25914,8824,17090
0fccc97f00f5003d3f5e40cfe33340ae,110,94,278059,49532,228527,89,70,162075,58273,103802
d16259ec6c6fe7d8179bfdb6b957caec,111,77,176293,57846,118447,96,62,226268,46299,179969
ffebc1108c603fa3386081a93ad92d16,30,27,22607,7925,14682,35,29,19104,8393,10711
32e34b00bf10691ab2e519fbde81cb96,22,17,14430,3487,10943,22,19,8340,4114,4226
3b4910f335f2403e8840e2dbed0af8f3,41,25,24318,9156,15162,42,34,47364,10839,36525
ae9295858c21ab544d42064de39dd626,41,33,38600,11291,27309,34,20,20511,8693,11818
44eb4bf7588043e99857a5e6c8e3bd93,160,121,425087,88802,336285,105,78,280591,79723,200868
0181bc47ca20bb25ea64eaae9e30fbe6,38,36,33964,18978,14986,42,29,52786,14216,38570
456ca82dc8c5fb1be1b049c3e0d635e8,56,44,64746,22174,42572,68,63,78386,25132,53254
3130a247511010f0c29ee0eb72c91ada,32,22,19162,6596,12566,33,19,18411,7249,11162
13832251a0efa6cbc43f71c5c72e91eb,126,90,428155,133567,294588,130,107,326239,139409,186830
c5bb10af896eb9f200fde86a58a755da,112,86,222483,33776,188707,89,70,158542,33652,124890
cc337fb853b32028a24046e609ba720b,86,71,155509,33857,121652,96,80,184972,38770,146202
6f50ae9704deec21706ce99cc1a6c30b,155,111,304325,59929,244396,85,59,160578,52205,108373
dd7965627917ae9d9c9dd035b7997f9b,149,117,411417,72647,338770,136,118,351002,106443,244559
155c1bad652e9a11520a4f546f50414c,191,129,817789,206171,611618,206,141,746602,223281,523321
4e2f0ce28bc32132bb148555005ae347,83,61,263176,96172,167004,181,133,498187,101125,397062
002f8edcedcd4d7f37c794c60ef70d6a,105,92,262275,67002,195273,121,96,282337,64866,217471
03b62115113510a291c721652ad43ae2,161,127,617416,150112,467304,130,106,538527,190518,348009
8ee59a6775d007bfd358a22f7ffbcfc0,25,19,7997,4152,3845,21,13,9019,2035,6984
7141af1ed5b46dae6c5944e8c8845a8a,2,2,180,35,145,0,1,0,40,-40
a95d1ed9235947ca4295084595473f2d,36,26,21013,9403,11610,33,27,18274,8053,10221
ff776c8f5bf32aa5da275b6664a723c0,72,53,116186,35609,80577,103,88,165884,28103,137781
68608bc4dc65094241a5a00bc8546353,24,20,7507,4718,2789,19,17,9051,3107,5944
5edeef97eb1ac63adafc23591984cacf,102,75,184942,43028,141914,56,49,89479,46417,43062
54070556696b30cc0d190f4cc1078168,90,68,201501,43179,158322,115,99,238981,63796,175185
ca6571055f60cf4c344903baeb4fa352,46,34,51780,12205,39575,49,39,49233,14744,34489
a8a1e38994256330dfcadbbb01449c58,42,31,26895,9579,17316,27,28,25203,11624,13579
d890fc7f93769e82e58a3723de2572a2,10,6,1511,1009,502,8,9,1198,1368,-170
7cd40476dc8d190eb00500cb25841369,65,53,96625,14307,82318,66,51,85869,18823,67046
20e7ed860644f766a0d7638dd3260bd9,54,44,72459,21405,51054,63,40,69173,14816,54357
dfa184f13bcde58f0a05e2d2fc5f3796,100,83,243063,60253,182810,75,66,158620,70131,88489
4891a063a41edebc4cf4f1e4292618d8,27,25,10494,6773,3721,25,20,16126,5878,10248
1a25f6dbdf8a5463a87aee805561becd,101,74,222075,57046,165029,120,90,226571,64666,161905
596585ed6c4a50efb7217bcfa91a18f0,79,54,106559,35347,71212,70,64,136837,41381,95456
838b7aa744b023ca1b8d4a8137545e65,133,115,407208,110069,297139,157,110,575145,104192,470953
5a8459dc6d11413be9d6a166b15f07a6,160,90,302696,73358,229338,150,101,403217,88324,314893
619b797567a31c124d47b8956abecdca,125,86,341650,101546,240104,198,150,617137,94908,522229
6d855a2b719c289f81e1231b51a8ce6f,63,49,102727,41423,61304,73,71,99664,45650,54014
17e578bd68f8da6471121ca029dc7960,29,21,16488,3060,13428,24,16,7253,4403,2850
a825fd51b03a84e0810e26a72b055538,41,34,27560,8538,19022,30,28,18249,11297,6952
9a14763b703e073094906bbe342fdf81,83,65,109524,27167,82357,73,61,90374,25916,64458
32c430d842d63da664c3958dfb111e82,250,180,1675778,225250,1450528,177,133,1634141,246450,1387691
39eea366d788d1a76ce1512b9af68a68,80,58,129839,30832,99007,71,53,97322,35708,61614
e8cb7b0656b2054ef610830d7144c150,202,146,515586,70670,444916,110,88,293020,95284,197736
a57d68103550c11fb68601a0b14bf38d,107,89,303296,52547,250749,100,82,214356,65519,148837
cb202e8763798967ca8643787009c86e,126,106,403427,125601,277826,187,137,579250,97221,482029
7ed4f3ea74eb501b7b927bc63edd7b45,121,105,306535,85949,220586,113,89,210240,66701,143539
4b32ab8a11e40f5b174092cecf23853f,165,127,567297,165820,401477,198,149,807694,129688,678006
d61e641ee3957ec61dafb5f09846e357,43,33,39470,18493,20977,42,40,54938,14215,40723
415574817746a8576d002558cec848b1,67,57,110718,37029,73689,83,67,146302,32306,113996
73722ec54365c0a2cdb2fa88013da8c2,203,132,759011,179705,579306,217,151,1113907,219494,894413
dd7e650ff7f9a24942d64cff02dbcb56,157,119,486287,98709,387578,157,109,399284,110125,289159
9937fbaba7ca323bea299ba04ed5633a,183,137,520100,56853,463247,148,120,440941,52187,388754
4782c71b52669d822f3ec873872fd5c4,198,129,823628,164343,659285,172,138,593276,184829,408447
ef0e4e96f2905895f33e943945fa9bd5,29,20,13409,6770,6639,26,28,22225,4912,17313
f7d39e804ca93f2557d80384b0a6510f,162,116,501727,81808,419919,150,95,348239,70823,277416
46153fcd724ab6f0a2058f394eed0d7c,189,140,573400,82038,491362,174,142,609272,89001,520271
5de41da56e3dcfebed302b9529e53e12,29,22,10061,5245,4816,27,25,10187,6152,4035
f491d00db759a101628b2bd0e20a5139,27,23,26330,8185,18145,51,39,38063,12603,25460
89a9f20ec1ccc4f5e5bd1be22331e795,81,52,127934,22988,104946,68,50,83815,40989,42826
c917788d866ebc335b3fa40fb7c7d814,83,66,138265,40424,97841,87,62,145314,35089,110225
163e47ec2180521e045aadb3cfa09262,73,48,170532,58374,112158,120,60,194114,69696,124418
c778e6c32416a801e16bdd4eec81721b,167,136,455133,148195,306938,131,101,408791,91776,317015
660361c48f07d51ce462d468ef03173f,97,69,162112,28754,133358,68,56,90377,34052,56325
ffe7c47d3debebe913411ff7e47a8197,106,66,204421,72382,132039,85,62,204522,74525,129997
fe1cd0b31cec2ea5a885bb3ae29447f8,41,42,46714,19665,27049,57,35,52787,21072,31715
6ff3209c9b1881c42f416321a758dfe5,130,87,272227,59045,213182,132,93,253004,61497,191507
84dd86cced2c9999c90035ab6ee78943,169,128,898120,168163,729957,227,162,845837,170734,675103
a8d27eb02eba1ee8ddd9114d0c6235bb,54,42,80575,21108,59467,59,45,97127,24118,73009
e89cfbdd67cdb02e35a5c76f7342928e,72,56,97453,40283,57170,104,95,178701,45046,133655
6186b7484e0dccc3cd525f71dbccc4fd,99,76,197264,60504,136760,146,132,296549,80608,215941
cf943c0ebe574010cf45698861ec59da,152,99,287226,73251,213975,114,94,279981,89243,190738
ca9f83d4e7cca2c4eae01008a1f1bfee,159,110,436855,106557,330298,126,100,523205,113368,409837
dffb7e8803cc3f833bb56ca9399878f8,112,95,199368,46602,152766,114,85,202030,39147,162883
6563c04ef572c2e50993e778cb6501bd,46,44,71853,20638,51215,58,47,68546,24480,44066
1b5e6f9087b08303a52e21eb0e274718,119,101,301314,69495,231819,93,71,201125,49610,151515
9624a6ff747f38b5bf5728f427fbd5d5,44,31,74122,23893,50229,47,35,63012,24252,38760
c1d3bba9f0dcdd9c34a14693ffbf6c73,23,23,6634,4551,2083,28,16,8646,2801,5845
c8ee9e67d03d9dce975fc621ef33560c,132,82,240158,39900,200258,108,65,160295,53028,107267
92e5755b26acd46d570027ca3ebce65f,54,37,60108,17684,42424,45,41,57587,29189,28398
61860294280225708538b07521848fcb,101,76,217091,37188,179903,91,83,158731,34630,124101
b2f699c959b795e370200d8f1684137f,165,145,671420,178773,492647,102,74,465436,77341,388095
c1424fa3ff509239d1f20daba067a25f,112,85,318032,74473,243559,142,111,462913,72871,390042
310938390971487897cd6735afcc888d,147,120,516595,120954,395641,150,116,555725,97665,458060
1195beafecb1bd74b3a24dcaff063b78,168,121,477398,104324,373074,156,96,455616,110529,345087
268311059c3978a07dd834df50f333a1,178,126,477334,123208,354126,173,131,522309,110901,411408
22e4c442daa91d70c462047be30175bc,96,76,201028,34791,166237,60,50,100997,59470,41527
b6c1a93abe01eaa2bcc1ca100e4712ca,156,131,479828,112472,367356,178,127,534532,138109,396423
59cc354b112922e726e3fe4cb0174908,76,41,103481,20664,82817,67,43,69389,23344,46045
b46ed831de54a591299460cb7fba92d9,184,132,410713,68101,342612,124,92,320243,70766,249477
01ffbd3b7f6e33ca232efe5459f02dfb,34,25,18921,7330,11591,33,26,19925,8125,11800
cd5cb0cd8917989ab534e2003e0f3244,98,70,192871,58222,134649,96,82,188920,45614,143306
aee068120df2155d2505da0eb8df530c,77,51,146532,26289,120243,103,87,197981,38650,159331
81f7ce9d61b7f838569b536fe6e1a5d1,163,109,447156,64300,382856,110,91,299362,73096,226266
86e5e33c93cb950e79739e8f843b138d,175,104,404586,67230,337356,160,110,333574,96876,236698
2f22650a73691e2662d6ee6c7996628a,111,81,232243,62067,170176,104,83,289377,68454,220923
1b741dd9765b838a1173ab59ec5051d0,132,101,300158,83362,216796,130,108,398625,84412,314213
a5746708e3763a68a4de6e73926ee7e0,22,15,8275,2375,5900,15,17,3944,3458,486
665c4de253e5f575c835b952ca2aebeb,51,36,52921,23140,29781,50,35,65525,23576,41949
e2110e2a13f44a37252ade94582b0770,115,101,237852,52907,184945,108,72,261918,43736,218182
8f3a48a3c1834df8296ec371db9d5121,27,14,13618,2269,11349,20,16,6062,4778,1284
63df7d6899f03f778fc18ee37debf643,43,33,34259,13239,21020,44,32,34715,8920,25795
2ca736a354e5c6148609f0e7e2035305,208,151,871953,136401,735552,186,109,686154,141308,544846
0644c69b2e48f8586b9f2455e4edf3ea,214,154,1086021,186557,899464,202,137,1261094,169229,1091865
532cbf415cdf4278c61fb961ea52f2bf,85,62,155237,63496,91741,108,95,255025,51277,203748
a66a5b76e375a6d3f340cab2257173af,177,131,894619,186836,707783,190,144,714911,170247,544664
4b6b734a21f0f503fb44dd5c787ed32a,140,99,331482,79598,251884,130,97,314860,83674,231186
516aa25bb03b2c18e9f66cac96854be9,84,64,129261,26650,102611,86,67,112049,44243,67806
3d6b6912407a50c36ee9a7d44750ed8e,82,72,162260,39440,122820,113,81,213129,44771,168358
9cef47ed37cfc73f71b327deec41c508,60,48,65235,18706,46529,53,37,49526,19532,29994
0a146ef889edaaebad62bd5b6523ee70,0,0,0,0,0,0,0,0,0,0
1bb4dc282a00f5b58283cc048333e22c,203,138,1059459,214378,845081,234,187,1544924,343915,1201009
bbc2c4e487bd4ce29f466888b95b8741,66,45,89273,31267,58006,55,46,86800,35745,51055
9a60a24d74cc5315239e9866190e77fd,42,26,21694,5130,16564,35,25,15880,4562,11318
a9566a42e8670d96248fffa6376388b1,56,38,64348,21422,42926,56,43,63622,21899,41723
b6e2d02edcd6eca86b6ce0cddcf25947,19,16,4590,2064,2526,23,15,4231,1657,2574
b483237ae0b3b7259b85ce1ba1739746,167,124,485660,113975,371685,148,106,398222,106903,291319
caac45ccf1c941bd5c657de996d8e5e6,36,28,37326,16428,20898,38,28,33665,15008,18657
7034bceb32ebc72e0d334a4160d25874,161,106,329414,70847,258567,119,101,345578,75186,270392
76ecc6892e9b3b761865c33b9bb1ac23,20,15,3281,1898,1383,16,20,2274,2416,-142
37abfb57695998c0b4155aea56b7c0db,68,43,80842,18370,62472,59,49,75300,26924,48376
3eb2335250b24fa60187a1fe71dc9cc3,86,70,212659,60157,152502,108,72,204612,46634,157978
9a81b743575e2d97a68497364b2b5c2f,207,151,899160,192419,706741,222,130,996998,121554,875444
931d3445e8ea3efd159fad3d5dea9e19,63,42,68770,32599,36171,63,47,95875,29932,65943
35fb86d4e3cf05a6961cbe29485503ba,82,64,150453,54775,95678,71,55,123520,55093,68427
89abf46504dd8c2dbddc1b8ce2352c38,27,25,23128,9799,13329,25,23,16034,8105,7929
f15c632a12cf782b6bb9425ebf1f9696,23,19,13233,8081,5152,30,20,26759,6020,20739
08604071a7786581c623d0e5b6465c22,57,49,73579,35849,37730,65,53,114906,39571,75335
026817b1353de5cbb2f0e7aae0f6f14b,2,3,383,318,65,3,4,318,465,-147
fcfc70788bcfe08c23f9c46a89ac43aa,104,84,237396,37596,199800,115,103,180644,59621,121023
62b426ce34a3fb77d100642731cbeb47,122,94,248995,54568,194427,139,86,239694,64095,175599
3fcae08622ad349cc35cb2f86c0f1084,53,34,50148,15514,34634,42,34,49227,20194,29033
cc79eac2bf12fc9392ffe14daad3691e,29,20,40704,10463,30241,25,26,31646,19212,12434
c14d01dcba64d2d1a3cccb75f8c29afd,156,112,660857,113148,547709,184,142,672963,111660,561303
08e5db4cac0f0f168797f5962b3c9739,148,121,426484,115842,310642,194,117,529949,74924,455025
6668e93c259c22280ba34af7d96c5c80,124,102,260164,53017,207147,143,125,319184,65456,253728
2eb59243c57a71561fe4dfaca517134f,79,58,85472,41905,43567,82,64,139056,34771,104285
80c9ca9dba53bf1075138d8588615cc9,71,60,119393,30383,89010,73,56,104708,41740,62968
e0c9dc5b3337b9fcf79399ee86738807,94,80,162634,45282,117352,108,82,167587,45674,121913
0373f7db137004a862890b25b12d6a9b,136,119,391530,78156,313374,90,82,230338,55929,174409
1ca526cd4d118997b686ed9ae40c9e24,155,119,477578,121895,355683,172,136,577632,118733,458899
7a3b57891fff1789b63ddcecf9ce8274,100,81,211920,74061,137859,133,95,319747,53303,266444
5f72e1106be6808b60ae77fa4db40550,129,89,271530,60376,211154,111,92,225433,73121,152312
163b424e76f92ba751115a717cb422ba,136,97,386328,130139,256189,149,116,496706,113849,382857
de0c9497547eab9705a62ba3c48ec234,62,57,67546,26563,40983,41,35,65032,14325,50707
a0ad7436b825529012fe0b9f57e96721,76,62,104529,26856,77673,75,71,99990,26382,73608
1801fa71983a9aff5a8f477983871541,183,103,445127,72714,372413,141,110,387318,77953,309365
8f6265c7f485c851adaf73bb77247275,166,125,418897,84964,333933,156,119,423595,89528,334067
a63a3fc9f3605ab998019f40d2f94fcf,122,97,222947,49118,173829,102,82,175866,36140,139726
95d356dbe6323451f116b6a34a9cc216,99,62,201793,49245,152548,93,63,206403,53699,152704
bd07c27f5c93c985cdb19d03ad427aa8,137,100,470633,92057,378576,166,121,543002,129894,413108
9ca25a68b58b3e84c13bbdfb4c65bd9c,117,87,327762,59251,268511,175,142,553450,89730,463720
5cf72249c58c5b5f8e28cfe718e5e0a4,74,60,121419,60910,60509,102,86,188790,58069,130721
39ae11ce8cfef6e2b88d994129f9a040,116,103,289877,81153,208724,177,125,447491,54630,392861
39c427d935c42488aea15ec738ecbcd8,67,56,106192,48103,58089,81,61,138743,30823,107920
1b342ec77bdb25b113c8d6018b5cc7b4,61,36,46061,15896,30165,50,45,32804,13236,19568
6777b4d22e60006ff292e430f5adbf55,142,107,289340,72959,216381,176,130,480282,60642,419640
40a661c123db0507a61cf86376b83bfd,131,103,307461,78604,228857,145,109,369443,56658,312785
a4d5221b60692027d6e4eb707145b8c2,86,52,151183,31916,119267,95,61,179593,41129,138464
d33396ede065da926fb35f8d5884528d,167,130,486272,103493,382779,138,118,395201,130406,264795
35cbbfb608dd7319c785d6a47d79c8b1,104,83,200284,62737,137547,114,61,160423,56612,103811
7d25a46729417cbac4243ddd54fb3ef5,21,15,9289,2621,6668,22,15,6963,3501,3462
935798b1080b8375f81f94a134194679,82,65,172026,31683,140343,63,44,97406,29474,67932
f36d0572d6a9449f7d0d68963fec2ad9,66,54,85740,36410,49330,69,55,83407,27020,56387
d6398657570b6fcfcf1111809c3b456f,107,83,186525,54257,132268,104,88,193382,49768,143614
3b05efad52c6016f443006007a817639,88,62,153623,32556,121067,73,54,106627,27812,78815
c025dc796163fa62301d0d389801b321,108,86,206213,54982,151231,106,84,209930,53525,156405
d5e4163a0fdfc26d221e4adedd748d9e,82,67,147193,27941,119252,49,47,59668,25658,34010
38d576c704f4fc32ca707ce612aa282c,185,131,975175,174805,800370,252,159,947733,139685,808048
5d8110fbaa5853553cee1110995c9196,71,57,88854,34824,54030,89,71,141076,31305,109771
28e7d19577e96d4b2b81358258c33cad,131,108,313185,95139,218046,177,121,406217,76076,330141
a8afda1b9a8af7e38fb086a7fbe9d2ab,39,34,33244,10374,22870,41,33,44151,13311,30840
eba28971d4824521739c1cfc36d27407,176,141,1286844,222405,1064439,203,156,883443,198705,684738
e247dfdd3199a18342712f5c554d32dc,128,96,236864,70649,166215,143,107,298799,47025,251774
9757f848b7cb672646bd1d18bb34c4e3,28,22,16520,7339,9181,24,23,13881,6252,7629
3faa73302fffe29c0fe748bd417eb826,113,89,256239,67910,188329,168,128,520985,61152,459833
252b51eeaa5f5e910244470990f921e1,90,76,147022,37158,109864,68,51,116370,40145,76225
518fa4dc61fcf46e24e6908a2f65551c,213,141,991128,150161,840967,206,167,911910,259465,652445
441e2f3a0aaa1be356ec2fdea6057151,87,66,133093,33818,99275,63,46,91559,27062,64497
13ca41d21aad5581275fea97df246623,107,91,301187,98794,202393,114,97,240949,90751,150198
943042bddc58eb067a6283be9f935482,128,94,257901,65312,192589,124,99,262270,57953,204317
17ef64e68db1e0a25a01fa28d95cb644,45,39,70260,22062,48198,69,50,116320,27909,88411
de682a884ace344672dc8663438f992c,39,27,33048,11594,21454,35,36,24797,12596,12201
d9bd5f7894979f7d58e2cd3dcff84127,61,42,80153,22751,57402,48,37,59447,21262,38185
4fb2bd31f7351b66b0391ee5bbd71c72,59,55,92343,27555,64788,50,32,60006,25950,34056
aae23aa9a5fe834e5e38ff5db7a233b1,160,127,506656,102935,403721,142,119,358888,128469,230419
861721a68b7a4fad98f6a86644c1e33f,161,122,444880,71429,373451,99,79,277657,69071,208586
ac62e06d8bc06e3022e4dc61162def2f,145,125,403383,108787,294596,155,124,482196,76161,406035
03970f67e4581347362120404ab462a4,59,43,68035,21286,46749,48,31,57466,21196,36270
515c1d98cc389f4a87455d88b7c836a6,101,75,140921,42207,98714,94,77,136428,41720,94708
1c3672419e4e42713713065926c6b4a4,30,24,23072,9632,13440,26,24,17158,8224,8934
0d40bb6d3b037afc0ebc3844457fbff1,45,35,47791,18610,29181,56,42,53584,15608,37976
5dab04a94ac90fafb6212a9c7b68ebbe,29,30,22782,17740,5042,34,21,33788,9874,23914
2b0de7866b092efb90467b4521d61bf0,112,74,230660,62368,168292,150,97,298096,54643,243453
ac4479e53774429e7479653eb7c91970,25,17,7290,2799,4491,26,25,8899,4691,4208
90f196f2d28650b9138c70cad7cff303,31,27,22668,8263,14405,32,21,23818,5338,18480
b3692be3717f694ec5fae9f2bbca97ce,70,55,139677,54054,85623,86,55,115526,34333,81193
f015230719bd7cbe7dbb35a6c38eb74a,106,64,203898,28549,175349,88,71,122585,58001,64584
8c0be5442c20b407e80637333970a58a,155,99,529409,107314,422095,150,126,481251,106273,374978
cbcd28bec26b3ee566268dc850b2e5a2,26,18,10974,3230,7744,23,19,6365,4637,1728
084c6283223301e68d4986e9440d3236,193,140,898530,227779,670751,216,161,1065970,164323,901647
9060d4e38c6ef3c5104bde8f4861edd9,109,86,214107,49630,164477,112,85,207033,45855,161178
6dbab5554bf1efbfcacc1a8d7c1ab018,73,65,156435,85266,71169,112,94,269391,77608,191783
4c1537786a081d13ab61eba943467905,162,116,432834,90187,342647,101,66,275154,64865,210289
3414bcc24b25c5dd5c2637b46d072892,41,38,88458,32320,56138,54,45,137928,28756,109172
d43eaf2c8198a9a8e8b3b226c332a970,192,141,564770,95740,469030,162,115,407715,101609,306106
8af8d73557986adc9c7fffdc80d998f5,87,83,161828,45301,116527,78,59,117636,39495,78141
5053595e60e41c3bf8d6f6f5dca55385,83,52,162426,39888,122538,117,99,256461,55448,201013
dde1a511549afa40ec7be7913b9f1b35,36,27,18164,7138,11026,27,20,14865,6170,8695
176706c9280c645f0383b497d549fac2,25,20,10632,4225,6407,21,19,9854,3248,6606
88a2d19aacbb1d610d887e55c4e05010,65,58,129268,34299,94969,63,52,75991,33075,42916
0933f50ded1d679652aaf94a010fb413,92,71,190832,48833,141999,96,75,165062,47643,117419
d797d2fc21672b2c3e98c67532e091e8,55,50,90468,20811,69657,92,62,141005,29398,111607
e890f735a185373f2628dedb8b1a3f6b,19,17,6314,2804,3510,27,17,8700,2547,6153
823ae0ef8c277d0e33f07d2108f81800,44,31,37041,12445,24596,51,36,36067,13123,22944
12e1924d19cface255c86ef8b333ebaa,1,1,188,198,-10,1,1,198,188,10
ed90770693843607dfb01013bd90e6a6,2,3,858,522,336,3,0,522,0,522
8120f97d41411851275e783214ee51ad,205,177,1237663,191100,1046563,135,108,707530,166565,540965
a7b024343458876356497403fcb57b26,44,24,28505,13949,14556,40,42,40934,14890,26044
e13a80057f55560c35e52b9fc4c31fd9,40,30,35499,20637,14862,39,26,56738,12791,43947
142c813ac1f338e127388d408f4fa0ae,164,115,509584,149468,360116,109,94,450930,148653,302277
7cfc67f0d5d06ef7de467d50ebc85f97,123,103,299969,102723,197246,160,115,434612,83133,351479
c3fb6735407931a915a5a22352b2be23,139,105,284492,95320,189172,151,104,382985,69258,313727
2cfc71ce111b616dc37875c3dc5dd616,173,127,587972,116090,471882,150,130,769468,120223,649245
c5113df59ab6a0a1aa23cf7bf236a311,186,145,545913,86901,459012,171,144,594747,107036,487711
042da42db84c6b83b99396163886f1d9,74,58,101426,34739,66687,94,86,140314,37351,102963
68fdfaccef97f2230153f80a45e3567e,53,40,50357,18317,32040,53,31,39946,17691,22255
6289c0317a43880d23fade9994d932da,25,19,15626,5439,10187,28,20,13954,5815,8139
9307c6fee5596549155c1eddf85f47c3,57,48,65748,17950,47798,64,51,72241,24192,48049
ae5892d7f08236d60742a0e774354dca,23,18,10731,3350,7381,31,25,17659,5308,12351
38a77a9693a9286b5caabe9dac8a9e51,111,84,297019,55651,241368,126,97,312716,86813,225903
4ac2719a33e691267c5c24e4631b5447,26,15,11067,2562,8505,22,20,5542,4503,1039
d2e13ee5235e7f6b8678a1d9342d1dd6,32,28,18404,9407,8997,49,40,42488,10262,32226
6390b4df0ebbe36d08389da56be0e64b,88,70,144364,33986,110378,87,75,131464,37099,94365
be8f5f25c780974db65d95fd4574d01f,76,59,80236,19674,60562,61,47,78061,17423,60638
c42ad345f9dcda0ff3a8bfd34e073f94,91,76,170692,52338,118354,125,101,316609,44949,271660
55041b5ca164fdd9c245e12130fedf51,20,19,14598,3724,10874,26,15,12502,4630,7872
9c9b1e8a630e4089115734c4e2f9d215,39,29,40276,15527,24749,41,32,37231,13722,23509
34d2dd515e9ba1d49defd2da03bc3a21,20,15,4028,2312,1716,19,12,4598,2673,1925
cd7b790809b430dc32ceca2d49d8c594,195,149,526573,108068,418505,145,108,450776,127890,322886
33dc4c29e74af6d67c2955062e576dca,119,83,164529,63469,101060,105,83,203983,47220,156763
5c326e889061a5756c6ddbe9bb3f5b7a,107,75,249593,68260,181333,142,110,364212,62181,302031
db8de2e3d13a0487f96105f127751e7a,130,97,383873,75138,308735,151,114,362572,86714,275858
1fbbddeb3a25d923d5dfe175dc129299,47,44,41182,14470,26712,35,32,22640,17943,4697
1737e2155b7318853c61bca647152c0f,13,12,1775,1201,574,15,12,1845,1369,476
24d4d236f330c37cb2008f778cc125ba,34,24,19278,5710,13568,33,26,18391,7660,10731
df044292211f0d053caa06760275d766,62,49,68546,23779,44767,52,37,54117,17323,36794
93f3a4f18311615584350a97fbf735fb,92,69,140431,73602,66829,102,88,213023,68830,144193
c39a08ed4ecd92d9eaccf901d60a721f,151,120,564624,72072,492552,186,147,758515,127047,631468
4235550746680d992821b4074c9fb4b1,70,51,135791,43061,92730,70,49,100367,42220,58147
7fe500a9f8b3b6e564d0c465b4ed643a,115,91,221616,49808,171808,78,65,105310,36553,68757
6d82c50a28ab7734a50f58453cd10618,29,27,12953,10125,2828,50,39,66738,9966,56772
93ecac4c15a9529e272ba1ce1190859a,1,2,41,100,-59,2,1,100,41,59
6c57048924b3adea0e2ea2fcb0e5a78b,211,117,656415,90815,565600,198,167,695461,118637,576824
6a6d2cc0e96ef888fee5d2fe1efc4743,122,101,303603,67111,236492,103,78,217099,73064,144035
ba7de4545a4bfabb86e4cff9f9e25eed,169,111,715863,142770,573093,195,152,922889,170128,752761
f06aaf734577c3e1a2a5d63998919940,201,158,805210,93511,711699,162,127,620360,95579,524781
f46b4dd9cd2865db5d3c9bec1bd90a8f,82,68,122364,42094,80270,109,93,213364,34651,178713
20d6e8226fcc2821d3f47b981adf33a9,0,0,0,0,0,1,0,4,0,4
70d544c4e7a706187ee4e42e316cf1cb,32,25,19480,9805,9675,32,30,24896,8143,16753
b0bcbae97bd9e29b1ac5def57e7b27c6,126,93,252829,53430,199399,126,107,339475,60233,279242
880c31afdd33efda1b9316ac00eb0b5a,111,97,243429,45823,197606,84,64,127154,56162,70992
20dfd9b03192e57c29ea16710ef6e8f5,157,129,440181,130010,310171,127,93,385375,136869,248506
9b6332c65c2803b2d40c8636b0185a36,62,56,123323,68723,54600,95,73,284957,56899,228058
4f4b55a53200a4418ab155d51ff35b24,42,29,34364,5055,29309,54,40,38675,10673,28002
b28a0e94fd061c06e2e0a32a259d201a,15,14,2974,2226,748,18,12,5561,2016,3545
15ad0efa1712eef41fa5aa48c8b8f866,177,132,483810,75356,408454,135,116,372972,104589,268383
bfb986485fbac818b28b1634bb5c079e,29,25,23560,11689,11871,35,22,27278,11135,16143
1ecc7a76df18fd55322aa112cd949631,32,25,22571,9977,12594,31,21,19049,9682,9367
e645ac23db2aa7db3dccc255c6407eba,25,21,12114,6943,5171,25,21,12568,6890,5678
12ec730b4f0b0929cf8cae3a3a5af4b1,50,40,60383,24605,35778,64,36,88578,20192,68386
26076d3f8531526c2ce82a41cc4c1ee9,54,37,68707,11287,57420,34,24,33908,15143,18765
9009748dea419e198d43a94da851832b,176,117,533952,115839,418113,154,120,514827,165720,349107
d4f3aa1e4b19406c1e64bdeb758b58fa,59,53,85058,34191,50867,65,48,88801,23066,65735
f33346467d5fcdeeab45bc12857e7df8,173,107,839570,138754,700816,198,153,969245,159132,810113
b1757eac8ec78a3e682cbcd543b3cdaf,39,31,19443,14675,4768,38,34,29435,11400,18035
e4f48d0afaf25bf2f9e12257954ce7c2,116,86,233352,66608,166744,136,85,222890,52751,170139
757581a93bc6e94b77ae99e0501c8d13,48,34,45814,9136,36678,36,27,27335,7365,19970
a743dbe8fb34da56362d85937969f046,54,46,70305,24276,46029,42,35,62849,16898,45951
c5cc80fddedb4bd4a6216c70556e0110,7,9,2965,808,2157,10,7,1045,796,249
8ae49d26e55db7ed2aeae054dd6f3abe,99,82,194937,78166,116771,78,65,159797,89087,70710
6bc414eb2be207cad807362b20212cd2,130,108,309852,68108,241744,132,99,309981,65420,244561
841bf54eeff707d35164ec9d45be19b0,183,141,748723,149902,598821,171,123,761122,178035,583087
9876119b8e488737ae1f1464fcf3da32,62,50,92821,23693,69128,61,47,61963,28428,33535
03e98a356d9738f1a6cc23087a37397b,108,93,281942,72561,209381,122,93,316164,79417,236747
05b3cacfba5241ebe801ae4f293c40c6,118,101,200631,50593,150038,90,68,141985,45524,96461
8b260df8b160fa50ec63d3da49b8d3a4,131,78,230722,45482,185240,118,94,192755,59250,133505
699f68c35ed08882f5c8cec7dbcf4768,47,30,44652,20065,24587,42,37,51369,16382,34987
afdb846ce321feabefe37db32f9b49d3,124,96,260520,64845,195675,112,88,273028,58674,214354
52d1911b43ed330a17b93637f1131615,68,45,139663,22665,116998,82,65,109640,31400,78240
04ad6210480ecd1966be8fd5f6cf956f,55,43,41891,22648,19243,41,34,50127,17880,32247
9c0ed3e12773a4fe1faad775cff4df90,58,44,54892,22469,32423,64,56,67951,28586,39365
d51d3d91b6b6b3c32b31a7be8e34c660,65,49,74267,24754,49513,76,59,117388,22378,95010
94c8d3b04f4be9ca5cd63dbead3126b2,107,90,292650,69402,223248,120,96,242390,68957,173433
a130c3140c27f2bc2340c184e5e43e39,76,58,148097,56476,91621,137,83,221342,41630,179712
8585132e76dfa62a53dfca52b9b92526,53,34,115284,34344,80940,48,40,97530,33368,64162
10bf717883b68cdea06272f1728f3b38,59,48,68726,39627,29099,64,52,105235,34895,70340
603be03a724d066fc359c9491bcc7284,23,19,10773,4578,6195,23,20,7963,2924,5039
8b7deaedf4d6ede126fb3fe23e7a48ae,116,76,194621,51112,143509,123,96,272162,49027,223135
db8e14b9a60f83de3f706f2e443e141a,74,56,105540,36595,68945,110,81,218096,29035,189061
3c5f1a4093a4a3c1cd0fd45bd505119c,134,96,348246,75535,272711,175,121,439798,70004,369794
63949f1a3e44974ebb0b9a297a124cd7,20,21,5502,1514,3988,19,14,4498,2290,2208
d6bdc20d72bc16dbe1da3287ef185c52,66,47,91117,26342,64775,57,44,93120,31995,61125
8576f7e083dddf6a3ed5ac5d54b9db26,52,47,118378,38597,79781,71,60,120850,40671,80179
62d04d841b5c9f6da9987d7a9389fb94,149,130,505005,135338,369667,213,162,731640,111070,620570
39b5962276041baaca4f6657cf9c86e7,38,29,43594,22346,21248,44,38,52632,21227,31405
f1ac7b48ae5910911a420742081f69ca,155,128,387589,63039,324550,91,76,217438,62370,155068
4eb4476d9a0fa601a5183fc985d3183b,123,94,273248,53808,219440,110,90,301013,51663,249350
2c349a32adccf42bdcc9f539b1991db3,39,24,29058,8119,20939,38,28,21303,10534,10769
3a1d8b81ca2225d927786edf2be44dd6,93,81,170730,48631,122099,95,81,189096,31818,157278
c543f97e9c58693a13d6da025cfc027b,174,136,575848,105739,470109,162,110,474314,148386,325928
52344046345f62c38a60c065bd2c6706,147,110,455990,135303,320687,150,116,464187,121287,342900
c161f9b5481c0f613b65187cd6ca2be8,75,51,88025,28709,59316,96,64,158992,26696,132296
e4b9a270fe8b66f08daabe9d95faea70,85,59,167447,52013,115434,97,82,215010,50040,164970
bf3f7011b02cf01b7439350ffc332e20,24,18,15249,4953,10296,27,21,12932,7305,5627
fa3cc62122cca02910222566840dbb8d,41,32,27428,9012,18416,40,31,28601,8954,19647
2a0cfb65b84e67fbab245353b1c4654a,30,22,20874,5065,15809,35,21,26563,5705,20858
df4d84f2ea52e71bdf002a0de0c32cb9,118,95,189320,53775,135545,88,75,146716,48858,97858
349a6cbcc2e192e79b14b51c8aded7ee,106,76,214552,45258,169294,129,99,234938,42568,192370
2c062e9249b7890e0ed38c5fb5272bab,19,22,16131,7377,8754,20,21,15473,6230,9243
9e02e45870f0828aed501999aafd5cba,34,23,19447,7270,12177,38,31,31954,8961,22993
ae295b015346ff50988f546b132af049,104,94,244797,92554,152243,107,77,284736,77281,207455
86409fdd53790e62635423f624d6145e,163,139,708333,156161,552172,156,129,496732,177833,318899
bf917bf829e3716386e6700196169b50,97,82,186802,52878,133924,111,80,196788,40838,155950
7e2fe01e2ec74d6349a11450dbc23825,80,66,157150,44874,112276,106,85,148562,54907,93655
c2b680691fbb75198d47b455550da948,83,66,189444,42270,147174,51,41,85522,29229,56293
2e1d9d59d4d36bba77b7211fd3c587b1,65,55,99907,28891,71016,77,66,93616,23757,69859
5d0ddd2913b5a206c139ce1e9d40b106,95,84,230740,71579,159161,146,125,365197,85327,279870
ad2fca2bfc669f3de033ec7e84d3d807,87,61,156609,27786,128823,68,67,97357,44088,53269
98a69bef34066ed6660eeef79d7c5c36,45,25,38758,15947,22811,48,34,41909,16489,25420
1e5091b3c5bad5deb63e3b186204799b,32,23,26319,9599,16720,30,30,26058,10256,15802
a8d6760c0f416a94a1ee8c5b56dc073d,124,95,271561,85819,185742,142,102,373470,86819,286651
7f640e8732d2bea64a419f47fcc02f67,29,23,22691,8403,14288,33,20,30186,10302,19884
cd40a213f5557264102b8614caf1bf15,147,107,574948,87669,487279,191,166,609724,126048,483676
b05a640e2249fba6c58f54d9ebc00129,125,87,275128,48744,226384,79,68,144092,85060,59032
e891bccb77e0b0fd4e0a3adc679bbefb,25,20,10592,6262,4330,28,22,14482,5885,8597
8c68f68b87e1293877df63d8b81937a1,81,60,190046,52951,137095,108,82,216318,52322,163996
0a0a25d64518c5ff70c0552cfe307e8c,13,16,3255,2568,687,20,15,4411,1545,2866
48bff34208751d80cb752e8d78972bfb,40,34,59706,12176,47530,38,27,28680,19015,9665
344e56aa03e1f0a0574bf34fbfe32073,23,21,15202,9996,5206,25,21,16844,9436,7408
662e41adcd23be81d4c875b84cb4cc4a,25,20,15991,6457,9534,24,22,13768,6927,6841
28c324c687237567906766794546dd82,45,41,36246,17107,19139,50,42,35720,18611,17109
2fb8b55aa3167b232f7f182573fea66e,184,145,649854,158514,491340,185,147,784051,104456,679595
ddf90815e4718647ec01d704f8045eb5,66,43,66142,24051,42091,61,55,64042,26006,38036
4f7baf50f2bb1d063e8cc2ae1db60224,57,42,49348,12079,37269,36,27,30245,10678,19567
1b58ee85dce0bd5a5ef975164aab9c14,63,59,117987,32194,85793,54,34,90979,24192,66787
0bd1ece202c279ee5b1cdb4b9e609bd7,48,37,41704,14262,27442,47,36,44564,13064,31500
61ae3b5299253ba0a7ab2e1ccbc836b0,32,24,27970,14095,13875,31,20,21258,8499,12759
cbdcf939b8dbc05d99c9074e9e0c1dc9,34,23,36376,11778,24598,33,20,31997,9582,22415
bb86ecf85294ad8de258611e474ccc6c,145,125,417694,117501,300193,120,106,372840,84956,287884
a774f20880bdd82b0e3f75a6e8784a9d,66,65,110348,30614,79734,107,94,184947,35468,149479
f2e8ba48f5e7a1751f593d97f09e5f0d,46,30,53721,21214,32507,40,33,42460,25453,17007
07719700c32dcfa3f1ecd760a6cc8013,33,27,25966,12019,13947,40,28,30578,10925,19653
f5f3196daf6cfe7decb8588417f17a7d,163,123,563108,77787,485321,127,111,452279,87907,364372
864f040713de0a1e462a9acfa50d7aee,194,129,791745,180102,611643,189,145,667498,152211,515287
8f7de871663916f664cd4e779d426a05,81,60,102386,34100,68286,76,51,132444,25540,106904
e0f37aea5541098f427a22689babb61b,124,88,234743,64502,170241,120,92,266080,58080,208000
22a4f223372e08048cf29e461042172b,24,21,13849,4989,8860,31,26,21201,7307,13894
04fb4e6d290b0f387e45afd9a7467f36,105,75,190229,37223,153006,80,82,128264,52395,75869
47422f4bfd8a7ab51a092fbbc50322a9,182,151,665259,107009,558250,169,123,549056,88348,460708
00fbcd5772ae2608cf09caf7e115b298,51,45,64568,27226,37342,87,70,133608,30291,103317
060e1069b86d6c6421b179af5d13c058,22,19,12338,4694,7644,32,27,12533,5935,6598
23d9bdc5155c85cab3a84ad8f6c0ae9d,158,132,417184,102506,314678,112,82,276589,68389,208200
90dc9c584d3d017f126ac64d888f4885,200,156,705590,95236,610354,154,130,520665,122529,398136
0179bfddce72134e931a05d23d6c8982,37,24,46028,11947,34081,30,24,28447,11951,16496
f2430468c081bd04366d2d5a78e934da,74,56,118898,40068,78830,93,76,163911,36498,127413
564bd59e7d58d5a6368a7d62585a3c42,159,115,373434,99920,273514,178,145,542619,108813,433806
15ea2b615a099e62e9df531f40a571f9,47,32,71788,20545,51243,47,37,50853,27399,23454
9b8902807483aec259b43b05f66756f9,108,88,236214,78061,158153,98,74,259981,65479,194502
275f4bf74cfa58d056b8fc54a06afd86,151,116,456544,101441,355103,150,124,411927,103622,308305
2e5b885753505733f218071a1bb62c6d,44,30,55862,16172,39690,32,27,27459,20361,7098
18e562563efa4e1b737eb217e2d62b0d,37,26,23385,7772,15613,32,26,21122,8084,13038
69342c7ff590f97370b7eb6cb55081b3,79,58,115289,29940,85349,106,77,170258,35001,135257
3eee4400876cf0051dafac2d5f3b365e,30,22,27519,10476,17043,30,23,23766,10619,13147
b07825709d71c943b1570f996fb105e8,25,20,12919,4554,8365,22,19,8275,7208,1067
c6706fc09b01c50bf59340d3ae13cbcb,169,113,598003,97648,500355,179,134,695891,104418,591473
b93baeaf5f1bc5ce88ad239744ceeda0,49,41,98852,24304,74548,59,51,86640,24794,61846
8d9b1f0cf7fa881a81f0190de5fdd65e,95,66,221081,55078,166003,104,81,276556,75626,200930
3f3dd67ef9ed5a4887a6ea4b5daa280e,12,6,2522,704,1818,11,7,1267,1343,-76
61e8b9674ae9d86c444ff30d8ab47fa2,57,45,52186,15257,36929,34,39,40201,12055,28146
177ae3948b39edded6696e3986d2cd34,34,27,12943,6204,6739,26,20,12056,4367,7689
d2950bb985732970c83d15cac56f5aed,48,43,38310,13953,24357,55,48,53911,16132,37779
a9475ee47c8a10d6cf37c1461814653e,173,129,721438,129803,591635,140,99,535441,182725,352716
7487913920146f7b3d4af7737a3b5efa,38,29,27992,9004,18988,38,27,23715,9874,13841
ffe401e616468f17373ade34c1606c65,46,35,42480,18048,24432,48,39,45308,19034,26274
42967f08c01a1d37f33ed9be1b4c4b86,41,21,48676,16741,31935,33,31,49664,18320,31344
34483a018904435474780ef5da822d9e,77,57,130103,33386,96717,89,71,162841,39073,123768
39e78d25b2e2dd45a79d779d52497828,12,11,2499,1553,946,15,13,2955,1687,1268
328354a135976d9d41f59d7995e99bb1,227,150,881653,196071,685582,193,139,1032011,228624,803387
8bc11d1d7fc01c7a697f40cefb63d213,111,87,404749,171784,232965,198,140,584153,123747,460406
024784633385b5a46ff423a02ae076c3,30,23,26905,9491,17414,31,22,23415,9496,13919
8c6896605dacc9d75f50fdce1d5f618b,30,22,25240,7350,17890,44,37,38654,9763,28891
d3e97975590de1f21c72833934e0a2a6,45,34,51337,20198,31139,52,38,47949,20769,27180
8df158858b999de6aa20d65b08dac6b8,23,24,8099,4636,3463,26,20,8488,3435,5053
34826fb8432e4ae09c190b8797b4be88,177,130,743617,176608,567009,201,139,683986,122895,561091
cf2ace78414869ad08911b93f90e223b,182,126,967043,164140,802903,196,147,1059916,246882,813034
fbab1999edb5ed9e588644d9ecfe2ffe,126,96,438352,106611,331741,199,170,828966,111028,717938
feca8b7a5ae8072ee5a08820023a2b7b,60,47,54990,22788,32202,62,52,64255,23007,41248
f5d08b524cd9b91db16330e92f0f7b74,132,98,572568,101851,470717,158,119,471125,97778,373347
c550c8128b7c2c0ef40394b42291b857,26,22,12899,5689,7210,25,24,11442,5165,6277
0c0d1a8fe076202746eb9f02491baac4,134,111,317192,57767,259425,130,111,299322,54223,245099
29347f255f1e5ed835ee3e172ce0017c,74,52,82248,15499,66749,55,39,67100,15981,51119
ea4ad9958fb8d6864e0401ce04b9e4f3,79,72,148857,40904,107953,56,46,88046,40364,47682
5fd8029724bc8dcdb5194088b390190f,115,88,256471,52316,204155,136,105,238823,57586,181237
cba0ec679d15ef842321370df94b65e4,169,134,573896,122096,451800,145,127,554092,119199,434893
da5db302901dfad37006b6515f9bcaaa,87,69,175519,24441,151078,115,94,184563,36684,147879
5ff1e27ffcc9facf01de874ded331f35,149,114,427920,90140,337780,136,120,434951,106481,328470
b86454235c4b7bb9fc932b87cb6119fc,56,35,40867,10381,30486,34,27,32878,7756,25122
bc364eabc8efce20a95933b47f87878b,28,21,12833,3879,8954,28,23,10255,3888,6367
300a8342bba31040d15627357c2512d9,71,47,86365,24684,61681,47,39,59592,20250,39342
e0a8370cbd083a028b46c07b9a6c0700,73,54,102125,21072,81053,40,34,47461,20656,26805
324218ad5dd6780d50adb187b11cff98,148,124,605476,172825,432651,217,181,1341980,157838,1184142
1d0aa1b33ac081ffdaefaca841add1ce,135,114,482672,63344,419328,166,130,467825,70460,397365
924412ff47c8147ad99d121e625f87a4,146,115,363014,73627,289387,151,117,331859,76541,255318
0d132c1467d92029541c2a87a021fd07,59,43,44770,23626,21144,57,44,59930,18945,40985
baf837fee0dc8e716447b1c22ce4efb2,55,40,79942,20449,59493,47,35,58514,24763,33751
dc27d5296f63de906635cc9a329ab5b0,154,123,704021,109092,594929,149,114,473089,94713,378376
f555ea4e75549ded7e860ed5e9377475,100,70,239142,65352,173790,154,133,389893,85071,304822
a2aff3b8d7eb98fe8ec857fdd64526bd,36,37,22847,12164,10683,48,34,30147,10233,19914
3d1b2d7844dbcbf52246748c6cb626f5,36,26,28700,13524,15176,58,43,64610,14871,49739
b76aeaeb12de936c23caece66bc572b1,98,87,183886,58357,125529,93,78,187741,61219,126522
1519d01eede95b72407a880605d42782,93,74,179392,42307,137085,96,78,175900,45276,130624
5ee80a3778352128deda45ba835ef30e,63,51,114459,33386,81073,61,50,80683,45870,34813
0fbe64e539d3bcb5558c920463180e34,91,71,110574,29752,80822,76,59,76589,27382,49207
92277397875f07f0ccef07f636bc9328,35,23,28153,12407,15746,41,30,36605,11687,24918
0c90f58596750678a7b318044f50f687,84,66,113248,43083,70165,94,72,167998,24562,143436
fea3794ba704009b7f25b89d88521185,88,72,210690,33496,177194,89,75,138968,49782,89186
018dfb63c736618f71eee410a328e02f,81,73,165533,63192,102341,100,93,191910,45309,146601
88c152da211dadc873641350c87e26c1,34,29,25733,8641,17092,39,24,31061,7722,23339
1642491040ac47e52957b4ea974ff539,33,27,39443,18897,20546,36,25,62221,15641,46580
07ac71ccbe4f441d5ace8a59b53593a3,129,80,450705,95336,355369,201,151,787009,138391,648618
334eb104a67f1e2e307779ec1b48f770,228,169,1287310,217410,1069900,230,176,971354,324277,647077
4ef13037e349c8cfec7deef206c67764,131,87,277881,81411,196470,153,108,378280,59652,318628
5965a791543468135b11075a50e669d6,62,42,93012,33179,59833,49,35,88324,22745,65579
17ef2042caa6db522d74914f276cade9,151,115,398703,96182,302521,146,96,340349,95621,244728
73cca3f4b103c3fa7d4d807d68e43ebe,107,67,315988,83230,232758,133,95,412837,69053,343784
076f3b85426914015ebbf36a8d857ab9,72,52,105248,18080,87168,79,73,87354,27250,60104
61fe55ee9b4f26b424a96df662f173df,33,27,17953,7006,10947,30,18,16708,6304,10404
ca9a378becdbb8e683a50e83a07ad8de,167,121,610643,112458,498185,215,169,875316,115449,759867
1105435ced9a696359e661f94851686d,69,58,126834,30139,96695,46,45,87502,33398,54104
50d2fb7ad49e5501293483522f4fafea,55,40,63211,20474,42737,53,41,67894,27826,40068
82c7079011378936142700027c21f647,41,37,56652,13619,43033,35,27,31065,11455,19610
dae29579950743ebace85890144e25aa,115,100,285958,46503,239455,68,50,107503,30803,76700
40c3855d1b6908edd4503a524ec60b31,23,23,17333,4186,13147,31,25,19329,5431,13898
6b99e2e9fbf1d369c31e3fdcef53d4d2,182,144,691765,150270,541495,164,117,686915,99348,587567
c2422ae94493763a807385d73919fc5e,45,37,88085,19132,68953,39,31,41822,21176,20646
23e0e22393d193005623dc1aedd2f239,70,53,172565,46982,125583,103,86,244312,51196,193116
e54dd1568e57cb42f3be4e9a2f824f8e,68,50,103543,39718,63825,52,44,65200,30597,34603
297a060bcdce7c3b4ab188c61c76af5e,148,108,445840,50215,395625,169,142,505964,77840,428124
9cb1076576478c43818783aad508e071,132,106,456294,127428,328866,166,118,512939,107363,405576
4dd418dd4930820172fc956256f167d6,138,106,457162,120480,336682,146,118,564773,115267,449506
b19aec9017cf0ad2a1c012c21fb86965,44,38,45154,13906,31248,43,35,23315,11799,11516
9a86799e27b48246e1a20bfc4441566e,29,26,25611,10357,15254,38,25,29256,10013,19243
e02f2be35134318bedf489f3c97d8ee8,86,57,127483,24663,102820,75,53,78850,37915,40935
39a7b1b1329b9b9597c7a33873e9e344,44,31,40455,12748,27707,39,38,37579,15528,22051
aeb261f216d2018da81bd138c1836f33,72,63,115895,42568,73327,112,90,194315,47457,146858
83f48648e4b68ac4345ad7a886fc1d13,111,96,207647,51052,156595,102,83,167796,57425,110371
d7f53fd1cf8d07a6ed2f53c8127e90f6,58,45,62380,14795,47585,67,48,47838,18118,29720
9718d1884148397a34f47de45d8c053a,82,72,200275,49712,150563,113,90,242085,56319,185766
39dcffa6a2afeb294d8c94d9795fa8d9,86,68,169252,40659,128593,97,84,185536,31317,154219
caecda1beb50145d958824326e3425a0,137,118,354502,72238,282264,128,117,308518,108911,199607
f2727a10cded06d5b7c4cd5f3ad56030,115,83,168836,23630,145206,111,89,130530,32276,98254
4fb6b4ecfc29ebdc6c5ed859c428c210,16,9,2654,1455,1199,14,15,3161,2328,833
adc3a13bcccadad9959a598dbdb6b7ef,166,124,555004,85775,469229,160,116,413771,109669,304102
7148889526643bc718b0050e5827b1a6,167,141,669648,127746,541902,148,107,534107,115381,418726
b6dc455991c90819930954687a9a8911,135,98,274685,61096,213589,105,83,200573,61544,139029
bcd738f1164a74ec9b597feac7f121b2,57,38,53176,13491,39685,31,26,25918,10405,15513
3d770bd39324a47827afee6d3c87a300,120,82,308061,69031,239030,138,103,378088,89262,288826
048cc44d6c146ce3941d8093bbf18c1f,125,97,323566,71675,251891,119,85,218442,68271,150171
11504ee3d03831938157a2b5108b3dec,137,98,367804,80049,287755,154,128,574072,80820,493252
59dc0a49a6e8c9d4476c72d14c46293a,24,21,12240,5088,7152,26,20,14514,4855,9659
deb0eea5c79b547e83dd78a52741a0ac,127,102,311051,52298,258753,127,94,285111,36868,248243
6fc548e5ceb9d5508e869b8da3f5b11c,54,48,80408,19794,60614,77,65,89895,30194,59701
85c4ece3ef5d853c5b6fe8695431bf28,165,111,436244,83669,352575,197,115,502163,91290,410873
014407fa4ab382b0a6ea672ca5e6f812,138,115,329385,77980,251405,152,118,313253,53221,260032
341c7cb87a9f11be4da6b5bcfe9e25c3,61,46,75016,15621,59395,40,25,37913,11581,26332
28aadd77a2ce6f53e13709c34e79f770,36,35,32462,12549,19913,46,40,40543,15752,24791
47544e6d391a8b2bf0f0de04630a8742,32,19,31822,6899,24923,27,24,13878,8271,5607
c102cf0b22533a0a801fd3889c08c90d,42,34,57220,21709,35511,62,45,103991,17880,86111
f62a50b535bcf2b36f8d886d33574130,48,40,56872,14891,41981,36,38,23965,10780,13185
c7ab166ef84ab13a15b58673a8b5affa,105,91,201323,61260,140063,125,90,197091,38424,158667
61fb616317ca304f89fb652acd12e310,57,47,44175,13938,30237,48,37,28202,13066,15136
6129887f132dbea8936fc5fa0106d8a1,170,144,551214,162027,389187,133,103,483484,122866,360618
ae20f7e6cde259ba4894767ea3f4675a,40,28,35009,9747,25262,40,26,32108,14832,17276
6ee0199d4b79bbe33b547b484d5be2be,124,93,318771,64980,253791,130,91,332362,55402,276960
781a4ab580f9a6f4da23ad8d44e7d759,34,24,28890,14167,14723,39,34,30944,12859,18085
81c257973070b7d283bfcfc3c7e5933a,41,32,36678,14810,21868,47,30,51394,12456,38938
80c5bc01ec2fdb82d3eb621ab966659b,168,124,581455,100777,480678,147,124,404792,145971,258821
8be6ecfac9acba2d64b9d24845426d13,27,24,4895,2743,2152,24,16,4498,2494,2004
094ca161c5653fecd8776a782439e17c,128,87,270732,48226,222506,138,103,293613,72285,221328
68a67e2e868c9c4436f0fb6602ca4e06,91,76,138531,40904,97627,97,67,142696,34783,107913
b9994fa696810dab26ea6dcd42ef8de2,35,30,45224,19717,25507,45,37,51738,15584,36154
167a4b42786710efd0840be32b70d8a2,75,56,120963,25713,95250,83,60,140776,24831,115945
09371173a624d137c634786fb2824d59,99,68,163450,40693,122757,70,57,125303,37081,88222
6e7d0b8c2c4d4f5d4d8b673285bcdff4,82,79,106463,32454,74009,70,47,115236,37985,77251
e2e2460bb8aa4d1bfa80f8981196c0e1,132,105,330993,55611,275382,112,79,228416,82988,145428
3da106b70a104fc815cd5123527c1fcf,109,84,255736,34387,221349,52,47,103467,34259,69208
578f9e9b6ef0d932a5765cc6ffa11742,78,63,109474,36517,72957,86,67,122212,27151,95061
a683d52c174cbcff7ec8f33e6968c124,40,31,26169,13812,12357,47,35,34330,12196,22134
4434ed760f7680154ede2845c461ebc0,95,66,163567,39216,124351,91,64,112329,34683,77646
a2d4ebaee88de3f9cead1363fc069614,38,25,20685,8206,12479,29,23,20435,7508,12927
c6366c5a8fd5cb6aabd9f765fd601dee,28,24,22020,12068,9952,49,32,28502,10870,17632
34b15ea7e39bd7e3d94d8a903a184191,46,40,39487,12427,27060,50,30,53133,7854,45279
9ad61a24efaa00a93340353884941c18,44,35,45301,15064,30237,36,28,36734,15759,20975
74892147dc731ca3ebc5e291623bd21e,73,61,107314,25615,81699,79,58,111062,30021,81041
2307432e99973fc56369dbcb5c4e8c4f,193,131,448796,65884,382912,147,119,370767,60536,310231
3bd2ddf0c2d64d9d764ca3be4011a4ea,30,23,16837,4637,12200,28,21,14990,7214,7776
38ff5c3395a18a5c0aceab5952e786ac,141,103,446367,113991,332376,123,86,308274,121940,186334
3214709325c2559e9a02b2d75a4ed7b6,164,130,322454,74659,247795,128,113,292938,83812,209126
be03faf3ba7446cf66e8ffc16ba5d303,124,96,274310,95562,178748,146,112,358073,134071,224002
34d3d182954eafcde6d918c37d3719f8,160,128,588940,99392,489548,145,116,501317,106030,395287
be99a1a12fa7f430c6404782a178d069,193,165,856970,115493,741477,154,130,573757,130988,442769
f66d9295fcc1989742c05eec4e712472,76,65,195326,52498,142828,97,82,171225,49986,121239
f43d8c13ab8f70948eccb655d3e3527b,159,119,389335,73483,315852,150,129,350360,85455,264905
aaa9b41408ba1f42c14ed06f67cca081,85,70,150861,54406,96455,140,118,283411,53592,229819
f6527ff28a2130f4e270156c92c76908,34,28,22842,8832,14010,31,23,19743,8179,11564
956f0a7e95315fc841e228551045611a,60,34,94851,26414,68437,44,31,90075,24029,66046
c5eeadcb65e66e300e0994620a9ac63d,83,57,165572,29823,135749,121,91,255244,44402,210842
c7e3fe4499b05c51dd8d8a2f40cf7045,72,47,102273,16074,86199,54,57,56766,25884,30882
15e95ae95d29e3f42f58deb7de7d7f78,63,46,94708,39581,55127,80,67,132591,32364,100227
d0d6386cd9af94cfcea549a71bf2cfd6,102,77,217681,41916,175765,95,79,152828,43079,109749
270002ccb7d060c9d6790fb5c1bb79e9,99,71,183757,40614,143143,78,65,149145,51611,97534
96b6be83213494dfd3f5d9f47e9180bd,151,111,506723,121428,385295,172,140,615650,117290,498360
283548bbcdc344769f7d13d5ea5aa2e0,180,132,874115,212585,661530,199,149,765776,167543,598233
ab12e1fcc698a7b42fa273ba4705f198,69,44,76325,17243,59082,63,46,101831,14689,87142
7e8dc4a5790bac48cf1ae296bd1776c6,67,41,83412,21822,61590,45,39,63467,27707,35760
42a7de396238d8f37fc54fbf082aa32a,119,86,225121,47043,178078,105,92,188005,59314,128691
a391024023fbd2fd6a2af435acd6371d,131,99,400163,112455,287708,143,98,389601,136408,253193
0186f319fcc13fcde58dcd20e5084d66,151,140,661713,155702,506011,182,139,667633,111639,555994
a186d8df1412776c6a9d86d918580191,64,51,78704,23010,55694,80,64,96093,30002,66091
0517dfbf4cd8a0c51b6592daa7c2ed8d,121,103,323163,60455,262708,128,103,414119,75970,338149
a738fe8d647ad4dcb1090dfa9e8f3ac4,48,36,52314,16516,35798,47,40,50765,15128,35637
2578beb8a0a3eed47455a5ce4e6c2ee1,68,54,149726,47527,102199,81,56,152776,51873,100903
d8e4a575768b3d877f2160edfab566e4,144,103,366792,121521,245271,131,76,328124,94530,233594
4f67d8a4674dd02135a04c50f5a1055b,45,34,70550,16725,53825,58,59,68974,25821,43153
a71708e1d456cffbf3808d25558afce1,115,94,337693,103132,234561,199,155,484324,90434,393890
a19d92f0c93665468d9790a8196042ab,14,16,3480,1760,1720,14,12,2030,2170,-140
6ece6516372cc54e2167feee48aae282,37,22,17605,7986,9619,28,26,14963,7567,7396
8c2a521ccfe377542fe390092abf6ec6,189,131,866415,109504,756911,201,132,513822,91202,422620
cac0a324b605f528deaf34c5447ad02d,20,19,7221,3423,3798,25,19,14119,3856,10263
72da1b8e660e555956fcb2a20187b76c,170,138,733537,129739,603798,184,155,562682,127274,435408
d9b9c25a582faf6789a8f9f49c5ceec7,39,28,41253,12261,28992,28,23,26444,16178,10266
b451fe1738e52927021f5f974adba6f9,22,17,18647,4890,13757,31,27,16090,7109,8981
b258e08c489eff3de9fb59a76d8981be,63,50,107177,28430,78747,74,62,117583,36327,81256
73cd66b83f00d16741c8963cf24a8a1f,155,136,450505,104085,346420,149,126,442866,99056,343810
b984f81724eb22f4c3f69f080df25d47,36,28,42700,14619,28081,30,26,29559,18175,11384
7e1898f918266edff56519887812ae04,62,44,88408,25818,62590,58,45,104721,28879,75842
aa6ce3291e22d46872e14cd9a1abcca2,50,45,61158,26461,34697,58,40,61846,20348,41498
5a2f07b0c45dca4c7913adc16f1a6326,46,40,61319,16044,45275,66,64,73868,26540,47328
6e9feb4e086cd99f69d5daeb269193dc,113,87,217661,50935,166726,102,92,254680,58909,195771
f7a3a62e2adbf4313456ef811c24c7c3,62,54,63774,22810,40964,52,50,59354,19217,40137
09bdc81a568fda5b6ebfaa3b93e2d4d4,145,126,302071,65408,236663,148,109,270928,55487,215441
ee2ccba12b821c23ad88e483a93a7d2d,6,2,630,371,259,2,6,371,630,-259
5ba589778c4634b01ed26b3ffc71ee2a,158,112,532919,84233,448686,162,144,677537,104011,573526
5b18e87af8c3d28f71422bcd59edbacd,186,125,369644,69975,299669,164,121,423361,60577,362784
19f61724e89cfc82927f60cfcbe36f1c,151,118,378779,79109,299670,166,117,357839,71678,286161
94c589f1123e39b2cf77d5391cab2c08,81,62,150322,62129,88193,121,96,252728,58555,194173
2a9f364a73cf317afec7b99f6236af9c,72,61,88321,26969,61352,64,44,92138,22469,69669
dc2c36b5b0c0c42b07a942adcefb2ca8,19,14,2962,1538,1424,18,14,4128,1317,2811
6cbbf4ff1678e451da862de12263795d,62,38,76386,22908,53478,67,52,69565,20281,49284
15169b374c02676b62fdef2a5e728bf8,22,18,7874,4127,3747,26,17,12082,4620,7462
591b8609683e573ee4132678c9cd68a3,197,165,1122475,169299,953176,194,145,688427,159501,528926
f03fab677b637dfb62b94a956c74fc7b,28,19,19319,6414,12905,28,23,14614,5929,8685
ca6d226f2a62af300a894f510ba0e681,221,144,1139824,167308,972516,210,164,1102686,210137,892549
ed85e2d4c60851b6476ca0f27eb68b3b,48,34,31879,11358,20521,32,27,26768,7867,18901
9cc4991a4551c8b53d2e7d127429f10f,173,124,330972,61527,269445,140,97,328086,63504,264582
51ffafc28f22c377d99c43c7b3ab2f08,43,34,23063,8626,14437,29,23,22607,7776,14831
7a3765df425df4241a0b6f6447cd8268,205,141,923815,219580,704235,205,150,928862,189683,739179
bd7643219d2e945ad055e551e23d2abe,47,41,63747,21114,42633,73,52,87361,21063,66298
7d22feeeb01fcb46d531eada5be9f5e1,59,43,80596,37917,42679,44,38,62821,31400,31421
c9aa3d4e634a0592f744566696915e1b,144,104,467805,113689,354116,188,145,689060,104212,584848
be277bbb224147fd25a4527f4ed401a0,38,24,25537,7027,18510,33,25,21155,7237,13918
c4baf024b7433a9eaa46f024f41ec799,62,47,71615,18068,53547,62,41,72318,19565,52753
088be056aba1d47404b9fca992771393,74,66,135162,36712,98450,92,75,111332,26139,85193
92733b11d4060e272da896242a521e3b,27,22,13340,6877,6463,27,18,13603,5426,8177
cb424fd12f87a252636d854cd563160b,108,88,277468,78833,198635,151,131,426720,65352,361368
824aa9110b569d461ce1abe75f087464,105,82,231001,61606,169395,118,87,232620,56789,175831
0b24eb3def5cea7c43b13cbb665f5f7a,25,21,27129,8220,18909,20,21,21963,8142,13821
d324e78743acd2d2fdee38846ea718c8,107,92,285853,69783,216070,156,117,360968,84591,276377
cb2c7a5f03715557e2ad228e1ac49da9,106,83,257990,75858,182132,161,112,412159,66615,345544
d8ec0f834cfdc2a6094d4b7f7fdaf11b,132,101,484132,71197,412935,176,114,432351,70505,361846
b3e1fae3b2c45bc95b41215e6321c66f,119,80,270521,69019,201502,139,103,328751,60936,267815
26daeee6f7af55de358e022f01814b8a,130,86,305466,92017,213449,114,99,281610,60198,221412
dfca9d0e952d3bec04c85801bda2b3e2,44,38,63333,14533,48800,41,36,59172,16246,42926
b69b650aa0f2c69c39ab367a0eecf6a6,38,27,35956,11462,24494,41,34,30686,14033,16653
6c475bab49c68913a13cdaff3bbe9a17,211,136,611852,158150,453702,214,139,747995,113854,634141
907829f48122f9a335ae7ad904d4786e,38,34,27126,12517,14609,46,36,41203,11746,29457
1e9395d45427c21df481c34c595c37cc,36,27,32917,16360,16557,44,21,29212,10537,18675
c1d98ab1947cf250d337096bb9e57735,76,67,141286,35471,105815,54,37,84972,28108,56864
ccff70a4bb12bc5390bf5af60cdac64f,226,168,1135050,203125,931925,201,139,726975,153753,573222
0e7f9a6b94dc54215ecf313bb27081ee,110,87,229585,60934,168651,153,122,291325,54985,236340
627a90c0690d82dde8609515f67f175a,46,32,68012,21448,46564,49,35,44074,16511,27563
d23897685e83fc68ce4435204c404358,34,22,15964,6151,9813,27,22,18227,6960,11267
03a06a5255186f17b133825e4ed84e22,182,131,504245,82229,422016,150,123,379382,85870,293512
ee26085977864c544b563a012b12c947,28,22,10651,4352,6299,24,18,11298,3863,7435
a6f39d5368f9f90ca1d402de7da14fa8,85,65,216036,57753,158283,82,69,183421,53684,129737
db7184e2e2629b0b4707acb1e60083bd,115,76,239799,39408,200391,106,81,210243,43355,166888
338b444da9b89cd1f88171c3fd47cd98,226,149,1479884,137050,1342834,232,160,1192883,191111,1001772
8c744a3adc39342a64998541f6640e44,26,21,17569,6988,10581,29,24,14563,6612,7951
72da3ab197c057c7636049d93b0a2de5,28,22,21032,5972,15060,33,24,17942,5580,12362
dcc6665110524cfad23cee1026785830,37,32,37245,13767,23478,44,39,49651,14290,35361
ec260da5813a52a5e7be5019d048ed2e,36,32,39625,18449,21176,44,33,94583,20123,74460
c8ba1493f19f9c178e8da13780a0355c,99,82,277257,68335,208922,140,107,532959,79129,453830
c3a98c49f49e5263b62e956f39edd4eb,60,52,55962,19583,36379,56,49,51774,17013,34761
fdd1a8fdbf67ba6d143461c140b6b811,78,51,103570,28833,74737,62,53,94717,27117,67600
9581b335a411d4eb2274d3ff02a1cdf2,107,80,225272,58249,167023,105,84,176147,40107,136040
ce17def6c28b487f4988c5b008f0c1bb,44,40,75498,20451,55047,52,45,51085,21969,29116
d493569796aa4cb352f6a3d25f9d2877,46,31,56673,16425,40248,47,42,53246,18070,35176
de7d639e607874cea59b2d389b4f3e91,40,34,40279,20206,20073,49,44,48502,20044,28458
c8e2d05cfc69adb9c7026d4fbd56ca7e,100,78,177969,53007,124962,100,81,191295,51065,140230
5a0825648823e8d4d6ae651bf2f2f811,72,50,119281,24760,94521,78,65,114080,43843,70237
ce5040689436efc738b1e84884391ad4,94,71,176277,44316,131961,75,58,143340,46433,96907
f7f7e00bb1e672a33cae7ac611ca2cfa,127,93,264065,62523,201542,117,94,241590,58184,183406
5bbe008c1d13e8062a45b3757145b7f1,77,70,109027,28247,80780,75,55,131618,22443,109175
fab01f81e7f7cb3498db13e5d8989732,46,38,48297,12242,36055,53,38,61026,12352,48674
6760a0c9960cf1a4949aea2b7f11f487,105,78,155613,48682,106931,89,75,135632,44035,91597
a2a4a5e580eb7ed9e3f58f116df6991c,37,30,26436,12633,13803,45,35,42211,12364,29847
ef2986439de279c498588dab21d70945,164,135,481713,107793,373920,142,121,404109,89853,314256
ed327b1a5f3e67745865936c93ae7351,43,37,44056,16902,27154,51,41,37261,22785,14476
2577000c8b66055d164f598b2a814411,37,32,70829,21024,49805,35,24,44954,20043,24911
d6f288065b0f71453c67e88a868fa483,49,43,48813,34622,14191,69,57,115795,23687,92108
2483ce808a3815cc5eceb14562d55811,161,110,369758,107704,262054,183,123,495352,74988,420364
1f03fc0a7d951f41f1b3f7dff4d1b2e8,155,100,367027,40772,326255,106,74,195060,77649,117411
9c2dbbb2cdfd460994cba278e117d248,21,17,13310,5793,7517,29,23,26885,6650,20235
c8ab46141507d068ccd2fc0e2194a74c,129,95,324170,69645,254525,143,105,406499,89242,317257
415d39b21adbb17e48226776c3c72e81,99,69,208920,43163,165757,108,89,223240,65764,157476
d76f05ff6a8b7a9ce287c2fd611b6c14,102,82,199014,76532,122482,164,116,402240,64189,338051
8e9b87f4c6ccf3e83e644184edecd55e,29,25,11793,5753,6040,27,19,8676,3837,4839
72d9be478b0889bc10187993341e780c,15,8,2798,1001,1797,8,8,1477,1704,-227
f740acedd19ef4ba49fe615273c09d91,72,71,137741,29626,108115,60,40,71001,27509,43492
57da712620e858a4ec35f6a48ec4b9d1,79,64,125133,31433,93700,89,75,127489,43330,84159
167809ff8585ebaec93a0a20efac1a06,30,22,27942,14565,13377,31,23,29987,13137,16850
d6516b362a4577938a7522944bc3d4d5,94,83,213920,48582,165338,105,88,268873,33130,235743
3f5d71d5b721db3ea5d50b388c2876cc,112,97,254807,56201,198606,117,88,260454,59697,200757
b91ad5a04ae872cbb01374ddf84e5828,119,75,250821,48251,202570,115,86,276875,73351,203524
40fe55895b43c3b2da0aef856178f1f1,121,91,349865,84226,265639,113,95,293792,79140,214652
4d96747cccf4cd3f186f4a63ceeaebbc,112,100,188309,35097,153212,88,79,147066,39236,107830
5676cb187a6b22baf2c854ec8e334e70,119,84,302373,56466,245907,105,79,230977,58257,172720
5894e0893a8bd1683249df08e8a154e5,32,29,29790,9857,19933,43,29,31908,11733,20175
36126946accf5b27c1f1f11296968030,213,149,720475,159645,560830,193,151,611768,174148,437620
31e71232551234fad28fba6e6098a560,68,54,72646,30986,41660,53,43,67234,28186,39048
dcef6c6e56e2915ae30f8c4963005877,138,91,343133,105843,237290,165,120,469592,96337,373255
7da13c66f8718e798933cf8b783f0184,128,97,236464,34442,202022,94,82,172835,41030,131805
427c2abe8575a067498ca4d4fca0ccd6,131,100,463285,96988,366297,188,133,580043,101537,478506
0572138ab4a21e53239d46805d36a78c,105,83,214647,62696,151951,95,81,195354,49123,146231
426e3342a9254a0b050882f8c114a866,146,111,311814,57046,254768,106,87,261551,66194,195357
ff82e7df04197769e6e121889c5d24fe,60,42,57629,12124,45505,42,36,42323,14304,28019
9b5c6ae4d9b4412199ee89f08d60f8e0,133,104,371632,56242,315390,119,97,257174,58705,198469
e845d6ce27b85f22fcfdf15df152d829,242,160,999106,152312,846794,197,135,1018436,154948,863488
22b666513fdff9ae147c4807f04ad37e,23,20,9310,3941,5369,28,20,9647,4466,5181
d9b4cdfd7b1584e70e00158f2c75ae3b,30,24,10850,5096,5754,29,26,15072,9240,5832
12e79f6188c0f4c5f239c72870e243a6,45,33,41696,17807,23889,39,26,32681,17601,15080
88fee78fdd44f5c08b789afdc974377f,46,37,83318,31310,52008,56,36,96672,32287,64385
b848e4efc17c35f53839e450cfe37d67,92,75,181189,53420,127769,120,87,215519,48603,166916
58e109f855b124eef1356e2d6aa022ad,69,57,93969,39763,54206,94,72,111756,32451,79305
1e5d05ddb01906d4b203328825d7947d,153,131,500136,108035,392101,155,109,388044,72149,315895
7e532f3ff3fced42f53fe625c803fab5,79,52,146113,32611,113502,58,46,93218,38508,54710
94812d22018d726850fb726247ede247,43,28,40003,8913,31090,38,28,32295,9067,23228
29e855dc3ad2950b09c55a0ade243eeb,112,83,309516,68682,240834,145,121,377122,66768,310354
6dfde7a46c62f8b7d698de2ab6ad9afc,21,20,16232,4922,11310,21,18,16366,6695,9671
f570ab878de534d1a000a6ce67692554,62,43,107606,26207,81399,59,51,81506,28530,52976
46ec266091d6b1cdebfbd8cf2f3dc263,126,101,361362,79232,282130,136,107,417435,59131,358304
30b0eb5228126493a910c52e00528b9d,127,90,212080,59707,152373,132,94,359271,52206,307065
87944f08fb972f89a69a7b0f9a3e8485,93,64,228901,70064,158837,94,57,202512,81887,120625
a6e4d7c4e88aafc10c228f09f06375b8,152,125,329561,45461,284100,139,99,256801,34921,221880
8819ac4be87ca05e66374542a0c8a551,93,73,122967,28975,93992,101,83,130922,33149,97773
ce14984fdd60cf2213c612f28958c784,139,110,341646,39946,301700,107,90,239586,55608,183978
c72142441d061f214f30557282fb4250,121,92,223885,58713,165172,116,98,193606,44323,149283
5fc8b6016de8a7f8b6aa9b06c4bbeb49,146,95,426188,141609,284579,160,126,576659,145484,431175
f1ad6c4debc315132a22800d5929a23e,69,60,111482,33564,77918,70,56,86879,38878,48001
2da63f42ae9de15b252657b47b0d7d0e,109,90,185647,38729,146918,84,66,126116,39157,86959
4ba0d23a6f7319ade036411381314980,108,77,342234,64971,277263,129,105,334640,80686,253954
9050b9583f750ed9d184e98d49660903,32,24,41440,10402,31038,37,21,23673,12469,11204
91953404da87610e5d3fe30dee54f73f,52,49,30211,19934,10277,54,42,56203,14204,41999
d9d7c7a4ae963f3333d421b444562644,188,133,698939,121405,577534,129,94,428183,87742,340441
36b2e08045d45b1c26e42eb604e784ea,155,113,573387,97202,476185,168,131,582919,117131,465788
3eff0271432c6c0da9befea54e93f5af,48,37,61867,24637,37230,64,66,80477,27661,52816
5be8056c64ea838d507b72814fe3478e,121,95,271692,59031,212661,167,127,501793,97357,404436
4d3aea1d5cea721df9f8611e18e4af2d,54,44,37762,16868,20894,69,56,66851,9962,56889
7303dc3988b183b99804df6803376678,157,103,461516,161086,300430,162,118,731813,135316,596497
b8948ac384a556789958103c2a3e7d33,108,90,203232,48411,154821,129,107,287849,54720,233129
9c05fc3f1e0de66c1dbc934103790382,64,56,133575,31148,102427,71,63,106184,46677,59507
c14a8eb169bff20a697af0601b7091b0,76,72,95480,29035,66445,55,30,65454,15206,50248
cd41c70c26c9f37b87a4088c726a6f82,85,57,173401,22455,150946,71,53,117435,35752,81683
b08050f58ae7725599fa8cb69908451e,114,84,230368,49487,180881,118,92,221196,38513,182683
593ef4c9037ada1918f3f8b573794946,0,0,0,0,0,0,0,0,0,0
978d8bcfaa3b93865b83a70ebe1a7f41,19,20,5043,1923,3120,20,19,3747,1560,2187
d7042c147e9204cffbd69fe4438038c1,20,20,11304,5535,5769,30,19,11769,5559,6210
1fc3121c6e1f86caeb65fb58b48f1b02,124,77,220718,73845,146873,141,120,309398,70707,238691
8027ba9eb467d3a86d9b7e1cb9de871b,111,84,207056,45563,161493,130,71,204556,43907,160649
5da52371a547641f8aa369c856a756cc,137,106,366918,60100,306818,138,97,260432,54207,206225
7be8c35d5a44e05d99d2049e972b8e0b,45,39,56109,21232,34877,63,47,58328,24568,33760
e7c88d36932a490de2a1f358cd0fb7b3,101,74,229584,76195,153389,77,78,211713,82596,129117
9a542af768082b1adf921ae8bff76a2c,21,18,8580,3687,4893,22,16,6220,4458,1762
35950b0916bcb7e9d2e69a7eb9dc5b4e,98,87,267917,77405,190512,141,110,415287,70662,344625
3ba493eb9ed23431d68c1aa36004cb9e,168,104,517975,123117,394858,163,127,518201,94132,424069
fe6bfbd71eb6b72a28c098d6f0463c9e,118,84,259744,75879,183865,140,116,382097,69108,312989
d245861997ed8380c8c2fa34253f9319,7,8,988,1205,-217,7,6,1117,900,217
c07b4e4b3a0a29472b6b841776381df5,87,67,178139,40997,137142,77,48,129478,42666,86812
a931dc8a913a7aa432323569f63eec1d,31,25,36923,10911,26012,32,28,26069,13429,12640
c7697bbd5bc97303dea65008e9c7cb9d,139,109,320559,83481,237078,164,137,623919,92111,531808
2d0dd857d4b4f58e003965bbcf339829,163,119,991943,200740,791203,190,159,690550,238215,452335
b57a6d120aba35edcf56dc38089ee8c8,166,108,826539,77649,748890,222,174,897165,113836,783329
32ae457bc3aef9df31670a3613cb4dd6,179,130,532610,116266,416344,189,160,656934,130010,526924
1e6bbad67551d8e130455ad580c1c70f,45,28,39186,11125,28061,45,32,35283,13994,21289
d29a4c59396f893acff81e03d3f48f76,141,102,314332,65336,248996,111,74,228559,48178,180381
5452e6875c889ec3b8fd81c3a1b08900,2,1,120,25,95,1,2,25,120,-95
dcef4a488f6b217501224a56eeaea937,151,116,593701,151552,442149,182,129,611094,152176,458918
b9b0b65f490d76640c791355633dadae,103,79,182003,29150,152853,53,46,92283,26431,65852
ac573902212de04454866551a037d801,204,142,1414982,310663,1104319,261,179,1676412,247392,1429020
857ab180a4b3536487062fd8d70d50d7,131,90,300160,75753,224407,162,128,465807,82631,383176
e99b000766ec8f9523d13d6a875fc6d1,139,122,398360,141640,256720,137,101,339094,115925,223169
03aeff7035317e8ee7cd1ce702d3965c,184,158,740057,147277,592780,177,112,606959,131240,475719
fe2eaff52db45a3f1cd411a7e0e9bbb7,13,14,1798,1830,-32,15,8,2168,1028,1140
7fb41d7e68c4db72f5675fa7fb6f9842,16,14,3200,2157,1043,20,12,6501,1312,5189
57277a9ce5aae4ae2a6d3857f43d8656,202,139,1013636,173367,840269,199,149,1208579,173128,1035451
d4c944021dca7ab991377fbdd0ab90a1,147,108,380495,90436,290059,152,119,563933,119104,444829
2b8ab638f3c1ee4f7a37da5aefefad62,169,132,411094,108866,302228,140,124,412057,104536,307521
6d8a3b3a5efc235051153da6e7a3c559,18,16,5393,3937,1456,22,18,6108,2927,3181
eced829ce3b5739e0614c36c750974a3,121,99,160640,56858,103782,105,83,172470,40392,132078
9d81152a95b363ee84a15cf74e14b330,65,53,59597,32757,26840,76,60,126650,30391,96259
5e43987d252b9cebac2926c6da5081d1,28,24,27304,13828,13476,34,32,42191,10821,31370
9a0c76ab24405fd5c1c7741b0857a6ff,131,96,199582,41272,158310,117,83,187889,40544,147345
df8d651a277f3987277cff02166fad09,73,48,143427,40659,102768,90,83,218092,60276,157816
ddefb00cc912015bafec5b85309af626,100,90,167859,41125,126734,71,62,78687,46270,32417
fa6056c2413c79ef68a568f746a2b601,194,151,764259,115508,648751,142,105,604790,89044,515746
9c5c45c5f884c8edb0353419cb0f3d8a,46,26,62653,11094,51559,29,24,24775,15327,9448
f181c911de9036b676c2ef4270bffa1b,83,69,114234,35371,78863,71,56,114758,33605,81153
b3de5e6a17f17289cc906e36588578e3,99,70,170609,33072,137537,68,48,89443,35541,53902
83563127a400df70c7c73c783f4799cd,37,30,48301,12060,36241,39,31,40727,15950,24777
7374d27aa89f98e110644467c19170ef,56,48,95892,31670,64222,75,65,130855,30263,100592
01bc606b982544f59ecf14a6d30f36c0,67,49,105084,38953,66131,55,42,89138,28288,60850
83a2fb952efe00cc2dcb76b673882410,115,85,224480,52784,171696,65,57,127582,36570,91012
b196c5040486a733003c04afbb89c48b,164,97,475587,116831,358756,148,121,501162,125466,375696
cd5c58daa076cac896f8bc6b3fab47d3,78,61,151452,27875,123577,87,75,191299,33755,157544
317650c454508da6df533a491a1383af,200,140,715025,122390,592635,187,137,677466,104115,573351
ab58e348c50473f98e5b0ddd1f030d14,105,88,220161,44825,175336,88,71,164006,46610,117396
eb210b01ea46c1927051e9e700e8353c,108,74,203411,43934,159477,118,90,213905,54872,159033
70a1d78bbab0f7adf10e1995d2d89fc3,29,21,18564,4908,13656,42,33,25442,6959,18483
aaeaf8570c4a3b5191be717bf36f7fcf,53,52,82703,42349,40354,57,50,92181,37655,54526
1b1c50679c683939a547277a3f14b081,151,113,297002,54026,242976,134,92,208444,42191,166253
2f33480099df3df1e48b2f5eb9fef9dd,221,160,747451,203263,544188,225,190,1221839,165078,1056761
c7da8a7d9c0c30b3cb06d869a8f2099a,167,119,524413,70892,453521,110,72,409139,71435,337704
367a8efaa07a0a386776687589fc0617,69,60,62386,19949,42437,73,57,69718,23306,46412
7e70b28d26dce7d1bc174d807ba68f3b,27,21,18779,8103,10676,32,21,19020,7197,11823
8528efc5e9dc8292a5b5b012fda60f92,151,114,507982,123708,384274,116,91,384741,131959,252782
e74aaf78427c9834c0711e6e419c781c,30,25,20312,9455,10857,29,25,20143,8456,11687
f6af3981b00e2b6ba97c8ab46cc0a440,138,93,332540,51934,280606,108,83,278930,75950,202980
9d8a10e70da942d6a824dc63f629b98a,31,28,28486,10843,17643,64,51,57110,14726,42384
176842f998333c173b6ae13fb849c2a3,101,87,196130,51345,144785,123,88,278970,42558,236412
22d8d50f12ccc86690b19a817fec98b9,94,72,226951,52752,174199,102,82,201550,60824,140726
c3af3b7f9b65499365deff07a1dc02ca,122,100,435328,83458,351870,147,102,496515,102680,393835
c905f00e94f2f6f3e002d1724cd3a6e9,199,136,654392,103144,551248,152,107,505850,125342,380508
26e88bf318dd9d8ca03747ff750e8356,82,63,139847,65896,73951,116,95,242480,55879,186601
121aecc6318c84906a130cbd2f5a9587,82,72,275683,79882,195801,115,92,256483,74644,181839
6ec5036db3eaf746b35ced2fbc82e01e,23,22,16219,7748,8471,28,20,24545,8558,15987
9b4aae5af8c106faa1960b1a465c734a,3,3,306,81,225,2,3,138,284,-146
d095974f5780d9bf7c102ee5dce39b5a,34,27,23702,11926,11776,33,24,24208,10812,13396
a082eee5187132811ad2fd52f67d35bc,119,98,407899,93188,314711,108,91,327642,77533,250109
04af5331b5911a1a81ff949036c719b6,23,18,8425,2733,5692,21,15,5425,3765,1660
eb3484cc38615619399c74b46795a36a,137,110,314422,76833,237589,112,88,280226,68536,211690
84f910b059c9cefd5fdddc9d34a07684,19,13,6383,2811,3572,14,11,7579,2382,5197
009075a41349a5fcbc2f887d9ab6d989,31,32,29154,15258,13896,41,38,29997,12637,17360
e07afc3270a87e674af9125facf9a275,222,158,1006841,165005,841836,117,95,677689,193875,483814
7cd1a016b848c765979b031beea01cef,57,39,85984,26615,59369,68,62,102036,28361,73675
31286f53d7d6561cb038a0f704d697c2,167,103,451450,142338,309112,145,103,633285,83865,549420
9c522e98e58fdeab6d75c3261a68b59e,26,20,19762,7608,12154,26,19,21596,5957,15639
d1998dc56fc70c47ae432c6e254fa431,55,34,45297,16560,28737,47,36,51760,18219,33541
6d997cc81e6df2aaf4d17382e5b5fdf3,42,41,30704,16198,14506,48,41,37490,15320,22170
83e5b68b716e96f78595aeeaac95dd37,64,52,118431,36262,82169,95,74,110028,36312,73716
5b822ff68b14c42ab6096aff2f769bb5,65,60,111285,32240,79045,70,61,97596,29878,67718
330404f5d00e185b7f6cb7f23061a580,25,22,8668,4413,4255,22,16,13156,3509,9647
8a488178e01ac8d078f306397e0cf3fa,35,22,40957,7432,33525,48,30,48167,11652,36515
8e0d2f9be67f9f63c75a911872a42f44,32,25,15285,5982,9303,32,25,16991,7360,9631
2bae8b6129139636a66338b3ae7ee2d8,135,107,422770,103549,319221,159,130,529690,136448,393242
fda4d2cc15f87f8620d07c67cee1868a,39,29,28361,8602,19759,33,31,24145,9619,14526
fc1d6b90c14d865d52dc45d3f3b0a148,121,94,247779,82624,165155,109,98,251257,69516,181741
8eec36dbd529657f0c0192f1a56b28ab,112,103,170588,55466,115122,110,80,172636,35739,136897
f604fa831104865318c2e10db9c8cd07,131,108,299144,110114,189030,139,106,365861,71839,294022
aa9505311811f57222f07cf014be534c,54,41,64039,22080,41959,50,32,66043,19347,46696
3e3cf8a627147b8317241b50e40101fa,53,40,85778,26988,58790,54,47,54406,28189,26217
d3a2afe0d8895af906627e6a09c4f700,15,18,2288,1519,769,20,13,3013,1450,1563
63e3edd0cf050ea83e1539c8f8157b42,142,91,270991,69689,201302,153,120,422212,60524,361688
c5a9cf7edd40b3233d0ed647206b647c,59,46,111342,26546,84796,79,57,99326,30615,68711
c1d9e7f0596940be6b64fc53094e597b,24,18,11361,2845,8516,21,14,10132,2285,7847
2ffce6ba880cfa8c016e52601672f15a,130,112,282863,47938,234925,149,119,350924,62432,288492
f05c53d7c3e0fcd20d79ce2d3077a5a2,126,87,258840,47281,211559,125,96,287242,60186,227056
812b1872717c75efc4335b4b827105f5,23,21,8462,3811,4651,20,17,7035,3440,3595
c61211902a1a7205c0d852d6972a8250,10,7,2478,1275,1203,10,6,2057,592,1465
4f13a5ae0bc546a55637b95af35ff268,59,34,69623,17115,52508,50,45,50812,30749,20063
1a405dbac936aeff405ab983a03dd827,144,117,466445,85755,380690,164,101,408933,58109,350824
6b05b039d8174fa23178462b8359fe4b,69,42,113539,23052,90487,59,41,95277,43952,51325
256e0bdf80d63ef5ef9d7a0bb49f3ef5,29,25,14974,8776,6198,34,22,20711,6516,14195
a963f257b7e40748ee2a0b8282753bd7,152,114,452567,168626,283941,187,137,644465,130977,513488
49ffc5a7f8832a7a188e527096bf824f,118,99,258096,62958,195138,99,88,220473,68569,151904
30f9f745111ea6bc397fbf7b81a9b136,144,126,343844,56218,287626,137,101,353648,51338,302310
295fd67e56d3b2e12cbef3359ba43ffa,132,107,231939,52339,179600,121,101,249613,39967,209646
99d60dfd33732d1cc2f535061d003e86,55,46,70156,21876,48280,52,28,72117,13668,58449
e597f98d985db1296858a89e8c981e61,90,53,185958,62008,123950,81,67,213862,53551,160311
f787810a48b23dcc0518a6b1cc6e773d,2,3,368,343,25,1,1,262,302,-40
61192b1933eea2d45e566981d347a78c,133,102,271126,84145,186981,133,95,314156,67943,246213
20eda47faccd589e93ed561ad03e1393,40,34,42603,13395,29208,29,22,35062,12464,22598
20ece6e2c277f0134de067695d5124a0,199,134,649066,138635,510431,203,157,868953,195497,673456
e50de7c54cafc74ab65ed043ca8b8faf,18,14,6670,1994,4676,21,22,6146,4697,1449
6610043ebb69835723d7659f0455a4c6,116,102,286787,66591,220196,108,75,251858,51721,200137
9ec7d98e29eb9541e2561dfb56d24933,137,115,610494,136349,474145,162,106,652318,167381,484937
5a6bd6802d7e8da06a876ee6bfc81731,61,47,82951,23843,59108,61,56,56397,36144,20253
dff0f795d92241fc9a81fde611ec8b22,23,19,8453,3874,4579,22,19,11272,4234,7038
5e33ab6bb3b0cef7c7e41f480ae99262,91,78,204941,68303,136638,107,82,196948,74542,122406
d8967014ec21317974825bdaa72b9621,138,107,410658,143177,267481,175,117,420637,88569,332068
14d44b897e18263230807cedba47492a,42,38,38943,12688,26255,43,41,24244,13909,10335
963378f15c8945f1535fdd5b2b36112b,46,36,75579,31297,44282,50,40,81553,27735,53818
f488c8edcd509aaf82ae9e8727b65798,35,28,29902,10389,19513,43,31,26585,14290,12295
63f72f7874165612a9e170c9346d05cc,34,23,41820,10457,31363,33,25,27237,16299,10938
7a33b5d27127cffbc8ebd194490360f3,61,42,71201,25506,45695,65,51,86611,26916,59695
340ec87b12197f8110705d41c6ff8bd2,100,79,258982,64351,194631,125,99,214875,78472,136403
6968efbc5cc16d94fd7d1bc70f170684,79,69,140902,51168,89734,100,78,213149,59083,154066
880e214c19cae0ecef8d16187cec6835,129,101,409541,99051,310490,124,109,352413,102063,250350
01956496186841d13200bedf1a9aa83f,41,32,56571,21905,34666,41,30,34548,20681,13867
666853bff533d8239a32cd1a5736de33,84,67,119706,33866,85840,84,48,101984,25603,76381
511df680cf89d928f3f6812cfeddcb7a,170,145,656973,115516,541457,178,155,717156,122377,594779
2f5d5067676c409eb530f5d3e90373de,108,79,171973,57706,114267,126,102,287640,42870,244770
5288395335204caf926c0ea6a1f6b01b,30,20,29376,9929,19447,34,24,30280,8665,21615
0848ee58e672e2c6fb3290d61164817b,85,79,137830,76751,61079,107,61,201491,39735,161756
898da759b1c6606d9eb62e5aded15486,75,45,77697,27236,50461,47,38,87902,22742,65160
62f891cf87d9310b5c24b7c1a982c768,39,30,46177,23289,22888,52,43,68916,21873,47043
3f6aed98cadd9a1fec0e8ee1e454a347,32,25,21495,9878,11617,34,27,26673,8164,18509
66d16bcce4592d70a987e38cc4365abd,107,76,182813,53369,129444,82,71,129757,70085,59672
99666eeed58317a1e4cc62ac812c983d,11,14,2669,2106,563,12,8,2325,1275,1050
bcf3c42932ba186002629a7114cd5197,9,8,1172,1309,-137,11,8,2508,1002,1506
0e2867811aabc65219018ba4ffc9b760,23,18,9759,2902,6857,20,18,4299,3927,372
062d3389f5db47b04527b05fabcdbd95,140,114,533623,106113,427510,144,102,442489,90633,351856
8b814f10551cd2ab26f91d932056edc1,176,118,504752,100762,403990,164,132,492309,123689,368620
120dfc1721e54b51b7e686ba06563464,136,116,374820,73757,301063,105,76,220481,68535,151946
64696baa5b618a280420879126029a07,100,67,183795,59212,124583,115,84,249861,79210,170651
9872028541573a93c21b1c4ed38b63ea,198,131,834355,215828,618527,220,179,1197151,191075,1006076
c4f665ee469aa4ff2ba41cdf3e030b7f,123,91,217573,38470,179103,108,82,209032,33863,175169
6b4cd690a311627eaa5aae4edea9951f,110,65,157780,35978,121802,95,65,119216,45742,73474
0c15634adcc1956b0333a45d01d8bf52,73,58,90466,30114,60352,43,37,65972,16470,49502
7049dcdd9502f313234dcff3eed4ae55,92,78,180140,56716,123424,89,71,159971,50482,109489
f17173fcf04bed01cfd758b1785517ad,143,105,553081,115396,437685,170,128,593629,188175,405454
23e52e3d4f28dbaa7b5feff7fdc53ed2,57,44,66429,16728,49701,63,53,51979,16896,35083
ebecf166c9d7012a02bf2d13b573de3b,81,63,118161,42434,75727,124,92,176700,40031,136669
7306442f4c88d315a915ce3a76f29c1f,55,42,66513,26847,39666,75,63,97696,25999,71697
51f9e9ef9b663fab82bb7e3e90e88f43,144,99,272733,62716,210017,98,70,269365,52400,216965
7df5e0d8c4c0b554f9e79cf9372542fa,39,33,75078,18284,56794,40,29,49046,20155,28891
72dbf3bd2f7390d2d506ea720c4c43c4,152,132,437835,106302,331533,112,97,356384,67131,289253
8bf3f6f4f3839ea531c6c4bf5b1cb25c,44,35,61618,23176,38442,63,48,92076,22037,70039
0c4974df4b479237a5add9f94cd1b29d,197,127,830350,85609,744741,191,153,737736,102525,635211
34bb1413514e727dca569325f76b8063,106,79,241321,54755,186566,126,92,276700,53659,223041
ac23db66fbb59400ef16aef75b086346,89,73,231021,70152,160869,108,94,293080,86699,206381
01b98f346c4aadafa460dcb962c03b68,112,89,264886,52893,211993,145,95,297449,64438,233011
fa496b1d05c4ce269827b2d7b3ed97c2,28,22,19213,5569,13644,24,19,11124,3494,7630
b8ab239e44ccc723f6ef8ab68a746786,0,0,0,0,0,0,0,0,0,0
c97ce1989016e03fef4177e188992b99,135,108,282263,60743,221520,127,91,217954,70196,147758
dbfecbec0ae855d30b0048fa6b04bb1a,160,123,497672,87192,410480,139,120,375292,86614,288678
67f7bacae0de869739b3b51b9e2e0135,109,81,261304,65187,196117,147,108,247195,54933,192262
13124d35df97cbca9d0924b41105c20d,56,45,75546,16116,59430,40,32,28539,18255,10284
c8f0174d99248f13d045deb89a09ff31,24,18,9818,2993,6825,27,22,10550,5280,5270
25e8b0b2fd60a3c2e6fae72ee76dcf62,129,112,344586,70638,273948,144,103,366552,65662,300890
1d645a6f3fa1971ca0ce01636d7fa3fa,88,65,101145,37277,63868,70,57,122875,33190,89685
fc99366924bbd250d05a6c34cad13bfa,173,147,1024970,180808,844162,229,160,959027,169290,789737
eaf53198a521e1b5052047aa571ed9a7,72,49,118587,43353,75234,78,68,103564,38741,64823
84885fe39c306fb94470f42e88eb63da,65,60,94738,29893,64845,88,66,134098,19541,114557
f14b263abadc753051e8910abc52183d,141,105,324731,61042,263689,156,106,312462,48577,263885
a2fca0da92ced27700e489a335660f27,55,31,66338,16495,49843,56,46,53493,21579,31914
48a0d652f16ec9c79be72504bd87f2be,76,66,111663,40634,71029,68,52,112065,52570,59495
3a9915114af60f8a3191ab46d0db6726,117,80,225128,45132,179996,86,68,165296,41911,123385
5b0c2c7e18afb5abbbe5164161218a4d,136,106,399380,115230,284150,170,117,874521,133747,740774
5f7e552cf5c8e61f15451f09680d0daf,116,88,217529,50446,167083,108,85,185719,52874,132845
f872ad5a4c8c3097dbf91fdd51ce4b20,147,119,414517,97847,316670,123,98,305467,91141,214326
5c66c450dcabcc7b4dbc51f4bbb7f3e0,90,66,133925,33814,100111,74,54,91616,25899,65717
c7ea3782596ff8ad2e1c67fab331658e,48,31,71506,20872,50634,38,32,45323,25904,19419
8f5575c0a2dd9f6469ce6e3da58e0455,69,54,143218,50477,92741,78,67,148976,42047,106929
2a22b728e297ad65dcbe6af82fbb6001,175,132,861466,249626,611840,200,159,1171745,275555,896190
86e7744a3a6184c2f02f8fd017add422,45,34,43712,19131,24581,41,34,43778,14729,29049
4fcf23bd63883c43ead34a8a83d4c385,1,0,68,0,68,0,1,0,68,-68
47bd880d59fae4c680ecc61c45a01324,77,50,115705,35316,80389,63,49,76832,31893,44939
e316ce085d7e3ccd3f831c02fb1388fb,60,45,89594,29512,60082,68,61,97365,42775,54590
6f7910f73a4f47427033a25fcd39037c,139,86,312149,90342,221807,176,111,368894,89535,279359
51e2fb1d129f97d53aa8d7a1730b9685,175,125,494527,93258,401269,194,143,598228,160358,437870
ee591fa49c9fa8b36e4de5c37bc67499,96,75,226021,57902,168119,95,62,229113,36140,192973
c7b8c4d5f0b81fd133c7deb2279f6ea5,152,103,480316,90085,390231,122,90,308010,116153,191857
8cf22fa863397d94759dcbdd5186b8a3,124,86,254798,62080,192718,135,123,272168,77035,195133
3b1c88263a37d16eadd4fd4365f9b68c,166,122,647489,170977,476512,155,118,672902,166708,506194
c5976ddf90f44e8757d42048326de6d7,31,25,30475,12283,18192,38,29,28152,10372,17780
03e8e0cd1828dd7607240f6edc90eeea,71,60,109032,34537,74495,83,84,112513,34699,77814
614f3dd987365bea63803c73afdd566b,65,46,127407,31778,95629,100,85,174599,49312,125287
df661473df9a8d1ebafb08442866aa15,60,52,139052,27446,111606,70,50,80135,37247,42888
864dd4cfe89da45398d5249c15b5b59c,121,95,339986,77976,262010,113,86,303251,74684,228567
10f24e4d8420e7498e1711e90e446cc6,21,11,4865,2219,2646,14,16,3454,2382,1072
e23db155dbc1f96987b964b3146cff3e,90,76,172702,59146,113556,126,98,216496,51888,164608
e198b1379e2d140c04edc219ab953567,93,65,203579,44939,158640,176,132,408597,56980,351617
a04c7a973bf536ab4445b31b9b59d90e,40,32,46908,14519,32389,42,41,32117,15786,16331
3024799c4ef52fa64e7af1cc271a9c45,163,123,498323,108939,389384,187,141,653217,124639,528578
bf3a399288765947371a20afee602c0a,40,29,37271,11973,25298,36,35,38308,19733,18575
43e9d1fcbf539a3c9cad23065bed7297,40,31,44940,25204,19736,41,34,62173,17035,45138
b8c83881f18025e13fe46ec598002748,131,117,439435,75340,364095,113,86,259715,143680,116035
dc18e0b98bbd4b70a5b4d5a22620f414,51,46,55201,28494,26707,79,60,96357,19463,76894
ec54e53ceb8780d00ee03a8ffe0dad39,99,78,171590,32483,139107,113,103,211562,32670,178892
91407fed31d8e77a69a73e64c87cd938,153,120,816659,207576,609083,211,143,776420,182446,593974
3cebd506bac6c100c2966211e6ac6350,99,79,214604,27944,186660,101,86,193297,49506,143791
9e91d3bf21b6dfb033962b3496e25509,181,110,932860,206869,725991,239,182,1302593,204807,1097786
cec3a8d40a5b81cafa0edf76e5dffd43,32,26,21318,9129,12189,32,23,23252,9757,13495
a46714fab0deaa7ec67d8fd518590ab5,46,36,46249,9895,36354,55,37,43017,9926,33091
241b592a779650f42f6cdfba0466ad7e,143,110,346114,76111,270003,125,92,331557,89827,241730
6613cbd62e6d6031b59f2ff7e851baec,37,36,37852,21866,15986,40,33,42442,14846,27596
c4ec09e8bf7abf5429697dbbeabd9a26,46,37,32211,11142,21069,48,40,48877,13018,35859
ce93d21f722bb6414769698915728fa5,52,41,67932,22657,45275,60,42,83420,19543,63877
09d0b2d2f0dd94c87aaffca19ac963c3,82,76,149747,41680,108067,68,54,98502,40044,58458
ad7a78bcbb1cacf65079f6430099885e,126,101,314246,105369,208877,130,106,348203,94116,254087
f9e3c70a2b7695beda3564672e31cb65,182,146,567581,144597,422984,145,112,425686,144832,280854
fc1a465e689f16629cc0dd6ec448884a,85,71,157353,63149,94204,123,89,269453,54313,215140
f6b57acf08ebd92eac177662dedbc225,117,96,245910,76159,169751,111,83,225476,50191,175285
b08bb44e8f5c65b83190a75f0ae3fa45,52,41,71419,24324,47095,64,49,80674,22040,58634
eb024dca322badf9194a769133bfe446,29,28,15690,13121,2569,36,33,27188,10726,16462
46bde440891e4b48752cc62e947aaf6c,103,98,205979,47559,158420,90,64,140340,33282,107058
89943a6a3e31f42195749365a9d17161,102,88,231524,47517,184007,102,94,194123,59298,134825
08513a947eaa80ace29adcfdb38f2186,141,112,477703,108142,369561,158,100,451101,102678,348423
b960307d95e3525e18a7cb29f48c8aa6,137,98,317064,91009,226055,128,91,312114,83679,228435
d88c94180bd45485f400500f58f8a772,11,9,1842,760,1082,22,13,4261,1330,2931
c3b4e20f4e1cc9795e989794ee96372a,85,64,115053,23012,92041,76,54,86446,18675,67771
a96c483471cbac9ce9200ff3ce208547,42,36,49741,21154,28587,67,48,111759,26063,85696
1d6555cb973afb3f9a3774a4a4786611,98,77,176046,35087,140959,83,64,95766,45471,50295
0862840a7dbfd98c86c3a09fa5679bf5,131,97,267549,57660,209889,101,84,195350,45097,150253
ec0549f06b8b3d4dc2f458feee551e11,147,107,419913,79459,340454,177,130,512171,125429,386742
fb6a377f6c6c0a97fd16fc12446d5379,16,16,5220,2368,2852,21,13,7584,2167,5417
ef2102c12b9ae79ffc5223e29283eebd,39,32,32513,17805,14708,48,36,53213,18450,34763
014329c0e212ec75dda0f67b70147a61,39,32,60679,23134,37545,38,38,61114,25779,35335
122d0b2e495191f3b9483d36cb228580,140,110,314341,65113,249228,140,114,276933,49213,227720
1409b1fd7b8302466242a3c2ec60f226,103,83,173974,37269,136705,122,80,186273,36944,149329
2a977a66ae9ec6de35c8f0b195af3e8b,17,11,4887,1184,3703,12,12,1796,1467,329
d74c7f2a2cf6c3cd34024aff2383f163,65,45,94577,21731,72846,77,66,138426,33181,105245
3dd1b69907bcd9884734fa272fa9a243,114,101,301996,97724,204272,112,80,293340,56429,236911
f0eeecf7619247c303ead4ff2ec87d3c,146,106,388103,84453,303650,182,114,399625,80342,319283
c2ac75186025eb76b2859875693859ee,88,77,152432,56233,96199,114,103,242166,53416,188750
286e51863299db7b5bdc636ca0fe79bc,182,134,473907,70315,403592,108,90,296238,105041,191197
4c5444ec41e2d574f2c1f67dea346daa,56,46,88809,28939,59870,53,36,64273,27955,36318
f8aa23b92d58a8b3d182c87ccdce40f4,94,72,109703,37491,72212,82,58,93856,34385,59471
d506f1841565720d212e4ce371962645,15,16,2076,2501,-425,17,11,4035,1063,2972
f36900235ffa822ae0653ffca4de2b57,194,165,977902,195195,782707,193,131,820521,127975,692546
27b40541adcf8bc731c5554e3f71b77c,157,130,601813,104032,497781,160,129,608492,122550,485942
9aa0ba34db9c666900310160625ff6f0,31,24,25444,7826,17618,30,21,16538,8668,7870
980c329bb85b0a6ca553c88341b9f9ac,103,79,182917,52654,130263,92,72,154695,53770,100925
a4e0133665f15118b2496a9b7db58ddd,128,102,353825,63258,290567,157,132,592647,98081,494566
f4d6d228b80760239cc2fcff196f34bd,70,53,83035,19101,63934,45,30,64506,12535,51971
e0e8cad699b4e635365b4937ddffcbe8,41,31,45398,18660,26738,35,27,56479,15602,40877
6a83bf4ecdbdb7af6a0fed9d2144e587,60,46,82739,34569,48170,62,42,98991,25067,73924
566b38517d58306683ebfce55124b90f,157,85,294432,56138,238294,97,69,175427,51258,124169
c1e697e9f15747df917481d6f5ac1692,39,28,39014,12125,26889,39,29,29447,16660,12787
4a4825ae36d386230bbc37f8aa1858ff,72,52,112534,39626,72908,98,73,159911,47307,112604
6b04117f1b03d16355a70bb6498fbe93,126,96,262715,74927,187788,120,104,282499,51608,230891
82836b4a12679df562031a233f245e42,136,93,289485,53689,235796,127,94,300586,75333,225253
ccc1396f047c891d4625d3ab0540a83e,79,60,77733,22633,55100,73,63,75097,23252,51845
edca56b46226d84f396f6180dddab806,172,129,473883,80868,393015,193,113,453062,72608,380454
a4deded8a32af74ba2740516f5c1b143,196,127,842164,146922,695242,193,142,661851,113149,548702
496ef74df4f7ecb713c3c647823fb390,23,16,9872,4021,5851,16,15,5504,4711,793
88300608f817a7f01de1b6710f124979,163,124,451086,145883,305203,114,85,507839,127540,380299
ee45d6965ef3a6505788ff865cb25b6c,17,14,4639,1475,3164,17,9,3959,2635,1324
b3fba06cb0cf1c7ca1d62bda3cae7e46,116,93,227919,36184,191735,97,64,174034,38555,135479
de24bf13e36a3992bb3ce7350382f8a2,5,1,529,118,411,1,5,118,529,-411
b7b3d1e3842f4856ff281d417ee75c64,80,59,129074,55262,73812,106,78,174747,66455,108292
bb509d3c42eeea0e959e0352b008f6b9,20,18,3884,1854,2030,21,17,3786,2351,1435
81151a2d2e397ca06633863a45ff4d74,32,27,18630,5214,13416,35,25,26462,5108,21354
2a53ba588e45b039c5bf66bf195ea98a,46,35,31989,8153,23836,40,28,25443,9555,15888
6b1c435bfc3fa5e360d971e06f3ef759,54,38,86665,17286,69379,42,32,38451,21550,16901
c7b8ea4e27052a456777e8b0a5aed286,94,72,140118,57693,82425,90,70,151408,47711,103697
ced96649bd126c67e0f97d9efa697954,52,42,92107,24716,67391,69,45,95685,30114,65571
c93d35c7f3bbec87195d6e9464c87892,157,85,377009,57298,319711,122,88,304403,71270,233133
ac7d6e709ec3d05d6fafc48a9610d8e9,144,104,434884,78392,356492,109,91,277854,99742,178112
2b30f76eb59635cae37b798f7b99076a,93,71,174910,48055,126855,113,102,212944,56958,155986
2e89b0983cc45ee92b1f120d30608fc9,156,104,245722,64919,180803,148,115,267673,73546,194127
73edde2b676829630c234605f8c1f841,63,50,88545,17848,70697,65,33,71005,14457,56548
cecbc3fb3b46e0a192aa6f18046bbd66,54,34,73426,17793,55633,70,40,83731,13699,70032
3bfa09ed48124e23423346156f003f50,142,84,395630,67977,327653,146,108,278168,91101,187067
0ca0db65d4a2a10650d0f34ee2150555,148,111,694590,126584,568006,189,137,1040645,161183,879462
454a1c24d04c6beffdb2a65317313a0f,175,149,663837,154229,509608,212,144,750491,101639,648852
7f4a1e9a01cc93a4607abe1063f7b7eb,72,55,125849,27840,98009,81,58,126071,43611,82460
a905072af9a52fcd983c59916cbd66dc,88,67,187124,57275,129849,74,54,137717,64276,73441
e47c03791c25971d9ff4b2aee680def8,99,83,243839,83988,159851,126,103,303517,73729,229788
aeef02d7e847afb528cb0d27057a62a1,113,98,227650,67020,160630,81,70,187600,43540,144060
c5826c56fd0e300ebb51c227388b6dfb,51,47,54105,22603,31502,51,42,60947,22768,38179
a73adaeda455de0e9309dcbb6fa99c9e,105,70,243945,73411,170534,137,100,340276,102718,237558
e376ba17a0fde057f56159e6426b811f,98,86,234652,82945,151707,156,111,414777,66555,348222
22cb88ebcfecb0cd289cf80247eff89f,127,94,329201,76959,252242,133,98,342644,72615,270029
38409f3ba92a2732e5180df4378cdf8e,70,60,90223,29135,61088,73,63,111228,28194,83034
3cfb8fe4b7ab3cc75a99ce40c5063c03,59,42,94593,26244,68349,69,60,109821,30469,79352
1fb9a8dcf3d2a8ecc0a6390e974d44e7,175,118,366711,72826,293885,95,75,209116,68267,140849
5fda3f155c5a64d4518e70d32b69c7f6,118,86,289622,70178,219444,171,133,459105,87789,371316
ec69188ff2922627617b54632df2eefa,155,106,430766,86635,344131,162,146,635440,106060,529380
16b0259645f5d3a16541ccaf85c4c8dd,56,45,113961,28441,85520,48,40,73264,32809,40455
f38543b9a232a9d85e693b5338517530,119,82,225557,59139,166418,84,68,200074,55527,144547
e8516ac0b1169b81f19ce6cb56d57fc1,181,131,614030,96667,517363,203,149,535630,132141,403489
ef98e616a6f8bfcc4383d254332475c4,142,111,545555,144822,400733,199,155,781611,113118,668493
6c7b46fb59eda719bc5343740e53242b,113,84,244480,62086,182394,168,132,336500,73917,262583
9b80d6c9a98828e87b0e7b884201d549,48,32,41291,8578,32713,29,30,32753,9814,22939
4139726048392d342375fc6de48022e9,80,51,162601,36331,126270,86,57,155354,31383,123971
ed390acd38520f7bbab3adbdd8d6ddd8,120,113,293614,95138,198476,106,77,247032,54242,192790
3f7abfd1603dfd79482fe911836f13d7,53,42,57016,11831,45185,39,33,38913,8675,30238
5207796e9143284aa0ad1a14ede6bcc5,37,27,52153,13512,38641,43,35,40425,18771,21654
ffbf7b4868b167914dd4894a1071167c,24,21,18946,6051,12895,29,16,16059,5945,10114
f5a70f1b1aa5b6cfd0838a4248c8b2f7,126,95,238016,80764,157252,179,153,521712,85319,436393
215aacd97648ac50b15742cd5ad4c8e3,111,87,276305,87262,189043,123,92,389192,62422,326770
4f36a04e34e3213078ba66adcc816e39,15,11,2308,507,1801,8,12,1102,1129,-27
ab47a72a00b83c4b259a2028c22fba05,136,117,359847,56652,303195,112,90,260268,59349,200919
35f625cf4e53af3246af1c0dd252f803,73,57,148869,41292,107577,69,60,128767,48172,80595
57671ada1c5d883b5bc84eaeedbf7bd4,99,75,229145,44243,184902,93,71,154629,51737,102892
4d934b2eaa6923054518aa826f74c5c1,39,31,56021,18152,37869,61,46,94553,21169,73384
9b1a07bc3aaa03ca824cdb313986ac72,131,81,253977,56609,197368,130,105,299444,63298,236146
938db9b007c54106f8e2f20a26df2631,120,93,225307,55038,170269,102,85,223750,63863,159887
6acc9bbc5680c2ca728577648e059cff,36,26,22038,6475,15563,25,22,24620,6461,18159
f9f5d88ed7bac4d04fd118075ac87be4,27,18,10350,3023,7327,22,15,7972,3176,4796
13bc1e50d9bc5648c5e14feff20bdcb0,190,130,916275,186357,729918,190,155,1073077,199259,873818
6494fa4d028b8a2b670ee2e4c4edc85a,32,26,32674,12678,19996,28,25,28326,14577,13749
fa97eb677d13385f684f25a9828d9955,100,75,242154,62667,179487,125,86,312715,52829,259886
c03c8133c3b7f5d3a545b822599fc058,229,177,1055765,202107,853658,217,164,956495,162984,793511
679d7710b913362f27078e242c301faa,86,68,117350,37092,80258,59,47,89491,27283,62208
deab5c7f48b9483379fd907adb172882,24,19,4549,2654,1895,22,20,10056,2323,7733
6b618dac7db5db34c70759acfb612d63,73,51,88029,22723,65306,53,44,65708,19636,46072
1dab58da8c68c7b336a06b3ce418fb38,207,149,1053996,113308,940688,222,159,695499,132150,563349
8baa0389232a7ea7efd73bede276cbd2,41,31,37945,18769,19176,33,28,30433,14878,15555
d75baa5925d734c76e05f9be36b99f15,40,34,29960,11591,18369,44,35,43774,11976,31798
a48e920cc2c3f28969d9ba76c5331c0c,83,65,284746,78441,206305,106,93,331172,117865,213307
ffbead019e5af8a89a828fa753dadd9b,118,71,260656,62193,198463,159,121,306047,76209,229838
1f9906bca0c0e6d176b2695d38e250e5,34,28,25346,7798,17548,28,31,25086,11146,13940
8402ceb32714820309c3d58602e93200,67,53,72281,21395,50886,54,36,52414,16233,36181
20ef23a095a51ded8cd8d803cb54b3c5,155,107,311846,57121,254725,133,90,220421,61065,159356
bcc8b54da369cfc3bca29f04d8872632,29,21,17526,6769,10757,32,21,30052,5590,24462
f700507ac8790af8c78a987565920431,24,22,12040,5282,6758,22,19,10774,5796,4978
e1587103a99b8e106e59206415f4192c,96,76,140630,36151,104479,86,69,169726,39913,129813
fc02529e5c17a35b431106684eec8423,99,84,169947,44437,125510,67,47,101808,39936,61872
e8162cf116b8b39cde06a7b7ab7f4608,164,138,421146,132659,288487,160,125,447359,118760,328599
659d3ee0591121aaf77d85ed00dae116,84,69,131583,26935,104648,96,85,151393,42124,109269
d36da2bb8e9afba34b755e285bd743b9,84,76,114740,36444,78296,81,67,123376,34904,88472
ab5065d47677c479cf4450669e0a58ba,244,185,1301050,289323,1011727,204,131,958317,181567,776750
07c76acb3e9aeaefd6cacb9b9774a622,45,40,52131,17601,34530,57,46,55262,18109,37153
308759fbdda793b65e6b04a7fb26889b,50,47,44971,13952,31019,44,28,41237,10011,31226
2ba5a2c46372092006f0edc622715ffb,121,72,293123,80841,212282,170,109,362675,70358,292317
85cdab170f4da27e83d6dadf944af72e,94,72,200440,52771,147669,77,57,166392,40289,126103
b3c8a4bfb658d2404d859ad2cbb10193,122,106,385284,113822,271462,178,125,609285,78488,530797
4a8dd172ed7041638e2397b24eaae3a2,108,93,232708,61142,171566,145,105,339458,67267,272191
1c1e90dd7628b5ab0cf212037c76aa3c,103,74,163287,44868,118419,118,80,138427,60981,77446
9076a47846e93ca75f760d6356312654,153,117,525960,62961,462999,153,124,478436,64822,413614
345cc2b66bcf5ecf98442bbff92e3bcd,84,65,118708,33835,84873,105,82,130190,28274,101916
79bff601f43c399cebb7f04bff561728,16,16,4199,2617,1582,18,18,3985,2514,1471
48ec3ba305bf2304fcfcfbd3a85f6252,141,98,270216,71142,199074,150,95,280795,61481,219314
39182de68dda84a289b1fb0be15a76d2,25,20,12304,4327,7977,26,12,13249,2571,10678
4571b67f0b89f73ac4a48e8900860e54,64,41,122970,58989,63981,106,86,211790,76970,134820
8efb1dd5447893bf4fd438c65f0b354e,84,52,173905,47819,126086,47,48,94425,52621,41804
a7aec4bbeed2a4fd313407d1e7b7518b,105,62,170538,26646,143892,89,62,132482,33623,98859
de450e262816a6221a566ec14ecc47f4,120,87,241002,49659,191343,106,66,240925,36446,204479
cf24a2af2adc987f491dc1ba21e38e51,6,5,438,595,-157,6,4,788,149,639
a344c15739ef477670127f546f9fc64c,177,152,504796,150056,354740,141,115,498755,170745,328010
81180f7da07d57ac499b953862792203,117,87,339298,142823,196475,148,108,528823,90104,438719
49c98800294ae6d89b1a0819c9ca1b1a,114,82,236556,68377,168179,85,70,214300,81892,132408
ee86c0b8eb9226cd7f0182f5167bba66,33,20,28861,7072,21789,26,25,16989,11159,5830
694b999bf378bd564c43ed5303296588,10,9,1852,1689,163,10,7,2108,1573,535
c65ac57e959ca8051a1ddf9a924277ee,81,77,127157,25653,101504,59,48,72859,19335,53524
b2be66541bbeac1019fe1bc18c5502b7,133,95,358443,90971,267472,179,135,555167,98426,456741
299bc65cc04064d7d897a998489cfd27,168,103,277895,44010,233885,136,113,226625,49344,177281
1ec4e1ffe707bcd63ecccce4f2432b31,106,80,157564,25067,132497,96,71,141504,24713,116791
8cd08eeae44ba6bf804c9bfff333b4ba,52,42,72734,27660,45074,52,45,81212,23070,58142
2bc579c82dfd9870cc798e5114ef51cf,31,19,17113,6862,10251,30,28,21112,9403,11709
cf6061d6a39b374ef6c0c40e14b87a54,55,45,46814,20787,26027,49,38,66295,20406,45889
da7e8412b595c52bd5b943ac5024323f,20,15,4597,2014,2583,18,14,2998,3352,-354
390ab23f8eee222f2a64bb51439f6814,91,76,252797,124537,128260,155,111,415824,79093,336731
54fe933dae1e6de257523ac4a4917e85,40,27,58969,17669,41300,34,30,44147,18469,25678
f4ce8a5c2ecceaf88f3b1a4fc8afeb8f,85,53,128454,27036,101418,98,72,117327,28557,88770
e9858217ac4aacdb96273f8ddecbc1c6,39,23,50234,14038,36196,43,33,61858,17052,44806
f3fadddb27018af3a2a6fac0869ca023,59,41,54412,23608,30804,44,32,51688,18503,33185
2e70b42efd139647b53215031ef35771,159,131,520227,131426,388801,168,110,603209,104863,498346
5fee4f68d05d9fe09af3a7cc92b2a84d,50,41,81167,32538,48629,87,66,135190,28295,106895
6fccd1359fa5be7c2d70fa298a65181e,58,53,60481,22161,38320,42,29,47668,13019,34649
9c1cf24cc94a9d2f44fd26ae0eb11424,23,20,11397,6966,4431,27,19,17857,5881,11976
693640868a9497591e99e33efd024332,31,27,15321,4909,10412,23,13,6637,1668,4969
a45a31745ceab62b53b10eaf4278cd2b,74,63,112633,32730,79903,66,51,91894,26978,64916
01da522a79360ee0fcb76f619e6630b5,160,120,556106,83160,472946,159,139,557459,104464,452995
671033f1e6a61bb4f7a28c47fdf19d41,142,111,392887,83544,309343,126,87,353025,85377,267648
c2912a6e0f852923d1f8135f1dd2b376,82,76,223042,76671,146371,118,89,276516,70071,206445
46abf7af274745f99154076a2c7623a0,97,76,171737,34415,137322,91,67,143983,36378,107605
5d4d6e8fab7f9ed34de50448ea568a19,18,15,3292,1208,2084,18,15,4531,1680,2851
13d00735cf262a7f10ab9ae859c367c9,78,61,129330,31034,98296,57,50,89717,28561,61156
62166e862b2b2e199b3358fc2f15a4f1,72,59,114762,32078,82684,66,38,123015,35310,87705
e69d33c24416ac39e67c8d209b6d54e7,78,58,96930,20779,76151,52,52,56479,19172,37307
6a9112ef32b813ee999dc24fee23206e,27,21,17727,8397,9330,25,19,17654,7450,10204
c82bd56f228fbfeb34c4233bfdbf494b,163,131,496167,127996,368171,150,124,503276,145054,358222
11db2d85f16b7e7a18753dc238d4a38c,4,3,542,897,-355,3,4,897,542,355
5e566273d6707ed50dc4a69f1fe143aa,54,48,84682,31405,53277,79,44,105627,23327,82300
c1c86b521a7aa77696896c9f576c7695,129,102,477245,118369,358876,140,106,521084,130106,390978
6164e685ed98e59a156a54f36c77947a,76,48,99710,21960,77750,79,62,104249,28386,75863
4dc0feaaac9d8941f791194fcb71c736,192,146,685744,122520,563224,178,142,644869,105201,539668
8461dad0df3afa867079dd68e9c4c173,92,75,175676,40708,134968,115,90,192322,43421,148901
967b475512f14fbcf573a671b9a213fb,50,38,42496,15296,27200,37,35,31817,17233,14584
3e14ed2673efe453088805532573ec87,49,36,58740,26388,32352,60,39,94668,26146,68522
e771aad9be7336e3a72dd17a7ee8f964,114,64,227051,27931,199120,68,63,100161,54582,45579
b2a0475033058275aad389c1a9fe9908,80,63,126181,46135,80046,79,59,138829,37831,100998
74a3146381fa19b9e605070c7a2cd7bc,114,86,290889,79195,211694,135,103,329769,76868,252901
3a2a5c17201e344a2484945203533402,148,123,290590,59378,231212,134,81,204845,51566,153279
25b7cd2c3882ffdca5cbab54a5705d42,143,112,294217,59440,234777,113,91,234147,65624,168523
8e6fcefb14c2d65c98d4b356851479dd,92,65,162632,32165,130467,90,63,119520,40038,79482
3cb1075828d826f1fbce9243100329d6,104,77,233990,75124,158866,80,67,125244,68851,56393
2a2be2a4cdc34a5d3f3c1ab6855a324d,71,61,122867,49977,72890,96,86,175568,49387,126181
d707913ca35853a103b76483a0eed0bd,28,21,11686,5127,6559,26,21,10805,6332,4473
1fb85b3aea3da560115a02b86b44582a,29,19,16887,4830,12057,26,21,15837,5652,10185
0c4f243ed97959c672d9fc476231039f,69,56,89856,27967,61889,81,61,102588,23847,78741
3f9acde225ad030f9d1b23636e8038e4,51,46,68583,48123,20460,84,61,127661,29412,98249
4143c6ffa383d28f869931c12cd522a7,131,114,315112,75867,239245,77,69,129196,92364,36832
4d86d336bad681b8b0faa6333a2d2585,171,139,579133,118302,460831,169,114,578588,85374,493214
a6c34723e023be1365271629a05dab1f,88,71,143458,50064,93394,76,64,142570,38804,103766
22ed242085b4963e1ee7341bf56b57d1,2,4,123,95,28,3,1,85,37,48
8d006a556f95ad0391db017cdf789eb1,28,20,23413,8627,14786,40,35,37918,11540,26378
0e7dfa05fcb63d7a8ff7b716ac6c600e,72,60,115110,33406,81704,59,50,91553,26784,64769
1902f83ed2ba9902f530aa32953abbd6,65,57,111213,34036,77177,60,48,117075,30246,86829
a2467a30b0fc1601164fa8f565fa9d89,48,40,51595,15540,36055,42,28,40135,12210,27925
7f49113e418d9da5ebb559040c3c9efe,63,52,58988,13664,45324,50,36,39531,10840,28691
9de7300ac079e215c9374f8501172da0,61,40,106111,22365,83746,49,38,47679,21865,25814
77afc3bc55fd3c8840983a80b565951a,106,70,210484,56858,153626,127,85,215579,63754,151825
3eaaf6c28b9e70e04849edca6f562e4c,146,117,445894,81774,364120,107,92,320056,85154,234902
139014cd64197e348634ccc0679ead60,95,76,132881,51008,81873,90,72,149199,47266,101933
638d8b1ffc841af6a91d171dbefbd225,109,86,234957,39174,195783,111,84,303028,42126,260902
001b0dcf31ce1acf5c9cbb613167d53f,97,80,222873,51293,171580,112,74,161368,57601,103767
72c6dd2723ffe3eb3a56765e23cc4533,80,68,153549,70050,83499,123,87,247645,57178,190467
bf39354f673a5781ca79703397a9432d,27,23,17508,7901,9607,29,18,18711,7677,11034
fc8839e692ef604ab4bbe9dbb25bc7ec,121,92,301964,77601,224363,168,109,445789,62811,382978
40560518283261c5add1f0f2bd29e74c,74,58,83265,23800,59465,59,54,93664,22328,71336
0762d0c5bd32ff9093b37eb8e765400f,5,8,664,450,214,6,3,856,251,605
4993eae71c3129617f0f081052bba41d,74,57,67442,38938,28504,95,72,125272,32059,93213
9b715fe8e617163b691b9282ae475658,54,45,72099,22661,49438,39,32,53455,14586,38869
eca211262a3b492fcf22b7c4e3d3e423,35,32,32568,9668,22900,34,36,28747,13785,14962
d5f84ea4e361113ccbfb7a7a906158d7,111,93,330672,82258,248414,150,119,480473,78394,402079
a1fe95e07f321118ed04e9a8a7d588b6,57,50,81370,34403,46967,81,69,124934,29610,95324
2f9e7e8aae586e46ad7063569fcd6fb9,22,13,6427,1180,5247,19,20,3714,2713,1001
88e5508b4e5b1b418cf0237abf03c1ac,124,107,357317,74605,282712,125,95,341226,46377,294849
84c8eb06cb89cd6be137ee155b4e3f1d,175,115,602036,99259,502777,168,128,620094,129531,490563
2650057c7054c66fee66ee11eed8c28c,124,102,270116,62598,207518,108,89,237809,61535,176274
415339930ead63a847a4e88122c5bc8d,38,34,42451,13484,28967,47,40,33064,16107,16957
da36f1794f502049b1be53910b8f20ea,180,128,468731,78134,390597,168,124,380405,77838,302567
0944870e78d294bfa120212eee5112f7,171,100,319630,76495,243135,94,64,251152,84480,166672
f8f7633bd25ecfb17d3b036d75ff8f90,142,113,537240,165148,372092,192,142,770962,147084,623878
9b4322122e7cf5dc2f17b4e837ae94ea,115,90,239732,89064,150668,159,128,390342,120545,269797
6fda2ecccd594a6896e785b805ec12d2,131,93,338100,63055,275045,132,104,344585,46827,297758
38e8738200fc8cedb5c2af13bcd16a2a,206,136,604307,73421,530886,173,132,457271,78236,379035
ba39b651014cc325f2167071cdbfe1f7,24,22,9901,4467,5434,24,19,9623,4092,5531
7b60e02834cba22a90b39cc0d60f161e,72,58,83632,31878,51754,77,52,92246,29502,62744
c64a98f7cdb013e257077e9fb226f2e9,105,87,164945,23781,141164,108,76,139947,36344,103603
4c30f04332fadeee68a85719dbc68956,16,11,3266,2131,1135,14,16,3905,2340,1565
db73f539154d35cddc59df501c1a3464,25,20,12445,4981,7464,25,22,15181,6541,8640
2c295db41ca52d1c43c771af3127fb9d,59,46,69787,19322,50465,44,40,48141,22573,25568
137f41dc22734dd63c9c673a27bf4f6a,50,44,76660,24013,52647,41,25,41586,19041,22545
e7df00e9009b6dda71732161b74f544b,96,76,193494,40333,153161,75,60,117761,30076,87685
318f2ff2f2132cf6b90c7ecae3039382,106,62,150021,46468,103553,92,55,161783,36440,125343
7ef715643663637d47ccf171d4eb4e7e,53,37,54880,19859,35021,41,33,61193,17815,43378
72c08e83f3aa4096d30141cc12714b2f,25,16,17583,3796,13787,35,18,23618,5251,18367
4aae38c6ebf99e5bc2ea3a789e0d1456,132,102,298054,88800,209254,113,75,211274,61824,149450
3216eadffa42c5fafd8ee149b4472d56,173,138,548594,94330,454264,151,127,394820,123316,271504
1e9754947a1146f6cd31d4122581eb19,195,141,469676,87957,381719,150,130,356863,119774,237089
3a0981caf97b811c32fa1604492b6a85,120,105,361700,99882,261818,125,95,381643,98529,283114
b326996a2da4200deeb47489e0bd31e5,106,69,164371,37417,126954,118,89,215159,41547,173612
4352dec4721b6070f00721b78849761c,84,63,197688,64864,132824,162,123,502968,67477,435491
c40668768f8857fdf05f1d750b579018,117,80,223564,70544,153020,157,136,304956,84355,220601
1134c6e55de78b128ee956eaf61a32bf,23,20,7497,3153,4344,23,17,6243,3450,2793
1f53e93754e1a87c4c5ea659bfcbce2a,21,16,6261,2179,4082,23,16,6386,3066,3320
4c5c614efeeb252778c4f653ce73a26e,101,80,372816,106206,266610,191,147,594140,96855,497285
b5054b9d708043b34c331bebd3fdd3f0,142,98,339337,76549,262788,90,85,184709,55585,129124
714beb3225826bc110d9b047bfbfe202,16,15,3543,2025,1518,16,12,3056,1411,1645
a27efd5a1bfb2ab38afc067f2292aa70,182,137,574691,155991,418700,174,115,508870,131272,377598
5739bbe96a99651b98d27fd5c53b647a,147,99,400360,74171,326189,167,108,372876,101989,270887
1a39a502d2990368b8a231ef35a58834,62,46,95972,32206,63766,77,64,87381,35122,52259
9b5306103954470d7e8a24c90a42ad3b,70,57,88937,48521,40416,81,66,110721,40791,69930
eb76184e2f332e446c29567e4006e1c3,63,52,67159,34064,33095,83,70,111957,31568,80389
dd9cef6784fcb08f0ff4517a6d880e22,73,51,129674,47154,82520,86,54,159759,35801,123958
d5d377edc24b234bbddb84ad9644e9ef,158,133,458435,89377,369058,124,99,295990,61338,234652
38f7000969b238f0b0fe06d30f0b602e,110,86,253928,79457,174471,142,108,351991,69976,282015
d9aca3a8c8f09a86e688b946d8d5e8a2,70,66,136632,48115,88517,90,73,152310,42998,109312
f708edc4c8fd8da78603b8349da91588,92,80,257071,58681,198390,94,87,192687,79437,113250
133ac87c64729091cce22ced1805e1e7,121,85,210613,48068,162545,124,77,178618,53935,124683
9652fce0cd388930838a16682e35c1d0,122,96,380055,73112,306943,112,95,388218,81732,306486
34aa709da83e4837e170fa3382bb6cc6,27,24,15901,6656,9245,33,28,23744,8249,15495
3ee55b28ccb63af3d408500a380654b5,187,134,470614,104355,366259,115,77,298728,93327,205401
0cc717f3a9dd1918043256990a0aa122,35,24,24505,12805,11700,39,36,34003,10542,23461
1f88c0cbd72e4dab6d2874d7b48d7475,114,100,304453,70059,234394,169,146,385777,83931,301846
47d777e5a161a65d2951085a398b2caa,40,26,40663,15800,24863,36,25,49425,17463,31962
09a71345fd88ec32846ed7d1b327aaa8,122,103,260534,43909,216625,112,96,314927,51965,262962
5c969103a76c207349fde9a366b28f9f,29,24,13913,6899,7014,24,22,11886,6556,5330
513c505b4f25c1fd6ea7894259535623,44,35,42604,12570,30034,49,33,46333,11325,35008
6088eb65d166d5f3a1a612dab83b1bb5,119,92,225323,52746,172577,92,75,205882,55798,150084
4abb9aa438514506034bdd70727599e5,132,113,287916,67122,220794,101,88,200548,72350,128198
1afcd1e365296c737404e74c14030aa8,143,124,511825,158378,353447,203,158,744004,140922,603082
b5cd66a39031bb128ce5f7c16d21e9a6,67,56,79507,37778,41729,95,84,158937,33880,125057
c34768f187e67fb4abe3a3eb135ba519,42,29,60526,21757,38769,40,37,71460,25007,46453
2eeea25fbd156c902d469536b54a460b,33,26,28068,10965,17103,42,29,43548,9992,33556
1d24126351929d916ec72299a6098c33,42,41,27343,14329,13014,49,36,35173,12311,22862
021fcd24862645098b4ad0a61c36be6a,129,98,264776,55121,209655,122,98,361320,56434,304886
5f866ff06ab2460ceb5c337c70dcc472,159,118,587580,187165,400415,191,144,790686,164694,625992
e94c9ea660fd3cdf5561b7156a74a69d,28,24,12110,3919,8191,24,19,9410,4785,4625
c1b8e7a26e0a44ad983c8266a63963c3,56,37,79536,36242,43294,58,44,101163,29681,71482
1800ecd6d538fd9e811ed08de8040111,46,29,47713,13817,33896,52,47,56053,20049,36004
99d330306cc5ac98c4155897c9743403,25,20,10052,3971,6081,30,24,16479,5376,11103
43f09fb98bdd3af7ee367fbc2b4bf061,44,26,35519,13718,21801,40,33,33151,13916,19235
1f726b994f8472c5279c84fd7d008135,138,112,340339,82311,258028,138,95,379890,60087,319803
f0e4f48e4dc05a3398a1a84efea4520e,56,50,87878,36924,50954,62,51,124406,28736,95670
7b806ddf6d6d616c10ae2089ffb8b5be,74,60,89825,28717,61108,71,70,148412,30546,117866
80c881e43bd394621fc926de0d3b2a07,121,88,245379,53564,191815,95,81,253772,65127,188645
8d7b2bb975e52f0fc0c3c33db2e32995,122,89,298213,87999,210214,115,80,282245,82950,199295
901a680c30b34d2daa14e1fb513079c9,112,71,226068,35273,190795,109,97,239316,67516,171800
a4f649e58945aca295cc6d52e3046f63,74,57,93722,19395,74327,76,59,76532,23790,52742
360f03ab02f44c4e9e9038fac1092a49,104,72,138775,31341,107434,51,41,76949,34404,42545
b72e2ec76e3b1055159cc35d195a1622,102,80,173115,44405,128710,115,98,280029,41246,238783
6a6fcae7d297b62d466eb18b2c83439c,110,79,182580,47869,134711,114,86,209408,55684,153724
d165aaeb9ae033f8709c0cdb54287ae2,35,27,25426,7629,17797,31,30,17596,8578,9018
76595b0a3eb5e5bc82339a8c5b7bfdef,136,87,343636,88553,255083,121,100,416975,118973,298002
31eb15d83483284f706f518436e12d9c,27,21,11047,4070,6977,22,18,9669,4349,5320
8f0c40015036111ebbbbf967261f7293,49,45,53381,22161,31220,41,31,36669,19915,16754
35ac2dcbe86b8b30e25ba2421f0b10f8,28,23,18521,7282,11239,24,20,14525,6252,8273
8b5f1d13a1443cfeaefa19992595e0e7,171,133,833655,188984,644671,206,160,735941,190658,545283
83991aca163dda5c5079fbcee98231fc,148,114,400967,44305,356662,99,78,210023,53168,156855
4e074a2599f92ce7f2f13cd44dc83784,140,112,511513,81615,429898,159,107,371210,117475,253735
cdde2f4931187673c18dabfe6233baab,169,111,674595,88619,585976,167,132,588091,138466,449625
ba70b673e605b96d1854fbab5f86f9ac,46,41,54754,22890,31864,38,29,30751,18242,12509
c5fd37823ead32714b8239863b7b4abe,190,131,485647,140476,345171,151,141,459053,121490,337563
616764991b560a7c41c0822a0972cb32,93,77,201193,43418,157775,93,74,227823,37702,190121
ae208ad62d1c81201f6e6c93bd31a495,21,14,6741,2950,3791,19,17,5841,3323,2518
f93f3f56b04107139a71a29a7283243c,133,100,372609,96425,276184,139,118,357916,104246,253670
3105381fdeeb1bd09883616fd3987519,35,33,35860,14041,21819,38,29,30570,16913,13657
3a2f9398fb24fdcb9d3711173a3776c5,91,80,165901,46804,119097,66,46,124310,28027,96283
7c6ab07a77d8fda8d552b34d6fcfc61a,102,75,182466,30793,151673,116,83,150327,49997,100330
f877c089f8186eace3111b50a9aaf212,47,45,75176,31617,43559,58,50,81373,27482,53891
ccfc30f5c715ed62491ecc499a34a30a,91,73,166891,47704,119187,99,92,170659,36454,134205
9d13503b199b8c4bdb5ab32b886dffa6,58,32,63868,12982,50886,49,38,39886,17630,22256
b21caba12599dda41c57f75e6308c97c,82,69,134516,42963,91553,59,48,117594,40892,76702
f0bbc939a71c5c22cacb4cda176f66ca,8,7,654,705,-51,12,6,2950,297,2653
a5006890562e2b6e4bbed034ae42d4f2,210,164,883222,198590,684632,204,157,874406,179701,694705
46e92602694ab318057aef67e28ba234,67,57,93493,27928,65565,106,87,199385,31091,168294
f55c5607afa5b96eff93e6d1fc0c877f,47,42,60623,13494,47129,41,29,30685,12194,18491
bc4ef5bb6934bacb87abf9b8ab591d54,74,68,132711,55661,77050,80,62,172191,35700,136491
c9b2227d905bebcbd206744e9565ade4,120,106,272276,55828,216448,100,79,148126,48504,99622
4ff847fd77a826e8761f7da96a113966,116,99,198171,42217,155954,98,82,137718,54468,83250
0c0eca2a50c0c421d893e77c4bc8adb4,100,68,129236,28032,101204,89,73,153475,35655,117820
95f9a9422819ac7b3756aa45c7bf1849,32,31,16558,7326,9232,29,25,16973,7012,9961
062264786ea34fa730a5bc489cef7892,72,51,109155,36510,72645,81,69,154822,29693,125129
7f465aaa8858924209926cd27a741918,106,92,274114,74874,199240,130,124,270537,62061,208476
92872682a66aab1fbddb591a605305bf,94,82,115101,45034,70067,101,87,145354,36267,109087
1ee5630e472d79a45bc1ab8d559a36f7,18,12,8168,2318,5850,18,14,7746,3231,4515
901cd41573a8a9121dfab034e6723781,135,97,406734,171007,235727,140,114,462259,144989,317270
37a782ae3bfce7d2c75b141ae1d70331,66,57,88858,17754,71104,57,49,70515,21650,48865
9d8e73ca7f1341967f7cd576b03d5fe2,114,98,220755,64015,156740,89,74,170793,57312,113481
e2987f2a8b695a38c2bd9e1d90be5317,114,90,284491,59184,225307,195,141,450585,56757,393828
f48c85954ed6f82c154aa6fff025aba9,93,73,124641,27322,97319,93,60,118428,26021,92407
cc4239afebb2b173b02f603a8a867ac5,36,26,41028,11085,29943,44,30,48175,16350,31825
9c78a88b8462954be9c031f65377b217,103,87,363513,104898,258615,145,97,351786,112728,239058
e47d1ad4d0693ef1b3a6a09f27b96f1d,112,104,238722,73074,165648,101,70,269057,49447,219610
f7a84501b5c4399938d884424443bbf7,89,56,156978,51140,105838,156,91,298514,57435,241079
2ad542185387199ac8d865d7708c1b16,221,151,674089,87544,586545,119,90,342418,121918,220500
2227ddb5db0c4eb72dfa94461eba5c93,161,99,362531,63594,298937,147,92,278303,69547,208756
57755330a74ba4c3497ebc961f6b5845,79,64,235439,69480,165959,86,66,187352,51010,136342
51b3e922252980bbda88a85ffe4cd36e,23,21,14864,7716,7148,27,20,13403,7634,5769
603b1c8ba7c94c0df4bfe3631ecd388a,157,128,562090,64957,497133,123,85,300808,92938,207870
b1de192bebf8782274aa9c9c5a0e348c,96,78,140887,48636,92251,82,75,148920,45968,102952
628acbbe807dbd61b6935e56a26dc23f,28,24,22944,6026,16918,36,19,31779,6599,25180
47aae34dbf96a937105b054d3f54c607,23,17,12568,3121,9447,33,31,29128,4460,24668
07e1b8276b256282426986da48ffbca1,135,119,303826,57034,246792,126,116,290981,54857,236124
9a9cd8be544bc5fa3c24d813b7b4b42e,71,44,119838,29755,90083,68,57,122696,34167,88529
f753ddc10b25a115373f1b8c07220ddc,69,57,134694,40630,94064,97,77,187875,47408,140467
3befbbc7cce2a53bbe18516522ab4675,140,103,302921,98054,204867,100,82,300917,91558,209359
86f40281e8b61b080cdd8e385931e5a0,127,101,364760,94083,270677,177,106,446446,85620,360826
d767f8f0368cf617bea4776c8ab35d2e,161,137,498327,111274,387053,173,144,441056,108347,332709
0bdd3e1aa3202607c8f29f705a7f292e,164,121,923190,194916,728274,189,133,711229,150348,560881
afb6b9ae95d45aae1949041b52ce1a5f,46,40,59420,19712,39708,45,41,50796,21070,29726
760c2dfe0c28bfd669e3e6c0196d1cc0,13,11,2990,1500,1490,17,17,3540,1294,2246
307761b658900f1f19ca091dd0f7e3f4,0,0,0,0,0,0,0,0,0,0
eb2940f978e1d44f89cc0bc7e72501ff,142,102,441095,72547,368548,133,91,349425,92508,256917
b894a750d13b842dd9fac9bcf57f9cea,78,72,144730,49605,95125,88,62,180197,41206,138991
0792b285fcfc328530374dd1352b1225,22,15,7299,2569,4730,18,13,5077,2550,2527
498318e0cc385281334c1f654503ed80,138,116,465833,108596,357237,163,117,565808,104108,461700
a292f2d2e5b77130d8ebf43f9139574c,88,71,203413,37708,165705,94,66,162885,35771,127114
f34a97d4e7b0442d97259ebf81488c86,71,52,120302,37448,82854,80,42,143582,32481,111101
9473690655c208e7c2b4bd9e80f9d510,61,41,101156,45630,55526,74,51,154100,36923,117177
9d0f04f57c9e55e53edb39e454afee69,108,84,223896,64980,158916,95,65,188834,48008,140826
7ef43dd40e781a4a62f7140335d99a07,82,64,136708,35418,101290,65,47,86803,31521,55282
cf1a3e72528c9a8e7b0c060640a9ed4a,188,145,466521,89033,377488,121,98,318764,131340,187424
e8561ef96b6bbec9c93dcc956daea5a5,179,145,357704,64645,293059,139,110,314877,77847,237030
43f33c6e89914609a7145a926ea21d5e,143,106,502921,171737,331184,161,122,533330,133048,400282
6ba9401265c0f5659f503d8080d6eb95,16,12,2965,1286,1679,15,14,2892,1608,1284
d186e49167b78cd7e9ba2d3143d7a851,96,76,261530,72967,188563,135,120,361335,57712,303623
b5b45a001514fa40396ad18fe787a713,35,31,31376,11885,19491,40,27,35629,9617,26012
08dd682702d012983a6afff548285692,144,117,452642,103457,349185,98,77,254258,86155,168103
1ee4d65c8c833c9d5c5203cf7f9f97c8,120,88,266637,76422,190215,134,105,270692,75268,195424
c12be070b980b0592cc982b24c04a0f9,92,69,246857,60195,186662,141,83,261732,55685,206047
389b172748d9d1c91e306a44d0434e81,47,37,65339,28275,37064,84,66,120396,22223,98173
e0b5da74b8a7ca8bc884988fbfd9b014,46,36,58819,19106,39713,47,28,42361,17209,25152
af853c62249f499f4c89d8cce09efee3,30,21,29326,10849,18477,30,24,26989,9744,17245
b5a106fcd7a6ce4f256a2488a50e28a2,17,8,3018,1605,1413,16,15,3382,1314,2068
faa545196a6cc7217d8937b7ffe081e0,118,83,256560,58939,197621,112,74,202984,57926,145058
2a7ee0712ad7a1118daf6ff50609c987,36,31,42917,18470,24447,38,34,45005,17164,27841
1093a55e75e1f0b78f494d53174d6b05,40,32,44493,23393,21100,47,38,71731,21008,50723
8246e33ae7ba5377d8f996686a91bece,121,102,602826,167824,435002,181,135,785419,180558,604861
a2d34838545caaedf114893e15bf11b8,110,89,254892,104835,150057,125,87,326039,103952,222087
f083160b6cb74b4db24913b2ede407d3,21,19,12323,5403,6920,28,21,15256,6460,8796
cc757acc3d8de05164d1d60ddabc7122,95,74,227283,58445,168838,130,88,267240,58474,208766
fc47ea8f65937168552d84ee4f328569,2,2,401,676,-275,2,2,676,401,275
a12b40d284d07fd77cea31bc05e422ce,64,56,70774,14207,56567,62,46,71751,12948,58803
13e3cca1eecd1741ba1a0d234eef72f4,128,98,265802,64260,201542,114,87,262323,62332,199991
66bdbace63427c2e4fca4d698393e84e,106,80,183855,31135,152720,88,73,149512,47379,102133
5e13f18a7041c4af0ca33c2f798bd94e,155,120,356812,118169,238643,139,96,246485,66085,180400
0bfb9f598bfd0c07b5d453e72e484aca,90,73,137988,36064,101924,96,82,111122,27202,83920
9a9d75320ebd65bedef1dd5883f51989,55,37,61242,27463,33779,50,38,77191,30510,46681
0a0342079e52ddf51ad853d5589d3c32,46,37,76465,33234,43231,62,49,115780,29303,86477
5113d46ad86e0bd7de850eb7d954721f,44,38,45334,15631,29703,41,37,40563,18932,21631
a6145b051f0da17a022e870b61ae830a,20,13,6666,2251,4415,22,16,4344,4038,306
60615a41fe7945b216c8c2161e30a893,99,79,227208,45459,181749,136,111,287537,55878,231659
ad8d62eb5c59423a3bed914bbe42e2be,3,1,336,50,286,1,3,50,336,-286
5a4c19b2cccccf7cc47c99b675a66503,23,21,12210,5500,6710,31,21,15764,5661,10103
3a4e846cd405dc801c5c469160a06341,62,50,93433,28580,64853,69,58,175916,34702,141214
253d35afbc3702220126b62cce3e0f07,103,80,214205,56523,157682,133,122,298425,75281,223144
cd634c3a86f05b4cf7fa3a7c797f7e27,87,66,129049,48080,80969,124,84,208032,55449,152583
8df87a15c9fab6eb500991f505615152,131,105,400025,138342,261683,181,135,569969,133812,436157
29ab1d85160d2226c8af4c4796f107ee,136,106,360158,96358,263800,159,123,426860,67252,359608
8bf84b1cda6f22cfe96fb93ae5b3b329,130,95,395942,109362,286580,125,113,478692,146483,332209
3aeb5c586bcb2faad6454761a2d561bc,147,96,329138,37534,291604,146,103,352007,64879,287128
011ef086f3a36494fa0e726724e59b13,95,76,200758,68158,132600,136,109,388131,62967,325164
91b261579bca0aa9ff30dfdfd39950cd,80,73,114815,80204,34611,111,91,238095,55561,182534
5d8d253e568a29bdd69d456daf934562,74,57,149352,28754,120598,67,51,67277,30375,36902
4c2a167c1499198401d51c65c07c3209,98,73,193863,47636,146227,126,85,206149,41715,164434
6c8c0f6a99322bb55d89179ef6f3be7a,57,36,60178,23250,36928,71,55,82869,25664,57205
12c93c24ce7d6dfd6b670ec4c4df5ee7,1,2,241,347,-106,2,1,347,241,106
df861dc80982fba2438d54c4991831cb,30,20,28317,11483,16834,33,28,32881,12834,20047
ca9a96df590e93a923de24eeb1624904,55,38,45725,16310,29415,50,39,56216,15829,40387
d403a4219907d7ca8fade8371e294160,196,107,481309,111661,369648,129,77,341405,119993,221412
006fd6428c5b6c6466bf5610e23d50c3,22,20,4756,1467,3289,18,16,5061,1505,3556
4172d41eee0564170fcc9350192722bc,126,81,303852,56421,247431,156,101,312427,61193,251234
d09bc238d4f0127c6a4751ad64846c97,95,80,169726,59632,110094,88,82,163662,49002,114660
4d6845455b34afcd3aa6c0c38cb76669,88,73,198253,57021,141232,86,72,205439,64995,140444
e1fa1e072ba9f9da2f04b378ea9436fe,83,73,107221,33072,74149,62,53,78187,19363,58824
4f9dccfc2fe5d8171e31b126ad9ebb25,155,120,436032,56921,379111,181,131,443978,75859,368119
0ca2c7cea9daaa2093bd27ace46e8edf,43,29,44952,11634,33318,44,30,36377,16420,19957
1b07524616c74f627653dbfbc0f87d8e,88,72,105312,27670,77642,110,86,135144,32538,102606
35cb060c0cdc0cf1f5eb4a966267a513,45,37,50387,16404,33983,44,39,41183,19461,21722
8383ed63b3f8bdd1f890631e2aa13e63,170,112,479689,71496,408193,120,97,332177,69928,262249
ed3360bdb62c4176df857334efb0142f,92,83,158219,39008,119211,86,58,153907,26949,126958
83db1bb4c5563a94f13e7039505b846c,74,55,150080,40156,109924,77,75,115531,39361,76170
5a4f047d0820897b2b55b0fff0783d4b,22,17,10046,3038,7008,17,16,4571,3818,753
dc4c9f2dd18534680301e78fe34dbfa3,3,2,757,24,733,3,4,168,901,-733
d92ff67d9b83773cb3958ace105bcc74,106,74,356883,71049,285834,184,156,654470,92365,562105
b89649c530f8ad6b4bfe590baf8eaf8a,204,158,967034,189406,777628,176,116,697579,179870,517709
3c41a498235726f150daac900f1b4eb8,63,52,113770,37101,76669,64,53,76541,33385,43156
a5f445c861f4bed586eacf161c2a9d27,164,125,509965,94243,415722,165,140,650024,88078,561946
e3104976dc5972488f9b450637c85182,171,131,719316,138544,580772,199,147,656378,186268,470110
3c572f92386ba0dcddc2aad64442de45,58,50,109981,35198,74783,60,47,115334,28957,86377
9bc89a636423f37a8dcec03f9a97684f,157,123,571130,111485,459645,187,144,615475,164000,451475
9fe3e97d89a6faad666e69dde1bd7111,117,80,246708,41462,205246,127,92,225654,47766,177888
97213e841c7c435d2e4634479fd54e20,49,34,32695,14317,18378,64,48,56569,12993,43576
3d16d69f18f872c7d15a6a75fff6e2b9,139,100,576596,158401,418195,155,117,517292,98104,419188
17dd34d3878917d8e93b3173e99c9aa7,147,119,400577,61597,338980,141,116,355638,75311,280327
614ca7f2648abe3b5bd917db234e6495,122,104,290877,63857,227020,119,89,222386,71439,150947
6292d3b167290467f2da345251ab46ba,36,29,28640,8920,19720,30,24,23020,7708,15312
bc3ac20dd299a6f77b82fa6a1350219b,97,65,150286,37353,112933,87,67,113146,32399,80747
87d24f89e35a26cf94d28b97143568db,79,59,157163,51102,106061,120,108,326002,46783,279219
5b785b967261d5f2c1763bf0f942f5c2,193,127,537494,95815,441679,158,119,587908,92497,495411
c19398908d647cb1d6ccec0d48c0afe8,150,106,459268,118740,340528,151,120,526100,137097,389003
ff9c61f1763b211cf023d034e0adfff8,147,110,471548,65907,405641,115,90,308128,78714,229414
7de6b840f209fa484e4d6f8f3a5ae958,98,66,197561,61762,135799,140,104,409709,64049,345660
7afd9d90eb098c0f1728063361d4b91a,162,124,420740,104661,316079,99,79,231353,81455,149898
5206d4ccd3fdb999a1c83f4d2d2766cb,54,43,68145,19844,48301,46,41,44223,21383,22840
416aad4eee24e2c2c5ec136a9a6207d6,87,74,338586,146723,191863,159,118,566551,120896,445655
48875c0b1d80b8937af113db56551fdc,124,96,323610,93401,230209,202,119,611169,68668,542501
372673cb7638256f4afe3378fd547dd2,182,131,476593,99806,376787,137,115,414585,96264,318321
90bec907ed4a12c2ff6fa5970ae4a7a7,86,66,97923,26229,71694,96,77,163314,23517,139797
f4ec2d145d68943af5a52c6637cd082a,50,41,75866,21525,54341,59,42,55794,22423,33371
6ed57f88147b236a036c4d0acbc0d58a,33,26,45987,9702,36285,39,37,32248,18841,13407
f1e6e8354106a5f3bf0845732a002c4f,149,107,399064,73472,325592,176,137,462178,89483,372695
4d13baf33f77bf6cb67da8b600ad5d8e,94,75,156627,34078,122549,82,63,97661,39194,58467
a9e678cc50bac70dae43e8dfa52078ba,55,50,88457,20067,68390,51,43,56743,18643,38100
9eb7338651c59389a602e8a4d6fbea85,130,74,229370,78849,150521,119,82,260317,62218,198099
5c4eb44fdfcecd24f79f74648945bdd0,155,117,508405,96210,412195,176,138,560866,101431,459435
ffd9b10ddcdcedc184488d3210473091,100,80,212785,54803,157982,114,89,262401,66697,195704
0634fcf20d663cc200692ee34904f4f3,189,126,585096,70913,514183,163,122,511376,70350,441026
abea6101db19d8230793f99d027cca99,155,109,333839,54399,279440,142,116,257638,57810,199828
2c4acf826fa83376793172410ebf41b8,28,22,9295,3281,6014,28,21,8297,3125,5172
75a122d6a026bc84f9eb426c62b68688,209,160,1541145,227391,1313754,179,143,1341391,231468,1109923
b078ea98a9d2d0c02a7e4a5d8f80e333,85,75,136708,38920,97788,143,109,239659,35598,204061
59c47605e8dad7d5f7f434227ec5cb68,95,73,182132,44173,137959,103,83,254308,52880,201428
c8b71adb971d49643815bed8e7180fe5,157,106,445527,85905,359622,155,117,411079,106403,304676
0f5edcbe1c2102369ed530d994ac0579,43,32,41927,14366,27561,36,28,26949,18263,8686
5ff24e5f95a49b696a3cc9f85ce12d7d,65,48,106175,30751,75424,46,36,79858,36977,42881
00e170dbfd83bb5187db27ac2e88db3a,59,44,67059,18208,48851,59,53,91709,26938,64771
fe6cc35e8dbd8070db65ff59c22f8200,92,77,190832,51518,139314,104,79,190483,48896,141587
752de191a8b320a130fd6aa49b23c33d,14,13,3301,1230,2071,18,11,2425,1513,912
02a998239e62edfa149a47ef44fda5ae,130,92,457813,75555,382258,118,101,339144,108356,230788
56cdadbbc4676ff677ce7e69e19c6edc,73,69,122836,27988,94848,63,52,103126,24133,78993
638a5f0ef678e599578547b50168ee9f,40,31,34487,10257,24230,48,42,44507,16094,28413
5ee154c973ca659229597cbe1038c3d4,21,15,12011,4843,7168,26,19,11508,5929,5579
35381d3d2d3cd96b75ba372973f3c45a,37,30,63966,24000,39966,52,41,64746,24449,40297
bf210d7ea0e4a8fd41e6a5cf2fb28f55,87,62,177502,56559,120943,104,76,216370,72295,144075
5dd26800af978f24e55d6b075bbf9739,77,35,66487,14321,52166,46,36,55453,18849,36604
8353ad6543ffe8c8eb3116cc69a67fa5,19,12,5994,2159,3835,13,14,4354,2116,2238
df7cd9b3015e0194f4b2633d501b69d8,26,22,17048,5559,11489,26,21,10214,6112,4102
fee3ca2e3927b3f6faca7af093a3b8ba,34,28,48885,20506,28379,50,36,64590,18352,46238
63f73daa6f90801198a1de0e9e4d6f78,69,48,71514,17235,54279,61,49,50832,21244,29588
cf99ce66f9113296b93956c6a95bfd21,81,62,144771,36700,108071,79,61,127905,35949,91956
3c40d6973a90fe6521d1e7880b612242,37,21,31554,11924,19630,39,31,48889,15457,33432
a227f5a9c16b223819084946efd8d633,139,105,293344,48380,244964,119,104,205718,73818,131900
9277a5d8d1fd420396650e5ba6e4acb7,94,61,138286,30693,107593,68,51,68406,43646,24760
3e3389aa698a721a4598e899c2c9750d,54,40,51486,12416,39070,49,49,36619,16900,19719
9637a923a6bfa493bc97107e1aaf4d12,146,123,475648,102733,372915,170,147,612764,97396,515368
dcc56bee8bc8bcd25b8b9a7ef54b50b6,88,65,121935,22572,99363,88,77,112263,33876,78387
f08b2c12204eb71af472d0fcdf7c6846,105,84,160374,35195,125179,82,58,116176,27759,88417
2e087a3eebca6932ade7eed0ce42837e,107,64,254074,41684,212390,107,74,193886,33054,160832
e7c0c4d2102443df57ea7a595b6ffaff,140,121,372489,66553,305936,83,56,217389,77662,139727
dbcfd92e750600611363e8d57ac37c2b,200,134,685451,73019,612432,168,134,544529,108530,435999
9284e13c9dbab7cc93819f2978017b0f,7,8,1583,592,991,15,6,1659,987,672
4d64f8eb564ddeb5fce3378c544d6a8d,6,4,890,196,694,5,3,398,652,-254
fcfbd736362b2c6d83b4323fe88563e9,11,11,1540,1701,-161,12,7,2066,949,1117
8d435af412785e3d49318221c83246fd,34,26,24252,9248,15004,31,32,19264,10457,8807
fa5058ed3e58a5438c23112b6ab8e1a2,145,97,429204,103754,325450,195,140,491821,102679,389142
ec4596cd9c9f51bb6052a88118c6a289,44,34,43312,15537,27775,81,64,81486,23039,58447
b344253f2329e07aba834be9fa0dc39a,99,77,213138,52917,160221,96,79,178783,45291,133492
1130e383502c8a9db63eacd09be3c13b,121,117,336742,66706,270036,131,110,347044,89942,257102
4701dddd8a381c7c04683d5ecbcad6a8,91,74,178061,47622,130439,89,79,168809,41600,127209
b2575f42927887ce1a594d44e994cbcf,51,38,90430,24866,65564,49,41,45640,31447,14193
827a6a3794f28fc2330c65aabb9a0ac2,62,51,109909,28533,81376,78,54,135118,27423,107695
ce62b779a7d2b14b4fc9eaba50d5cd1b,145,111,328324,89930,238394,93,79,178984,62715,116269
cfe5327de59b65ed3172fc4a0e222e36,105,87,293041,78138,214903,182,144,453879,96973,356906
bbb53e0c1768daf36f02da838d1ba909,113,93,336891,62596,274295,135,102,419465,59962,359503
badceab8d95eabb775ce6195e74ba1ee,111,76,182706,41838,140868,59,54,114210,28148,86062
b2c104bff8ef9afa7d1704a36c5f53b6,101,70,157343,49949,107394,101,72,189858,35286,154572
4d2623964e1556f9340afa8388a5e727,36,29,40273,10706,29567,38,26,29468,13632,15836
2caec8cc627d894eedb5ab01f253b648,217,133,720647,127596,593051,224,172,694096,159905,534191
8da798aa0c321a42dd57b41900f87e29,15,8,4099,1292,2807,17,14,2865,1793,1072
36feec4548aed39440da71cc6848bdb2,220,163,1263049,290775,972274,192,146,1163778,275725,888053
2c9b8663dec9f821c4573fa537db4c3b,37,30,25757,14895,10862,37,25,31149,18244,12905
b2263f8c08676e6daea697c2ebbca525,104,80,185180,34760,150420,112,84,218782,38069,180713
f88159dd6925a7115b5db257cf67db15,162,133,467420,81071,386349,179,144,429502,80313,349189
2cdb6916569c0235e6319ccf2906fd5c,35,30,34919,13407,21512,34,29,34304,15746,18558
0e033c525798191e0b550fe0a93727f9,48,32,62744,18216,44528,53,54,59162,31176,27986
e30f286a10584bc6873e6dfcbfdb41ec,123,93,214020,29621,184399,98,77,179603,35339,144264
fed62fafd34e868b3b23b78e4bc4fe5c,134,115,314334,82504,231830,158,132,386113,62381,323732
8a0a2bff2cf8e52935b50c40918cce3b,45,39,38109,18759,19350,34,28,38781,18087,20694
3b490a93dfad2ba14868859a8476bc55,64,56,117359,24260,93099,64,57,105132,29858,75274
0000c270e25494c03d5c81036463fc45,81,65,157661,31252,126409,121,99,215094,44397,170697
78da1224b692d93748f1aab7c3506bc6,130,109,378599,98087,280512,141,122,392435,68103,324332
b89585dcb838c13f8876045d4823f337,23,19,7490,6061,1429,25,19,13153,3640,9513
94420bcf05e29e307be5a04a80de2c69,20,16,9205,4803,4402,26,20,9948,4233,5715
adde6d291c1b1db7a6d3b8844b14ee06,122,86,203384,41950,161434,133,107,252443,51557,200886
97fa6388ac19dbed5bb6c1a8253896d3,124,96,238146,86034,152112,140,109,314002,60300,253702
a9bbb2454b489e730855ef3a6abd9b79,108,77,170867,39795,131072,89,75,179488,41830,137658
0229e36d56e086717eb7dcea587e889c,87,70,230428,92709,137719,153,118,381285,75947,305338
05965609c1f42830471c518d78c3286f,119,93,254832,63917,190915,125,85,324592,57792,266800
1a45ed7f8faecb41c8907da5252a60e4,125,80,247526,41860,205666,125,97,302966,71999,230967
ac4eef73ce4f91489b7c4e3eaa6fee92,123,92,309186,81192,227994,139,103,346207,66712,279495
7a51b7ab784861a279a65136d47974c8,124,104,238566,51642,186924,132,98,236682,64870,171812
c03d5c72cd94abc7fd8950d409269931,78,64,100852,22859,77993,50,42,52277,21780,30497
df768880150caf0cb3e937c233169c6e,25,18,15690,8005,7685,29,19,17629,6594,11035
5bb1cbc26efbaf6532019ce1b32ab3e9,82,60,134018,39759,94259,80,64,112450,38418,74032
8999947335c790284ff681434d23e383,138,119,353756,73981,279775,150,131,364375,80664,283711
ba02e6b87b96b34af14883ce8c307f7c,136,112,297188,57172,240016,110,89,350538,90666,259872
06b7f29c763615e8fbd32ab5c65c69c1,49,37,83754,33026,50728,88,60,96514,35347,61167
9017b618d8b32706d6b560febe927410,45,34,46458,18735,27723,38,31,49550,17965,31585
fdce4eb302cbca17a10bccb0b98ae546,85,93,180030,53616,126414,120,95,232426,76006,156420
19d58134f40a50b943e33bba04ee5bd5,149,92,332640,63689,268951,166,120,415645,75974,339671
410353e08ad0243f3fbf423d075f5906,197,145,687223,237974,449249,232,161,757629,158599,599030
ed8e31bea263e09dc27970dad82a38b4,104,78,236512,35491,201021,103,79,173911,52871,121040
c6efaa9634f35c5e568758ed60a3d5ea,96,81,215609,57616,157993,128,90,242954,66438,176516
7b619a8daf0ec49cd8ffaa6cdada2a22,99,90,237395,50759,186636,65,49,190435,32263,158172
c6797bf36c3c66d092029e44d35e2477,25,25,17997,5133,12864,33,23,17362,7714,9648
a4f2f43b26d6c7c04800151da4dbb38d,57,45,45193,16830,28363,55,43,49217,17532,31685
ff72c97d5922adf94f08a6888ec11f4f,37,24,29696,8388,21308,34,29,23560,10201,13359
b09143d49ebe64c3375ff972f3d58874,73,55,142664,40613,102051,73,42,146382,37136,109246
4dc12c859207f72f36e003b7fcd3711b,126,96,431873,83767,348106,158,132,480886,107016,373870
c6f648596bb2d8d7006d57d2914f026e,128,87,223694,49753,173941,89,69,110857,51652,59205
2c104c05151749b136675d914e795aac,0,0,0,0,0,0,0,0,0,0
f9de2e7de315be11ac24a56cf1ef9433,132,98,264579,57679,206900,140,116,307302,62665,244637
15781bfb437d4e4e74063ba4fbe87b9f,126,84,338817,55714,283103,120,80,247513,74387,173126
7645364b0d4f55fdb7c09b089b7385a7,99,80,177849,65324,112525,122,87,224853,66713,158140
bcca9469770375df6c3ed5101e9bbeb1,97,84,224992,62981,162011,157,105,342030,63609,278421
9923ff574c22d2a47e5ea378a19df5a9,108,87,225992,58971,167021,122,89,201773,55752,146021
4430fb9e4f21acfb3252dbdf3df7e640,36,27,43917,9184,34733,33,21,28238,10491,17747
8e43c2fec371590c68eb0e96e510bba8,28,21,14263,6287,7976,29,23,8854,5990,2864
9de4b1525cbe28457df5317513e71bf8,173,118,392345,141929,250416,122,77,367071,92321,274750
e3c5939a60da77185525b39284337e11,85,66,135619,30027,105592,72,60,100485,31585,68900
81ffbbc686dca799a5a1e05e190cf55f,36,28,47111,6777,40334,36,26,30677,9075,21602
9e31c8ba6454ed0d848261e8c9527703,67,49,89163,30242,58921,54,46,68956,34548,34408
7301d861ec9186f559dcf348585c6205,29,25,18912,8295,10617,35,24,21762,7942,13820
4700d6bb41fc91f3400a68d48bfdc3d1,104,85,164294,47867,116427,84,67,146953,47364,99589
b36d82e7200ace7b02db2e42c202d983,93,75,183134,62832,120302,108,85,224613,68256,156357
9ed10327b6ee3f7aa0f8d3ea5de6da02,174,133,551882,213957,337925,170,107,866997,105773,761224
17dea801c074e80026cde63caa41c2d1,39,31,56018,12401,43617,29,26,37986,20784,17202
f89d859292873b8263847e1e7cb20d94,21,18,13127,4778,8349,28,19,11629,3938,7691
04fa8d5ad9301d1154c8abf48e42e3e0,6,5,1190,979,211,5,5,979,1084,-105
906fed864a75eea475c12adbbfa3d386,76,63,106052,38296,67756,105,91,211848,40242,171606
28ee837932f76232a4b0a83a40dc241e,173,113,648252,101881,546371,198,117,680031,144421,535610
f9c159f8dcc5621769f47e6edc9db5b9,210,148,600404,96570,503834,158,133,482261,155654,326607
edc288b768c0319d98c4b67c3834947f,90,73,201281,69875,131406,96,61,178286,55493,122793
e28246e50b988bad9c2ab8a87fd444c4,54,36,53085,11506,41579,39,31,27965,12435,15530
1bd0cfea6e35e1fa23f8164ef5063563,18,22,4414,3263,1151,22,17,4687,2943,1744
9d581eae7652a31b8ac98dff0d32a173,45,38,51230,12414,38816,49,38,32721,16805,15916
f42ec090589c8d9ca2c844387005d3fd,73,58,125156,32214,92942,54,41,103987,27488,76499
3bcb8fc53ce64defc0c7eb7f4a2c35d8,130,105,288410,60031,228379,135,106,257288,51858,205430
dec87a7daf0f7b4cfb1ab1bc48c6b6cf,98,70,195543,43823,151720,104,78,174956,36646,138310
7309698dd8e0eeb025df147910a1f2ff,205,161,889102,166332,722770,224,152,1028844,119529,909315
0ac9d87fcfee8ab97d32a0e30a7a3254,37,29,28436,10299,18137,35,29,19264,13704,5560
e088e4f457cad94442d8897b5540267a,164,100,417634,137070,280564,190,129,462511,119338,343173
41d31818e0e42cd5b12762253fba3650,215,163,771238,130912,640326,175,132,800625,135746,664879
d71820ddfbd3c916bb2d7777ab820ca5,62,50,102075,34419,67656,80,66,109867,28876,80991
ea1b5ee25dbb382a9da85da16025a949,130,110,336894,77253,259641,132,96,281178,68341,212837
94449ae56aa6c0e1cfcb98448f3dd06a,86,73,205016,48814,156202,75,55,117845,33741,84104
27560d4eea2773370adfeef781b227cb,203,143,990154,122279,867875,208,155,1075913,161879,914034
e853a0110eac54dcefc185ed82a307ba,38,32,32334,8462,23872,31,26,22241,5514,16727
6aba04ee5bfb578788799f3b01c41da2,100,84,166078,49066,117012,117,93,229105,50467,178638
51a481605950bfe2b94d34d3953cdb53,8,2,1251,63,1188,2,5,172,1106,-934
e51f5edf369d06ee8018a643980796d5,69,55,85355,17471,67884,55,45,54086,20222,33864
0238dfbe67334936866a3191e82689d0,166,137,684720,133574,551146,155,112,722045,129599,592446
361573dfb553fb8e31231f304cca9d60,22,18,6470,5237,1233,23,20,9998,5192,4806
345e679b843327491662429ff7784285,132,102,259157,65536,193621,103,83,192624,54724,137900
d5fe06f94cfa4cc5f82cd61ec32d27c1,63,49,100688,29009,71679,72,62,135870,38306,97564
0dd99d7810d9f25fc67ff3e3501e980d,97,65,102399,47919,54480,67,69,122844,40151,82693
b45e4a7989aba2d29120c9e1894ae573,149,94,316489,46888,269601,141,105,341166,47784,293382
ede1bd16110a429aa70420620873b8eb,139,100,341502,53521,287981,157,122,433616,56211,377405
b846aa51e832bd147b4a21fe07bb90a3,14,11,3179,1572,1607,12,10,1989,1028,961
78ea33d7bccc10df33cb828c3e60a320,38,33,63016,10944,52072,48,36,48915,12373,36542
904f0ac4fc8642eb074f2a01bbb427cf,132,102,328955,60047,268908,112,97,246644,69945,176699
76c8b72d7fdf5588f6959f191edd9eab,23,17,11635,3925,7710,25,20,11682,4839,6843
6531c8d7ac05cd7413402889e265e0a8,96,62,158916,35206,123710,83,69,149290,40708,108582
0483ffd2889454dd5a35d98b678e59ce,48,47,67679,42871,24808,59,53,87591,28217,59374
30316e93471f2d12bafbc990d4944365,194,133,758821,158887,599934,191,137,751678,146390,605288
16bc78f99958044cfb0ecbbeb276c82c,86,61,108543,33697,74846,86,64,125082,40279,84803
155b7e11a669b906f7a05fa3ada87c69,62,52,108517,24795,83722,74,52,90935,30330,60605
6e9e6a0d95f323cd7f83b4b75fe9cb3d,40,29,28607,14885,13722,36,23,33800,9157,24643
e4cb81a24ee272ee0110b64ca0bc1ea3,169,111,441464,85968,355496,101,64,248408,74910,173498
416727531d4a07936103aa7521291776,72,57,142733,46202,96531,89,68,210320,44951,165369
84527d778e1961776f01ac90d138f0b9,76,57,117811,36172,81639,82,68,156208,38721,117487
d29bc47119ba66ee5c23bc32227e967c,143,113,365835,71345,294490,143,110,359931,60533,299398
91f07966c7ca043dab81ba4992be25e9,37,30,24010,8788,15222,37,21,19213,5465,13748
31048a82afa7cfdd23323ec95def0368,73,45,149317,34845,114472,124,107,333875,54271,279604
fd926c3c6596358b17593684fdf9ebde,123,95,292835,72229,220606,121,101,331404,64952,266452
ebca13398ad8c42c472a78b6bdf30f88,136,101,290040,45507,244533,117,108,245393,42374,203019
a235f461da4209aae50c733e5f7b4c28,89,72,150480,31414,119066,84,80,121983,33619,88364
c685ac0617883a4813b41d1b14683540,104,98,173463,29055,144408,91,76,138352,25085,113267
de23b9c66eb1959ff416974838d2af4e,174,149,558293,106865,451428,146,110,439669,110497,329172
6e47cd60e4be90727b96e5980a274afe,143,118,420334,131088,289246,179,134,584558,110231,474327
fe2d9b7306f84de95dca0b6183b0005d,92,66,217330,77744,139586,121,102,271923,65390,206533
b8f7b3f6d2527d751851a96aaea34478,50,42,54803,16165,38638,36,34,31049,21063,9986
48e335965982a019e50dbe42dd2be05d,133,91,243450,45194,198256,110,92,202366,45543,156823
7fb527b9f907352cc17eea776b8a22dc,211,165,1452830,196273,1256557,234,156,1166918,296456,870462
ee7d40a0e4493bc76ce989bec434795d,45,39,40302,14745,25557,48,39,50697,13043,37654
87ede6c27ee7fc35eb6fa6b4cf76f1f3,58,42,75845,13565,62280,63,48,60299,15989,44310
d67adab231991edcb95c2b737b41acb3,103,97,382574,106842,275732,133,108,413250,79197,334053
fe5a44edd02fab5a8352dd8e2750cff9,19,14,6715,3485,3230,22,18,8292,3378,4914
f351fc23213cfe372a933b8d15efcf62,43,37,40370,15020,25350,43,31,37570,15159,22411
dc61d8edd5352534079f31cc60e4050e,33,16,23243,6231,17012,31,21,24285,7748,16537
c8091983c5cdea0f20a0cfa45a7ca0ca,98,66,126850,46393,80457,72,47,107289,31425,75864
2a90dec4d288940349eb7fb8bd55e57e,216,159,776470,159570,616900,182,140,582030,136522,445508
100501e64c8e74cb31ca2d1388464b69,156,91,336458,62159,274299,115,88,243394,107008,136386
6ffa51398ea0f240d7c89c3ea9970aff,223,146,734360,125784,608576,194,153,853189,102951,750238
038846c0a5cb704fee5fc6b584ccb6f2,169,128,680695,156137,524558,198,139,701277,146223,555054
be5311f74acbe5d4c31f383cd0a3d1e0,39,37,47121,16211,30910,35,39,27893,15330,12563
62c7d314de00da945defb8f6a0501241,21,22,11302,6001,5301,29,19,15461,6412,9049
0c1bbda39f5c1079c2f075b6ab909cee,86,66,108390,25199,83191,55,40,75953,27414,48539
2407799a8c9d6a59d9b125db1772ca7c,76,65,180925,34631,146294,64,52,110571,40072,70499
a175875291c57e79c727aa4c4ac19481,47,35,53198,18401,34797,29,30,44579,20698,23881
0c511d630181ffbe10f5290ce294f9b3,96,81,173403,28871,144532,86,68,139532,32547,106985
c02e4cd0b6edeb147e477e19d33551db,128,113,306398,89214,217184,144,124,395536,85102,310434
19c6d390877dfc4c346e54f56452a56c,91,79,201620,51084,150536,84,67,125843,50012,75831
0b835c7a216c282175da754e426a1efd,45,32,95167,24123,71044,48,39,77961,32583,45378
5e5cd6ed62c24c422705a03f4b63db6d,48,34,62135,19772,42363,40,34,52233,20466,31767
d304be4d94d81bcf6a8c809a41463dec,122,96,264869,61889,202980,131,105,255939,42815,213124
0f24c981b70aa68d606a46481564fee2,5,4,355,614,-259,5,3,725,162,563
0c5362e309869b74cfe1634bd003cbfe,59,46,81798,16520,65278,41,34,36695,13591,23104
68bba1df6758033dc18db37536d5751e,163,119,704062,141024,563038,163,128,522156,150419,371737
8366847ab6365bc2390f6838b3250759,72,52,98560,20863,77697,84,62,100044,25427,74617
c0d921727f1fd5e990690a1091a9d8f8,57,43,58120,13080,45040,37,32,35427,14417,21010
c583e025c70ea23ceb10b4791e1d32a3,139,98,261729,59225,202504,117,97,239993,64492,175501
b62dac152b2475e1aac52fd943c6c6a3,102,85,222813,61487,161326,144,97,376054,46902,329152
83a5d82e7e7d859b22032036eedb5fe0,107,85,203735,59497,144238,87,67,207209,43002,164207
5eb974d7a43ef10fe43d41a35456f2d9,130,117,297430,50448,246982,125,109,365902,50884,315018
b6478e5cb72eb185eec0e4fa3da119df,152,116,525961,90663,435298,191,116,421891,100117,321774
9a52aa76dbbd2f607f1dfa64d45d0693,28,21,11168,4007,7161,27,24,18958,4254,14704
b4bf8949d027802b0888665627ae5913,67,58,116322,33820,82502,55,39,83759,36757,47002
857362a60c8a59a0476489ee0a01824d,53,38,83395,26885,56510,44,40,83508,35425,48083
7c8473c0b83142296aa0551b49249434,37,24,44229,14163,30066,32,26,33960,10869,23091
cba1c2bad824d901603bd069d4232250,73,54,111085,16588,94497,68,43,78483,24599,53884
71b6737649a18015e9867b782682858b,70,52,110777,25571,85206,82,68,127392,30018,97374
b302312f83cdc291e8f13dd38902069e,103,86,219090,50887,168203,140,124,294761,57092,237669
b12be5213079d462a7da157cdf4195dd,41,31,35155,13980,21175,40,30,41196,11500,29696
746ba741c22dd2b9ad618169aa3e9e39,58,42,103769,20634,83135,56,42,60445,26629,33816
8e1e3043a10f2e5c48f0975323135e0f,176,144,969523,108674,860849,137,119,614928,139970,474958
51d29359093a435319272f2a24c8ec44,24,16,10371,2461,7910,23,20,7140,4177,2963
31fec905f15796e9f00522c89fc9f638,80,64,84057,25615,58442,80,62,77441,22857,54584
2143b67dc7e7b23c18bd6d7dd3ca49ac,70,67,128495,34870,93625,62,55,78367,27339,51028
b66c723c5061935956ef387db414761c,106,85,235394,66997,168397,159,96,302872,69140,233732
36db70961a69bf4f77daa18fe6d22832,38,24,44666,18536,26130,33,32,50796,16660,34136
4e5e25d0ce5e727f64f5e957d615f9c9,88,67,125112,27649,97463,114,73,169515,30520,138995
cef87385912a721b0e5958fd6d449ac5,164,122,496518,156144,340374,157,142,516158,108988,407170
fcb85deadb2369dd7414ec20c04c3780,144,92,246622,51958,194664,152,114,284210,48941,235269
e6ff68e6e6e79f1126c09c212a594d69,68,51,77190,21310,55880,98,80,138994,28853,110141
b863a77bb0e3a71d9acbb47f06641f9a,100,87,197656,44249,153407,97,72,179130,39814,139316
f282f99e0abfcf50a1015582acf0e4a8,48,34,47247,16109,31138,44,39,36244,21706,14538
d0f45ebb12a14b23dcbb774e8a5eef03,18,17,5029,4444,585,22,17,8411,2440,5971
93fe788bb7629f16034189c177803179,0,1,0,12,-12,2,1,108,96,12
5b29a2719bc853f21fef53ecb6a597a8,44,29,44896,13704,31192,42,32,38275,15568,22707
068172fe6e25405b3cd16099b1f377f7,73,56,118210,25126,93084,53,39,61459,25549,35910
88a02b59bea17882ba3bac058562ee09,104,71,192722,53225,139497,77,56,109181,62952,46229
97b2742ed7fa81e019c5082191a0fe3c,171,116,602656,119880,482776,157,101,473660,110555,363105
fb2278612065c8ec3592cdc502bc9d6a,33,31,29743,15255,14488,35,30,30843,13577,17266
4f9d094d14c10a309dd253afa9c541a1,160,137,363386,96438,266948,137,121,417453,82545,334908
c3a7adca4349713d540ae111c5a4fa97,35,21,14528,3477,11051,33,25,11272,5100,6172
77f7adc31af749f331ba04119585e767,164,124,525193,80237,444956,109,76,267261,80174,187087
4aab2235630e0bbd32c37d464dfd7582,104,83,205222,57875,147347,97,73,193943,50649,143294
005feb551021b05029ac1ce127466ecd,97,74,195331,61135,134196,92,76,186154,62193,123961
1d71df98bbb2828e453f1679c8673810,152,100,298547,59242,239305,120,97,176179,51002,125177
fd12d947b6607be3be2f08634cc9410a,94,75,141610,56024,85586,132,94,248692,34203,214489
b7dbf2dd48f1f5ebc6395548baf2b054,115,83,281151,54336,226815,144,122,396020,66980,329040
a5f220adec42dadfa9909272051a56ec,163,127,547054,124941,422113,154,126,539288,121088,418200
83c3c3839aa9fadc515c15bef153e16e,140,109,394904,57809,337095,160,115,467258,50877,416381
bc9bfe156a404eb2a2ee0fa4ab4b88eb,32,26,24269,12185,12084,29,29,30629,12010,18619
81c6ae9faf121edad042360cfa3582fb,0,3,0,466,-466,3,0,466,0,466
88122f7beef3dc7948b598461378eef2,115,87,223855,54794,169061,134,117,260554,59101,201453
257d323f216173b8d328a7dcf06f743c,48,36,46456,8161,38295,42,29,29288,8613,20675
687496cd5d661421aa292af6ee1298ed,134,100,332028,70591,261437,146,125,421767,92412,329355
0f3c286cf00c91953ce2d5b01aedcc7c,64,39,82805,37058,45747,50,53,84312,40838,43474
fdec161ba99825125da50f91fe22472b,79,71,160577,41173,119404,87,60,153458,30644,122814
e7990d0166f366162f3165b6fee689b0,112,91,200040,45324,154716,117,91,180232,37978,142254
07ade550369bbebc2342935ae0a14d52,169,152,743814,148462,595352,207,158,875290,157121,718169
00d9b8d726d3fcb45b8da5a7f6373ffd,41,32,30858,10124,20734,42,27,32589,7609,24980
63606a6546e9bb03df8ae0ec856f2ca9,144,100,354674,58094,296580,126,70,275025,59189,215836
0eb28081f05c1aea3acdaac7e85f9387,68,50,96088,25031,71057,44,41,65782,32692,33090
72a757b4d261446fd9f1a96dd25d9c88,83,81,141551,39179,102372,67,56,129295,39716,89579
ce51b1a7e6c70b1f4f5b4aa39e962a98,29,22,14398,7649,6749,28,21,13364,8682,4682
ab786d948b8706ed1a17324b6a445b8c,27,26,28711,9309,19402,26,24,20688,8970,11718
bd49af499c8b1743bb35df94dc8d953b,143,118,391193,86648,304545,146,126,406671,113524,293147
7e77627e71c6f7eddd1a8d154c37a389,46,37,72034,16791,55243,62,47,93210,22080,71130
d52dbfa33445ea7a6791bfd7cc2bcc73,93,72,253526,85560,167966,143,105,364410,80588,283822
a823ad46072f85d221881d8b34fadb01,68,61,98830,27404,71426,82,58,106387,31652,74735
0bda36070f931aa3062ad939566ed1f6,149,119,515813,129134,386679,195,134,687440,172710,514730
ef6fa9c014253b845159b14f3d13db12,117,94,288248,56376,231872,125,104,279399,61313,218086
7fc55265e4efd880cf69f82e64620fe1,110,82,291403,86254,205149,121,81,401175,85890,315285
7ea8b22e57de5212a792e63f5401c8c5,43,41,38726,14396,24330,53,38,39959,19478,20481
fd6ab8f1ac4861ab01465151aa6e38aa,57,42,60415,19911,40504,53,46,60859,20946,39913
def0b1045382250c1f155fbed8c8389c,184,149,604730,62946,541784,146,124,446079,85191,360888
d0fd912753eb3d207f73bfc6856cc1a9,156,114,519303,106858,412445,144,116,429731,124791,304940
ca189e783a852b7802f5039eb9f55805,99,83,204774,40611,164163,76,67,122767,45757,77010
cda14be1df7e44aa3e860f0d52250fbc,118,83,229719,56240,173479,115,69,171085,48724,122361
bceced22ac68c8c962c180aef6259395,92,59,133158,35423,97735,100,65,123197,40832,82365
33bd0086dcc02d0b7d7d4ddfb1b5f066,159,114,488108,91018,397090,170,117,462995,82657,380338
73789f6378d980c30824afd59c402d97,29,24,10884,6193,4691,24,21,14897,6144,8753
93425b30354a96f9d7376b8d667a898d,60,46,93903,25052,68851,61,43,63147,25316,37831
3364ff99a69189aa99c13783283f7495,121,99,245959,53806,192153,110,87,219732,49679,170053
7a44e2728384213885ba6b080389a0c0,48,43,63318,25109,38209,67,56,79927,23793,56134
7b26a1487b7f13730eb5da22d50d1b3a,79,70,168127,57796,110331,97,76,163943,48246,115697
1ad7f26d5293048c5e3b579179e3c8f5,111,79,225551,32738,192813,119,84,146415,48323,98092
6489448f171dda7a279c5841aa5e33d7,50,44,41527,17954,23573,44,39,40431,14483,25948
5aca27d4ec0a8d2af48874f76e440bd6,58,47,76023,23455,52568,73,69,117869,37270,80599
7518187e46f02e3f506987bcf6bb59fa,25,20,6947,3442,3505,25,21,6440,5585,855
e99ae0dc04802973c7eb2288db8911cd,0,0,0,0,0,1,0,38,0,38
9cb21c3d6c342e0b6f0d55ca1dec3b9e,13,10,3097,1648,1449,14,9,2289,1231,1058
d8e48b5a044b0dcfb3f8c10c78baff53,26,21,9861,4648,5213,29,18,14884,4377,10507
694dab41f2eb2f4d256aa11e06d67d99,76,64,185527,113524,72003,138,106,351676,110406,241270
ccc6adbcfdd271b5d908f843e04d17e2,40,26,51888,9626,42262,50,35,53082,13935,39147
57d20c2c2eac5dc6f023abf81d102d06,26,19,13798,4842,8956,23,21,9516,6519,2997
0e43de39c0d44cf94a89629906e68f6f,58,45,76079,15350,60729,63,55,80694,24457,56237
7580937664decc88d63d35c5ada1535c,132,100,395947,60518,335429,142,95,353942,53430,300512
254e306a4cfc0af99426f7c9153c7b0c,132,94,214255,59260,154995,124,96,297864,75914,221950
b3f915bdfe0fcc9106667c6327b8e539,100,86,270333,50931,219402,126,92,296268,72840,223428
8bdc21ff70e6a7dac6066911324d1285,164,133,541582,105094,436488,169,111,498236,99333,398903
42adf9215369ec12c8768e041069d5ef,196,131,952288,123659,828629,216,143,991869,147649,844220
5a3dd1eeddc74478926c1c2b1a8bd041,52,38,79471,18849,60622,51,42,78157,22448,55709
98be5993fdcf2240a25d4de25b09fc6d,76,55,126471,29562,96909,97,71,145906,27073,118833
03cd99f3d2ac4742366296531662f6a8,82,68,292666,56932,235734,141,125,424113,107028,317085
2932c48add1eb3800b06fb99344768a1,153,118,422694,84787,337907,179,130,504522,59592,444930
8d8fe45ffaa996a3a26e4f09b1286f2c,165,132,510421,106894,403527,187,132,570167,72276,497891
d47b2e983cb3dc5ecad17ab931454a3c,161,135,581141,85784,495357,141,114,442782,105723,337059
e1c284685a5fbd1358466f4558fff128,126,82,207592,71253,136339,104,78,187829,43314,144515
9fa900f6175b1e2bcbf979bd67fa1a24,50,45,68009,22897,45112,46,34,59180,22912,36268
cd05e7292f15c5cfa73df4a194973fbf,51,38,81582,24396,57186,53,38,56714,23224,33490
0878dc0f3237cb65a9d0ceb7589f6586,55,37,92379,41052,51327,79,72,127663,46989,80674
2be0a82ce414e8d269c426f5dfddda43,72,57,91342,30486,60856,70,58,94855,28074,66781
63d8d9292907d29192cbf75b2819103b,115,77,164114,25694,138420,86,81,146110,32148,113962
20d6b3ddb954bc5be3f708d24c2d4e6e,129,78,196739,45154,151585,126,90,222198,43751,178447
52aee5e67d513f2979b55ec8dc8eb4b2,77,55,144651,39226,105425,108,86,226125,48640,177485
240e42f70241ab743cdbdee6c0367d8e,16,16,2918,2770,148,15,10,4109,1509,2600
446cbbcebfde8053cded0257f7d52286,64,45,60132,15736,44396,63,32,63919,12241,51678
ac09286d8c748fdc9a2cb4d44199740f,2,0,234,0,234,0,2,0,234,-234
8e6ecab0829158ef11ae82fb7dbb2ae1,91,69,126956,33641,93315,50,36,69715,19433,50282
1dd97514979f788ad99ef23b369e1248,118,88,219018,51964,167054,113,84,209530,61090,148440
578013acd135a5549b8a2b200c93edc4,84,56,147217,42431,104786,92,71,221263,52677,168586
086dc80812a2797185385c99928cb1da,25,13,5462,3083,2379,23,17,7026,2763,4263
c3119a36d78ef5ba688b7a43ed3ba824,23,18,12401,4148,8253,26,18,13162,6578,6584
e6a59ef5c44b532e8624f32ba5aa6c1f,4,0,507,0,507,2,0,97,0,97
fd19007815f9f63c00ec4c48d5906d5e,107,82,235771,55040,180731,127,99,266774,52636,214138
2f45261d0979ebb6b6329c674c6c3be6,43,32,29558,12165,17393,35,31,23007,9705,13302
3bf9a3adc078dd6f22c5428db3330ff5,109,80,244977,90582,154395,146,102,370472,69556,300916
1a171f943740bade23c6754bd7da2ae6,144,108,382999,81884,301115,147,117,415855,101364,314491
0205fc443684b4f6eab19f503eac5300,92,75,179358,38734,140624,95,76,148299,42585,105714
d50b7d7f6b665af792e54e4717bc31f2,109,84,183896,81982,101914,143,110,309069,70331,238738
2056af30fe81a8449944728daa8bee5f,66,52,79192,24350,54842,65,56,71691,21326,50365
3127cc19b4f8eee3934b523d4c714683,15,14,3738,2783,955,20,14,4872,1560,3312
c4c6e05bf09e1474493d1272c6eecfb0,74,48,88704,14132,74572,58,40,54118,17867,36251
b39472fdd8a705ced077b630828e9c38,73,54,150498,51331,99167,91,78,167460,53629,113831
e0426e39bdf64cdead51689aa0aea34f,28,22,19939,10957,8982,31,29,37658,10167,27491
5b148da9996dd3a0d27940cd11a4cd35,126,98,146574,37190,109384,68,52,102541,31759,70782
c5d8a1c420733238ed93a7af4479c348,67,52,118508,27610,90898,78,68,110632,28995,81637
463f527e072e0b6f32be13336a5f080b,149,110,363540,83235,280305,154,115,338281,86690,251591
5fa4b7f3ac2879f6283bda6376acad57,36,29,31125,7572,23553,31,23,20710,11298,9412
0df246a08f9e276acb23266a8594afc2,34,28,30025,16200,13825,37,30,43999,16253,27746
787697a0c38b098e507b6d54611b035d,68,55,134832,36570,98262,99,72,204878,50460,154418
87631724385f06cd6105c7fecea0d34d,71,67,72864,21476,51388,84,79,79615,18801,60814
e1d12d853011fe901a71909d7879cc5e,157,108,602474,195169,407305,160,127,667474,188792,478682
3e0eac37115e7df20ac0f33d1f4e5d7c,184,132,629305,84444,544861,149,110,584947,93211,491736
4e413cd8dc83f52167f0483a24e1a60d,202,124,567557,149952,417605,209,129,515103,113316,401787
9e170329d9e1b0e87670080cddceada8,40,35,47186,20200,26986,44,32,39736,14059,25677
60dbbd97a509ede761de587311da7797,9,6,674,594,80,7,5,1272,443,829
8d3e561aee50fb02d00ee91bc5668a45,161,125,498775,77743,421032,154,118,407872,85648,322224
958d6deb4a99a2a87365b204f80ac33c,18,16,5572,4354,1218,21,21,7039,3909,3130
277413fdb7b4056d579677536b14e34b,99,77,200282,36553,163729,100,82,122808,42816,79992
3a29223a4af714d4272456d60f080ac8,80,75,132599,37382,95217,58,46,96538,31164,65374
f461078d1602b9f49e34536ed785e034,84,57,186952,79754,107198,122,82,341466,63073,278393
78c04f736480929d130f29ddcc1798af,116,87,222707,49595,173112,134,96,244320,55686,188634
e4095c7563fe167eaa692c8bf01180f5,124,99,271624,76266,195358,91,72,248850,62186,186664
85fb19164ca1c258d6812e5660242e8b,131,99,316514,43743,272771,144,105,249055,54693,194362
8a2456039d1d2b0050da31c438c467b9,45,37,68409,19532,48877,37,30,44173,20491,23682
2aafb5e42f509ab34a729fe5686b098e,5,1,545,322,223,5,3,672,459,213
982bd50da9732b9c5a9107c16eb38194,172,105,421972,103091,318881,202,124,487475,83780,403695
c65b68b3219d4cd6ff3000c18f3f2e99,26,22,12524,5181,7343,25,21,11107,5929,5178
c6e18e88cc8f8c63c98d8b926f99cb94,147,100,373671,70217,303454,151,117,359375,83761,275614
17f9ae8fe320a3207c54292478bfe6ec,70,54,93848,24762,69086,68,59,85394,29731,55663
594f90bee57803246408202364d495b3,97,70,153156,50233,102923,102,82,197098,48274,148824
21b1da743bd2580fae4312aa41f753d1,99,69,186070,39817,146253,128,111,313501,59297,254204
ed783aba56b7ac7beeb615748658a768,133,83,278839,62568,216271,87,75,159685,73142,86543
cd907345533baf0e0c815ee54df895cd,56,50,75103,23220,51883,45,34,63211,25825,37386
7975068fbbcdd1dd9fbece62ca785b8e,38,27,25342,9862,15480,32,18,17108,8444,8664
de33c7edf05aa9bdb23537556a16b47c,180,132,527427,177025,350402,199,145,758412,176149,582263
391f6b26c28cd3fbc9b8f6f3a2051f8d,143,124,389928,78186,311742,147,126,426684,74441,352243
8c913335e5e7af6d8a302d63a6111e35,136,101,383768,105092,278676,155,105,599181,102877,496304
84b50bc93746b45efacda7bbb9337150,132,92,322281,58356,263925,150,112,309274,69592,239682
2ca7e99259bd16770bd80e15c0961f5e,157,123,460637,131059,329578,177,128,606555,102507,504048
74479af12afba983372b7efca7d4711f,37,30,50509,17110,33399,57,54,64811,20385,44426
3d4e4baf833f39a920e41fec9122a6cf,187,115,703877,178230,525647,181,133,592680,160404,432276
da8d60ac776eeb966d3dd7eff501bc66,20,20,7377,2694,4683,19,19,5030,3219,1811
87c90789482c2031e52d4c71b00d7bc2,29,24,14222,9448,4774,29,30,16125,9528,6597
be76edcbef962a8e70aa40f348480589,156,130,572492,62372,510120,148,113,305318,69187,236131
c0d63c3b5663e6f0c36ef43c625248cf,27,19,13427,5545,7882,19,22,11802,6664,5138
0969c10d37b8d0b17d5caa764709d1f4,42,31,32633,11845,20788,43,35,33347,14690,18657
e36742dc0604b7913af9441ef2d9d511,45,32,58291,16656,41635,47,38,70095,16645,53450
7e3615182f61e73b85b18a1fec1bbf1e,133,101,436909,106017,330892,125,100,388766,98117,290649
80e48026f6fc9050510db51894ed10e0,193,134,542458,91033,451425,142,95,503103,115239,387864
ba4582a7eff32d36f7132716f4044bae,77,61,149424,37429,111995,100,72,174451,32882,141569
337c44dec3599c324a6b17748bdb6b8e,25,17,15266,4348,10918,31,23,12360,6126,6234
ace5a89d5ecf4e2d465dacaa9905dcf8,109,84,251882,54132,197750,156,136,383824,85781,298043
b651f3567e563af05e302358afc451b3,94,72,188960,68963,119997,104,74,225081,74595,150486
80513d1e8d121b1f039b65d92041aad6,50,42,102642,29108,73534,74,59,73619,40248,33371
530da0a1d7e92ff4bd6fa284b6d4aa4f,158,116,447694,99106,348588,157,136,415642,100531,315111
33359a43bbdeccaba43f67971d8922bd,105,74,181727,23135,158592,121,90,206724,40936,165788
70a1109951b264d2435f3a60298eaa5b,22,18,7184,3414,3770,23,20,10597,3868,6729
ffa92c55189999bda67ad49c52fa857f,24,16,12762,4675,8087,32,29,25605,6071,19534
dfba9c550cbfab307941efb0003744e1,212,149,894721,157557,737164,219,149,861269,164021,697248
fd49615572c914a81a6b44d3fc5c756e,52,46,64852,23564,41288,66,49,79282,19572,59710
8b9967c6d2fe7fb593b04657a25b174c,93,72,174775,59642,115133,113,72,180426,52235,128191
87c77967b22ca25111d886a724fc7ca8,24,20,9379,5305,4074,30,21,13286,4355,8931
2734f86aca3ecda0817c84b6b30c769a,102,60,114726,33645,81081,95,74,105372,41121,64251
c27be22a3c442d76eb09736996be47b3,33,26,31946,17836,14110,41,31,39837,15005,24832
1bf162c3da3b86594f39ad0fc0b992d7,28,19,14672,5513,9159,24,21,12239,3539,8700
d969dc73de97b14e14e594a4b681e54f,83,71,142826,39171,103655,81,70,159296,34603,124693
b2785d802cc6d90a74497360b317becd,35,27,36620,8246,28374,31,26,34044,6336,27708
a178e5b005879b8d87fa1e05ba043f3f,125,95,348075,103358,244717,91,66,265923,91699,174224
e5d7d046e48bc5f6591f872623d540a8,23,12,7852,2896,4956,17,16,9683,2230,7453
6ff15199f79730635e6d31dce21fffa6,81,41,105188,21313,83875,63,54,85759,27275,58484
ababc45872a8d28c0a8d434e35467e93,154,112,454848,83101,371747,137,99,407538,67671,339867
a0ce3046592c08272566fe70e9032cec,74,72,106646,42835,63811,65,49,124542,28134,96408
37e84628f9b54ae41efd459c85d91404,46,34,35204,12579,22625,44,35,31261,12849,18412
2e6ba32f08c0524a6fc2bba1ea0dcf4a,14,14,4806,3384,1422,16,13,5793,1765,4028
8cccd6759805628e9e7ca24a039b15e1,121,92,288670,51836,236834,106,86,233949,56496,177453
cdb454c526a5056af89a818ab542b1ed,136,97,414008,92886,321122,178,139,577406,86396,491010
d03782ba34c88cc866719f1ab81e77c7,58,37,65069,20042,45027,54,40,66575,17522,49053
faaef5f113707e6a0ba164383317c65a,145,90,283563,64267,219296,95,74,188181,73732,114449
c9709e85448ab10fa9454d0757ccc719,7,5,648,235,413,8,4,762,361,401
4380d8fd1b1c2e6ee16e964b6346e20b,69,61,102621,31717,70904,74,58,108926,28394,80532
9545eda731576d12671e2e9e7452309b,38,31,39021,12214,26807,45,34,39927,14603,25324
dc1dbb63365ed7860afc0b0ae1a75f7d,112,100,227613,53640,173973,113,93,222465,62080,160385
a1e788900a0384bcd6a1717d71a74b00,35,32,29423,11004,18419,31,22,18596,5647,12949
7a8f66b5e91956d52777d291085c45ec,15,16,2230,1154,1076,20,14,2368,847,1521
da6dd5e136d883d641a118380268ab61,110,64,172122,39877,132245,86,64,138071,50537,87534
f12a4a3a26d0233e7b7bbeaf9c09b9ec,161,113,546223,85369,460854,157,113,445948,96304,349644
a473cacaeae426d5eb4222b92d072fe9,33,26,51987,9636,42351,46,29,34451,11996,22455
d2243dd72481a6e3de1b6c3c699b135e,123,117,219231,56907,162324,130,107,258554,54612,203942
e8d30f09e6746a426dab6082ae65c85d,118,107,325946,95780,230166,153,115,479630,113725,365905
29ff6c431d357f21ef24e83e6189d4ff,115,69,204894,47997,156897,75,58,131966,68378,63588
a9d0d75b9a2220ed7e48ad635b7dd5c9,43,33,39651,14650,25001,41,41,30405,17892,12513
489cab1f46430bec0ad68b5a74c5660c,157,116,542216,89961,452255,176,125,462108,102849,359259
e873311b9b76b4d011e3e4b8ff755513,68,55,92751,33097,59654,50,40,77245,30148,47097
71adb1b746fe4140fa5551cbd4270895,130,103,313337,121831,191506,154,107,537502,73792,463710
ba23ee35b533a3befe918507856fd0fc,58,52,69262,18009,51253,58,45,67061,17291,49770
198d095f0b0b14757c54d5b8a84c49a7,20,15,8530,2466,6064,20,21,4719,4072,647
1df3cd6b88bedee171a47183f3e29555,105,68,237138,47734,189404,111,90,225656,52079,173577
b79c5aa79fccdc63d5cafc4caab4c3c2,112,88,197043,37012,160031,71,68,130683,49509,81174
347da4214d2bfa9f2cfd573abc3e186b,118,91,221284,51808,169476,130,100,244413,68845,175568
1f89cf27df8c3d742df2ccdf2a271afa,54,33,65999,9701,56298,58,50,43077,13173,29904
f113ae02287ca1671a5b25bad0962d88,105,67,158932,32279,126653,96,74,141452,30196,111256
f91e0d622ed015b26c9dc863b04399f9,84,72,157358,38526,118832,88,67,182706,38882,143824
8be73add21c0dc286552e2ff58512761,74,46,97721,30691,67030,52,46,121426,30541,90885
f9b248d365f0f78567e66c6f2dfa81e8,9,7,1827,763,1064,11,7,1889,755,1134
5098d0d293f1beb717ee50ffa14c8f1b,76,62,152538,48453,104085,117,91,210194,35936,174258
bdd97692e638e17aa6877a3ca679e237,58,42,72025,20991,51034,56,41,61537,19224,42313
d1c2d3c3237f4d4a339891f265061dd1,36,24,22862,9070,13792,53,47,39894,12800,27094
747a765f21473a5560d576d51e4ad5a4,16,12,3481,1379,2102,19,11,2469,1242,1227
dc1a7fc3f8d4fcc3df838b7cc81c7666,132,111,423610,78632,344978,106,80,325786,64015,261771
78d4a8407f4dcdb66b65fc1043238673,134,111,316153,76472,239681,164,118,367201,57445,309756
71215f0eb3a32693fd65a32a7c07f931,20,22,4222,4489,-267,24,19,11022,2952,8070
d0a9707217309420bb22bf3895e89ec9,16,13,3748,1954,1794,22,14,5731,1477,4254
5fd533519257d5c2ff3d879958650212,178,139,609437,170684,438753,184,148,678874,151170,527704
17b6b5af2163ca5d42d749b7a414b560,63,40,140159,32650,107509,98,75,143809,33358,110451
8b4be74f8b040c6c4476789917531f5a,39,25,44892,12160,32732,42,40,40535,15126,25409
40317f098c639d823456389e3fe1517a,120,92,243369,36865,206504,87,80,126103,39525,86578
cd6d9c2612f3d55c943ce7ce1ebde5b3,65,33,82886,15085,67801,41,29,45256,13329,31927
cc8b760d07303086e7fe382d2238815c,199,141,723928,131525,592403,192,167,943378,136739,806639
df2188c39c1e01e9f486038be30b04ee,31,26,13863,4606,9257,24,20,10885,6159,4726
57251527dbd9ac14f1ebc259507a9ffc,126,112,262159,57509,204650,102,84,240733,61742,178991
68b821190d1404a046e0a1fbe96297d5,79,65,116274,39899,76375,135,96,219656,35425,184231
2ed8fdf460ee40c2a521bfd74afe759c,94,68,156629,48903,107726,107,88,175936,40106,135830
86c580dd4dc3308f260a18978019586e,77,67,130860,44686,86174,85,69,140417,44458,95959
848c194733a1383ff21677097dde0a74,73,60,102427,38808,63619,81,67,130324,36356,93968
e61df243ecfb16fd14e69eeea32fcf16,42,33,33402,8990,24412,36,22,22486,6880,15606
8e26aa61c41f7f60e830454430f07f98,112,95,223201,60878,162323,100,80,206987,38652,168335
9cb9008c9b7df97350d86574f50d12f4,98,88,151861,33956,117905,72,57,80000,32772,47228
32bc13bd47c6feefcadb7b68ade33ba3,50,39,59058,21571,37487,41,34,43827,17103,26724
fbed2a43292dce2c8f70bcb9384203a0,104,81,207532,61396,146136,121,102,242019,64925,177094
27eaf0b873373f16e160b70e478dfeb9,83,72,134431,48064,86367,61,44,91076,25221,65855
179914a67863e2f12982de11c45f767d,119,94,223233,62726,160507,113,83,277866,57108,220758
7c0f895d2fea7ca27686baf675206803,178,120,394410,80350,314060,146,119,336892,106941,229951
42172a575951fe2468ac720e45bbff0f,77,60,154603,50889,103714,106,82,209912,46267,163645
e5cd43d1e1683bf64899599ce5f763ff,61,53,63193,23919,39274,60,53,83478,17988,65490
36c5e5b8e4d3d123bb31f35d99c45f2d,52,36,64473,18781,45692,59,58,74769,26975,47794
62c919db3f826cbc226049385b266abb,102,68,347046,84043,263003,158,114,381262,92311,288951
c516a4788e126651e4abbbe60bfc891d,31,24,12966,4117,8849,29,24,9473,6200,3273
e8c7504870f36613da051b67583f9406,27,21,10161,3659,6502,24,15,7429,2924,4505
31f214af161166c900bd56d5fede278c,53,35,36007,10533,25474,41,34,28932,8842,20090
84a7f3f9753f49d952dd394f485b8f34,66,49,113140,41301,71839,104,86,146279,45590,100689
cb6bcaf6c80131f17719368ede89f416,200,147,820287,78739,741548,151,119,438756,89635,349121
01028e0e9501549d321449143c87f6d8,85,55,210482,33394,177088,62,51,124354,35683,88671
a5472805c4db3726f4ab5b37d47e0aab,76,61,137540,31643,105897,74,63,115023,37771,77252
9fab181b16c05e573329f13e9ea00cfc,120,95,261618,112175,149443,151,85,389195,88525,300670
4a1f4f221a2dfb5fd8c9b70f8951672c,22,15,3871,2233,1638,20,17,5015,2168,2847
e4e75c49481b82f39f99f9e8c58ea943,62,39,138350,19091,119259,71,59,130124,33445,96679
8d5ecca5aafea68772d84af97865ddbf,133,101,252464,50280,202184,87,63,141797,76219,65578
58b75221960cc8cb5d2d04e3f7799a9e,42,33,51605,18152,33453,40,40,33349,22390,10959
cccd0afd43939389015719afd7f232db,185,105,790783,186194,604589,184,128,958749,200633,758116
eeff83190e7ba08d62fb28d5144ea9a2,131,88,235805,42901,192904,144,105,219594,52323,167271
595517e023d3ae63e893f8708fdf5f8c,79,65,108375,24946,83429,73,60,105776,31123,74653
e3fcdb5d1a3bb17f27f18646ad0aa548,110,82,121957,33474,88483,84,58,130825,27244,103581
f328add2ae483cb001768fb328e6d221,51,46,55583,19858,35725,58,44,75754,16175,59579
9a5882b692fe19780c870186c1fe2453,99,75,206571,53569,153002,114,89,269330,47043,222287
ec9a81f7ee6bdb7cb1da631d0f0a6b52,125,95,313050,103189,209861,181,112,534908,121062,413846
36c14778814bb521ebb79167e6cdb949,88,57,153065,26040,127025,83,58,131049,30972,100077
8e431980e145f43c49eb712f031dafae,35,20,24217,7640,16577,30,25,19828,8459,11369
276c4a8640fa53901cd1dedfb6349deb,49,34,73547,20238,53309,60,56,87427,24624,62803
e6bf45d840763dad57ff79003a9ddad8,180,100,684964,126109,558855,201,158,900105,190981,709124
d0af562a8aeb3ad71095d32c6fe0d5b9,108,77,150576,43192,107384,105,87,136413,43921,92492
75bab8622cc656bf0297aa73163b0c7b,142,103,301370,60943,240427,139,107,359494,84069,275425
7c1d4912547bfa8db2c4535d59b29eb8,149,108,413480,79930,333550,199,169,630774,105190,525584
e478f60d942b20b513d0a8f3ead866fa,34,34,36684,13185,23499,32,24,22563,11488,11075
5eb983909e163983b9b5871a35c79ac0,70,51,79124,22414,56710,53,43,55892,27192,28700
ea518bf3c1aa2f200cdab68065d10d80,73,55,129367,32014,97353,88,61,103091,33853,69238
c535a84a7300a14d47a85ff91a73fc45,107,89,255066,63996,191070,146,107,318204,84158,234046
3fc798522b11201a0787647dd8966455,23,22,11365,4040,7325,23,20,7701,5870,1831
7c8a4e17b00b9ebd8fc6e1d530c8421d,153,124,382654,73190,309464,139,125,447380,133115,314265
8914ccb40a3cc79d5332bb1d6c552509,81,61,182325,31637,150688,81,48,93438,25512,67926
6149f2a02770c26853251228d9a63b66,49,43,56652,22295,34357,43,35,37148,14739,22409
e5bc3ecc0beac63d91340305a6193ca2,145,112,307233,65127,242106,133,90,362887,58050,304837
9620d1868299750ad5f8c16147259a6b,49,36,41596,13623,27973,42,39,38814,12169,26645
f5831a4fdcec727776b5e20e7c049f82,69,42,92162,24338,67824,72,55,109871,26657,83214
a749a6da7352696a81f852ead4b254f1,47,36,59672,20123,39549,56,33,77946,19496,58450
2ffca09360994da8fdbd9eedc4859c2a,114,86,246306,51914,194392,125,101,244204,62997,181207
5ef34acbb23f570226c4ada0430932a6,98,83,141129,45046,96083,91,84,146701,47289,99412
688e93d044108b6bbcd00e3ac8946163,116,99,270590,55446,215144,130,95,237748,40856,196892
fc465b1358c7aeb7715f9f7dfcb93840,69,51,111818,34651,77167,109,98,175289,49597,125692
745a8e54878f0044b07171b145332060,35,26,25451,12367,13084,44,34,42628,10707,31921
1cc14c70366f9bcdef35eb8a45dc80c4,3,3,269,394,-125,1,2,316,225,91
107672708a5dceceb17f467fb41fdf2f,57,48,71456,25863,45593,77,47,134490,22762,111728
197e14aa2718428c376c601d600fbd3f,24,23,9462,4977,4485,27,24,11565,5321,6244
f83b87def966b2f91e91724cd36b8543,189,150,564472,132679,431793,108,88,405782,97120,308662
c6b66722fdcb5ac4697951e336176e7c,152,129,517703,95686,422017,191,138,500646,86335,414311
cd4c169a9d6fec0bb38d459fa21d7e0e,141,106,391131,73230,317901,131,102,405327,72763,332564
5e5265eede04107e6055874b1a57f924,171,127,533704,77377,456327,156,137,507738,104415,403323
e7ed22ea355f23941830f6a95c9a68c9,123,93,341313,58918,282395,121,99,272425,54551,217874
c856455480bf5822a74018922eede6c2,29,23,19218,6489,12729,32,27,17704,6814,10890
ec6f6e764cb96dfb3b5f0206258be8fd,174,130,575431,112770,462661,211,140,879146,107445,771701
01ae9a2c177c646d7070fd18eecfc75a,40,43,78299,22859,55440,52,41,66610,19063,47547
49c97ecab826e5a7d151f06a34d9e98d,72,57,122681,36296,86385,64,48,83094,41292,41802
9827b365ce48b46a8d76745f2dd41681,189,131,531782,102311,429471,167,129,464221,140033,324188
3ebb1d0563623c5d0efdb993c3c5b58d,175,140,667365,151694,515671,202,136,735220,129580,605640
5f584d5110ff9382ae1f13078705dac7,122,103,328727,54073,274654,112,80,179673,68207,111466
4f3c8f38077dcb03ad308f557fcb839f,166,119,475618,113537,362081,133,104,445578,136771,308807
8bc50aac992a081892448d062774f89f,178,132,769713,241152,528561,167,129,731150,167947,563203
c8db195d16b0be7349b0cf25e68e2e44,21,10,4039,816,3223,18,15,3471,1517,1954
b33133b646b8f866afc4f067f507e4a1,46,32,60729,9814,50915,30,23,31302,12838,18464
cec279dc8e3281cd0af0fad0246b80db,48,29,56712,15208,41504,48,37,45261,21035,24226
cc6778a14ba164d486d41a3be0808706,25,20,13693,6859,6834,41,29,28859,7330,21529
18df6b023c5db444e17afb61692a1bcb,45,31,46896,22293,24603,56,34,84420,20030,64390
41534372ac669226ff7f0384e187be27,32,27,32914,10723,22191,43,31,40530,10479,30051
8c0f8f88236ff2b18c20461163335bcd,26,20,17132,10518,6614,27,24,26450,8871,17579
c569501fbb43f237aa256072ab6818a2,80,68,87103,19214,67889,56,38,73565,16338,57227
39de9e3b474fe1d80cdec6958df2c468,210,141,791285,153651,637634,219,143,800403,199624,600779
9c43c8c6f5909d6b8586601b0e9480fc,159,118,466917,151495,315422,156,130,580181,126113,454068
e38a1195b3785dbbaf8f288453b4e243,41,33,48070,19774,28296,46,38,42889,27268,15621
fc2ac1aa8f9cce88f2bb548b656131b8,14,10,2203,913,1290,11,12,1502,1392,110
28e98c78ca754201c02440b6512d9551,112,91,286232,61997,224235,110,92,230307,62524,167783
bb138994a214707f0f8d1a139e17e2ba,44,34,43399,16577,26822,46,34,38245,15943,22302
d56ad3cc56ea9f381bdeaa2af71f1857,19,18,4914,2347,2567,18,16,5034,1261,3773
c6850bfe104abb7d421110cf14acb6d4,47,30,53713,12833,40880,44,33,59134,17073,42061
b58cd64d6dfc60714f9ca17348223fe2,66,39,131764,30692,101072,94,65,147551,41669,105882
8d7303ba790028dc7b780b7538deae36,134,99,343393,66179,277214,152,126,413562,79108,334454
26104e7ca4792a95ef41ea19a3b6ae96,9,4,1639,229,1410,13,6,1098,443,655
daf535470f749c4fa1973d1c7f751258,84,59,128973,40169,88804,77,54,131630,37155,94475
eb4c6d5cd2e7c25a1dece5617bba62c3,104,84,169935,52075,117860,97,95,223385,63516,159869
8220c4b5ee29cec1df762115885fef3c,108,88,212061,61371,150690,92,82,169276,52589,116687
e258bd19afef3044592653c2ee372b4b,174,117,673108,168851,504257,202,128,640356,190518,449838
fc01ef5a7e5ba8d0ce4ae35048351d88,95,68,79677,26069,53608,55,43,70122,19712,50410
cf8795aa756f7d832ddae7da711b8091,112,89,288727,44290,244437,85,70,177818,60338,117480
9bcacc761e296f9190acf260cce30bab,109,95,203324,46238,157086,81,53,170520,28300,142220
d2d279d0ea09fd342430828bb9ed2660,48,41,58174,23280,34894,54,33,50059,14178,35881
d51b39f82569d94c8155b8e76655a3c7,132,89,442075,88018,354057,88,77,242256,103785,138471
781b1089fc7a0b977e865a13b1f8b879,157,114,494817,121712,373105,165,134,490885,120081,370804
76227ddb84feeb193671ed5fd75bdbb4,213,145,738379,128438,609941,145,120,619517,161195,458322
182879decc12ed7b03a8931f0f1bd2be,91,73,142736,40517,102219,68,66,96236,32995,63241
21c2d9712c61df88cd2f407a37d8493a,181,125,715631,157974,557657,160,96,672625,134703,537922
355cd5a789c1314d1db61f2d3ec404f4,52,38,55976,24333,31643,65,51,103416,25936,77480
b29c3c2d9e6f0312396b394a1e51ceb3,35,32,39921,16250,23671,33,32,37392,15412,21980
383b18220e4acf487bbf5e3dff483532,102,91,219785,64409,155376,161,132,372173,66982,305191
7ee7210b7494cdb053a998eb2d0ce817,71,59,161740,46029,115711,110,95,198663,48596,150067
1f8c618fa5619c142d1e133253bba8a1,26,15,8409,2810,5599,20,18,5365,3598,1767
29b8856dbb3025168ff32bfafce47b18,142,129,353776,78046,275730,103,80,266512,65114,201398
cfd51e05e29f4be72a230bd43167c4dd,110,88,266827,54596,212231,110,74,200871,56094,144777
e21fed1fb08dafe832c3594d6656b438,112,71,236995,44304,192691,123,96,258630,49216,209414
27c4df4d66fb6aca571c6db667246a1e,165,124,661395,150287,511108,155,129,548274,171270,377004
be9c167d64f17373d7fdfb27312ddd5d,16,9,1996,643,1353,9,11,1026,701,325
a7e95efd0c78baf6806fd1272f41b8b2,50,39,60593,25147,35446,42,37,75296,28759,46537
aaaa60a5131ba5f03a12563ebc15ba2a,34,24,31929,16744,15185,36,26,39573,13699,25874
c4bafc3341e5b3eeeb73585c8678a33f,122,99,561048,149516,411532,153,130,741597,160660,580937
184033aa8c45096d1b131a3534b5c588,28,25,21083,7127,13956,28,24,21849,11189,10660
37791fd70c587de1f6ae1fd58b0d9281,91,80,224648,45106,179542,94,81,193534,35126,158408
3585ba3f12ef19bf77c1da91ce16fe19,58,49,72870,16942,55928,45,27,40486,9675,30811
725ec4b525a20f3088842bea2a22132c,1,2,177,354,-177,2,1,354,177,177
298be8c4893a6bc68f92bdc734a31e01,83,54,120884,44260,76624,102,77,169075,39579,129496
9c2b6eaef60b3ac402ce02f3c5c22255,47,32,67126,20639,46487,41,35,65758,26197,39561
01bd785a913aacf0df801e26c368ea27,121,101,468223,89055,379168,111,85,266227,64530,201697
93df2083cab8c30b2202abbba1c484f8,50,36,92819,29301,63518,52,37,74904,30720,44184
372905100557b0ba8cb6d8d377a1419b,10,7,1195,554,641,9,7,1140,826,314
e8f639777817fb9e78f250ad96882848,110,94,282752,54993,227759,129,99,257738,60753,196985
991d6bb851b80b9407e240b15df04ee7,160,115,418298,136556,281742,137,100,389128,110223,278905
06efd2f7cd238f78cc0be64415c88a67,79,62,134702,34166,100536,69,72,118539,38898,79641
dd83e232d0a0d18540a7dfbb26922a76,23,24,12674,7941,4733,27,19,15633,7565,8068
bbc3667af8894ee1d4346867c2d52b59,115,73,130480,28456,102024,87,69,90926,27077,63849
8c41051c5c7410a70ec3746b1b9f6cd4,114,76,155927,52688,103239,116,89,235793,45364,190429
0179c63509d3de2f529d8033787aaa49,95,78,189014,68389,120625,119,81,281262,46032,235230
d73e518f4bd1272b364e04c24af91c0c,24,19,13171,3962,9209,23,16,7521,4550,2971
3cc42c8b9892150256dbd217fe250894,55,39,71549,28785,42764,62,46,91130,19500,71630
8a029e164cfb7f560ecd4a22a2b6eb9f,37,29,30180,7661,22519,29,17,24575,5950,18625
bbeb13af49dd320cb7ac64d993c40cbd,46,36,40267,20893,19374,77,58,137039,24769,112270
0a6ae882bde06a3b163abc2843464b69,139,112,405816,85695,320121,137,117,423085,87744,335341
3f3e99c632d6335828cc29de1fff853f,113,77,213903,54830,159073,123,93,194896,68959,125937
cb1d6b05fe9b31a89b2f8ec2711b36b0,93,84,177685,57565,120120,72,49,110500,28031,82469
1c618df91c8ef7c53aae2e502c48185f,87,50,154741,40613,114128,93,85,162554,50146,112408
496aaa901cee977d12eb0412eafef854,138,104,319223,58056,261167,107,92,257747,73027,184720
e6ec39d9054832637538aee3664033ee,30,20,20096,7499,12597,26,22,14547,7520,7027
5aaebb50f8103dbbb1ec642148edb11f,262,173,956071,112360,843711,190,132,674445,108041,566404
75c37a137a45dd1e5ab0fe82af832504,33,31,19233,12106,7127,40,27,25961,8692,17269
ba9f5a8d2a35b4700c848443419d48a0,81,62,137483,38509,98974,109,93,174793,39569,135224
20ca5a1ac0e67c5e742b85e47a88f152,143,86,346261,88235,258026,164,116,361482,101882,259600
94ed28cc3432a680640d16867dd07bc2,246,170,979618,128441,851177,236,177,1221019,155390,1065629
7ba2a3ffa16fdeb69fa3e308b2570ed3,101,75,320075,85426,234649,156,117,478573,97147,381426
4ecf4ccc07f485533643f33b931bae55,2,4,118,254,-136,5,0,934,0,934
24078cb06291b74ab9541f4989f16782,30,25,12660,5948,6712,31,24,11943,7106,4837
b1278bd43ecbfbdddf16a638c66456a6,36,32,26506,11996,14510,33,29,31640,7259,24381
78ab3e7cd0725d16389053c55179fad1,22,17,5098,2272,2826,22,20,4042,3169,873
a437299bc69825e0c2576495605702f7,25,24,26571,12979,13592,29,25,26567,12490,14077
609d9d8e91e2c5c384a68099fe93843d,43,40,48764,16895,31869,54,41,46096,15632,30464
6c25d95f836ca183dbc966e9c2f1054b,198,141,665517,130816,534701,164,111,804955,134155,670800
4cd4497d38913846b740539cc7379b14,174,104,695560,122978,572582,177,128,623000,158301,464699
18bb77469d485fd662ea0f1e2a0f5b0e,52,43,105874,37775,68099,73,56,113600,33509,80091
3822e66b629895ccbf0d908addf9972e,112,101,200505,45516,154989,140,100,232375,52012,180363
e64bbe601d303fc47a79409331addf25,193,150,918565,177594,740971,174,116,1010813,139334,871479
d3f1462d9e49aed1c9e9f2d1970b1cbd,112,102,300089,81709,218380,136,121,341369,65772,275597
9df690a62a287a0ced56f2cea1ba2343,1,1,56,18,38,1,1,18,56,-38
a71cad2e4895b4d15c2fb7f244886089,37,26,22290,6549,15741,25,21,12834,4886,7948
de15dea77675c06d612e1a5e185efe53,65,67,121531,45832,75699,62,43,86743,42724,44019
16187d6031dc0bf018a34e71117c2903,139,107,408474,99535,308939,150,104,453689,118730,334959
ab08687617e9923b79f955c395ea76cd,15,11,4014,1352,2662,21,13,5132,2404,2728
e5200bfb33425c6315f37705a5713973,25,15,9762,4492,5270,24,22,9151,5633,3518
84f7d32d199233059c312dc61df554f2,68,60,105475,26926,78549,60,38,93653,19882,73771
939c3a81696405c133efddc9fb0e2db6,26,18,10511,5112,5399,21,17,10143,6027,4116
feeb1170092bb453640c0a24291c1ee3,55,52,44891,17283,27608,43,38,44572,11982,32590
4a36886161ad735ca62942494e6fb809,55,47,86678,25391,61287,70,60,116950,29856,87094
2698e6e371e996c8bc63c854ed5d7398,143,109,418727,90750,327977,156,119,556828,73066,483762
eba1425f05c4a74960e441f966d3db7a,48,40,72881,22430,50451,53,40,75811,26394,49417
a8feb25b274a5ce9d9f6200721821421,39,31,30701,10053,20648,51,25,44072,9558,34514
62c59bb27ca554883b7ce6e9534a71c5,33,21,24862,6115,18747,37,25,31596,8096,23500
7b73eb227247b03f66a52dad8621dfbb,139,101,338149,87902,250247,138,100,336403,62865,273538
e10322276a46f610aff2fdd5cc3a4ddd,27,24,8129,5971,2158,28,23,8219,4268,3951
c662640039d574aa6edd6b4cae7d65d1,104,79,205597,49581,156016,103,83,207622,51897,155725
7e2644e53fb142cf68eccd9f7aa092db,29,25,15060,5815,9245,28,19,13003,5524,7479
6ac52cc2777ed2fc4ed00c6ba48da4bc,66,44,88701,17490,71211,52,40,43747,18188,25559
eee589e0e177cbe9c01902a58e974eb8,18,14,4011,2930,1081,22,15,8130,1843,6287
2a609a0f05a3b092a6e1ae90f7aab316,71,53,132117,24278,107839,61,53,70428,37012,33416
83f3fc61b99cbe80118425140b1bc46c,122,89,340331,62382,277949,114,91,257141,66096,191045
223cfc0d9664f13e8a46cf0b6a97227c,67,53,112149,35116,77033,49,49,75106,37846,37260
8d4a5d8a6a5697d019abe79e97ebdb54,21,13,9005,2719,6286,21,19,7124,5511,1613
2c266d498465ca7c327f1978332b4ea7,102,72,266296,53077,213219,106,85,201464,88227,113237
b3e1396162a1fd094ee86f4a7af2f44d,106,84,206314,56770,149544,136,114,284620,55762,228858
93ec74e0f8e92c5fdc8be3c0e9528292,31,22,13214,7438,5776,36,26,17350,5709,11641
483076eaa227489f6d6077f542064331,89,69,125690,27558,98132,54,48,61728,34418,27310
3a51a02d944079922fb51130ce06712e,139,121,397232,95077,302155,147,105,351424,84511,266913
553fb9796fe3cbce02e282f8088beb49,74,56,109170,30993,78177,62,54,77218,36154,41064
30939498ef46f8a08ef0fc6e71ab34af,34,20,35994,7054,28940,37,26,26692,12425,14267
7d7f5e10dada28b2f1defa3e91ca15e3,172,128,743267,134736,608531,181,136,571428,171049,400379
e40663b42ed9cab8289fddae8d786052,23,19,8460,5381,3079,29,25,10189,5990,4199
4b0490ed03e8a0e5b989fba20262fa87,113,92,265785,70110,195675,89,77,218993,75724,143269
a661655eb69ec1dc934c4df65204fb77,29,22,19082,6657,12425,30,23,17044,9053,7991
4c069a464d44bf7baef2fb050cb67164,44,33,47863,20533,27330,46,34,49120,21753,27367
9bfca718defd2c3855385f2067f78351,173,115,516024,122585,393439,188,137,603589,132073,471516
8ece4f303d6794d285fdb980caf0179b,115,80,204428,59863,144565,67,59,120119,46808,73311
e1679d421ec0be81bcc693067c4abb4d,150,121,373317,86729,286588,129,108,384931,106415,278516
62262b61b7cea640dddc2e5aecb898e7,17,12,3466,1565,1901,13,12,2395,2381,14
48807543c8ea0db766dec46c340a50b1,149,118,307414,76894,230520,127,96,233664,66670,166994
5cabfb06f940edf824d051bb65445e47,28,20,25212,9152,16060,33,24,31479,9697,21782
204fbb6e2e424922c7e7da833cb3d976,23,16,9481,2870,6611,26,18,7475,3575,3900
d87f3795ad49d167430620551f67c2ba,178,114,462862,72180,390682,125,101,306565,99313,207252
a61c6dcb40e0df77827692b25316ea3d,75,43,103061,28280,74781,45,36,76551,20441,56110
3f9e2599a2a448614ed6af903c03b9c6,65,49,117824,40232,77592,65,57,113717,35985,77732
490c1a673874dc18013be8257da3b837,97,84,163793,47693,116100,118,96,176814,52482,124332
d4afe639c80d530310fa88eddd134a98,58,56,97492,48217,49275,119,90,254573,46538,208035
06ec60adb53d2403227c37c77bcd4930,64,54,93911,35983,57928,67,56,84704,33885,50819
fab278a8e136101003eafa65545e4d2f,67,49,86419,17964,68455,51,37,42957,19978,22979
8d9de3d06ba4b81baa239381cea2506a,70,58,120917,27575,93342,71,52,110729,24816,85913
fa367b284d626fad06406ab4577ef825,47,42,49883,12855,37028,68,60,79463,15598,63865
9d7ea5ba21230f42a8066fe6496be794,33,27,37850,16213,21637,40,26,42440,18379,24061
223458423e50ae649d5081cf93d143b7,14,13,2238,1555,683,16,12,3760,1367,2393
83ae27c5cbfb8ed35ed9a00ce20d8410,80,70,142900,32046,110854,88,70,133164,45241,87923
faf16992d03eb9fa8e79c4921fff0da5,34,24,19877,6559,13318,26,30,16566,8438,8128
5ee4c49117a7af44effe2bcf715090ed,123,96,306538,57966,248572,96,73,216870,53895,162975
193d54e34a03fe44d6dba84059640d37,61,45,101224,31239,69985,91,70,153425,34104,119321
b6e37c7bd810c2cca4ed2784402bdd9d,30,23,18900,5390,13510,29,19,15079,5642,9437
129bf244d8fd1cd38a6d7fad69a94481,19,16,5967,2974,2993,24,16,9512,2004,7508
228f3f533a508b12db157e72375dc4ce,126,77,280832,45384,235448,119,105,301158,77104,224054
5c694a458c5ada616beaff6ad6c5ded4,49,34,52973,15623,37350,49,44,57213,20749,36464
57185fe225b2cbc3309f4c1e259810f2,102,80,145323,36750,108573,62,53,92625,31841,60784
d346a17fafbb32666c4971e82c81f331,107,79,244877,55852,189025,115,83,294522,55529,238993
d8f1c46af8f46ba08c8025dc6a6d989c,106,76,243196,83631,159565,155,96,357630,53363,304267
9876555967a64e07744f861280c6d0be,46,36,33906,14737,19169,38,24,33542,9515,24027
dabb7e7e3322d58dfc3178e897d04e1f,107,81,220960,51445,169515,107,86,177515,53683,123832
391584cf06e8b6ae4052227201650279,154,140,426956,92027,334929,175,147,399240,83042,316198
e15596ea301aa442815945eb767060cf,120,101,247288,48424,198864,116,104,236587,42876,193711
507686a42af08ce00ffe495f79cf8ffe,30,23,21552,7893,13659,28,21,15280,10170,5110
00baf1535e6063e5fd102cabbf3b8ff2,112,84,228451,66898,161553,86,67,163085,43194,119891
710eb7c10a32c400e4d2833caf1ae7c2,111,96,332384,68735,263649,95,76,226403,58381,168022
c87dddda8c6a3d38eab53aaab2ebc8cc,53,31,59682,33586,26096,51,51,78138,26047,52091
93922e123c08dc830e80e205c0e62fc3,104,85,170596,51324,119272,82,70,141299,56327,84972
9ce7cc8b69ad7dc66a9e77ec1cd8fe3d,58,45,41964,12070,29894,41,35,35803,14705,21098
ab81e8e8da05cf5aa7bc698f00c5be0e,88,75,143272,39157,104115,62,43,57394,41781,15613
5acb3a64abd555105b7e2ab33a205175,72,47,81878,25503,56375,61,49,58918,27619,31299
c715d5a5bfd2d50209580ba327164faa,132,102,391565,71029,320536,149,112,441409,111036,330373
938ff0720bc6aeb635d3617b63c23a6c,105,85,180433,28060,152373,107,88,152138,39447,112691
81d57346e8ee9cb96ea95de6f3dcabfc,48,40,39610,25286,14324,43,25,48530,14369,34161
9b4f4433ed33cd0b43c4205b169aafa5,133,113,441952,106361,335591,158,114,515152,94245,420907
bfbc78cd70a545073e95331624903ffa,147,109,779191,209310,569881,218,165,709147,202066,507081
2dadcda603036737f23ba05334b8854e,176,129,473841,79979,393862,187,137,711412,82381,629031
4d0f5feb3a1cfa517b6cf384a489fcd4,149,112,393099,71086,322013,123,103,350965,76909,274056
f1d8245cd70d1a63a709d9079d6517b3,161,112,461990,56927,405063,141,96,277301,70588,206713
61d0077e9fc06aad51aeb578e16fc37c,126,105,326576,81826,244750,106,91,179846,76213,103633
1ab9323718fec45496f1660415815f94,142,105,434299,76870,357429,156,116,481173,112782,368391
b4dc628bb3a0cc92203889f15b2578a5,114,103,226652,51977,174675,77,57,138506,37376,101130
218ce67c05e05c97b76b06e57643247b,60,41,90525,32574,57951,69,52,92642,38873,53769
b4b192bf383fe071bd6309b93a7d798c,86,75,164544,49466,115078,101,77,224985,60213,164772
1f4cede604f81e621f3556b3d1062ef8,85,71,122408,21537,100871,95,79,153999,36349,117650
7d220c09b50601ad5b51a1028ad623b9,123,102,332647,76543,256104,99,80,298970,65101,233869
c7515ec66993922ede1a5763be6203e7,168,100,393024,51126,341898,156,126,435456,97716,337740
e0e655aa9c1d63f7fc75e9153eff5109,31,27,32241,9989,22252,32,22,26800,9736,17064
81caec2659507110161f6ff311b6a215,163,126,421705,131582,290123,178,140,617616,110746,506870
271d0a1c4db0f5239a2a50ef92e65f44,3,2,454,255,199,2,3,255,454,-199
d85560200d16a947232047191f8c00f4,38,28,30824,15922,14902,50,32,57060,14114,42946
43898185bcf2c3acdfefcf8bae13894f,115,76,191894,43251,148643,90,79,161768,52839,108929
b9cfa1a9cfa2fdf7111d8f772393eef8,142,115,464514,153494,311020,184,146,766806,121446,645360
24a4d7ae4e9fc4e6754945d877f413df,180,146,505549,84837,420712,142,109,473951,78152,395799
8164a9fa56e9178d6f8ada9f0b779486,133,108,361059,111806,249253,122,82,406710,97522,309188
5609dd4aead6d5c76e70239dce45a66d,28,17,9832,5237,4595,29,21,12777,4354,8423
98e1f104922980b216ad6b6a7215d02f,20,14,5436,2011,3425,20,15,4773,3817,956
ac44834b2e10913cfaba2b1b5668da5c,114,87,173519,42640,130879,86,73,160197,49858,110339
63148fe6ce060875ee5dae58b28e6ab3,38,24,18275,6532,11743,26,21,12360,6926,5434
dc3d7b03687ad55b6dee6a5a68506563,100,58,211178,67390,143788,127,83,258727,65337,193390
eb05b3a7b99297e372287bd0d91ceaa9,52,52,51975,23062,28913,46,41,44422,22655,21767
2b64a2a064bf092825a26f5ecea78944,97,79,236543,84494,152049,136,102,364152,75384,288768
7dfd3ce165316b0e22778490bd038cdc,63,60,75356,23376,51980,70,53,93457,25021,68436
1acce60892727d27e204f0f6fb7bfde4,153,114,511827,91353,420474,167,116,419428,125646,293782
23988fe2ed211f09f47d932971da8a56,27,22,9211,3430,5781,20,22,7632,2435,5197
f3022e98b1fd28495d948cd995beb91d,89,69,140155,22348,117807,98,95,103802,35537,68265
3d83a234e28588385e5693accd25b928,68,58,78162,31461,46701,65,59,89931,28996,60935
2c9f80b6dc9994292311f79a71496a86,210,140,805546,150920,654626,247,140,920893,162692,758201
15f7dd12f94cc3dfe217b1a960f40417,119,77,217427,45940,171487,90,65,127371,53076,74295
35a0d3ff89b4be2ed15d3eef8dccb98a,144,107,460088,123373,336715,163,108,435021,100122,334899
fd4cf64f4a79780d4d3daffa89ddbf9f,19,17,6480,3165,3315,15,12,3125,3137,-12
1a9acb74267ab60bc763ec0c72d7a60f,60,49,86340,17545,68795,44,47,42350,19481,22869
1784d34bad7bd4467f00104736b7d1c4,39,32,36192,11498,24694,35,31,26952,12079,14873
744e4139513181bead61213914f86ade,133,122,413912,137452,276460,134,100,425143,91345,333798
4d82c8cc4d771e1eeb71192672710036,115,79,205712,48924,156788,143,114,336264,78792,257472
d898e70fe89b181ddc310e19d62e1a56,88,82,191026,58710,132316,97,81,254794,63507,191287
59ca610bc8a1e3e73220980714bd8bec,106,83,143419,38813,104606,82,63,130831,40941,89890
6ee6f5f3854269465f1ae0f30c1817bb,78,63,101461,18676,82785,69,59,96009,17095,78914
23822943f1bd36e75711c2c5804756cb,16,19,7959,5072,2887,28,18,11547,3321,8226
943f8881ca242ea58bb74e62aeb49b56,74,53,117107,36971,80136,65,51,144836,34182,110654
f0d84264800040a5256a8bfd4c364d31,35,31,24974,11616,13358,39,29,26682,9705,16977
5dc1e44463b4e792b527c232778add8e,78,63,109212,35524,73688,90,69,122042,32715,89327
3d22b89883e919a871b226de726e5891,105,87,191476,60010,131466,92,67,128337,52217,76120
0789e1a0a8c9125d69c941762b3f2bde,56,50,109190,55076,54114,101,76,242412,44163,198249
421a56938b64574de9af2e6ac042837b,132,100,274197,53803,220394,107,68,196679,46224,150455
c27831ff44f658f6516d272bc3f73e1a,43,34,41986,16693,25293,39,35,56239,16465,39774
ed79208f4a6227e87168f75eb8b9ca16,152,106,328851,44145,284706,147,131,424340,66173,358167
be3308c616a7c6d140ed7a0b8c539672,37,29,48048,13588,34460,46,34,43308,15368,27940
ba3f49ac72bfce5670c2b2c1b058002d,50,45,57067,21027,36040,39,33,48018,25051,22967
9c1415d2226a64e56e771b9093a33bf5,170,133,389446,85619,303827,136,95,315604,69834,245770
0d575726b880156188f70cc3c66802a5,63,59,130037,37719,92318,69,58,128757,36770,91987
5ab9ec67777b96d204a70f61544c45aa,117,89,257678,62557,195121,93,84,196732,101638,95094
2c2ed1cb1b499e5fc7577376a8cc629a,38,29,38527,17369,21158,42,35,53054,11609,41445
917793715f0d49d604e0461045e175e8,111,80,206557,46262,160295,136,109,198704,43083,155621
2d46fe11e829b7e43f7daa2a47664ca7,38,27,35595,9375,26220,42,31,30492,11077,19415
1f84c28dac29689057145e510ea44062,62,44,85275,16512,68763,75,58,86893,27698,59195
020b609582cb24f6ebf3636e14550921,122,100,294202,66301,227901,117,99,220435,68261,152174
15ae0ca41f2719d1f84ab21223ce1901,30,18,21834,6006,15828,27,27,19817,8242,11575
57d13ff14e118ccb00c0fae638695498,91,71,119175,42252,76923,80,65,129806,43555,86251
ab4796aa2b66b353a2791af0cc1cc0b3,160,136,366882,68097,298785,135,102,376218,76903,299315
2257f8c2229b951bc93d3d3851f31a9f,141,120,393674,79731,313943,167,128,367281,68349,298932
46133811361fd79fff5bb06c15e95ee0,103,77,298731,99061,199670,141,116,370848,91463,279385
7b6075f03d000544a6047adeb15297fc,67,56,106860,39258,67602,79,71,128644,40452,88192
9bbe338c50df211555f894db17717a19,111,95,227486,85427,142059,167,121,342884,47007,295877
8739fb835f702bb31f5a6183801536c0,153,88,251712,49112,202600,117,107,198011,82013,115998
c7476700ecd7d468345780dadfaf1c94,24,19,5571,3158,2413,22,20,7810,2420,5390
43d13dd93dfae1f7896ac50a02b15aaf,7,6,521,337,184,7,4,611,267,344
fa27fe5c193ed39f57df51e16aa1eceb,65,42,73254,27361,45893,74,58,93353,30528,62825
f6f546bb51549fd599b2301696e13c9d,46,35,38406,13006,25400,50,43,58313,12031,46282
131eb538b2182277b888dd3a1dd25a9a,175,126,395425,69862,325563,119,97,276839,78401,198438
cc5aeca36067a61b7e5e509a491e1148,124,89,307577,85994,221583,160,103,444541,78423,366118
984de898d79722beb7316cc29e94f72c,2,2,289,358,-69,2,2,358,289,69
03a8d84f24855f7be71e450eb6d8d93d,55,39,76924,18184,58740,60,53,83663,17815,65848
d9c9c8c753d35fd232e20313af491209,73,55,168886,41657,127229,79,62,155827,53971,101856
f82dcaaf055cdbd0a253bbfcbcb7ec7e,171,110,423059,63007,360052,152,82,351802,46921,304881
750968b1fcefe9745159918e129c301e,59,49,73731,22571,51160,75,64,84736,24161,60575
f802dec87192950eb9b60e75d9ac4faf,203,140,652186,100125,552061,186,119,679295,104247,575048
0fc83b2013b93b1a522c7bfe4fb21032,42,30,31396,16987,14409,46,41,42070,13337,28733
ee968b0f82472e4f338ca680138aab1a,10,9,2661,956,1705,13,9,2663,1526,1137
4a6559b2218faf320f6316e64061b86a,21,17,6343,2369,3974,22,17,5017,2658,2359
31f3f6551047f1f4edbb6fed80520aee,31,25,32006,10864,21142,31,23,25701,8311,17390
a972fd45dc689e09d4e041ca183e570f,28,26,18124,5717,12407,29,22,9308,4371,4937
97b33ce9de27d517fd9e537b971465bf,163,119,432507,84873,347634,127,102,374142,84342,289800
540ee890c0de875fa8fa0ebc39f876a6,87,64,116287,21547,94740,71,46,76487,23270,53217
dc09ae99e1faf5b4029748fb413d2dfa,102,85,165845,50222,115623,121,92,283304,49675,233629
eaf75714e73c66864556191addf76d52,106,88,297836,69531,228305,140,98,344649,76548,268101
ff103ab2c8084d4906c8aadd6cb8481a,172,113,661062,111969,549093,160,117,563914,183330,380584
37167607fd08ad00b86ed00e53bc48a8,101,88,311096,70840,240256,130,94,342601,83902,258699
81d328b0c7e0eb4ccafa2249d45c5acd,92,69,193619,28312,165307,124,112,251306,54490,196816
7ce80fc00e6dc444dc980ad305df8082,1,0,119,0,119,0,0,0,0,0
64b2713d99bac8663b100b8dd9c7957b,124,97,226083,39732,186351,167,121,307962,44182,263780
18da000fbefa37d6cd33e1f360cce004,44,37,68914,20251,48663,38,28,31593,14503,17090
f3a6068b918073d2179c59f54ff32bfe,34,29,29764,19853,9911,46,31,44313,14146,30167
51d6f21e77d07e8013506cd13a78cc09,32,24,22220,6762,15458,23,29,18340,7379,10961
7cd4be20afbf4325ebd76dcf6298dc70,63,45,81056,21782,59274,63,44,81676,28305,53371
304473908bcc2afbd6156a559d291346,21,18,8870,2950,5920,26,17,9878,3005,6873
5d143934e984e7ab8801229fb62abcc4,166,127,422271,105286,316985,124,110,286582,101574,185008
3a53d94a8dd1c36b1dc811386d9f09e0,111,77,312660,52198,260462,177,158,517799,88272,429527
bfd89b7ff1fbf0d39f8cf00ab9534493,65,51,128155,56688,71467,136,108,309726,57029,252697
b6e813c9cb751b4625232bcf775a2a41,39,32,37294,12290,25004,37,33,28643,13513,15130
52a573096bba4692bf14fe5683085916,69,63,114389,45941,68448,105,90,199767,48917,150850
2761d598368cb3efa503cb952a598e83,75,56,148622,39977,108645,98,83,186746,49635,137111
8571147ad2dc7319003726b3edc79f1f,233,146,704319,102954,601365,193,113,540527,102341,438186
90fb625157b46c82f2876598bf48296d,76,61,116686,28585,88101,66,38,91674,16906,74768
74e06ffebc34c86fb4fedb290c89a53a,29,19,18629,8065,10564,28,24,21316,6809,14507
7f2a026d7e6fe0df40b2715a801919e1,130,102,340059,69792,270267,147,126,349870,86245,263625
03e0791cb948596a560c84733da5ee42,28,22,19932,7655,12277,35,30,29862,10404,19458
8f2b78d68fe06e54fcdbdcfeb6bc04b0,87,72,160095,32953,127142,108,102,148980,37938,111042
df500da7a70a17c730382cbd7a9463ca,24,18,7814,3399,4415,24,19,8317,3193,5124
746edbfeefac998dacc065edde86c53d,49,40,57628,23694,33934,65,48,79382,21503,57879
06bfb66742d09b7a4461ad5044b4beaf,99,73,171823,37508,134315,70,49,114950,43182,71768
c5a5c6873eb9310b1a469820aa08f5cc,125,110,262874,72743,190131,103,81,211249,56491,154758
e9b4d9124613bbdcff016d5bd8192dcf,101,73,185318,48510,136808,98,80,225274,37789,187485
b8d63d55504480dba6b991de45358557,96,75,168680,41812,126868,91,53,149255,22116,127139
1cdf57ae10f86178c3a0286e6f4f65e4,139,101,301672,54567,247105,111,96,247015,60842,186173
cbde3f2f05469abfc3083a85f89c33f1,35,26,27221,8423,18798,28,25,23512,10619,12893
c8a3301f6092a0acb277f8500d82528d,97,79,264142,90177,173965,120,78,256107,85072,171035
80efd58722af4d55ccd3971e28389822,159,121,421374,76512,344862,156,111,490733,85759,404974
7fff01f56e852d9f3169dbfd337e90da,52,46,67315,24437,42878,70,59,97251,27589,69662
23c5e68c44ad549edbcffd54a88cfa7c,40,34,48849,18294,30555,47,45,57048,20566,36482
5d4326cd6b92f66655c102490a576e66,53,48,83307,25062,58245,53,39,65107,27339,37768
55214e14e04c50aa2b345dcf487e00f6,47,45,53248,24256,28992,55,40,51945,22056,29889
5f472aa06876ffec33872c653df75d66,73,63,255714,51401,204313,86,70,204432,67494,136938
3de0c673e4b69d5ea4083092c0008371,56,36,57264,17192,40072,50,40,56069,22971,33098
c9f115a5bad621c84bf92798e997e81f,143,116,333105,88998,244107,147,114,391494,74700,316794
424c91e99892a896fc63ad6e4601b0a2,44,35,34871,17538,17333,47,35,44152,18377,25775
5cae83b58a0b57f1355a8413acacd5a2,178,122,429822,100620,329202,112,79,374645,99855,274790
66ac287bfb467c92f861324d22338049,12,13,1247,1278,-31,16,8,2992,698,2294
b1a160e8948754e7f28bb4d657faa58c,4,4,328,422,-94,4,3,443,158,285
af8fafd62aaadf8aff4f8330e333194e,76,71,117687,20269,97418,58,37,76847,20360,56487
a2ec00ae03384d8a5163889a664c0b1e,77,52,110702,25091,85611,85,60,175782,24036,151746
7431aafe6e644ee38022f61a7c17b511,90,76,107728,41311,66417,88,63,106771,38133,68638
44a6478e4563b7d8b3fd9c8841871ae3,44,36,44394,16867,27527,38,35,41040,17537,23503
aeae5db3e572eba23f41123afed42e06,131,103,255573,57249,198324,119,74,221727,39358,182369
fffead994cdd0b729755096bfcb535e5,203,130,643423,147683,495740,165,108,538239,114178,424061
7ca6ba9f76e96664a2bddff923460b9a,45,33,63282,24912,38370,41,35,69242,21683,47559
d0d8b8dc290103508ee1346a5232393e,101,89,313551,77944,235607,120,106,308685,84523,224162
646ac1ef314b0e388db53d5a1da7ce22,97,86,234477,81296,153181,75,58,152794,54667,98127
2bc7d66ccd5121d9c4c91c83d724d490,42,25,61659,19666,41993,61,56,91924,25705,66219
d9eadd5e4f0426890ae1dc9381fc686a,66,47,103473,28029,75444,74,66,98551,39606,58945
afa4abd8b6d63618eca9c894f4eea223,89,70,123733,42123,81610,93,59,136981,27685,109296
2aa907228380da09dc8389b0efba8adc,127,71,240406,64827,175579,139,96,312361,70935,241426
ae44921b22a45d0ec34033f141d5b496,169,139,464991,85804,379187,100,74,277641,73808,203833
ca71627c6bd7a94a6fe7d8795d624f4b,30,24,22332,9496,12836,31,28,21970,10499,11471
2a1d2bb77629331c2ac33c9766077ebe,74,60,138187,27809,110378,44,41,84369,12000,72369
a32fbaa0fb39bff025eda79089dcf6b1,34,26,17683,6966,10717,34,27,17575,11127,6448
cbe781d8d059bdce1441ab37dd03c53c,86,60,167383,63852,103531,109,77,209521,79180,130341
8076f254d008732cd2f6a72c81e2f9bc,12,6,3695,773,2922,10,6,1605,2051,-446
ec879729eb1e655b4442ab17cf0917ff,33,33,25893,8357,17536,57,47,51493,15161,36332
b50af545aa27e5842000024df90fb9d1,54,42,60709,22617,38092,55,47,68368,26601,41767
32393d6da37e3a44ff8c98b234309dd3,119,78,230154,44679,185475,88,66,175248,38333,136915
59c0e72ca3da01c9aabb0b0e92ebc9fc,151,123,473583,61085,412498,136,99,370153,62578,307575
854a3f0d69b5de911dcad0fbf5eb4415,30,21,22529,4076,18453,34,28,17471,9233,8238
e1e482e7c8b5710830b12cb3a1510838,6,6,660,730,-70,6,8,730,678,52
64f4b29dc5fd964dfaa2df047ec835f7,215,149,772753,117047,655706,202,147,681601,121568,560033
6b6c4f0edb1c915b4e36f699338ceba7,164,115,484673,80015,404658,132,116,374541,122105,252436
b194c97435bb30a7cf65b8f2adcbe545,38,36,33561,11417,22144,47,32,37169,12808,24361
0efee9bc05d36ee1b55b54b16935bea3,52,42,45123,15479,29644,48,39,34523,15742,18781
8e420369d9e0261bbdaa307995a8d994,30,27,24552,13215,11337,50,39,43762,12469,31293
9e5b53af717b4283735c49bc2cb3b802,117,84,309986,78933,231053,132,97,321287,51751,269536
7923d002d7eecb9f56f10a20c7bb1d69,176,138,533804,105675,428129,161,130,421357,111680,309677
35c6b9ec12c9bbce9671d4e80fdad01a,94,73,160405,39125,121280,67,54,118325,30047,88278
b2d137b117c4c325486975f5db2fca11,131,92,366759,63830,302929,107,65,219052,66766,152286
57a4e58eeffeb7c5229e05d9aab96403,45,42,97855,36654,61201,66,45,99689,33352,66337
30f26cb948663b7e062ad5f5cc25c9a5,103,82,261658,48077,213581,88,77,145439,52149,93290
eb37083bc76a82b79edf8f3eb62099a4,26,23,14006,6340,7666,27,20,13714,5921,7793
d1a9290c22205f14de9e3fd01f0f349c,134,92,376252,63641,312611,150,112,478016,78460,399556
78e9139eb92abc24d29c4fd5462111ce,122,87,254266,64001,190265,171,135,417279,77153,340126
590fc1abb56aaa4e55aadb7b0450d667,36,29,39137,16837,22300,33,28,43554,16793,26761
2762630fab2a678b41325c92d6065725,83,75,89396,37971,51425,88,57,120222,27287,92935
d7a7bf82e9b646e03dd3d9055e922c2e,101,71,212530,50690,161840,144,104,296370,38967,257403
e91ab1dfbfa644431da46c2b37bb879d,93,75,153442,43820,109622,118,83,228077,31497,196580
b6aad5ec53975eb0f56e012216663571,98,77,147391,39299,108092,87,61,141371,33345,108026
61127168b5f7a73a90d80333aef1b64d,45,31,54710,18439,36271,72,58,110862,27702,83160
3bf0a2b413d65912e5b98cf8f5e2f594,148,111,270839,37010,233829,129,88,202682,50868,151814
7448050ee6580534cf8e2bc87c9a6671,84,61,152055,54959,97096,136,100,339097,69054,270043
6d9b4a8a0d0ea54c287f858f36df3cff,173,117,562726,113785,448941,215,134,624778,48896,575882
d39f429ae4fefa2e0b20c77a6a0e177b,124,104,206203,53698,152505,116,91,228529,54122,174407
d82aa5d58ca5ea92a08516bb051c6213,123,104,341238,114369,226869,188,154,624896,106171,518725
89912f8835cbb7f7065f68bc9a698b53,76,51,154118,33320,120798,105,83,217419,47529,169890
29c0fc57457a3fb66137c7c43ec108dd,150,117,527679,87782,439897,139,102,451404,83260,368144
2b25a99adf289c8ce4bdf3239da48ab0,43,30,49915,10904,39011,62,46,58781,13363,45418
dd38ef82f3fcd6dcb8ac74c1e5d51a98,69,56,114058,26887,87171,87,66,94876,36008,58868
0aabd72e544afaf3a7ceb25c1ea77bb0,157,117,521780,122511,399269,208,137,699615,129890,569725
873037819de1bbd02172638aa1558a96,98,81,214357,70392,143965,170,137,385081,57315,327766
1827a9e34d4ecdaeaa339c76e0867b9f,40,35,44661,19801,24860,50,34,46739,13174,33565
51df4c813a8086d9b7c962e377571b04,160,124,484566,93142,391424,154,117,388708,108686,280022
4615dc42dbe65b0f39d80d0265f75ffb,24,16,13021,5438,7583,30,22,15102,5347,9755
0dab84e548fdf10af94e1b7977d047ca,134,108,429849,81359,348490,140,118,374511,92351,282160
604095cdb40dc979afefcfa42331c496,81,59,126463,37164,89299,94,73,136438,31072,105366
d754b07cc6a71a6f69a12c22ec2d7ac1,95,61,138545,47548,90997,61,51,67648,43731,23917
e43e588d745749dd60545cf9d58efb5f,65,56,86404,24106,62298,54,51,74612,26992,47620
5cbcf03b9352a2ded840bdf7899293a8,130,96,307355,87272,220083,165,123,515963,96093,419870
f07499c25776554de15a2b4029872209,137,93,261308,64559,196749,122,91,221766,73976,147790
011e2f4a1dbca9b8662509c7a3519397,89,68,198531,77040,121491,95,70,224887,59566,165321
0bf97e41d00eca1eb1a0d5abc627427a,68,36,50214,13055,37159,49,34,41092,13014,28078
7c2baaa8b5c124d0e27c6bd4a07a83aa,35,28,29116,11399,17717,28,27,36137,9768,26369
61746f2a7ab7f890a2be741197dd8465,122,102,270852,53393,217459,105,86,268870,46591,222279
a26e74424ab247da6a93369a77923682,208,147,749360,98821,650539,199,136,741846,110792,631054
a3810e6b6f7adabdadd5b5932258633c,26,21,7214,4206,3008,23,20,7006,3295,3711
453b7cd5eb2c5b747dbf0286560151da,134,96,335582,83223,252359,134,103,453005,70605,382400
ce5e9d3536e388d8072c7847c55a0e89,40,31,37142,8757,28385,29,25,34485,12810,21675
cfc5f9be7080e26d08eeb9b6ece8fdab,68,62,110288,33203,77085,63,41,88769,26361,62408
405ab2922609f2b6ba7be4cb14bfa119,76,59,159016,34401,124615,96,87,148984,40817,108167
2d34b51ec4cf3db8148ce042941e6520,107,81,245265,75971,169294,110,89,286522,75265,211257
9307ebfc0f9559b3929469e632394f1e,85,67,156310,21356,134954,49,36,74952,20206,54746
3c498ae503445fef3595531addac37de,57,48,66124,26931,39193,63,52,53744,25848,27896
aaf57411b19c08124178af8dc8ee39b4,70,50,84484,26451,58033,84,75,134579,25037,109542
683c8bc8927c5bf87dbeca42e43a759d,25,17,7680,2886,4794,24,22,6545,5138,1407
66fda32c9476fc29881c691abd38916d,136,100,353837,79400,274437,157,119,406751,69283,337468
5cb5f3ad54478c2f19804b5add55ebaf,157,101,279394,70863,208531,112,91,233931,76024,157907
86925b049c866686fe9bf0433846e4d6,88,52,132987,29586,103401,111,83,149642,38387,111255
5e641512f3af4e28112b615da935669b,42,36,31890,7049,24841,42,28,20459,5583,14876
085db6828e4de07ecd13425d0fbac16c,163,122,780594,107037,673557,176,136,758787,128929,629858
08eecf897924c1eae68cd34eeaedecd3,46,50,45754,21427,24327,70,48,82847,18583,64264
b5ced975566c5b615e06b5265b0df749,174,122,536204,141739,394465,163,126,741605,124786,616819
48b85975434ca5b54e27bcf88b37b8dd,23,19,5170,4730,440,24,21,16258,3243,13015
aabb7a18d57d73815f1006cec92ba19d,96,82,171811,39970,131841,77,59,122926,37318,85608
5261d811bfffd8dabec57b1cda480f90,65,50,157734,40457,117277,108,99,210310,73316,136994
9f58a7e5afa129c75c841fff2d27f358,154,111,540387,127940,412447,170,146,598495,135975,462520
9681963c8aed619ed248034980b512a5,49,35,59282,13079,46203,39,35,28920,16031,12889
84e7105e38189fd7555a292273f027ae,227,145,896132,130996,765136,223,156,1051851,154486,897365
91a9152ee9fd73cd2053b46969697c04,20,14,7116,1926,5190,21,17,5969,3226,2743
2b0ca641d41d20689f3babcc166f4b6f,109,89,184696,53242,131454,85,63,172193,33941,138252
1853107b09e2b040a72d91625d70ca0f,62,52,103863,32122,71741,70,55,111894,33343,78551
3539011934a35da1b9e802f8c8f68608,50,40,71966,27855,44111,62,48,76424,28314,48110
f54eeec4125ed44827855c610a01f56a,24,17,10186,5276,4910,23,24,15198,4806,10392
1c1bb3331743b1f98313f117d19a1faf,73,61,102679,23250,79429,54,42,74547,26288,48259
2dd5a294c81e4017620013db4491340e,165,111,421783,80097,341686,135,95,362088,107693,254395
0199297b2ab401957212f74841e17131,186,130,641725,133579,508146,190,134,725426,95665,629761
d57dd08d4b506d0890215d0dee61f710,137,97,382483,91763,290720,138,105,339956,91102,248854
752a7f9200a446fbb78f3e34f72f0a20,161,115,524383,61630,462753,149,121,378627,66420,312207
e7db0eff6808d30c8a53e053ae87615b,27,23,14010,3752,10258,26,19,7669,4530,3139
1ea6a4e2bea2c6d33fd4069dc12f0554,48,38,43027,19374,23653,40,32,39338,13245,26093
95b7592713553d821fccc30d6deb0639,127,88,299407,72925,226482,131,107,338300,101550,236750
040bd437d61d1fe05b7f1e9cae97fef7,139,87,275104,67864,207240,124,101,201137,74586,126551
3b08f858921219f27df1b7eba97770d0,151,120,503866,108041,395825,139,111,401123,136545,264578
e19574a6663876a5caa852b283c1b0d9,12,10,1632,1445,187,11,9,1755,1100,655
c0da1219066e31cb5ff9424ad6c104dd,53,42,65677,24241,41436,50,43,82346,29744,52602
462ebb05bff46fa611b11d87cc39b1d8,195,160,824115,138777,685338,181,107,488768,146509,342259
0fc94a30378dee6e6f1fdb45dac5860a,123,97,337932,96766,241166,145,123,405743,77995,327748
1dd933caa341ec63989824a93309c417,34,26,25441,12510,12931,33,27,42218,8981,33237
b384734e250e18aa714366143316bc78,104,80,262998,72748,190250,114,94,235604,85539,150065
9acec3d76836f0f9f2b7aaf290b0ba06,42,31,53144,16369,36775,38,35,50244,20978,29266
677b579dc49d0ede7085d9891081ff31,95,79,137729,34067,103662,67,54,101126,29920,71206
96416ec470e9564489efc8deb2075e2e,159,128,330871,52872,277999,113,91,257910,62325,195585
c10d469ef57d4993781854bcf3f1927a,129,89,325349,104857,220492,193,137,447954,78495,369459
3b8e23480eb8a8879ba8d95c190e3cc4,23,21,13096,6340,6756,24,18,11775,6030,5745
fa15020dc3821580cafbdfa753a8c207,44,34,54656,14333,40323,34,26,32908,16335,16573
1488db10b1376d90fef1dad262af678a,96,74,144787,46489,98298,101,76,183383,29026,154357
ae111868220588a47a5f1ec2e98924cd,37,30,47457,17589,29868,37,33,46507,16111,30396
0b1172afddbd5bf89fc27d01fb0805b1,20,15,7617,1656,5961,23,23,10977,5205,5772
2a3fa24d1927ef7a14102e8cc98efb24,77,58,213519,49345,164174,73,59,122210,56640,65570
5294f17a8c8f72a6b036b96a27389481,53,44,60652,23826,36826,63,60,76901,27609,49292
e471b0a70162c2c3ec10e8f4bedf4a9e,27,22,14522,6256,8266,27,23,21031,6926,14105
ef4f20a7ab640ece7b3d58aa0f03916a,45,33,53894,21460,32434,51,43,51885,15701,36184
0212e04218708a583376c11c8d66cc7a,127,93,413169,143396,269773,160,107,610701,102087,508614
83ac679bff33889725806b9bea11efc5,89,50,165208,44351,120857,118,90,245985,51627,194358
7d750e25c37364197eacd8b7e1c0dfe4,76,56,210127,42092,168035,89,70,222106,49035,173071
17369eb83704db1cc2d4c775d65ac6b6,72,68,78188,38648,39540,72,58,109992,28904,81088
cb20e29d0e04683e08c2f70cd5c0df35,50,28,54643,10106,44537,55,39,65154,9246,55908
3259c86c5139881e3c36d3a45fd4d639,93,75,153468,33910,119558,99,81,116263,35619,80644
8733b18f7b60eaa5c4104ae93401e961,79,66,90956,42648,48308,83,64,168644,35267,133377
2a903a7bb939052b601002aa93f28b59,111,89,259283,81327,177956,127,98,273355,70653,202702
16e49266ca013de899587484e9a952b2,26,21,22511,7206,15305,31,21,22367,8204,14163
dd8a7808e0ca84fd71919a5a57536a49,22,17,10295,3505,6790,25,21,8544,5522,3022
648c76bf865e28668aca9df8e88c044d,193,137,955017,201055,753962,240,158,1202945,162555,1040390
c4d00232718bb8eb6e52a4f5d8467018,33,22,14040,3473,10567,24,16,9624,3972,5652
0bd84ed5a3d4267facccc36f0987868c,213,146,436605,80890,355715,150,105,279185,69474,209711
9bab179c05e17f69cacc479b91946bdd,59,52,92714,34967,57747,63,55,83057,40193,42864
4acdf14593598c4fafb9256033cc60fe,2,1,305,196,109,2,3,240,349,-109
ce47027f10f632d532690a512de13da7,39,27,67722,10729,56993,48,43,42221,13831,28390
efbde4fb4da5b122fe7cb746cf7fe449,69,46,114122,47184,66938,80,67,141898,48637,93261
ea3464a864fd3e17e45ee84e21d0ee8a,11,8,2469,755,1714,13,10,1579,974,605
c8f9d9d754ab535a9e184fcc3e358a30,169,129,865835,239854,625981,156,139,988984,277647,711337
c055e2928d0bce5399c600148de35dc8,133,108,493340,111573,381767,172,141,794552,109882,684670
178cc187afb84176bd2d12e574c4d4e3,83,76,226026,64040,161986,104,89,306860,46032,260828
8ce094a536b6d76a6d58b26b28dbcbaf,51,40,90701,46485,44216,71,59,155816,45225,110591
15c08816f1c81a167f5be0bdfc6b66bc,34,31,27568,13968,13600,41,34,28274,11260,17014
0409a5e8003b3c82d66e6df2af99941d,45,29,69669,15921,53748,39,29,51063,16521,34542
71868d04aec5aa3b50666f987bbfb58f,36,31,30511,7226,23285,38,28,19882,6329,13553
2cabeddc453b64bb84332039240bb010,74,63,144464,39285,105179,62,42,64236,27998,36238
58e4edcb159d2ac12d425e11507a4878,63,56,99431,20749,78682,90,69,124867,22906,101961
009becc8c3b3ec91ff49f38523c7163c,80,64,140292,42485,97807,108,66,157956,30547,127409
5af485e65ddff6a637a5c52848dd0fd6,203,123,581030,112923,468107,133,77,315032,121109,193923
b02cce038885f3cfc0a0309360d896e2,176,123,947156,140819,806337,207,159,704841,127379,577462
60506763671e926e5cb9e345bee4fac0,125,70,337318,73064,264254,146,126,371697,93864,277833
1640c508f2ad3a9dc871e4b97d159417,144,108,361697,80120,281577,128,91,289236,87951,201285
a3bdcec745505d78c229e594263c2e3b,41,30,31297,10405,20892,39,31,28293,11172,17121
b2c3cc5f830b5979023abe2608e156ac,38,28,37170,13813,23357,34,25,34062,15576,18486
36b3de769d8716077c3d441819c3b556,65,50,95645,28531,67114,66,62,129678,37407,92271
adb9724e32363a99e6512c6a6e60c9a8,101,83,189574,36378,153196,94,68,166376,41850,124526
03bf8043d4f094e3cb072353a9af1886,106,75,156014,59142,96872,117,92,305559,65161,240398
53c556b508ce3c66e5b4703f5f175577,154,104,382889,84702,298187,92,65,274255,81141,193114
ac78765aaa42b01b27ee66200f48db8a,171,120,487259,67447,419812,121,92,236357,50716,185641
7f588414d7a05f48aee7733239b99a06,138,97,325308,72683,252625,108,89,261366,81098,180268
d9b9866bc439cc9b416f5662912269d3,153,114,461371,126455,334916,176,113,758879,119762,639117
39dbf0b5b36de341c6cdce69968877c4,126,99,313181,93562,219619,179,138,416831,74506,342325
b1812d8a51f3d4f9a44e17a165ae9a74,179,139,501739,85408,416331,138,110,387019,75413,311606
17d922ae7773f9c045d27ecb0ef7d98c,83,67,175968,40023,135945,108,88,196989,41070,155919
783e7aa9ddf7109b041a73765691b573,23,19,9166,2943,6223,21,16,5466,3754,1712
752d017cea868fd3328c482866005cc2,60,33,58985,12450,46535,50,42,38517,14606,23911
797b865933c19a1e46c588319b0318a4,113,103,325092,98383,226709,160,123,473719,74176,399543
adc462f1d215f5c5c39bc75cb0e62fdc,73,51,143375,22292,121083,75,68,116307,44857,71450
824aa0b4d7983cbf4513ee3e6cfed499,85,72,159620,34369,125251,59,53,103987,31066,72921
202ea83a34f315af8f306a02bc5f52da,55,46,88266,20770,67496,46,33,60593,15096,45497
41296cbdf1ef5724bb2783af94e179f2,106,82,164001,46287,117714,127,87,227067,40139,186928
d198316260ca92b9e194b437f1a38720,214,154,730062,98965,631097,204,175,658014,147716,510298
8895f71814338a919f7b1757e7aa2e06,46,38,53444,20122,33322,41,37,51737,20244,31493
cd000183937ff93fb1bef67576573b62,29,22,20644,7526,13118,31,21,21239,8050,13189
e0aac2acdabd57481e69b18b82376a03,70,41,84712,25972,58740,75,56,94737,32675,62062
ba6dea4945d9faffc13c3e27d3d6fa9f,124,93,321929,61555,260374,144,126,354100,67514,286586
c083f4f305485912d5c73ba4fdcb0f5b,122,88,290307,63601,226706,156,107,332435,73138,259297
13ad52ac55df5623b83ba5ebad6608d1,39,34,23611,11150,12461,46,38,29270,13537,15733
db8d22cda3e73d62f82ce5736bd79807,13,12,2239,1724,515,16,12,3262,1449,1813
1b32d0357fb2a548c83f483bdfe46cec,27,20,20449,5411,15038,42,34,25141,8866,16275
f0452833a80f09a36936a1bdc6495a8c,155,118,531255,80635,450620,148,121,446970,115230,331740
5895bc1ca483236f34808a556ecc9786,127,97,266429,52302,214127,109,98,235767,50641,185126
46f92cc6d7638e67100031820a850a8b,181,150,1017345,185468,831877,180,146,1116426,176587,939839
21065f00e0bbbf7ca0e18e3445dcdaca,145,106,511818,75785,436033,154,124,507320,70260,437060
b663aaec89c6ba65f4b293e797f3df57,185,138,524434,72871,451563,136,90,249041,69763,179278
4a30cdec74b2eb660e36edafc5fc51c8,103,89,194346,42694,151652,95,74,161353,44441,116912
06ca27951e5bec041e4a7effdf94458d,73,55,102434,26216,76218,72,60,99379,37097,62282
a2355df2dc2c14247933d409d5d0b9a4,120,79,270471,59039,211432,115,92,280934,58154,222780
50c4e3f263f9e5612ade6f6861fbdbff,77,68,170961,56054,114907,117,92,234869,63772,171097
0c75929f2e75c1fc43ce26c15b75812d,162,122,386488,82003,304485,122,103,260282,61246,199036
8abf762f3a7ab8062db11dc59ef165b6,50,39,47749,12777,34972,42,37,35303,12590,22713
89d2495530fc996480dcdfdefbd55013,34,28,12116,6849,5267,37,29,17745,7805,9940
93d0e8e972756ee2300669d204c97451,94,79,99342,26097,73245,61,61,86096,31687,54409
e445b8521436121144efd4afdf84c182,136,108,350108,56661,293447,113,89,229557,59381,170176
3278932dd5354edf94407f01ec1073c6,74,62,109878,22938,86940,70,59,62970,31345,31625
ed3b9d0413ddf21cf585f26f4bd34863,37,32,38055,13209,24846,23,21,31214,8630,22584
62da8486c0d2b974e181deccb2732017,134,109,427645,124200,303445,204,157,689379,87233,602146
7d0d733a857d1438bd4488a980e5147f,18,11,3031,819,2212,16,11,5535,751,4784
4b73745fd044127a55bbcb6f5ce38864,86,78,125755,48804,76951,119,75,194861,32592,162269
e62732a67d876bf6c690a1e8410cfc43,148,119,404420,93988,310432,157,112,467906,74447,393459
2b93aa7524b3f01cbc56771fbc9a91e1,30,25,19089,6459,12630,38,30,35615,6826,28789
04177465af931e84aa3c80007e913f77,171,121,494635,133855,360780,171,149,738123,154605,583518
016efad5e111e2baf80aeb7c20c33a58,176,110,297572,63789,233783,125,77,201437,57787,143650
f2d733820570676240c60b428b61d5da,106,94,213390,60016,153374,111,88,286134,58113,228021
16786309b3720c4044f1f9f7072e03c2,103,79,171646,45383,126263,124,101,268660,38254,230406
9d13309dea8e02a6657e6afb89e27e27,166,112,442068,82487,359581,181,147,450007,91124,358883
794f3e4628eabd97c59f7942c2b24ef1,71,69,96223,30541,65682,51,43,78079,29811,48268
a3e44f957d4a31f36d235a897d6caab8,143,99,533252,169602,363650,156,113,555524,175596,379928
8cd6e7b41809df25d7c4d5bc59cb9f59,74,64,158125,30940,127185,77,56,96993,28993,68000
b6476cbc1ea289cd5912dc905d6fe1b8,176,86,496823,97517,399306,154,99,489537,100729,388808
22d9975456046d292fbdfe381b11ac8a,27,21,14600,4940,9660,25,21,10414,6701,3713
0b666bddf2ebbf77789906bd2d80a0dc,123,78,210554,37908,172646,104,91,176232,52798,123434
d37c5e81ac56fb6e70f8f35ca405fece,86,66,110780,28224,82556,78,51,80771,23571,57200
b66acfed4cd4e62b72c0a8413742f37b,97,77,230005,53174,176831,125,105,265117,59738,205379
4f1d53b171e61b8126d3904ff672c2f4,50,44,67678,26673,41005,46,36,49461,26304,23157
26804faadf0c7d6a61c47f35f333af58,46,37,44553,15278,29275,50,36,43433,14698,28735
98b165d5680cd0cb21ed03ae08dd80c5,28,23,14163,5418,8745,26,20,14251,5768,8483
177e0b4d2bbfbb46fd8170ca779381fb,168,125,507737,85516,422221,195,142,488475,111360,377115
bd046a4997f685f047b1786e10843325,28,19,8642,3231,5411,20,20,7119,3305,3814
8b169edf190f2ba7ce0a024e4e70505a,85,74,156768,76437,80331,146,111,334224,62292,271932
55adb38f6041a42a1fae499dc7ed3786,0,0,0,0,0,0,0,0,0,0
22420b130f20f6a58ad031084cad349a,134,90,365967,57179,308788,157,104,411711,115194,296517
6b98f7828808e7b7f11e587ac8c841ff,23,14,8130,1265,6865,22,19,5802,2767,3035
0d481ac53a465a211bc7d8bdc6c3cc77,39,30,30604,13344,17260,34,26,34401,11711,22690
43336e54a6f9383a5aecdf1dfb744eb9,1,2,219,351,-132,4,1,695,219,476
1d0b13d27c9ef3933e629d63abad5edf,114,79,219170,35141,184029,84,67,155176,44541,110635
f15510f4824b5d1c8de09f5c2c46ef6a,68,57,99213,27421,71792,94,80,127967,46150,81817
e849580e3324a55b9a8e9c41104ec1bd,12,5,2385,327,2058,12,11,1132,1488,-356
96afe230824ac16de94a85cc969d2f6d,117,91,290693,47636,243057,117,88,247212,57478,189734
80b7dcab250f0df6b0859561520b01d1,128,80,313438,38597,274841,129,110,298524,56747,241777
13a9ee7f307f857b55bae71670b4f84e,31,23,28648,10869,17779,42,30,42011,12129,29882
196f173ee410283cf187b7d74cc3965f,154,115,552069,95449,456620,145,116,421746,103509,318237
b0f573231948585d38c89fc67be84cad,4,4,556,286,270,2,2,200,428,-228
addd8b60d03ec9cf2ba7245c4084073e,162,110,497070,96476,400594,157,113,525074,110584,414490
e80778b5d76b3bd184473035219d92fd,47,38,46862,6108,40754,32,28,23026,9164,13862
9257a691a7f4ce8a403a24ae17688f1e,180,90,347481,83680,263801,105,68,283779,98025,185754
ab2d64435ccc6bc8442b4b8d3c481b1a,59,49,87875,29745,58130,92,63,125547,25818,99729
84b15e2cd4a1c3b103278ec070925919,193,150,726403,161940,564463,192,135,754023,182882,571141
bb66661b08966c8fd477759e2c9e6221,27,17,12762,3870,8892,25,20,11477,5261,6216
469b4f5d0e1a053359c84457c984ade1,14,12,2902,1605,1297,10,6,2291,1072,1219
0d73e89b273a650f3d0670aba3c494a1,37,23,47753,15109,32644,34,31,40358,17598,22760
7b67c40e3e747cc801af2b37b2681939,79,53,118117,59161,58956,91,71,205526,52439,153087
af9a155100e396a96174e81a1fa3cc75,143,112,394515,123424,271091,159,124,444736,125419,319317
0f53190c79d07828beec24c1c21aac46,140,94,378114,73716,304398,146,111,444006,79386,364620
59f9976c77965ab6bb9f38a8c1743677,35,32,24822,12636,12186,43,33,31883,13663,18220
79aa43bf3d7b2a677ad85c0db4e51cd8,53,39,82169,28811,53358,50,44,91871,28928,62943
3d4beb5b50ea9a8922e1072b0570d8d7,54,37,59214,15612,43602,62,52,55878,21312,34566
5c1c9cc3e05f342acabafea13be10ec1,57,43,104425,31648,72777,54,49,91295,42439,48856
9517fa444dda5e151397f5555d9a7690,3,7,259,889,-630,4,2,798,207,591
6fc1fcebf15402291502af4cd15720de,119,72,315730,74052,241678,136,97,369777,87987,281790
94ea2ccbf7a93330864aeac8856df547,71,43,137329,50405,86924,98,89,232657,60543,172114
9b389d537bdd1cb1fda561796eb56643,80,68,118069,37128,80941,88,79,141027,35738,105289
50c2c2d85ce78e28e683afd67584279e,141,91,250539,52389,198150,90,86,188499,42377,146122
fb0af5905353c00d1866fefcf3976107,37,31,34750,15538,19212,59,35,70325,11247,59078
b90ec7e520ef9f0208edee72b1e11154,117,74,252641,60494,192147,133,93,293525,75102,218423
63839be8b30250c92524b01230726c0f,52,38,97439,37161,60278,73,50,89132,36763,52369
89820d02be3fc0acebdb5598fb65a5c8,117,93,206962,48792,158170,141,129,318421,61163,257258
b94afaf7944ecd7c65c5ae0bc2eaf5f0,4,4,286,298,-12,4,3,298,246,52
ac2f5b16cc3095f11263b67273630ce0,26,19,9070,4084,4986,28,18,11216,3181,8035
aeb10ee3e7274e183dde8fedf70352df,153,125,441696,81797,359899,141,112,485800,86249,399551
8d0a2b1b0775a022ff0972a3e0262007,102,70,213484,62287,151197,114,80,245275,43223,202052
62c9d539aaf9548a6f4bd94a0aba15be,59,47,72387,21912,50475,46,32,46657,13983,32674
9b62af99550773c0dfa0eba1e859f644,98,74,154489,44437,110052,90,73,139724,41535,98189
710197c796536a36fcc2538497c3d2aa,110,92,333357,130377,202980,146,132,636068,137744,498324
c3f9e09eeb323a297e26e00b01877b67,129,110,320854,105280,215574,110,76,218457,81813,136644
d4231e5e5a5b50492a020821132644b5,163,126,415730,133326,282404,164,82,435642,82179,353463
ceadae5b18a6891864cd0d5ddea62882,176,127,517657,83221,434436,115,90,328249,104934,223315
ac9520cf3877ef26e28a4911de1bd5f7,158,88,301273,72965,228308,176,119,402966,64052,338914
c4f6f7b049e114ae7849bb459b38a976,2,3,57,261,-204,3,1,261,49,212
2d10d82de61af7f70a818c22cb8536e9,59,45,69052,16775,52277,54,39,58415,20881,37534
9d5f47e9a7bbc9767acbcece9c9921d3,89,70,209479,46285,163194,83,60,173439,43788,129651
e6bc45568f888391cb1050493aecde09,35,34,46741,14470,32271,46,31,40139,12895,27244
dc60738a98e939dabfab38ac2eb07e1d,55,42,81339,21454,59885,55,44,64908,31374,33534
07b08dd5ad76c37030b859ebea9d1e6c,151,114,418040,82524,335516,122,90,321486,49473,272013
2df7de6e347c5c470a06b4109fea3183,91,67,133933,26758,107175,79,61,123408,27055,96353
b29218f7f794114bd7c615d268ebad03,134,107,259780,85853,173927,125,91,270050,65841,204209
df6b82dd5226e9c2c4da97a7c6dde4cd,40,32,60628,17881,42747,41,27,44575,21705,22870
42213d27ecc91a3d4e8677e0040db9d8,106,80,260931,52760,208171,104,75,232696,43465,189231
7d72c1cba15e6a54cf5c36ba7bafc1bc,63,45,106392,30335,76057,108,92,164765,50075,114690
29494c3b046f1222eae35dda4f5aba8d,67,57,109248,34086,75162,70,57,98550,26653,71897
48d1aa3c631e332bd66b8584039216e6,140,99,272829,74209,198620,169,129,460675,77083,383592
376448c7cfc9085523666176c707590d,50,41,53673,32316,21357,71,62,103274,26255,77019
5f520c4f18a34a7b1d76f41becb28b6c,181,110,547838,97833,450005,212,139,716188,102324,613864
2861c4a549568c0467ae688c00ef114e,100,74,187690,46306,141384,92,82,165199,50575,114624
0066164f10e817308b61830d5213563a,114,88,250098,56532,193566,134,101,280723,48334,232389
a4b19ce65ff8f20604906149478821ec,28,22,16922,9115,7807,26,18,20323,7556,12767
9635b4c0de2ac524311f2f6501908d02,164,129,450981,95947,355034,107,92,273147,101601,171546
2c18821af4f0e2cf7c1fb3d3089ab4ff,106,80,145650,45112,100538,128,96,213095,49717,163378
28d082aed088674ad2c8f89a3deb3ea0,54,29,53304,10823,42481,35,31,29852,19225,10627
f7083e00dc28bc753778392aa79d1d50,151,116,453695,116152,337543,155,137,519958,92683,427275
a6053416826efbebe199d277e025f460,22,11,8072,2662,5410,17,14,5444,1702,3742
58604ff02b2a14c2cc9f9019c56327f9,168,132,699695,153532,546163,183,132,511049,115708,395341
473d2ff79ae64b35276b64ad7b396595,27,19,20271,8561,11710,21,22,13911,10665,3246
b17f7a4604ded0329d89e0d68a8b5a0f,39,36,42617,18269,24348,37,28,48657,16534,32123
aea46082712c6caf511bd5a3c2bbcbec,152,122,403229,102391,300838,151,116,455603,105724,349879
b6432a554333e665ef4ddbe80d337b22,93,78,150392,41397,108995,106,78,190387,40681,149706
de7af6346a9c35e660e8b05a9840e79e,39,33,51352,11685,39667,40,35,51806,12408,39398
e141059b1979ed7cc4321dacdd7f7ee1,222,173,735879,145972,589907,167,92,514528,125373,389155
f53c2b947bbd01f74c12fe8cbab44f09,2,2,99,157,-58,1,1,89,31,58
11e698766cb299d324eeffd6d523dafc,12,8,3101,1754,1347,11,9,2379,2125,254
684e58126728539e9fd4eacddea42968,91,53,233215,56938,176277,132,126,346675,72608,274067
356ea89ce289a2238aef28995c38c6da,58,52,87037,19523,67514,57,48,68527,23738,44789
cf36f3cd06b8acf565a46c36ac1c6170,7,6,664,362,302,5,4,374,399,-25
7dc88f90fbea9065e4759ae318f7d225,122,88,305435,86044,219391,179,137,510667,92837,417830
33b83b6067f481f321aee5d285df4897,35,29,27020,15820,11200,38,27,38014,11031,26983
a86459afa119a5e07f3b1369b5efb42b,36,36,37028,13714,23314,46,34,27995,10760,17235
a27443ec556338b20de119e31db93ab1,58,53,83284,29418,53866,55,34,75823,24953,50870
7c66183458e7d906ff51dfcdf68fd29a,135,99,481720,68605,413115,156,135,388074,86419,301655
422f9df7dba34e186b3f1af7b6165400,61,44,70924,24200,46724,59,47,72500,26022,46478
2785ed586901e9584ff96ef3e0690a9f,134,98,287799,51975,235824,117,94,223535,47223,176312
251c87e26ff0c2ac04ffb0d647bc027d,139,103,241797,34846,206951,101,91,181806,68315,113491
3cb12ff40aa5b249b7b1989619e9595a,176,114,390089,88914,301175,170,134,411924,102964,308960
20bcd289aa4ca17d5367d5bfac29caf3,142,108,372803,99383,273420,125,108,392078,100596,291482
9ca88fe04008bae6b712a81811c0ddbc,71,64,106121,24269,81852,67,35,83000,19899,63101
b7ab08fccd419956d57364475545ee09,27,23,28237,9335,18902,26,28,26941,9236,17705
398d8edd45c621867fb834ea4094a65f,65,46,63333,21973,41360,73,58,109824,26907,82917
11735f4a54fa15a70c721b69f358643e,36,22,22932,10088,12844,55,52,50815,12538,38277
1c4d0bf3e7314f13a6e632460bbfe2d3,82,67,176121,55423,120698,95,75,213956,45221,168735
04eee6f7b7055f9d6045e4999f665203,39,24,33605,10603,23002,30,23,23467,9695,13772
ab4c71006c27372becb8c9bea78df72c,138,91,330657,55147,275510,142,102,426982,83942,343040
3d1ad56b253c41b1967b3b4f21a09df9,73,50,125220,26983,98237,96,82,134000,35846,98154
9ae787a8d516346039498703d39ae209,75,67,111184,29593,81591,100,69,127452,25044,102408
685a2833aa13efeda94c1d4ac29d7b8d,51,33,74802,14419,60383,52,46,55998,15563,40435
30b7c2a29351331771398a3e4bc27ee2,117,103,273748,74283,199465,154,128,451462,81496,369966
895151dc96a1a63e3b6f6378aac299f4,24,18,6146,3688,2458,18,18,5667,3988,1679
da2f3bdd8734e0562f84d59cb25ac2ef,42,44,65021,25007,40014,67,52,85652,23398,62254
405b0e271a9ba309a3dcf40ac05f32eb,96,65,154308,36447,117861,90,69,140985,36476,104509
ba540a0f26f215b378214cde3e21ae61,84,58,118662,23969,94693,102,82,178890,31841,147049
360dece5b389b1f5c80b26cb834f8d96,47,36,45691,9364,36327,37,29,27380,9864,17516
ebff8b253dfab59ab21275b329f07f78,72,47,82420,34115,48305,71,63,118263,40433,77830
c10bb44daea1c9ff65009332c48e35f9,169,114,738617,100753,637864,192,168,693763,139153,554610
c797d0c318bc8cebc66ed9b22bc3c106,163,131,573655,86445,487210,113,76,329279,88600,240679
d809de9b65902bc4ce0de65356a17a81,94,63,143869,48406,95463,114,90,224406,46943,177463
4cab1e8cfd0c73fd3a3ba5fa76e604bb,163,128,644490,146716,497774,133,104,481836,162786,319050
f6e69c89c37ec863cfc5ab968d1151b7,73,56,77408,32103,45305,68,53,104762,26858,77904
33b17a74788d1a97751be99162a4ec95,85,65,177141,35644,141497,78,70,162209,33732,128477
183a2a4fb556459004bbc539dec0b799,108,94,242820,69875,172945,82,65,197276,62516,134760
5193e7ab0612a9f6471654cb47458ebb,135,110,375831,60459,315372,159,132,386398,76636,309762
91f93463b8a5bdc2681f6210739637b0,35,31,28675,7189,21486,34,23,17982,9060,8922
35e093db7894a4f537ef8592425f9ab5,103,59,150936,46246,104690,113,80,188771,53800,134971
56f7a3b21c8e45c304280dd167366431,189,144,724848,131387,593461,191,152,588445,136973,451472
4a91c4223c57ed825c4be95e9467fc2a,68,54,90105,27516,62589,85,74,107764,46259,61505
4822ec7dcf13080d28b95dec7f9f0927,168,136,637972,102693,535279,174,111,545961,100765,445196
abf4051763f50c9129f36c98e0ffe919,201,153,876779,133376,743403,212,151,743284,176497,566787
f9fd43f7b4af9215f649b4925f280a11,45,37,35566,12628,22938,45,33,24840,16558,8282
3e3ff1a1bc19428ecb44339a64ebec83,153,105,266938,60579,206359,144,118,331323,47744,283579
10e3816498a68751f80e9388fcf52fc0,113,76,367821,89385,278436,132,117,440182,91107,349075
04e895c1c0828dd908ecec41e81254ea,73,61,140418,40584,99834,72,67,97735,46355,51380
8e9f33569913b0d4e337553d88c9ad29,134,116,367650,86480,281170,121,96,351906,68428,283478
e050fd37b8deac2dc187bec3f49180e8,79,66,128951,37907,91044,73,71,112604,28219,84385
6ad52ab1c609ec22d9a7ab8719f75a58,30,17,28609,2321,26288,33,20,17154,6428,10726
b48fe99108438ecebacc22fc8ba934fc,123,95,271424,64002,207422,104,79,235367,61649,173718
f2ecd6cd48b75acc6738d63b18852c73,61,52,183593,78321,105272,149,121,479424,98094,381330
1210e790242e11073c5a63764e07418d,9,5,1774,556,1218,7,11,623,1379,-756
011736a3601809a947d63f294a0f5093,115,83,220615,59432,161183,122,100,277782,68828,208954
fc9735a367dd91a569e49ea3a9e6a0cc,154,107,333998,59342,274656,109,90,199002,61214,137788
1df28beab2606e79973c22d48dd90a1e,46,39,54201,21622,32579,45,37,47642,21024,26618
b9fa397d98bdd23f6821c214f718ad25,192,143,655549,137748,517801,180,133,667115,129224,537891
41f4849b7a4ce7861f8b230e8416a7a7,19,19,7375,2724,4651,19,19,6900,2583,4317
e0821ca7f0aa7394b01ea956abace97e,29,19,17250,5923,11327,30,25,26480,5570,20910
5a59c4522231473e4dfc99faf32eba85,136,93,222520,68894,153626,98,71,195531,44082,151449
7c2bf822ef494e5b981fe5a2d9b3d533,15,9,3388,1311,2077,12,12,2353,1629,724
5e6db38cd684da2e00cc10a1d18934bf,191,152,534828,72226,462602,148,108,484488,93515,390973
91aeab5b01d304e00b1d23924e8e3b49,70,58,180758,41976,138782,90,71,147248,55494,91754
791c86326bb315e209d7fe146d9b24f0,36,28,27364,8176,19188,31,26,17377,7601,9776
101fa3f0d3925fafa972cf6516e8de75,108,75,323313,38879,284434,115,101,286833,52121,234712
ed773e2044d64d97593365cbf62cb2eb,147,104,508531,84302,424229,186,129,546390,95658,450732
aa24e752b22448ff168bd05c1ce91f1c,83,47,188334,80743,107591,144,104,336208,75432,260776
8b4d3d253da8e3ac761d34a1266ded33,56,46,81212,25155,56057,57,40,88328,21859,66469
0bbdb81b3a04b1af94c1160b82b07ad5,31,21,11279,5560,5719,27,20,10679,5753,4926
1cca9ee9adf828d64cb889bd54cac0c7,51,42,59272,15137,44135,52,24,70490,9356,61134
ec71fb0174ef6d0bee2faa96ec36c3a0,82,53,130135,22750,107385,88,68,116814,34146,82668
3b83e0ef1b9addcd16b7c0f260e8aeec,95,83,223501,93013,130488,148,113,371443,65919,305524
9e768a14b5015aedbcb9ac57e1df8791,29,26,12466,9804,2662,33,25,17163,5334,11829
e4816f5d75e02038661e7a887c9504d2,67,60,149841,40257,109584,79,61,158404,53013,105391
de936154010ddf6a800264fd53390998,33,29,30730,10883,19847,44,33,23015,8588,14427
da334cd5ed75fafabfd163b031d63561,232,176,920347,189272,731075,205,140,893572,188443,705129
c75029467c40de67d8868777dbe91619,102,70,187762,58017,129745,117,79,235882,40856,195026
5df7935fbf7f54fe40df7b13b6f4e078,94,74,210989,64925,146064,100,83,214734,70542,144192
756bcda76a6fbdd51171ba8ac924841d,144,110,526205,166439,359766,197,133,504195,155499,348696
034f8c3ff8c73fa31767bbd190ee4f93,147,121,401419,125005,276414,182,138,601564,107959,493605
c6628f8d86fac7a239416604a284f1c5,115,84,186389,68176,118213,144,98,258249,67582,190667
78a1f6679d5e6cd5b88be3dfacb7a6de,208,128,816108,129007,687101,195,129,651072,112460,538612
a6f3688b5f661d04636442ccabc07e27,64,41,81081,29368,51713,90,59,96536,28818,67718
ca06547736235dc1ae60a905d12b42f2,85,77,144267,81069,63198,170,144,359588,67998,291590
97a7f97dc0cb43a10dac04d137ea88e0,32,24,22759,8788,13971,27,21,16875,6166,10709
a049bbbd176486008de79e5a1d592b3c,139,121,323408,116176,207232,161,95,406226,107234,298992
ce0f4ecde8b5c4a5f8edddceff34021b,112,89,220274,42883,177391,93,67,136117,45615,90502
59ad535d28d268c4d01bb0679b58e04f,36,28,33889,9052,24837,37,29,19124,11567,7557
c4f3638a718189fe830ee9d2721cd3e9,122,100,223135,55889,167246,121,102,306598,44184,262414
42d899dd3a6f350c562f595011b04d65,68,47,87605,25529,62076,45,44,53209,24834,28375
8544642ec6ff51a1828bdaf64f593f89,92,76,170640,54811,115829,119,86,191972,64497,127475
8a0da410df38d6cc3d58444259c64201,69,51,55565,21178,34387,60,48,84590,12736,71854
a9c966cdce52c8d0408f86d8e869767d,26,20,8798,3020,5778,24,21,7403,2893,4510
6d3624b263bccdbdae279400e27de9c1,83,49,102759,35850,66909,108,63,163164,36570,126594
779db6d190f160b624b5a01a0e1b62b0,76,68,120787,34186,86601,75,61,129454,38657,90797
f2f78ae5a96a29e3bbac0f28d72a8a38,20,15,6273,2183,4090,18,23,4665,3103,1562
54b9c2290a56006d01e3df54b77878a7,6,6,880,919,-39,6,5,1022,931,91
576d02e1a9a26338d67936ec645e0858,110,78,277920,74637,203283,160,117,372991,93426,279565
f9cba0442ef598ac1d00dd95b6d62928,158,109,452908,59113,393795,122,103,314593,77874,236719
6dcd6de46286e3e734fdf7ccdd8765ea,198,148,607464,114714,492750,169,109,641559,96114,545445
423189746f41b50de4a244c31c70d499,3,2,788,130,658,3,3,175,788,-613
988a8471fd8cc0df2b3eca42b9a9329b,76,56,130906,34972,95934,72,58,123402,33402,90000
c44fb9ae1bf336668f51817d6ff5b54a,116,84,283715,56308,227407,133,103,309332,63351,245981
a6bfdb57ce425f0e2842f95a3bc482d6,75,54,117668,23821,93847,94,64,126802,26107,100695
66cb026aadba363ff084c30f1d82d369,24,17,10086,5569,4517,28,19,11216,5769,5447
4b961df3c73a8c9cd2a48238d2377717,37,33,25230,11336,13894,43,35,31933,12324,19609
1e663145053f7272f2e3e9a2500a3738,103,71,185755,31108,154647,70,59,94476,43750,50726
27773367017f33d7e3214471466f3a5c,47,35,58480,16799,41681,30,22,44453,11371,33082
2d2d2907ef6744b46a3ea5da361705bc,161,118,435850,119658,316192,138,105,426643,111169,315474
9a646c7a948034bcb20fdf7eb301b38b,110,76,164451,40744,123707,114,100,238301,35306,202995
a3af74725598466380a65ed9c3ff6835,24,19,12329,2618,9711,27,24,6536,4636,1900
df3b361389dfe152e290662fe87f848a,90,65,208975,88712,120263,131,105,422867,101578,321289
c0e6a61b57396b3ed4e6e46874cf26aa,12,12,1967,1135,832,18,8,4078,1026,3052
281fcc7e11b26ab1e70dbbee8402c557,92,73,186770,50923,135847,116,91,221575,42151,179424
9e3b62ce216108a8e94810878a2f3aad,132,95,379110,120038,259072,188,113,509799,139215,370584
1e09864fd8e861826039d5b02693dca3,37,37,38713,14213,24500,50,31,34969,17085,17884
83d39010d2f9a837fcd369029f820fb0,143,110,349287,53612,295675,160,139,444059,54314,389745
640c5e4f7e0177761d2122d24d4a2aa7,184,124,493426,117717,375709,191,159,542051,116312,425739
03befb998a8a52c17f4c4bc955f006d0,87,64,202805,56315,146490,84,64,159099,55497,103602
a0fceaecb23e2c7d7c67ae7d351d15b9,163,112,609731,77110,532621,157,121,425863,80361,345502
824231df50f58a7eba8686ed2ffc690f,71,50,96993,20394,76599,103,81,130122,36293,93829
6e25477fe943310c0b82936bfe2558a0,78,57,131743,46220,85523,80,56,102396,37959,64437
b30f28ad82228072840c872f8ea75941,35,29,28995,7952,21043,27,26,21107,10975,10132
198bfc40409f4d63e370569ef39098e5,14,12,2151,2649,-498,15,12,3057,993,2064
b2d58f34eaa30763cab1e0cfb400030f,73,63,159141,58221,100920,121,91,203799,75773,128026
bdcd622a45042393696644015d306408,76,67,125984,40550,85434,94,73,177452,48065,129387
864a6c5f4f0aac4b94659d463c62729b,67,57,108460,32930,75530,86,65,122232,34955,87277
1fedf67155b3fedf3d1f439ca2292e7d,34,30,35584,9009,26575,27,27,18168,12721,5447
6129f34a5883c4052eeb0cb3930713e3,90,73,130225,26363,103862,102,92,112975,35935,77040
e36d1dffb666082ecc2c215f0d6ad151,83,72,149156,33213,115943,111,83,242368,34249,208119
0267fe1976b7da4e5abcdadefab6b760,27,18,8514,4228,4286,25,19,11271,4408,6863
71f55084625323ee167db284d9383aee,148,109,329694,108474,221220,162,130,345156,110223,234933
0ef58bc3f10899dfc3348ad2300205e6,137,94,284227,60770,223457,110,97,212179,89598,122581
bfe61a719fb6f8ef167033d0482811d1,103,72,129923,24915,105008,72,55,73331,28197,45134
2e425f8eff073e3460abbaf7a85ae99b,97,85,179124,37441,141683,80,63,112050,48311,63739
e4bea255bc1c107120d8688635fe7683,48,38,47368,17911,29457,46,39,49536,20059,29477
822c9c5faccaab0da6ec459632304e12,22,17,6013,3304,2709,16,17,5395,3020,2375
025a60f0b83d7df79c02f40faff4bd41,72,60,143822,56605,87217,104,84,194995,57123,137872
c4b5960d542e3be877c5deacff4d0175,55,39,56155,18613,37542,44,35,43679,21173,22506
3f9a6f17684c4bd745746633f5486b23,3,6,768,524,244,5,3,680,768,-88
902965ba87d996ce4c78abc9b102ed39,31,19,8694,1896,6798,18,16,5283,3476,1807
59d5a57412049c0dc8d2de6a4739218b,21,17,3699,1895,1804,15,15,3414,1747,1667
255ebd280c0cdd6ce49d706b07659692,124,84,212318,35951,176367,94,73,164895,40976,123919
38bf5a3c94a25c95492e613001ed159c,164,118,516018,102235,413783,144,115,375669,80985,294684
bd33e84c56556516035077aad5d85421,149,96,455303,131671,323632,133,109,469060,175765,293295
2c72a9a564fce143747ad71372bf7c6a,90,70,164400,38749,125651,62,57,83530,32111,51419
4571e61ee0ca3e484031c06dd889978c,89,60,234228,50024,184204,167,131,357259,72456,284803
6bd4366c6557779e3de22f7d3106a388,135,90,611053,131959,479094,182,140,698333,201137,497196
b9b9d487a689dbb3ca53cea3e9b905ba,56,46,87327,26440,60887,61,51,79486,31480,48006
52315f75a7d51f48d46c8cb7857700df,62,52,93320,29706,63614,80,40,111968,21981,89987
246f25fe633711ba4731cc636c0bee59,117,100,314318,47908,266410,130,109,303589,54173,249416
cfb6ea660dbc2abcf7caf2d8ac1efaf0,143,107,366462,102206,264256,169,139,571346,87643,483703
cd46f7a9c7c1b46a0bbf20df582b2042,38,33,23408,8371,15037,37,30,25499,8870,16629
8f6545d98f92f8ad8c7ba67c75f9fdcf,123,88,247738,50872,196866,139,90,237907,49236,188671
8659151b466504415d92a9808f7ae236,89,70,165524,28988,136536,77,61,114063,46570,67493
e5aabcdadd2d87a92c19af72276f9265,80,67,192705,35520,157185,120,101,309456,44506,264950
970be57883a682ea284d091e1dffd99a,133,99,392703,102605,290098,138,83,328336,90039,238297
bb51b4be65d66baa0ba690c5e85e5021,27,18,23422,9724,13698,34,24,44506,6335,38171
4eaa42fcca7a9bc329d1b8257e217dfd,44,34,38016,14801,23215,44,40,30674,15346,15328
1791be031e0744c6e417f237e4f368c8,97,73,167254,43190,124064,89,67,132843,35512,97331
5adb5258a6d09cf532c7b0e80d064cfc,88,64,212604,65793,146811,158,123,423486,63550,359936
d4d6319e3b3094fbedc4811f2076fed7,4,3,577,229,348,5,6,289,591,-302
9d3b7aa7dfd9538ce59ee15f12975a92,27,24,10764,2862,7902,30,26,14143,3586,10557
00e08316f59b38f10477d572524cf833,49,37,50705,14906,35799,49,39,27856,20373,7483
cc6eefa236d597873d8e1ab0b1ccebf0,102,87,212656,60408,152248,102,89,213974,50553,163421
74cf069b3686ff62eb0132bcaad0294d,117,94,262378,58335,204043,99,72,180854,41236,139618
46c91c4e73e4bdd248d9089bc9e50139,73,52,147022,38785,108237,98,70,189378,28758,160620
c2955de29b81be340723fa0900492661,22,19,11455,3111,8344,23,16,5242,4355,887
6c027430fb979431cee424607897347f,25,15,10436,1940,8496,24,19,11618,4112,7506
d03a9fa610b5d6310a31273f8120672f,67,54,94517,31438,63079,97,83,180009,38750,141259
c14e7e7406e4ed313573bec898991d1f,25,19,10471,3460,7011,25,17,11293,4052,7241
1dad7124975b4aaea2aca48d2f2a51ae,23,20,14250,5091,9159,22,21,15039,8015,7024
67f5fca11ee4fa23c0829d66521c5fe9,22,19,7892,5659,2233,26,17,14317,3771,10546
d39c5767408bc3f95c92630ed79c28af,63,44,79773,22004,57769,60,45,69359,23640,45719
21fecca84faad30dde52ef305fea10a7,100,87,178416,49406,129010,109,77,196137,52223,143914
b169fc75542ffa10c27ca0696a5576fe,38,29,42395,18533,23862,44,30,83520,18114,65406
968a275fc44afdf1472c18a21ee2ec1e,63,56,102035,32949,69086,81,51,109195,27626,81569
385e2fb1d9ed9d69c995aa5c5c9c0235,104,66,166056,44242,121814,104,88,215349,38384,176965
302b4969d5d681010772f1dc911211ef,130,104,386562,64105,322457,135,94,306227,66967,239260
c2f712063b20922a1c266e82f517947a,145,118,324087,76707,247380,102,68,207498,51921,155577
e926a383916e9ac8f78d4af0318cbb81,84,76,133871,34175,99696,63,48,90065,33768,56297
71c1f053ac65f6a1996dd508dd1ce7a9,129,87,312976,87154,225822,126,104,345785,95494,250291
0b89929b448bf65c15839fe4d43d710d,76,46,126058,21688,104370,50,41,60472,27763,32709
84b7c43b40c4ee2b310fd1457385593e,147,90,387649,78814,308835,143,107,359442,92732,266710
eb70fa5e7d122314b3eee15a55eb43a9,163,99,402921,61700,341221,193,145,603938,60666,543272
4f0a6d544f80f4244d9382544b15bc4b,59,47,58352,23876,34476,69,55,71829,23324,48505
fb80cf60a7da2c631c4087ac1979d4c4,41,28,55615,17308,38307,40,36,38686,23184,15502
221e7db3877c3140deee4bafe274d85f,165,124,549459,143123,406336,145,117,427847,144708,283139
819ebff7ea070af66ac91a5e9aa24cb2,145,106,303605,68629,234976,126,101,253272,79488,173784
53b72b76947b311bd325930a7b6811ae,105,87,190182,51464,138718,105,79,231414,41267,190147
f02f0fda5de179e20d5a32a0dc4c05e7,165,106,543935,141127,402808,178,120,574521,173184,401337
14425e1f56d48f7e5fade50a34e15227,133,93,352355,84605,267750,184,163,630690,112007,518683
1e5bdb517a915aded74d1237dea66e74,64,45,135457,37720,97737,60,58,108093,46677,61416
704bf85ce75884464270833635310b7d,30,22,27451,11327,16124,29,21,23465,11402,12063
cc40902e61920ecb79f67b192086a2e7,47,36,45857,13708,32149,43,27,32684,14627,18057
bf1c3d80b3c8ba40f5c3d01b80901355,97,79,191450,48833,142617,108,82,248683,47884,200799
3cb636228779d8b82304adb64c3d8bab,195,133,857831,148633,709198,209,165,920659,187495,733164
126c2c3ea4fca8186657ade417ebb3f4,99,78,159154,53879,105275,123,90,215460,38132,177328
76dbe24f9ae281b29e98109e237a900d,136,78,200643,36127,164516,116,96,215066,45126,169940
266de9c31a5529dbe97424e684a169fd,67,58,119127,37386,81741,72,58,124727,40335,84392
99fc3105d4a90d317e5c756eba6391c0,78,71,104937,34981,69956,79,55,99221,27191,72030
5aa6f9f2bf7dcc987ee77179480d39cd,121,108,324221,95129,229092,144,112,425212,72940,352272
4bbcf9fd6c3976e73fef3dc4be0c47fb,33,28,35489,12908,22581,35,25,32987,13313,19674
0b501a1f4ad808da3e7663d607cdf4cd,91,74,164212,37227,126985,81,75,168264,58129,110135
d135b13dbab9545fbc31fed53d5e4d04,28,23,21516,7990,13526,27,25,19058,8152,10906
d6f4ace87d8b3951e44ab8ad00765878,84,80,194227,45739,148488,81,66,143123,64452,78671
ec6c77cf872bedef411dee4403798ff6,32,31,32071,20300,11771,39,30,47909,14851,33058
606727405e42be37641b25234ddf5a49,59,50,57667,29796,27871,78,73,175692,34018,141674
1b5b2115b4514be56a507085d75d7967,114,80,235185,45540,189645,99,78,162315,54128,108187
0f6f0dac50f70f4af2e1139f3308067b,212,150,770893,171044,599849,209,151,806849,152037,654812
db006eb59bb8f6c93ea5c2a9604d794f,86,71,158690,56797,101893,97,79,195333,55137,140196
57327a7a67e60eb56ef65c4420c4646a,29,20,9696,3500,6196,21,20,7648,4898,2750
5de2d9030d46058450f2425180a3d341,46,35,68230,23511,44719,50,37,77010,22034,54976
bb69ff524de26cacf1a9470d5b5549ce,133,84,334162,52736,281426,106,86,268125,77207,190918
a65a9c9a0e5458b75d5beae33c925930,33,23,25704,7823,17881,30,24,19259,10820,8439
13f2fc866b978e6a23d941374af926cd,43,27,38583,9178,29405,39,29,35343,8465,26878
15e34e15e92583de84532a4d7831d7a2,54,51,59022,33732,25290,58,47,66758,26914,39844
a34e9a56a2edf793e986f8b03ed62988,134,109,368300,67609,300691,142,111,437193,64615,372578
12b6132c03ff7987d6a8979ee34d0f42,96,69,184518,64056,120462,103,84,242306,60832,181474
e8d4045ae187f47b76c22559d91c0593,82,51,109395,21850,87545,97,73,145805,32805,113000
a85a59e3352d81961b8b7c9ab34f12c4,131,93,255785,53898,201887,94,67,172833,43544,129289
862a79f2fad09078cf6c592583aebdfe,47,42,49103,19487,29616,52,30,48822,16336,32486
0626f7912a806acb6bc6bcd49907dce5,110,89,164748,58419,106329,87,52,163297,44740,118557
0bc1f978a281ad6d6358fc5431925ca7,114,99,269455,68541,200914,116,91,327051,55564,271487
53d4d5dd5f42c7a2ca4337b7a6eddd76,44,37,51166,14035,37131,37,36,28720,15352,13368
01cb8a6368522e0e0bf4c4f8ae12205c,88,72,159576,46052,113524,112,84,217953,48135,169818
07537a3b0f3efe28a5ba2de6396c0914,119,97,220771,41485,179286,67,55,122211,41886,80325
a7e79ffef85152e5af8cb4c32626b596,113,89,251822,67266,184556,123,96,247293,90929,156364
aab5ca1712227ff9f364b478cfc92993,78,68,151616,53747,97869,122,78,218358,29317,189041
199daaaad06d3cd06b6b442da5087446,81,60,150037,38582,111455,77,62,125050,77848,47202
b69f407d0390025abd01fb37c826165a,72,58,99640,30485,69155,80,61,115436,27020,88416
5f77412d69cc07cae520b2d668a942cb,58,40,101045,43270,57775,56,52,108371,46794,61577
4f7cbaeee59ab474d5dc81368daafd21,110,93,210485,52341,158144,93,79,174478,58646,115832
e275f6e8322f4652bf2047770480bcc4,43,26,36808,8378,28430,33,32,28459,8675,19784
d4d71919d51c8af398e49157100fa934,124,77,213336,55032,158304,122,69,240323,42938,197385
36640cbf514e64960a14e724f0b0046e,34,23,39548,10200,29348,33,25,15501,10644,4857
8389c0f87b5d792cd47f667230886d19,241,168,1503149,158504,1344645,229,171,1140182,250378,889804
e4a49c3cef1f826828d9a4a661f85015,119,94,370905,95613,275292,149,121,385853,80000,305853
e3bd426cefb8873d526a687c06ca8cbe,170,134,691628,126354,565274,166,121,594953,85192,509761
4cdb35f330327a40fb3b00b3f68aec01,108,88,279318,116709,162609,105,72,304626,103760,200866
354bc7603c3e8e76b92ce3c59f2796be,106,83,188956,60276,128680,110,93,239534,63026,176508
be0b006ef3b800eebf5b6a7512130b65,83,61,140017,39135,100882,61,51,125114,35034,90080
b7f7241703888c80cb579ca8e141739e,34,27,39939,14285,25654,39,33,58119,16234,41885
3b6f7a6ee4c9f55de49480e98ec71f07,117,97,322007,72670,249337,130,111,369273,73280,295993
07e8f1e06d28736a1052425f352ca61b,36,21,18354,6380,11974,44,29,24546,8787,15759
9408489551ee97e5a6a9ce56b991f4bd,107,99,265927,72671,193256,89,78,169755,66423,103332
aec7624d57d3386d44ddf4df61e97e88,36,29,18875,8830,10045,38,29,32511,7179,25332
62d3ae51ffec0efb5c39f8116a646b54,121,91,288178,68797,219381,115,74,212860,54506,158354
bb67a859a85c86264b3d3bb2e550fcd6,190,124,585665,133744,451921,217,144,632177,127791,504386
4444790d0fe678dd02df765ee8efa830,67,53,129296,25121,104175,79,61,122225,33735,88490
d20867cc774ac28df42104d946caf33f,150,113,614871,125555,489316,160,138,571617,115291,456326
e884b8899aa033d10addf55685f07689,102,83,242964,47232,195732,88,71,146438,39358,107080
0e93f8e471190ec07e6511e056e0d579,128,102,306471,67568,238903,130,91,284746,82219,202527
ba07bcc404eb7ca23180a79765250d69,60,50,58548,20991,37557,57,44,71869,19574,52295
c33774758c7c896ab67c9edd3f895be2,130,85,365647,60731,304916,101,82,245202,62344,182858
5cac56f0aef11915b200da2d7f2af50d,166,143,695602,104388,591214,211,171,792207,112137,680070
1103adee2001b4c5524ee272319f9336,27,17,17128,7236,9892,26,21,17385,8053,9332
49078749b329fb4b89e8d3a7bc46877f,97,77,212024,67043,144981,77,57,184832,52024,132808
acd0ead414a21af309befe24302edc84,144,90,400209,83172,317037,153,113,419148,95176,323972
eb38c0fa6f1e0a0ab107c29bf4e579f3,73,57,131726,47396,84330,79,64,125268,43636,81632
2acd1270e3307f8854e6f32335c8364f,83,68,175525,40352,135173,84,72,163727,47228,116499
a3aac40fa92648270802b0bc9008de80,206,134,684453,159656,524797,145,109,550774,158048,392726
461e615d06e14aece2f9297c616f8a12,27,21,21838,7135,14703,23,21,17001,8313,8688
f800c98baa8752a6d93cb278b3d73e2b,138,115,445447,87569,357878,120,95,346655,105389,241266
a6fe5ac7de4de7653db5cc9a1508019e,126,102,226984,63829,163155,152,116,388213,51482,336731
d924f7cc7c53641337fb93015d35be4c,35,29,25379,17583,7796,40,30,37046,13298,23748
4ce46cf9d23409588ef12fe5a386db8e,27,23,9617,3888,5729,29,25,16630,6252,10378
23f0a2a054fdd6f56614b74d27782eee,48,32,46082,25920,20162,54,46,63397,24788,38609
8d75ab4ff596060809fb8465ad0cf4bf,153,106,478909,125093,353816,143,107,486022,143535,342487
2e996e665a0a1152d69c5cf8e694c623,153,115,588307,130082,458225,169,135,606569,152480,454089
95015be57dd1ab324f0a8732525fa710,108,91,230574,58366,172208,113,90,203561,59991,143570
5ed59d3484e301c1f5d70a97eda12e22,72,61,133306,47917,85389,71,58,123136,47279,75857
3639a2c56a632a7625f9008fac83355c,23,18,7867,4041,3826,20,16,6677,4515,2162
736d025629b47ee7ab10cd331ff46f96,39,29,33533,13407,20126,45,38,62082,16391,45691
143086ca3612f51c1d2bc352750d69af,98,78,183909,53966,129943,115,94,322674,49613,273061
4612397fb16bcf6d1091ae38edc3d3fa,107,80,181156,22706,158450,81,70,149205,35676,113529
5099dce11d772065985ff17bd3635228,210,151,1105477,166464,939013,200,142,937550,163884,773666
d9509ed74a53395fdbc17bb727ea5801,57,46,87791,22331,65460,62,54,100698,24080,76618
5750bef0e2d3f3e591cd341c4803e320,3,1,369,147,222,1,3,147,369,-222
f5e514d7d8c2e30fa57a3b99e222ae42,59,50,98744,23018,75726,71,62,83577,33260,50317
0e8821bd62cc78e02d7ff23525759c98,70,45,121341,29589,91752,81,68,143347,50562,92785
9c42405b0870068a9d38323c0e7d32f3,83,63,133772,39672,94100,86,63,140218,31236,108982
29bfd83426134b294863f5c44f937a98,102,70,194843,82089,112754,129,82,327049,81368,245681
bc5d1ed4e19cf06112760ed4415e85a2,10,13,1967,2192,-225,12,7,2523,1358,1165
bbbe4b6ea1ad3be6b3d7107a974d7dac,93,63,231575,64899,166676,157,105,400633,61340,339293
b64db478394d7954fa5e7b7c07160137,65,44,69242,21970,47272,54,43,66533,22186,44347
fab0789a1f66482398401a1498e0df50,60,43,71296,25948,45348,66,50,67485,33086,34399
a3cc248bc6b648c9e420c2ac9820cdc9,106,86,225106,57171,167935,117,92,187918,48637,139281
b904f184158291513e6bd81abe45e1ee,163,110,539866,63427,476439,125,97,351299,72635,278664
8b2a67ee844cd38891e18f9c1eb4dcf0,118,94,312855,96616,216239,156,129,587755,113228,474527
a948a8e0c42f7a1f11785bc8efb3fe17,65,51,73281,24010,49271,47,36,55926,18220,37706
68ed230275e52223d3faffb4fa045c62,46,39,87403,23884,63519,50,41,59787,26918,32869
0e1121409c40b6432ce8d42572297caa,127,106,304127,56549,247578,126,105,306254,46345,259909
a4bd21bcba42b7435d013e1500ddc392,69,59,112508,42523,69985,84,69,138670,38137,100533
04ab024e23801f187740a90d33e8122d,60,46,70969,17538,53431,48,34,41386,16605,24781
b3cf31fb54384d5660a010d75227018c,106,90,308189,65970,242219,113,90,280401,73782,206619
c5711be5d9b653c3f35e65b03c3b3c0f,137,115,318534,80454,238080,136,107,334277,79234,255043
d9c7c2c44165f248418fa13253c9ff30,89,60,133258,25071,108187,68,61,97394,26824,70570
64eef6c2457f8309581469b296565726,187,151,544328,121824,422504,142,115,412045,129151,282894
16c75e847b113fe7829a48cbb9464c23,115,94,280872,64934,215938,100,77,173288,69764,103524
24e0ded3ee1acae4eb039932a6f27d90,20,11,5287,976,4311,20,12,4052,1433,2619
6be866d635f4ee845f004314d7cd2c4a,80,61,118906,50131,68775,105,69,200835,54244,146591
af332b83e279f800f3d433612cc1d795,38,31,39928,12341,27587,36,24,29125,8744,20381
536a8a989083843ec1f46089ebf32e0c,53,39,54056,20985,33071,83,54,93139,19728,73411
f75d446cb5809157d9a92811f669043d,145,103,292326,77062,215264,107,89,244244,72416,171828
5ad2e5d220de06441c1c9dde00680ef5,137,112,409993,111100,298893,182,134,380624,96126,284498
f6f31812323708f6352a8ff284ec4283,146,113,344419,58028,286391,161,109,425930,72352,353578
55c4d9c2659370f551c9bb534c9f1eab,40,31,48723,17775,30948,67,47,89274,18421,70853
fbf94714a08ace8895710fa039d78542,5,3,920,194,726,3,5,194,920,-726
24d976e16227417dd9945779a9252c5f,161,128,513296,71990,441306,120,96,388836,93860,294976
52243646a66106ec75ff2df54f9be92d,36,32,22767,8996,13771,36,28,19542,7416,12126
076ef28b3edb7379aee6eac2edb2e3e0,132,104,416183,91160,325023,110,88,282323,148942,133381
a2afdaeda21fe8b069d7f649f35ddae2,39,32,34432,13754,20678,47,39,29619,15276,14343
03d902325ffbd8cd2702c82aea8c5447,25,23,16633,10540,6093,25,21,16150,8530,7620
aaca52b04cc3f44aec31552dbee6a492,132,97,309939,68689,241250,175,138,427227,82282,344945
2e9e11f6e776cec4899937893cca8644,129,111,344569,75332,269237,137,102,337338,89637,247701
d16eec0c116fbfa7107f4c2d6afcce89,211,141,1021365,114418,906947,184,134,623198,155845,467353
ffcac3b9d16f78b52e20ffa18061eccd,28,25,13839,9985,3854,31,25,22214,9183,13031
354bc405bbe3846f013cc508eef867ce,54,36,95695,34338,61357,70,49,131151,31287,99864
c7d94721c567f2050aa07f39e722d9f2,103,82,192526,81464,111062,105,95,257662,76266,181396
0c82e46094446bc5a5b5a29f8659d277,132,99,319064,41449,277615,161,142,335942,84067,251875
448f065383261e2f0cbcb03d2c22ecef,162,134,404140,82266,321874,155,114,379793,88034,291759
6d71fe3402fe91bc00e9aef828b7518a,218,138,477553,83762,393791,136,105,321771,90746,231025
420f86f6ecb1444b68bd2e86f915e63c,94,87,200571,51905,148666,139,88,278515,44162,234353
360e30a63bb19f5fc1b103860e91cf02,92,76,166664,28499,138165,60,47,83563,25481,58082
7b515ad5b59ac48cfd195fe5311ff21a,110,90,223736,54540,169196,125,104,275140,64839,210301
bd0510ba237129d8e69534715b6fe0cf,121,102,251291,41961,209330,102,83,189602,30867,158735
f7981c2fb6662ebbb65b88f1b7ded796,179,139,689041,135730,553311,188,143,901434,156399,745035
4f2c5cef2eaef17c778a34625d7dd677,134,105,360486,78037,282449,134,94,253516,55030,198486
c7c704fb0deffe26256ec0d3a02d6e94,32,24,24691,8256,16435,27,20,18534,8451,10083
3f4dd5d056143e7c7df0087354361c28,47,35,124755,44264,80491,78,64,152868,43446,109422
4034de04ecb2033642c4673f593d9c3b,102,63,124333,23800,100533,33,32,31156,20478,10678
31153b830e28e6439d18f071a2388760,120,87,227914,62410,165504,143,86,299830,55223,244607
8ce958b7f694ce9d98a62164fc028992,131,107,282670,66007,216663,133,104,271531,62559,208972
d8dc6ce620e2c4f8be355ee82fed84ae,90,78,171968,36368,135600,110,74,161890,39193,122697
c947586d927ef85062a741b6cb57f229,6,9,766,440,326,10,8,807,553,254
46cf8b34b60575ba318d3686aacea560,46,41,46546,21413,25133,54,48,63858,18704,45154
c9998cd44b98869cba2978322b770fb5,33,31,14569,9043,5526,31,22,16756,4801,11955
5849f217c32c825fd45da73558655757,125,102,359342,81112,278230,111,103,347319,74994,272325
067de31199af99144fb51d4b5a17a5f4,2,1,134,48,86,1,2,48,134,-86
eae7ae2081797dffdec2be330e8c700f,59,44,51395,21028,30367,46,41,56402,19673,36729
8efc3ed5711e18241e33a771a531d6ea,43,28,49480,17298,32182,45,33,40462,16518,23944
d8cbb7b3a2d7f1e6bd60fd635b299fcf,24,17,13546,5631,7915,22,18,13485,3916,9569
959b6105ceb7a1cd4524ac48d600a8d6,55,49,77714,30949,46765,70,50,102071,31153,70918
0bf63329ca1bf715ce82459254d9fbd8,87,61,139258,29453,109805,83,77,127057,30008,97049
04187a606e9f229d779bb113d7448ae3,14,10,1815,819,996,10,12,835,1140,-305
f73c562c276ade16924f8dae1d10d4ab,105,93,196311,59549,136762,95,67,131300,47324,83976
528c726a1e77f62d5f071d7d377b4aff,143,97,404816,89322,315494,165,127,395179,81116,314063
2077706416b3ffb774b994200174c2aa,46,33,59697,14850,44847,67,52,81325,14416,66909
c3547892d186fc2cc8ae7a5de52506db,59,54,85323,39824,45499,54,47,98995,33831,65164
5f29aa99c250aa53b1b51514f8f196c8,38,22,29674,7810,21864,37,28,36923,11189,25734
7efe292ca169f326310ef099edc7e3de,29,22,17023,9015,8008,27,25,18500,7585,10915
c3ace0758586d303069097b2eba94443,53,54,109013,38091,70922,65,58,121145,42054,79091
0f9a348d51b4f45e4487a675a278f921,115,99,192619,50484,142135,103,90,178487,54116,124371
605ad0a8e9f6c381ed965bb277bcd6a5,117,93,229834,43487,186347,111,93,246951,53935,193016
0b4d9fae2233633e16122157d6b96c91,56,51,66266,23910,42356,53,47,98417,18580,79837
11f452f5fb880d2c13a859bdd333b03a,164,124,528225,135559,392666,128,92,507672,135608,372064
91b569380401d5a6ba73a3aaf8a3d0c4,111,77,212200,49642,162558,157,127,422757,78580,344177
3064be2d70cc2340d21c8ef41d53d765,17,19,4643,2508,2135,15,14,3178,1648,1530
9572a2fa006e6f7abe8ffad144d58f81,170,134,598080,140267,457813,165,134,497209,124179,373030
13471487742c67420d838b46ca1186f6,186,140,742581,114543,628038,152,113,543270,167524,375746
88cfa17b8328463e0681734984053205,60,58,111126,44834,66292,73,50,109715,28150,81565
0a57d3362d1ee599e45885600de6f332,145,94,343425,80703,262722,112,92,253991,79701,174290
cde48208392f6863e195a45bc5450cd4,153,121,385488,48787,336701,112,92,205884,65371,140513
4debb3a4376ec12b1c07258841051c10,81,69,160212,53544,106668,78,68,174609,57261,117348
1dd852fd5e05cf3d5fb0f13bdde17623,87,69,128641,33223,95418,81,71,111142,38415,72727
deb9b5cbb4c3d2b860408837fe4499c6,122,95,313550,112294,201256,153,121,558937,121828,437109
9f604395705c67f3ef98ed367dfc0839,139,117,444746,101811,342935,164,115,476016,106293,369723
5f127c287aa87d377220bc11a4b136ee,39,36,33194,13359,19835,51,41,69607,14495,55112
fd61f34f9e287dcb943f2399b88ebe92,48,40,82701,25605,57096,54,43,80560,25984,54576
288ce2106be1c52be78d51a265902832,115,91,198395,53304,145091,125,80,223926,55204,168722
c289ef8b0fa24be8b4d77b7c15cf8196,80,57,148342,45570,102772,99,66,169324,34929,134395
4b56bfe855c681e73fc26328c90c8a17,121,88,211480,44273,167207,104,78,170643,55188,115455
1637eb5b136daf407bad9265e6247650,97,75,166669,52656,114013,144,97,369331,57159,312172
77146ba967d1c19a03bc7ae71d61bd37,33,25,30343,15597,14746,42,37,49309,14658,34651
263b4f319ee54cd02c028b540c43b6c2,138,87,358997,93018,265979,166,125,670017,90879,579138
5c0216d32d9eaddaefa6d77b2e65b010,152,120,398213,117263,280950,171,137,427915,160884,267031
1c3ca2749d3232c12f1257791067381f,140,113,412960,87692,325268,127,96,356476,55211,301265
68e414ae4f0416b7c508312a868fbf67,95,84,145392,36315,109077,109,76,166344,31118,135226
3133311ab56949bfb62b3570575dc103,59,38,66030,19325,46705,56,51,70097,22695,47402
6a34c0cd65207e2b0c7acd792cf372ef,28,25,17791,9692,8099,40,35,28389,6413,21976
65d683da9c29cc95edb2b540faa77099,28,24,14876,7427,7449,27,25,12711,8141,4570
380ce4fe6ca98e375dbdd9170d418f0b,27,25,21796,8616,13180,44,35,44209,10631,33578
4db0348f743eb206ef6f6e8b7886d605,134,115,415274,95717,319557,103,80,242524,85507,157017
187c6692c0b938ced7224d8c83b228ed,14,8,2354,764,1590,15,14,2094,1548,546
b97cb45cb47594a50cff60693aa39116,63,44,60498,18608,41890,59,32,55480,18511,36969
479f30f7f85bbd71482f6e065bb90e7c,14,8,2373,299,2074,12,9,1342,444,898
0ebf53fac8c39bb11fc2a8b3e9db8349,104,90,255285,73796,181489,122,102,382054,78196,303858
86d98c0a3df83a69579a7f5b34c58b7b,132,111,340122,104933,235189,125,90,351372,89908,261464
6bfbc3bb0d6e480b9fc76f5d1d840156,178,127,543669,122670,420999,156,109,473197,100457,372740
9b9d307bd82a1297e039cc26acf0bf8b,51,38,39231,12295,26936,50,32,34598,12174,22424
204d7042746f1ccdbfbcd07dcc2f55fe,45,25,52009,13883,38126,45,31,47327,12573,34754
33d3521e4faf58b45a87b5a965feef97,111,93,214677,36330,178347,72,60,105508,32443,73065
5ff66e1ecdba7d59894590e0054f1bfa,106,79,183266,35839,147427,97,64,143217,49946,93271
a0d660d1547ed521bf3d0c226cf27723,136,112,291496,66987,224509,130,96,291529,67829,223700
0ceebdb15ed94c6982aa1098907cb186,115,85,223295,37555,185740,100,67,147644,47617,100027
dd075faf10b49c9a33b0d6531d7b1569,68,56,81026,51266,29760,70,62,135980,34789,101191
791071c849c5700b567c96ae3c0f296d,119,86,213811,49302,164509,127,99,339957,48280,291677
38b10ca49713c8d890a79dc322d1b19b,87,74,206481,77517,128964,110,76,204217,56814,147403
86cc89899d8f46d8cdc0ec1094cf9393,133,88,262518,58888,203630,93,61,178204,59299,118905
baec6d0f42c7b4a9ca7958ab00effb17,23,15,19145,3155,15990,22,21,7360,6342,1018
7ca195628847794dfbb0ea70b6bf8937,73,56,108949,23889,85060,47,42,59776,20831,38945
30e59753321510c09341765f3caf988d,150,139,492458,123325,369133,138,105,453278,138023,315255
91288ae9d6938a25e8c7a51f89f5478d,86,66,180096,43345,136751,115,78,212652,45652,167000
b7ca3d83fc3bad59ab8a442a71ac9562,142,109,293786,37771,256015,152,125,296023,48142,247881
c36c78d780a2dc51445340bcfec1f56b,17,16,4229,2786,1443,16,16,5602,1933,3669
c8bbdfe0f98eb5b77aa4a197382df617,159,119,357962,99322,258640,173,113,390336,71702,318634
77c8e8923324bbd67e697c4bc2c7ae5c,75,67,125434,29475,95959,68,36,76392,26332,50060
67dad85cd5d56ec8a4a510ac539b953d,177,132,364810,112561,252249,118,89,253017,104377,148640
9ee50bf983581180555b095cce0bb5a9,30,26,37817,13804,24013,36,30,37695,15065,22630
b15cb91afc33cca7830fd99885874605,76,59,116199,50376,65823,96,91,194885,47566,147319
354c8d9355f38b864f6cb93520553473,107,80,209867,47584,162283,97,73,158205,66951,91254
c681084c7bbfccf8d959ad7768eeb3d3,79,68,108752,66634,42118,101,86,240297,52148,188149
38baf4f6152962931e26074232442c80,99,71,185692,101095,84597,174,86,377175,62996,314179
2d7476d2e1176425703b8bbc853e2de3,34,24,23121,9614,13507,49,35,48064,9290,38774
b0413b49555cf3b572e0ff707b4d5ecc,176,134,565764,81263,484501,131,107,428744,68097,360647
2b056de697b1b394838239fbed04e8c2,166,129,747697,200941,546756,188,137,765712,229445,536267
ec2d037ad19d286e2d842a0a589c6fed,68,50,107672,33400,74272,86,80,156205,48331,107874
014037666b6a8861657126259fb4a71f,113,98,226826,60814,166012,110,94,249237,55781,193456
1033c604c7636ca9e3d41d25c5b951ce,73,62,190081,40091,149990,147,120,263132,47736,215396
7b0fee9979fa5904132575acc82e68d8,41,32,27893,12171,15722,34,27,31930,8571,23359
9b24c79ba9706c5bbc728d60cddf1b07,129,101,301166,60966,240200,99,81,201252,45888,155364
ef61aa9170921186ac8bab41dbcd7bfd,137,89,289733,78742,210991,131,114,338470,64609,273861
55e4c5d54659f65795c7f970203840fc,89,76,160516,76980,83536,139,125,307238,75417,231821
ba134c164660c72fd72db8ec1e40c850,154,103,375684,76930,298754,119,103,315936,108239,207697
0c3ff2d19c13256ccfd49e0b6158cb41,180,121,581944,89937,492007,226,157,774673,103982,670691
8f364dce5d6d5099393a67498efa03a9,34,28,18102,4506,13596,29,20,10699,5205,5494
ceb240e5b3f6d2f1bc9907345f4eb267,81,66,175024,57298,117726,122,96,260170,55597,204573
bd7c9c5cfd18e52ed7ded1ea479aa242,137,99,250556,27217,223339,77,57,106398,29125,77273
e244cb691d53d7a0aa62142bf0daf181,85,68,148994,31882,117112,84,81,170010,37360,132650
09a4b645f23f4f711b44eceadd8c07a4,104,80,187982,56155,131827,116,78,205185,40056,165129
320d639f5f3072e4cbdb77f183a62879,133,103,296520,63818,232702,134,92,226947,44905,182042
893b767362ac8d522fc286183ab62001,117,96,261668,43538,218130,112,95,239628,39484,200144
6f40b57a0d50072bd1c52fedef565cd4,94,71,154071,41023,113048,101,73,216946,38946,178000
6ebb77a9457024760a35a6fe218a4ce2,125,89,299583,84450,215133,147,117,304033,79042,224991
690ca83f3a9143079d8d762c0b9ae0c7,78,52,134148,30256,103892,102,82,179511,40142,139369
34006c9825c6af6fef2751429fe8a79a,94,74,201491,46034,155457,85,73,148845,53250,95595
6b7d22fcf81ea14d5806ee1d98940b69,128,96,284303,60295,224008,108,89,226846,70990,155856
5abdaf4df4629a52e51e7cbfce240de5,50,42,58966,16469,42497,52,54,41414,18889,22525
2863ad37775dacc2e234bbbc9de2273e,155,102,336557,86942,249615,152,119,407163,130902,276261
74a3e9b5a93ae21d0a9f813a97e143aa,226,156,1251220,239161,1012059,203,180,1143192,404107,739085
ad98772ccdba42ccf9c5506f44126ae8,9,3,1902,26,1876,11,4,3076,96,2980
a9b4af1141286b979e00f33fb25a9d24,118,73,198282,52477,145805,116,96,229137,61433,167704
f4c21591d54fd7e6b0d9e806fccc4b14,99,78,189045,33067,155978,75,72,132823,37627,95196
85c996e25ac6d92fb10c68665a0f184c,126,93,273420,50202,223218,95,80,196562,51123,145439
aefbfc85b686b7a8ce99799acc9227f9,78,65,132126,43503,88623,83,60,106130,38969,67161
ec3379aabca70a35b459fe3977fdea08,83,79,131007,40004,91003,87,72,131994,34971,97023
be8a043d7e7bf701fb9c26b9e248b54b,68,58,113719,32108,81611,62,53,93638,26451,67187
426117a99f86911a07983549b1e2e937,90,65,242928,51544,191384,96,61,240769,55718,185051
7ccb6dd7f9e346e74d7a4370fa6c44f5,104,87,204773,44381,160392,119,93,162672,49744,112928
96d009ca11ac1bb249c4ed4a2a638854,157,109,419466,66860,352606,164,120,481405,61019,420386
fb58a706f3733d629bd0f0eb03814423,94,73,155130,57316,97814,70,50,109525,51081,58444
e28548be23d60bb5bc854e396b8a21a1,150,129,375589,79105,296484,120,106,311363,76938,234425
5baf441d513c408c456889e1236bd539,93,94,189013,42524,146489,102,69,133967,34674,99293
fa18d0e2a3f40b2581a0f99687576dc4,102,91,234157,66788,167369,119,99,275059,58105,216954
e4cb98d341d90e03f800bea11c8b0481,174,143,581510,142621,438889,149,109,470222,108319,361903
42d6dcffea82267c37051cd037b748e6,88,70,199649,47300,152349,86,74,151828,58300,93528
3f882bde4cdab69bfa9e6fc5e7fdfeb7,30,25,15859,7223,8636,33,20,22305,7207,15098
de164d6ee992ef1663932774aea3e83e,159,126,408369,75019,333350,135,114,370800,83861,286939
b4d8be615d2b49eae90758716d2c7332,62,48,70047,17727,52320,63,59,89877,21400,68477
5bb59adbfdc5b40c2202102c656ef3c9,144,100,347578,59152,288426,126,125,273279,83376,189903
c62536d85ef79fcd6b30a76a2e442928,162,126,363201,87019,276182,168,118,482395,93327,389068
1527c9bfb2fd81ea3d463d67e22ef2c2,27,23,14506,8049,6457,25,22,16446,8921,7525
f789d29811e2c343868a5400d748ed15,39,33,34831,12949,21882,38,35,42879,17884,24995
7a8c3399ddc658a76488e2b0b16fd26b,37,26,28624,11383,17241,39,29,35254,10578,24676
da19b8704e640ec7bd3a559908b951f5,56,42,88446,27673,60773,54,49,85578,36573,49005
be4ddd726eb6729e0962062b3cdce052,48,45,38200,21114,17086,59,29,62074,12850,49224
990cf10ab770b91611ff1aec1795d6e3,86,53,199472,57153,142319,78,69,158427,41607,116820
3f0b34fdfd8bd4fad04cfb6178ba547e,101,81,297525,74175,223350,158,115,354235,71461,282774
91f78a7d58908158d00311749edb5a0e,84,66,194836,50265,144571,82,67,172660,54129,118531
7b164916ce020585434052101c0480db,69,51,124640,30737,93903,81,67,91897,29330,62567
2fcf0803bd2bb49be8765b0b594dbc9d,36,32,46051,17622,28429,57,41,55269,13501,41768
ee61a3424b3bbcbf5b4180787e4732be,61,50,88440,27006,61434,53,43,56359,25524,30835
b11ed83c11d6f3d0784c6c01bdf07828,110,87,233522,50963,182559,121,105,241217,64544,176673
6ea93dd4c0fb8f86b58f9c89346b37ad,175,110,398345,69122,329223,186,102,439015,84531,354484
0f23ffa79583e70b4fe45343c153a1bf,95,73,140718,36623,104095,110,84,211081,30232,180849
95f6c0164fad3b35edf08edea9ba3a1e,24,21,15130,7774,7356,27,21,19668,5973,13695
90dde8a0cec1bd1c79796d84488f8095,89,70,161566,46462,115104,97,87,236326,51687,184639
642626bde86e550c1c2d09c6b6c59c30,78,67,146768,64144,82624,144,93,261735,57508,204227
e2e45eec92179738d7a1862d9701dd27,181,118,481492,136091,345401,183,141,524757,184465,340292
832a4e4bfa81cd2f2e098c57b62382a2,80,75,185289,42903,142386,80,59,104290,40128,64162
5a8862be0551b467c7257b5a28156148,37,27,27496,11798,15698,36,32,28024,13150,14874
49f0cd11be9304576947f6cf3d4d64dc,54,44,48865,18678,30187,61,50,78649,20084,58565
4f4d595c72ee2aa131e7071eb2519922,115,66,147564,50000,97564,104,79,226848,47286,179562
3b628cc446102987fb2d470649f3ae63,27,23,25862,6007,19855,29,21,12753,5699,7054
784900a6a1c7fc608c786e01f717eb84,97,82,253332,84099,169233,109,98,293894,75137,218757
42b28513c9e9a701461d53d7d94b2888,129,88,288164,69553,218611,120,107,226114,68679,157435
26978e40841c8cc95ade513fa0dad8f8,31,20,15498,4367,11131,24,20,11543,5378,6165
bd8db9f30dbc55b3c6af461548730dd6,31,23,12152,7999,4153,29,23,16996,5319,11677
e2d1da240441193e5a81137042f7313a,189,109,449980,127456,322524,165,125,467200,110564,356636
5c03feb1a706ca32a4c4f57051bc4a4e,45,40,58091,19309,38782,61,58,90032,22636,67396
fad8c663fb44ae997346f48b9ed58f3b,157,128,411701,53513,358188,109,93,246632,58959,187673
079109113189f53578ce062a4dcf47a5,59,37,81984,15651,66333,54,50,43306,27809,15497
d91d85ae3772842bd925c8cc2fe51e4f,178,145,680983,167848,513135,165,146,674603,212447,462156
aa2299fdb5997287934ec3b21f2826a9,24,22,10562,6642,3920,26,23,14334,4373,9961
093992348522afa83923cb3759a66d22,42,36,42480,14101,28379,36,34,33573,20334,13239
866e177974c4cd4bae55782f9a64538e,155,105,357220,42318,314902,106,86,226196,59298,166898
93fb508aa2364ec7e44e463d16202698,59,47,81513,16492,65021,53,38,69546,19812,49734
09ed3a8c976f7bc1c66e3077b7a9a9ef,20,15,5508,2943,2565,23,13,5936,1866,4070
5b4b5a1920c2d9370ba99df417cb8c31,90,72,278454,103403,175051,169,124,442237,107874,334363
1a449c33525155a05795d16ec46efc01,138,79,213356,40221,173135,112,81,265893,60693,205200
04be0050dcd9578c94f00c6f85d8e740,86,67,119315,18914,100401,71,42,71574,19628,51946
dcc84c4e42fc6f367f5a40c907b287bf,106,89,217407,71503,145904,153,122,353659,60389,293270
2c152547c26be9950c9c0d6b75229d3a,105,80,202015,49401,152614,113,96,278285,38696,239589
1ecb80f01faedc90d2f7bd66e925582b,61,50,91455,27478,63977,65,51,91447,32209,59238
0c2e9b239bbd25f30d7cfe4d7ea17271,3,3,496,527,-31,3,3,527,496,31
494ee7d8557d71f2ada34783273226e0,86,53,146906,39644,107262,115,84,151961,50262,101699
97f42f0641c45edeff6636731b0a4e97,24,22,9615,5598,4017,30,21,17125,4248,12877
8ba076e9f4ee5aa738cac1b94fecfbcd,48,41,70875,35432,35443,49,33,81493,30325,51168
61ab3d3b01dda1069551042fec63a4c6,119,81,257467,72281,185186,126,112,318226,81654,236572
e036f68ba7e7a1e37e67bc3f22eded6e,173,122,505612,118396,387216,165,123,522015,91192,430823
7a6c14006044a7d11e5a27a9abc24bbb,124,110,252121,66411,185710,113,71,272769,46114,226655
cc6f7d6e4e49ab0589a13929ee3968cb,23,16,4944,3207,1737,19,18,6645,2595,4050
70a12a208da13ebc2edcabe2e191b4fc,94,66,100396,32987,67409,69,50,90503,21636,68867
2783a851faa986d8eff23548269bfe8d,23,21,12647,8972,3675,25,21,16522,7734,8788
f4ca377ee40a57183245c838b4740e48,108,88,176392,32149,144243,82,57,113605,33755,79850
f88bb3241e40d79ec1acd248df88bc0a,44,30,38221,12814,25407,41,34,43487,15622,27865
116e04a388bc70ed4c27f7fbc6d3c540,89,59,139290,46935,92355,120,87,235683,40005,195678
2042234b6da14143dad74068a67097ee,57,51,77370,35090,42280,57,43,79328,27158,52170
396caeee45f6d1717d19db12affd4142,92,78,199399,51347,148052,86,75,159745,56661,103084
b591aa6bc18de4dd8acb39f56d364bc3,87,74,154572,63723,90849,102,85,199447,54720,144727
b0af9b8bf008af1f7b529b6250d4fc51,180,126,605839,53363,552476,143,114,347567,104884,242683
82eb909438bbf7b8d53b86f97b523760,152,114,439168,148008,291160,136,104,426539,200948,225591
f98fb10199be406fc9d16778f519ef38,116,80,268033,89719,178314,135,95,304426,73383,231043
1dad90e141380af5dd18e06021b71dfd,155,118,1093063,379469,713594,231,170,1666112,185032,1481080
a2c480ac578a0f724491f821d2fed4e6,44,43,51887,27975,23912,57,37,73332,19439,53893
d504287bb1a6cad5d5fe8f8d0c8ba1e8,36,32,26558,9423,17135,45,32,39752,12400,27352
4fbbb57e8e67d83c039b935ecc0e772a,62,50,79368,23000,56368,80,62,74974,30259,44715
4a1d7ff29cdceca65b7bc3946729f376,168,140,652468,109730,542738,128,114,321010,103310,217700
bb81948b4f12fb13e74fd52ee6b303cb,54,42,58449,27811,30638,47,36,62880,18221,44659
d729c7110e347f87677c41255a840a94,146,107,304406,74659,229747,156,112,363449,62203,301246
56bac673f0d5b51d84c8a5e598f5714d,25,22,16051,6717,9334,26,23,12389,10771,1618
aea1a939c1cb88945c8a23756849af79,48,41,50559,17769,32790,54,55,87479,28272,59207
1da573ec9d9dcdac4945a1787b652085,42,34,36006,11171,24835,39,31,18147,12467,5680
899602f14ad5d4c13d9284911495982e,141,95,512069,188214,323855,166,123,531606,146514,385092
e7cad3cde2b9d7178ab973b6d54c5f91,91,82,177682,51004,126678,68,64,153431,51195,102236
845a8095b58b907ad67c8f93ed9fb6b8,158,110,597210,152257,444953,150,105,621351,167383,453968
dbc1ec8452de76a07a5df3782debdde5,114,85,272956,104315,168641,138,101,298073,71674,226399
3fd30a52994efa7499fce3143ad757a5,46,35,47868,15079,32789,42,38,52092,15675,36417
dc3ac5dd2356cef0aadd1c8dc5801728,3,4,355,317,38,7,1,1154,37,1117
2dcc521df8467aeef778b79761fb9631,42,32,38278,16475,21803,46,36,46805,17162,29643
4948ad0a38684933fdf9d0bf81a1ecae,26,20,10145,3731,6414,26,20,10168,5621,4547
453fee86e524027db9c61f610e14c015,172,127,818168,155491,662677,179,143,743506,167417,576089
8cc3e2528f3185e554943041279ebb6d,165,123,453172,94318,358854,159,108,380874,130727,250147
0b2870809a0bc9d7ba96b9a56e962a16,49,42,93176,27695,65481,64,45,83139,32593,50546
25bb2419bf6114d1bcf0b10b85f42788,35,28,24980,15821,9159,33,31,29826,16250,13576
80d12634bf84dced056dbd91d30fbb51,48,40,62930,17663,45267,53,46,93010,20950,72060
9602dfe27b927c8a1319ae4a9297d001,130,102,298600,66354,232246,117,88,322695,80408,242287
3e35f8955dc246952910c0f37b548dfa,20,18,7762,2426,5336,21,11,6132,1448,4684
275d7fa8a39c92a5b288b25dc20f852a,127,82,216809,62620,154189,126,76,221067,64738,156329
9016db43c2888185cbc8b781d6a7c278,24,23,13391,4902,8489,27,21,14062,5758,8304
554c7c9b12c903b527a569700278a8da,75,52,148995,30699,118296,79,65,114039,31696,82343
e604d37dd584d4cb17c7b80a1c82d871,57,53,70516,23841,46675,52,39,56384,19803,36581
e6fe9a2ec4cc7bb1261a8abb9232134f,35,27,39370,17314,22056,42,32,46023,13549,32474
cb4ae4b76a8eea2e41bdd8e826364588,58,43,52650,16218,36432,51,38,47015,17412,29603
f22b2a1ff989df6d86a5c57b28d2f0ef,157,118,672729,177932,494797,182,113,614091,125787,488304
880820ac4831f28ad9c5cb40a3ba5adb,167,124,636405,129762,506643,215,144,926621,148664,777957
6d60a9c5ac670652fb1857177fc09f6d,27,25,15993,3968,12025,33,21,16510,5203,11307
eaf683970b68cb22bd1edfed08a3f606,60,44,47162,19435,27727,46,35,55160,17578,37582
0f60d033578f1f08a8da071a52f3e934,99,79,188822,76755,112067,136,106,322736,51154,271582
ed9b69dc0f6ab18a7b906387166bddd7,137,101,489756,118065,371691,154,109,527985,154883,373102
8521c93954d7027c7e691d8d87f9fdc5,79,64,117614,34164,83450,118,76,171898,30249,141649
b94fcf4cb4d2f4ef7df38c97ee5a1bb2,104,71,230910,56840,174070,146,103,283703,88045,195658
14b63152119c2d00a2110134c7bece0f,135,100,498205,113834,384371,181,157,607603,152047,455556
c5b7f497cff790cd2d378122881f206a,33,28,46965,18614,28351,41,32,55013,19431,35582
9f00af108a037bee44eec7d0a139ac03,131,115,349957,123642,226315,148,124,435800,94187,341613
39e6a7a920a8767d1678ed71930cc07d,39,29,50823,17329,33494,38,29,55469,21686,33783
16b8d3cbf9a35bc36fa17779797b4029,92,68,132286,39222,93064,79,63,111711,33616,78095
9c72b2f31e143f9f25b34edf2b2ae485,25,26,13509,4514,8995,24,17,13647,4835,8812
bb443a1a77db097b657119fa848bd026,40,31,32967,12145,20822,39,35,29241,14470,14771
74e060169583389698e004c4b7edcfe8,19,11,9590,4489,5101,27,22,11947,4903,7044
e4eacf6038b53a7306265c336a9062a9,74,57,126945,45199,81746,80,72,180938,48530,132408
1dceeaa09038f13ef62b410c228f8f99,27,22,12450,7248,5202,25,24,12820,8517,4303
06149b36100a2e5adcd0ab6102bae2ff,15,11,2284,595,1689,14,9,2043,1213,830
cebd6392e6fa86754c1d2d11aa1e31eb,142,115,328451,79982,248469,120,95,267322,83688,183634
85cf80f9318a42a70926daec1afc2053,51,34,66588,20373,46215,61,43,61898,22040,39858
0d8f96e2bff0dc8c1b7c02cf775bba39,35,35,39368,16638,22730,50,39,35889,13216,22673
0b24ad56d751cc02ac4a099cd76de43f,34,27,16602,6724,9878,36,29,21810,7042,14768
867d0546686a4852cabfd40c6a199ed2,199,147,510982,90674,420308,156,105,368555,70948,297607
2111bea3b35fe58531c7a8554f7caec1,111,89,201683,50432,151251,102,86,175258,45927,129331
18cf7aee3c40f1f34d91849e3a7b392b,6,2,1247,647,600,2,4,647,899,-252
122f71099405632e630f57c8c54a7ab6,127,87,278563,75928,202635,196,126,444291,74116,370175
45aa1da55992e5e329eb844e4b085e93,104,94,165033,44414,120619,76,69,150074,50220,99854
e5e948acdf4319edde07abce532b417d,133,103,323942,78729,245213,139,123,458064,91099,366965
14074c8ad42ef79212c23d4dfc411023,163,98,378566,79571,298995,159,101,391460,75649,315811
1976faf2198b51dc7d5aef6a6406f4a7,6,5,964,1359,-395,5,6,1359,964,395
f6b3e3d520af8bd21a969d33b342e964,173,121,686663,107443,579220,183,110,531460,145542,385918
dc40042595a3552834c4e14d4dd19a59,32,20,24207,7189,17018,26,21,19096,11373,7723
d953950ad0c605a8fac3e3261ede2d54,21,15,7813,5734,2079,20,16,8170,2321,5849
9267b0aa07a0b67ced13fe3244936dbc,94,77,185253,76834,108419,109,68,240655,65073,175582
ca8dbbcabc189c583494dead99ee04e6,66,54,111663,32036,79627,67,59,79889,35698,44191
5f5f6d0fa966a99972d9982d579ab5e3,94,70,155136,54846,100290,99,86,170679,63696,106983
64453968ac45e40e94b96e8cc5e7b548,33,22,31325,11375,19950,31,29,34173,10978,23195
36e5b902cf0ee51d147eb6bc7e2771fd,202,151,1078705,216890,861815,185,104,897809,197122,700687
fb3a8d5f1e255c5437569eb480b5c8bc,71,41,84280,21272,63008,66,46,106620,23525,83095
de0ba297ff9e82245c1e40b7291f16f5,78,67,91127,27998,63129,50,35,64592,22252,42340
d5926867a657e579fc9a28f2d57390a7,187,118,501561,60566,440995,119,93,332460,75146,257314
6ac75c57e74a7bf7a32843fc4514d357,20,18,7002,2614,4388,26,20,12557,4905,7652
6ac990eecfdd0bfea25ba7ab9ccaeb6c,23,19,21462,8149,13313,30,22,22117,8528,13589
1f37c25adc4654cab1bac9217e86555e,41,33,50881,23270,27611,45,32,63452,14722,48730
44e7735983b9390be6d2ee34be547b4e,77,64,137419,44414,93005,106,82,217131,43108,174023
3b66eb2bce9984214dc0e3c6aa5dd33f,156,120,381620,60096,321524,143,126,334267,78118,256149
bb6945dda15c410335b4b3be248a91ab,124,80,231457,62281,169176,108,75,212926,49366,163560
ea649226ac32c262246123e3131cfa87,115,103,249866,67413,182453,139,106,387040,61833,325207
ec1b5e1222a52879e78bd35f5075f63e,92,71,157012,41152,115860,88,76,147508,51872,95636
a1421b2b3d82b62b26a190d57a266f5d,25,23,13576,5680,7896,27,20,10794,4942,5852
bff74a5ab4ac72be0225688888186444,38,33,53119,18880,34239,37,28,49812,18857,30955
55b96e53a8f2084d5d40ca67ef0d6e64,15,6,2009,460,1549,16,15,1915,1284,631
06de7ff799a5118b3a452cce92d3c2ef,144,114,481860,101249,380611,132,106,393723,110069,283654
4b6e8a487f54d10fa3dbab1f202d197f,64,47,83095,21266,61829,89,66,131811,27171,104640
2f82cfdfb748fa9ff6047c433ffb990e,91,67,185650,47545,138105,103,70,190495,43880,146615
8742ffebc531851a50ca00a403c7f7da,48,34,67006,13810,53196,40,31,33726,12413,21313
fd6fe75c6a76ffa1a5dadbb015cf6074,70,52,70031,24946,45085,58,43,64741,21190,43551
9922515c4f14441324c694b13cb21367,117,91,236558,56104,180454,98,81,227992,53044,174948
ed3826d2d964c7cb0b47d84d76e01a92,124,93,256281,78207,178074,96,83,191244,64449,126795
785ba8c8c12ee51309c2d37756a63c02,90,82,198711,69619,129092,98,76,193629,53180,140449
6b46cc689824f53591dc7319c94818ac,89,72,129806,60988,68818,97,67,160156,39822,120334
99e1749c8c6f8441521b93f51dc8411c,108,94,228057,54982,173075,82,68,186104,52750,133354
3e8d991e0a472c63f90cf4335992cfab,48,44,49154,20446,28708,58,47,70602,19626,50976
cb0bc5d2c7d750c0a73a446f4c29cb05,56,38,66568,25534,41034,76,58,101288,33349,67939
e2fededaa6faedbc91e9b6509080432a,31,24,23926,8465,15461,31,22,45895,8485,37410
64bb95d9a69ef16666bde0141c10e4a2,35,26,30068,9912,20156,43,37,30457,13379,17078
9c2a6f5fd581c21ffce874428d80ceef,74,63,110760,25170,85590,71,68,71901,25965,45936
9f31669274c8db537878ee5de7803c23,121,92,386066,117549,268517,137,121,426835,148629,278206
f8ee45aae7da9a93be43fff6ab19ae32,43,33,69990,23137,46853,34,29,87965,28430,59535
662597dbc144cc6ae91513f87bdefe53,132,100,318782,72404,246378,159,115,455272,65858,389414
0139234bc4092bb0a5a1bd689fde982f,63,38,83289,10946,72343,46,37,42236,16699,25537
f1418d863ac73c3e8ef6c9e9acb06d6c,72,50,98122,26458,71664,51,36,60134,27118,33016
6d844c1998eb278c0a1469cca992e497,52,44,63134,17870,45264,76,51,63332,20607,42725
4742e886f389bf7129b8ff5d04c1af03,104,87,180041,49729,130312,132,106,289803,57519,232284
21d68b873821f96a6eb89938d41c5c41,60,41,106382,45352,61030,87,72,212794,35861,176933
97a7df65aa815dff5108ccc3fea7a201,25,19,10389,3718,6671,25,21,7519,3709,3810
5ddfc845e6e7f163e8369d0adf2f6ca0,65,56,106566,34440,72126,71,51,81343,34652,46691
ac156bd1745433fff48a8b2d3bc1560d,165,108,485424,114034,371390,165,138,658937,103341,555596
184496db12820cfc60cbecb2693b3b02,93,69,160125,32457,127668,136,98,196858,31794,165064
3da9d9274e596d8671148f966c9323b0,88,71,184350,75450,108900,140,90,330607,99371,231236
f6ef8469019743909719f39a8c4aff8d,152,127,544522,170300,374222,168,104,624149,109279,514870
b85428a417dd4f2cbd9f40aad09c4606,98,75,128388,41841,86547,90,79,127639,28826,98813
bfe9cb9976a8b5766439cd5fa9b96a10,74,50,145829,32181,113648,63,42,99050,26141,72909
e4fc1bb04edbaf0c59e6020f0bc8b406,137,98,384185,67850,316335,170,153,607661,94366,513295
a95b052d1c59ca0662d4b2b7bf24c1e4,189,143,553024,164144,388880,178,119,643273,122310,520963
399aa069480b04ca16e845cfb148f701,40,28,25188,6086,19102,29,21,14956,5576,9380
6fdc85ea3ca601ca8aa24b3c448de967,152,125,504197,88143,416054,145,116,489580,86602,402978
28078677b0a26201241d338fa3826e1b,18,18,5458,2875,2583,21,17,4612,3544,1068
5a58d0073a9a5dc1a23d13eff7f074da,56,47,69865,23900,45965,57,43,64308,23035,41273
6b153d509e63add294658db17cd3b773,37,29,36280,14491,21789,34,22,36494,9254,27240
0048e685654ce10051ab93f228cc0586,116,80,302223,64001,238222,186,159,583084,110407,472677
f68eed5c98dcc47c407a5f90afe14396,213,167,1086478,197841,888637,207,145,1076925,132723,944202
696529ed2f18cf5879e661f75f1d6370,129,85,252611,50369,202242,127,106,274917,53333,221584
209fc189b1e4919c04048010db3812d8,19,16,8854,1928,6926,20,12,5917,1199,4718
af0aec1f014b3433c55d13cdfa6c0d7b,128,102,367757,75891,291866,134,108,374016,103743,270273
53c8b12d0251fbef1c09a6a28be5efa8,42,35,35517,11950,23567,42,39,42940,13137,29803
9e12fb664c21890944b9d45cd227f574,115,92,372840,113956,258884,163,131,745161,106230,638931
c3c980658f052943a04be40b73bcad15,23,13,5925,1686,4239,19,17,4597,2247,2350
fdde50183626af7548c8511e097b449b,100,82,205036,38605,166431,90,74,154196,56573,97623
a82fe9f24148af62aadc4644781b0386,18,17,1873,1280,593,16,13,1757,1283,474
38d525c8e671644c5c804c0e18d819aa,139,105,391077,94486,296591,147,109,428590,108698,319892
7656ea4df7ef1721107e83cc77f08682,178,119,531496,89162,442334,137,114,372434,86059,286375
500e2217a25ae574951f5604056d1183,132,94,315460,88282,227178,139,87,296334,86509,209825
e7fb73b051bd5fd516cf538710954992,44,27,51044,13046,37998,41,32,32811,17038,15773
9fa99585ba738b08296b26a46637f9e7,29,23,12785,7439,5346,31,22,12826,6091,6735
220265f3e9d4e577c99dc5251a154bed,78,56,110788,25501,85287,86,65,128234,33433,94801
c724665adca763d02b95ed13f0d69295,63,33,71968,25747,46221,82,61,102857,25986,76871
f499eb5cb22190c0bd3405f7a040785a,102,78,230306,84701,145605,140,105,379373,64612,314761
86cd22c820c4142a95a5f7f93cf0c122,58,50,89265,25096,64169,60,48,63840,22394,41446
691382fe199dc8938de2424f6ffef950,199,143,661241,173504,487737,202,154,797681,172192,625489
0b0bec2fbc8d7249d410bee7b16c977e,25,23,13839,6422,7417,30,17,15952,4312,11640
98b12c16c983161d377e7020652a2151,73,59,115003,35709,79294,103,85,177273,29561,147712
63134f08f85ab1a9ce351445e4fdf0a2,1,2,79,80,-1,2,1,80,79,1
d51ddd808c205a4adb1897d35a3d0de3,84,71,189992,43832,146160,105,89,155455,53369,102086
9ff65c4dec8aadc652ee70d220a7109c,170,115,790418,103988,686430,162,124,635623,183336,452287
e646d1d0cb22d15847a4a674d981b02e,88,66,114133,28917,85216,88,72,138910,39128,99782
83e583bcd125763f54357eda67147dee,142,119,461525,136364,325161,155,117,535918,93040,442878
953e8916c2acf1c89c46749d1b02f988,65,48,103582,37210,66372,118,77,207472,56540,150932
c31e536e741021ba9763249bf0108c16,39,27,36581,12657,23924,40,37,46954,17004,29950
cab1a37a44b69633df8a29c953fc3541,26,20,16586,8786,7800,22,21,13886,8425,5461
9c0db6500e1129f03c95c34bcae922ee,148,90,323367,49574,273793,116,97,269180,73638,195542
469d833949fe7005c8c06ba610e5bb57,103,80,183773,52906,130867,95,87,165067,63728,101339
7d3714d29706b082669f2ad64156b2ed,192,154,583836,155014,428822,204,161,820119,133607,686512
061837873ec9cd7f8e458baad4e421d5,105,62,192533,25025,167508,98,56,114347,38019,76328
adfe23cefe2e98bd7c18a6058c67ec94,24,19,21172,6960,14212,26,18,16432,6885,9547
5a9522845217fbeff20b8bd11f12df75,63,48,63224,23202,40022,64,61,76823,20213,56610
df5fa044aad2853030b500ca2bb8d225,135,100,272280,62484,209796,119,82,304033,55739,248294
a030adb8dd93047b4344d598398afcd5,66,44,137577,36726,100851,78,69,139725,57861,81864
cc75d78887b4ff5dae1c8868310ce276,3,2,446,48,398,4,3,153,446,-293
ef9681f35af88f3fbf7d6d7df0cac4a6,3,2,232,89,143,2,3,89,232,-143
8f824b99e6a2d883e69518a6617efaef,80,56,143521,54276,89245,121,81,217549,59149,158400
be50bf5996efaa51a1e88cb4088df140,126,102,340118,53986,286132,113,88,245781,58117,187664
5cf8211b306801f7a08579f23b29741f,53,38,50234,13138,37096,53,37,65314,12259,53055
671eaabd3a470d44c981edf7ecf848eb,68,46,99095,26027,73068,78,72,118024,23730,94294
a4d3c613ed8dd77433c435796623faa3,131,102,257862,71662,186200,118,84,271066,39023,232043
72761279218421674b864110a12bc1a3,20,21,7670,3509,4161,24,14,6543,2017,4526
13cedb00d016087c3d25c18eb2669f7d,229,183,1096461,251622,844839,177,111,914730,180094,734636
c8681a6cbe710b476673f574d408d425,55,48,62977,31023,31954,74,50,119662,17633,102029
fc38b63e3d33eb1985f540560d790a98,35,28,28064,9249,18815,33,26,17114,13062,4052
ebd2090716a8f4bd9d128758642406e8,126,82,252790,65674,187116,99,69,255130,44540,210590
882b4a004a13f1668f65bb8babeeec53,147,94,262604,71287,191317,148,100,251173,62721,188452
f133ea883daf79246bc950f8a6dbb96d,144,101,359476,64467,295009,151,118,414747,56354,358393
99c524a5e7ed5f9cee7478901fd8691d,161,110,390905,66570,324335,133,102,255297,97302,157995
5c333c55112b58a369a4c4985b2d7b85,166,115,418711,93988,324723,138,94,372269,87970,284299
1872a8c9a858d7ff9cc2265921446a98,61,50,86907,30663,56244,87,70,132141,35244,96897
462ebf9e4a145c1119a8aa6480c295e4,185,125,850418,145866,704552,222,164,1026860,156515,870345
ddb1db87588d13d6e8cc699c5b9a8ad5,107,84,276167,54010,222157,92,63,172906,42128,130778
99bfb6c6ce1af725f558c309147c0eb4,199,176,643781,193234,450547,128,98,432959,159933,273026
7726a72f3fc2bda3e77fa7ab9ebfd94d,40,24,55845,20847,34998,36,28,61778,19432,42346
0eaeb32c63144784b7ed017003f97ab4,205,151,689794,112662,577132,173,134,614625,109454,505171
afb1dce98216e30b3f96c3bb9f597d01,109,92,208790,56544,152246,108,72,210384,56325,154059
297c32ae3a77ba04393b0791029e4c8b,113,80,215531,29683,185848,78,51,115399,35938,79461
c9980ca4dde8c1711dbc8483f39776ed,5,3,551,246,305,2,4,162,467,-305
e132f1fc15e7d07bf7af1df1823c2199,152,99,651169,129837,521332,180,130,723025,120167,602858
bde2c117800dfd7b3b45d244f3fc8553,85,66,157304,32541,124763,59,47,111752,25274,86478
4fc3361ec07e6e7910be25ace4193aa6,40,34,40333,21993,18340,40,32,62813,19383,43430
d08a268addfa199889bf585d88525de3,133,87,191085,50480,140605,89,78,168072,65315,102757
527c113b43ed3492e4a94b69843e1282,122,107,253110,49496,203614,108,87,215607,47346,168261
7c62fe07aa9e5150c01143d7289cd9aa,97,78,219193,74178,145015,112,101,250648,59735,190913
afcd9bf54d4101685a1cce310f3514bf,74,56,134271,24360,109911,71,60,81237,26585,54652
4612f8b3dbe4375760a6f62b3f2ea9a6,79,61,133217,30262,102955,68,56,76190,27244,48946
a5f4285780d79690c6f1e0cfb845a57b,22,16,4671,1915,2756,18,14,3428,2495,933
f0a8f049d20bb2cc1386296184592a9c,87,71,120365,28417,91948,64,48,73280,29644,43636
1eb1c7bd2461db361db592c5f8250318,124,101,332672,68149,264523,153,105,355708,82013,273695
98e90e636d6406fd5a9c1be60c328e69,203,150,849487,146166,703321,157,115,643856,180213,463643
5abe6dda902cca060a140ddd4acb1275,108,79,236030,76414,159616,128,108,307663,66122,241541
e0ce9a8a4067bc65864801673facad88,61,53,90169,42829,47340,44,30,73148,27760,45388
9105112a9259ff2d97174a2dba5fee7a,169,121,400351,57994,342357,158,139,394161,78966,315195
7d2cd6bb7028ce9cc6d8c9a9bccff902,57,41,83269,21195,62074,49,41,56681,25204,31477
f32023be4741d230a72acfe0ab39182f,153,133,399061,63946,335115,147,128,296765,70893,225872
b8a38347a3254cd66dd287800998da1e,112,82,234294,56192,178102,128,92,261328,52186,209142
36b82f38df0b9474e185b06b4cb34a56,104,79,247518,48849,198669,138,112,325162,57780,267382
7d872f578969aaf5d428d6f72410eef0,122,86,348038,69482,278556,133,101,352484,91341,261143
78f622a84926b8f0f3a2c051933066ce,59,37,95396,18750,76646,65,54,71459,23853,47606
ecfbd011e774cdabe0d46688fb7be8c8,77,52,139662,35726,103936,88,74,149869,39584,110285
6911dcb238714c4ae9e93af7ab1960cc,67,36,83999,16214,67785,42,37,42336,21921,20415
fc9088d1155ea7b489a756ba939a135d,31,26,23127,8100,15027,27,23,23238,8223,15015
b7204695d8e557828859e1f0a022a6de,145,118,486900,102068,384832,179,140,596963,95127,501836
e1e6251df2a4dd0a635d46819cc4d81f,44,34,72711,20276,52435,55,48,78184,23825,54359
a47e5a6edbd638b5c20e015ceaed54c7,18,11,4054,1479,2575,15,15,4478,2229,2249
f5963c61349cb287f746491b9f92655d,65,46,113054,38158,74896,95,56,110267,34436,75831
b1f5171c39c8b76c84e9b6cfec82ad73,40,31,45070,15797,29273,37,27,39878,16264,23614
aaea8dfe623ea4c8716f771a5e27e028,37,29,43693,13373,30320,41,41,47120,18590,28530
5541c292640966820bc072915206f4db,21,12,6024,2280,3744,19,15,5452,2176,3276
83cf70195a3f2e1e3035df25032ebb6e,122,101,370556,103938,266618,123,85,335291,104489,230802
d89b2387f0506932925ef6d3eafbbf41,16,16,1840,2515,-675,17,12,2903,1108,1795
8d605c424c3aa5865c0594c0083789a1,71,51,99326,27081,72245,59,60,56021,29741,26280
98294aa2a67f2bba00474e50666186a0,35,29,27694,10907,16787,40,31,23696,10851,12845
ef5b89d6639ffaca020efd116fe42719,87,74,143161,36853,106308,71,60,103973,29127,74846
e39799d41e5230fa4cf14bd473dd086e,68,41,93242,19049,74193,57,49,58728,32084,26644
206b015856a28057c60de53bfad44142,152,108,386958,58479,328479,106,98,256145,71325,184820
482ac0205c41d419ac8e89e08048e8b5,58,45,103286,54104,49182,76,62,161466,40097,121369
21bc32e8edb93bede269a61d34f39ff0,114,84,226764,48054,178710,105,87,209267,44497,164770
497e8e4961df9e97593714501cad4125,101,75,189641,49368,140273,98,74,191294,67360,123934
fdae21719d32a7c2004154586e01aabb,45,33,41934,12877,29057,32,25,25907,14932,10975
af2d83e21148a156f796bab3341752c9,17,21,6754,3480,3274,27,19,6453,3479,2974
36f1d7bd4e27193b3176902fae50c880,72,53,200570,44845,155725,133,109,312526,63970,248556
ac4cd365e13cb200a24be7da459f7835,168,125,756352,134259,622093,202,159,842836,171339,671497
4a1856c1a23b0e3da3e51c59d4a56a0e,8,9,710,1561,-851,16,10,3530,732,2798
d26e62d0e40c69d9038dc20533f3a6b8,51,41,63157,22150,41007,40,36,61736,15909,45827
f00f18bf84ca038dae4ba71a354766c2,33,27,37069,16165,20904,39,32,32591,18613,13978
127622187cdc5e5fe31bb3aa6170118a,33,23,17865,6436,11429,29,21,16242,4726,11516
54131aa51a96031189fc8fe261d8ca6a,102,73,126426,25504,100922,70,62,86904,30343,56561
67c1ad4985ae7fff3b9d9b6acf43197c,29,27,10936,3601,7335,31,21,8532,4155,4377
27c44e765df9fc63917f1842f0948226,167,127,382697,77620,305077,136,108,320256,70845,249411
021077051dc96dfa75069ea23a05f72a,76,65,88042,32980,55062,75,59,102516,31061,71455
3748917c12d32f8f19f11c09367c5904,70,58,111084,33786,77298,82,72,130226,30349,99877
a8bf87be72f18e8ed6b27da759af60f8,112,73,278888,59524,219364,175,101,298140,61359,236781
ba114067bd5d7b2992c536c71e5609c3,43,30,45538,15666,29872,56,46,73529,16207,57322
5c68866de71ec62288d576ef2370cf12,50,41,64453,19834,44619,60,44,79233,20660,58573
44e903c4be063fdb473e7bef521f0cc6,164,104,481886,73217,408669,150,117,433576,88996,344580
94f458cc37b94bb0c0f0ad6c77e4fb7c,180,136,617902,89036,528866,146,115,508152,113606,394546
902c14e5741cb7cd18353ac7bdd4ba7a,3,6,656,725,-69,6,3,725,656,69
35f129411c8daf7264416e0df8d4becc,44,29,41894,12642,29252,34,25,27369,13479,13890
f9242944a3f00dd0a60eb4a4365b8e80,176,132,1018525,246125,772400,225,177,932040,193133,738907
72afb1cb16f1c9af64663d028b9ac28e,129,110,297825,93560,204265,150,115,387634,112822,274812
c181f17ac9871662c71359ccc809c1ed,115,70,253715,32565,221150,102,77,131806,34613,97193
b8c83b24da14224ad2100a1a8f4e5f9d,22,16,7863,2982,4881,22,12,5836,2405,3431
cc6e06d15f634a204aa6022153767576,160,128,801141,262755,538386,146,89,693484,198513,494971
810914afc6f5e4cafb68b9f2cf49b5b9,170,123,551568,89123,462445,121,98,365997,119369,246628
d09da40588af0f8ce638ecfcce63b181,140,97,246559,33793,212766,89,77,242731,34829,207902
1238903a132aea8728f8b1d8dde43f05,58,49,95329,41920,53409,85,68,121929,33996,87933
da8c8bd18085f738b65c28c19f01565f,134,98,316374,79760,236614,109,76,311032,95693,215339
0a843e356872fb141c81e8985186215d,82,64,104183,43991,60192,102,74,145154,31846,113308
accebe27c9ee918dc09e4c2462d5fb33,37,25,29250,8489,20761,35,23,21165,10578,10587
30c02b38c303fcc8f7ef3edefdcece27,47,32,41418,14440,26978,49,42,37443,20654,16789
e5fc0f86fe4ccd952b79a03e0e6f110c,90,66,192859,37371,155488,68,56,98001,55588,42413
d63461605d90d5443f806b57b408dd43,80,67,141782,37510,104272,91,82,187947,50402,137545
351ed4079296b364bfb5594ba419bc89,41,32,35756,12309,23447,29,28,22127,12905,9222
70bc2e0aad4be409f342b232730a4feb,45,37,34713,13381,21332,44,24,33526,12076,21450
d6983290a597fa96247317dea720e8fa,23,18,12704,5205,7499,24,24,11029,4415,6614
242887fd89c99da79920ce6c8294bda8,22,17,8620,3254,5366,32,16,10042,1733,8309
f31bbe25f7490caf53c89b3fdf0befed,151,111,486691,86447,400244,114,86,251624,130488,121136
a0c80ed4baf53e5718fce2abaa6779ad,147,98,309500,87415,222085,130,94,350235,79245,270990
50571e8e0a831ea5436def89564a6a91,35,25,29828,5735,24093,32,22,20191,8634,11557
854a8f37b9da500f5840b942b27963ad,112,81,386765,84396,302369,145,115,432370,109323,323047
289c3f9a8f7fe25832242fec41ed3734,28,22,23440,9389,14051,30,23,21603,10246,11357
6d5dbb18135f49270f177b54f224f14c,71,60,118037,37823,80214,80,54,136376,39493,96883
af9a544357595f1f6e7a7b16f317a1ce,56,50,53428,19161,34267,68,44,59053,17080,41973
f9fca0882ec21f40998694ccddf239a8,56,37,46367,12115,34252,41,28,43054,12542,30512
f1ad0607b343df6878255dc26b7f33b0,121,79,227594,65938,161656,159,107,379281,66322,312959
d7f096cdb0b34cef0b52ed9400bf33d2,0,0,0,0,0,0,0,0,0,0
9f3e295ddc4711b53bf88c4fb455d99f,123,94,226069,71398,154671,76,55,130092,34711,95381
b3e2a43082bc0024f70604bb209153cd,185,120,859392,104471,754921,155,130,464594,94463,370131
ed06155d45025952c97a9151d3f5461f,132,99,221930,49476,172454,110,86,299175,51154,248021
8600d2f1b4adb2fee211d6aa67f437ae,60,50,86375,22417,63958,60,43,76660,26108,50552
85a7adb702fafe1f79e6dd3c52bf31c2,37,30,34247,7896,26351,31,24,22166,9408,12758
1c9eb5803282d5e5d6c965033326de9c,44,29,42894,15656,27238,44,29,48239,16877,31362
0f41ef61633b4b65aefeac52bb14a9b1,168,121,456708,99657,357051,168,118,482718,95430,387288
6b183f784801ae9f8e5e7942802ebd7a,48,44,39468,14368,25100,41,35,30376,12834,17542
247adaa66fb5369efcf654f63774e242,191,162,706647,155561,551086,189,151,720606,148821,571785
cf3c84b9ee8e192618a359b0b9281dba,32,26,29861,8050,21811,25,16,15711,8918,6793
2377d07b31546aac01c189b0fed548aa,101,75,165523,48870,116653,107,81,223624,41257,182367
c5a8f6a0f65651142b3ef3d19aa7fb5e,188,109,666165,87048,579117,159,119,496629,110612,386017
c1146be6438aaa392540c0080baa878e,63,42,100629,25643,74986,56,46,102935,34947,67988
5e145c68a53193ec70e204d34b311b13,197,125,834199,156435,677764,187,139,745620,197995,547625
c2083b56668458ff0f9168a7b7796a70,171,121,438178,86717,351461,143,114,377786,91034,286752
3c202f3bd39128901283903d2433c66b,26,20,12339,6732,5607,28,23,13653,5119,8534
515478418b9f755e85e13e399b502843,137,83,370441,84397,286044,157,131,406955,155433,251522
bf71f1f1616e6b8bde7bf047b91dca54,124,89,260346,79154,181192,133,109,341959,71304,270655
338bf106fb2a61a9b0981b0198e49ee1,39,29,26386,14816,11570,45,33,39053,15185,23868
441e149e08990ad9b9698e213a22ffcb,106,87,351979,93983,257996,115,84,301115,97023,204092
4dd1d944d45da43409b4f6ce8bb1d4d9,105,73,187418,52401,135017,137,104,247917,54538,193379
f72227d929312df4c98c3507787ec9ab,70,43,63015,18690,44325,70,49,73982,13742,60240
d57e50421f505f2c66d47dbb54871e78,26,22,11014,6796,4218,26,23,10173,5485,4688
e207222822e79ad11b7e0a6367c0312a,125,100,399079,125960,273119,142,133,509067,93307,415760
f8794a104dad032538ac386dfbada738,26,14,7245,2174,5071,20,21,5475,2759,2716
8d8f73bce365f15f3b644ed6f03ef98d,30,23,21721,6852,14869,29,22,16026,9248,6778
c573ddc57bd632a11d1ad7cdd72663b9,106,76,205568,67424,138144,112,88,240187,59397,180790
c3334852874681f03623aab0e638a102,27,18,11508,2680,8828,17,19,7287,4363,2924
67a738fc9350e4cc43fb8bf0ad11714a,134,96,507182,127053,380129,195,114,741708,105766,635942
4962e5ae82e52964aba51b0f5306994b,85,66,159942,58840,101102,89,73,218210,54585,163625
b22d28a706d34cb79208a3c357634bd9,128,112,376157,129846,246311,108,87,303791,116077,187714
1b651b9a0e32021101e626f7ccd57140,25,24,12278,5695,6583,28,25,18169,6377,11792
7acbaef07d3a61eeea77f15389304591,82,63,152081,38308,113773,73,67,146363,31191,115172
6291ada9f9d0fbc5ee01932e7c0efc12,23,16,8214,3850,4364,22,17,9759,4325,5434
4d06629e17995383ea64e23be41e260c,66,52,87140,25724,61416,57,47,65096,20668,44428
416e2c9282c7b693a74109737fc4d9b9,139,108,309493,59275,250218,125,104,340195,72844,267351
971badf9e664e3cb3737db27c6c1ac3b,23,13,6771,2412,4359,16,14,5965,2053,3912
3248ccb45a34670d68f1e1ee1fb818c3,149,114,363821,86192,277629,150,105,341547,84085,257462
48eaa90323240aea31a3c0ba223f6271,98,84,162473,42634,119839,93,66,101485,35922,65563
b529e6b3a7c7cf4b9e58ab09cb7aad47,168,121,476107,104125,371982,160,121,395867,104766,291101
f7a9f88d0f28b9951aeaf4d4e21e6965,62,55,101823,33062,68761,66,43,84354,32084,52270
50e6d245dfd2859dbef2e2ef54764383,147,114,391312,115936,275376,167,121,468771,96321,372450
9b3593a02388c134fad47dd463f77e64,106,86,191624,55865,135759,95,74,176387,51458,124929
80d8b10dabcbbe48bbc601e3b1adddec,102,83,220649,40017,180632,130,96,255454,48840,206614
9da873062cdf8ec5efa9af629a63b949,62,41,55823,13364,42459,43,41,31271,12655,18616
7b9e4ef4fd03b57baaf410df02c9d610,145,112,374369,58911,315458,149,119,390859,94068,296791
6104eaeb169ee56a46d86c8cccfc61d8,88,69,136934,52967,83967,125,91,258219,49516,208703
b037330bef35796bef0dc0f5dc9c832f,77,65,183030,42669,140361,84,65,168151,62329,105822
7a465a7d90ee306e3a8bd06230ea5815,114,73,181984,45958,136026,120,78,219949,38684,181265
d6ccfaa2e4bf803ffbf9de75192143cb,49,40,42864,13704,29160,45,48,44374,19982,24392
e69d9f43d21a07ee995d69012ba1ed60,138,107,559519,120615,438904,202,168,676883,128455,548428
1a4480e005285f74d171d9f71019b16b,90,80,169854,42728,127126,69,53,128260,35613,92647
fd1e9322915f58e057324ef647e4b383,77,63,105736,21994,83742,60,47,69594,20393,49201
93e5aad06eecf742aeb46e9338fdf450,49,46,60897,22130,38767,52,37,61679,22537,39142
b94d23d12675fe55322eefd5a3095799,112,90,243125,47408,195717,87,81,138125,60483,77642
b592432406ce1f26c664ac49505735f1,71,60,114133,27475,86658,72,64,76991,28545,48446
f0b83629fdec417d36962315a0842156,181,144,549088,98324,450764,129,87,281634,78336,203298
9638ad37e4a62356d20210cb848a44e4,83,68,158092,23564,134528,39,35,49862,21147,28715
929b5c93565c28739cc634487c2da569,217,161,761906,103891,658015,226,177,840062,105955,734107
792cae6462be95f7014990be01d1ae58,103,88,167413,67462,99951,115,83,245422,50339,195083
7273770a10126660992cc61c2ed926ac,236,149,1439720,287166,1152554,237,171,953290,241318,711972
398ea5040f5e28577273d010ce64b643,85,60,158997,66976,92021,151,113,341497,42445,299052
60d229920962845af1322d6e7a5c0328,99,78,166127,62566,103561,132,107,312033,48042,263991
236aebcee5efa24fe434f45389a6a851,42,35,30053,12588,17465,36,27,28814,6927,21887
1786df5e9134e98c16dc35f6fd9e2f00,5,4,862,781,81,6,5,909,883,26
61911e047202343c4f02b972bc80768d,131,103,528039,138257,389782,177,137,694955,120925,574030
093131becde7d2aa7f8c1e4ae9bbe07f,65,45,119707,26815,92892,77,57,148084,27147,120937
41286daa607d9f50410ddbad1bacd137,38,27,30985,11930,19055,40,28,31595,15056,16539
1fd3fbbb208f587847b1cd677b97ae22,146,127,364936,63313,301623,171,144,416638,67118,349520
9b6a39e91573f537abd32624d12a75fd,71,54,122315,53177,69138,95,82,186526,48650,137876
85f4a933cc5908d45fc7345014586a79,186,145,470133,84023,386110,147,114,475655,83408,392247
0f9ed4971f7707db195d2bb48b561be2,37,23,41891,15086,26805,45,27,50224,14478,35746
71192805d8823eb426f26bf71f382adf,18,20,3892,1884,2008,23,17,4197,1599,2598
0806739b20c100aec86c5a42abd3a430,38,30,32450,14555,17895,38,29,48231,13611,34620
d9afe982346d8753683defdaa9a4e931,6,2,756,356,400,3,7,364,764,-400
ef2d26c5195e31345381aedc6e3fe18d,126,81,256463,28414,228049,95,88,175358,52802,122556
610a38265a9da66db1d6bde8157f6581,121,83,208117,38986,169131,104,88,214006,47653,166353
1ca38fe1699a355b512238be850f3fd8,96,74,255774,86833,168941,115,98,254673,84163,170510
c4c6cba7b312c3d33577c8cbbe696796,86,72,175312,31844,143468,76,76,115694,45169,70525
5632b351f099377dbcd64979ba58b1ec,119,89,310306,65656,244650,95,75,182910,74378,108532
9b5d7007e99f4b2274c884d6e78becbf,26,21,8253,3733,4520,24,18,7513,4970,2543
331604790b1cdb40ee85fa31a283915d,31,21,14475,7980,6495,30,28,21125,8572,12553
2e963abb562d0451cc53d2532adcb82c,48,37,71983,20831,51152,64,55,73117,24808,48309
a45f8ba00687b48ebbcf6f50e101df32,37,31,34176,10599,23577,25,17,18675,5307,13368
c823eebcf6d8880428be845c45274334,24,22,22100,9129,12971,19,23,23903,11489,12414
9fe8dabd22a5c0c1003779c9df1d8efb,104,79,284822,86513,198309,175,136,412490,97596,314894
1d99361965bb37900980ffaeffc34920,95,81,206454,72594,133860,94,79,227122,63047,164075
340861abcbcb8ee492666d753f6625d6,40,32,41914,21153,20761,56,48,71952,22804,49148
a8db94eac98323a72e74b62c8ded0ed7,106,75,201008,56431,144577,118,81,187220,54074,133146
227cc79dd4fb64e59e1b15e134295bb6,126,86,249597,71172,178425,94,71,181274,56068,125206
fd216769706d2a5047a3a932359e293b,21,16,10964,2930,8034,18,14,10152,3132,7020
2792a0be681663d6b9663fe8160ec2b2,59,46,66365,19235,47130,65,47,48872,22367,26505
0141fdc7b0522b710d77242c8a9ea087,186,125,598181,73832,524349,139,116,402676,127292,275384
f7923ee559ae8349a2b0cc06b01e3b29,50,42,37112,16405,20707,46,29,58845,14993,43852
15887377954889795d5d09b86a196025,130,106,425940,158361,267579,175,125,616241,114938,501303
ff22d0500f2c111190cc09feefcdf573,171,135,529817,96118,433699,141,108,385283,114992,270291
de5454e1a628cf6f8b6d827121844d25,4,2,504,159,345,4,1,336,261,75
1c860e79a4a8bcfebc30b8a1d9fcbadc,64,58,55962,25930,30032,76,52,70682,25524,45158
366c2ee2107ce49d49b951abcf687903,152,99,565693,86175,479518,194,155,619793,117866,501927
9f27a5b78b71d1f143b802aafe461f5b,122,99,309110,78643,230467,122,104,334282,92771,241511
0051886e26e5efc61b27e8598d595239,115,96,242140,54087,188053,60,49,104425,67380,37045
f695d05ed3f051111d26e3f89cab1c06,155,113,755800,120513,635287,165,121,626547,169145,457402
4c01d35c0d67e4bb3d4e597dca980bbd,158,111,433129,102999,330130,159,119,493009,113034,379975
9be540d1583c274d716c1ee4fe675999,144,84,338515,80417,258098,139,124,369016,110649,258367
6cd7178dc3594606ff7644c0cb7c3117,143,113,477101,89703,387398,175,118,400086,98529,301557
a35618b312fd036e2a0499811490b037,61,53,79447,19549,59898,75,47,106559,17771,88788
d3cbb0292834f96de75b1bbb428806c5,61,48,66566,20990,45576,60,48,66018,22749,43269
403ddaf6e5249c9aa56675fe1e89c875,16,17,5683,2517,3166,19,16,6436,2354,4082
62b9402df288f9d4d6cfb65cd301f282,41,27,29450,8612,20838,32,33,17350,10327,7023
51571ae168d7a5bf8d67ca4e224b9a29,68,50,70032,21509,48523,65,51,86038,19456,66582
f3cfcb1800f6aca1a565f3b6c6f68c57,133,113,293348,66857,226491,151,110,264725,59441,205284
25df952ba915455c1fc59b934a772e21,64,47,108413,35791,72622,80,63,112466,37653,74813
49035f2cca59447d9cdac37de5f54aa6,194,161,655517,142521,512996,173,145,733135,115457,617678
6a721b0c8405cc826e842fedd7ee7e2f,76,54,86463,20552,65911,66,57,66709,20620,46089
eb5d1277326e3f1456f8369d71fc9749,125,90,174684,24877,149807,105,84,174501,34403,140098
aa33b23f3d3ebc8e51c785d0900bd5f1,58,41,70284,38139,32145,64,57,144918,31619,113299
e909c778823bfe8463ba94ce75c8b838,36,27,31345,12376,18969,33,31,27724,15499,12225
d5d96344c4d931d86052641eec206600,81,60,116714,45361,71353,92,77,207603,35653,171950
5d29adc5d1ffc50957267418f3a46642,152,114,472918,115825,357093,174,110,468173,130179,337994
43e8568c25124b907c4ca91692ef3efd,66,46,54125,21804,32321,55,56,78958,24097,54861
8a84e0c53e08b8c3601b24c1150eb84a,72,60,102191,25379,76812,45,46,60609,24677,35932
f604af7172535dc682097aa358de593c,22,18,18008,4989,13019,26,25,19851,6761,13090
450d2cb522f1958558f1c0531f86e8b9,41,31,43198,18457,24741,48,31,58757,18273,40484
9d61ec5d3412bc5ffd6cbd84ddeaef5a,63,53,58623,23944,34679,64,49,96586,18105,78481
45d497a15c5099a0345bf959807c6e85,132,114,448874,159020,289854,161,114,443083,104038,339045
206183e7314581a085e878c9c035625f,156,105,530791,89399,441392,195,117,523105,82190,440915
1e7145c74f21b8b80cc9af7ed118c4f5,95,80,147316,48814,98502,91,77,165498,34301,131197
454c13db065a8606b3cbd32184b8577b,141,110,518091,109335,408756,166,136,511861,123260,388601
b728f7358eb68ca40b45938b9c65aa44,27,27,22182,13597,8585,33,29,30213,11721,18492
3af751281df47b18c21ff12bdacffa3b,12,13,1878,1157,721,17,10,2757,860,1897
198bfc726a5f581fd8cdebb0bd4bf5be,20,12,8193,3093,5100,29,11,9048,1065,7983
d7c4f3e7a3ce22668e9afe136b12ec83,12,5,2197,279,1918,6,11,445,572,-127
6d367044190e484d78e95a9602b0d1ea,104,76,167814,33199,134615,74,62,134644,52516,82128
0eecec7fdc3248b62d7c5753efbcb2c7,0,0,0,0,0,0,0,0,0,0
006b6c07db2e99b33a4012114de993ee,201,145,950374,124550,825824,190,134,707823,182134,525689
2a9e7a53f49533e6e28a460600ccc967,42,31,57533,16900,40633,45,32,47998,21528,26470
881b03577d658d7094e1733363f343de,80,54,110960,30663,80297,103,83,190010,31557,158453
9edd131aeb3b1f6305ccbcff2f44a2b1,21,22,6356,5142,1214,19,16,5807,3588,2219
b73c12b357af75932aa6d516d7d776de,106,87,328160,56515,271645,120,101,292389,81189,211200
0d9eaf7bf945ea9dc956c454e19d66bb,23,17,8166,5719,2447,29,17,13802,4355,9447
811558b70b914497f4b5438005ba757e,44,37,46336,16435,29901,59,46,71611,17812,53799
d20d8328d470876bbc1eea8915182cd8,87,73,152514,55935,96579,109,89,208233,47564,160669
e2d505e672f40e3a259e8eedf69e33ab,147,114,426709,132245,294464,112,84,351030,107999,243031
cb73837d002083b7c5ebd7f21e84b72e,111,76,233596,55189,178407,131,105,263934,45465,218469
d4fee9db3911dc462f9cc9239eb96ff1,76,61,127705,50101,77604,83,64,179093,49188,129905
e541c838271698eb5a2182de1419cf48,160,128,566938,96906,470032,152,139,579176,98076,481100
275d8a4f16ae13f7079d12e6dbfb129e,79,69,119392,32350,87042,60,62,86655,32014,54641
b92ee0c3bee010214f61472e54c03ec7,134,90,315929,122108,193821,184,122,417263,90878,326385
f2528e8abda798cb2bebfae873b63614,83,66,120944,36758,84186,62,51,83364,23208,60156
444d11f86d3858373e84e8f75e665819,130,110,363310,91443,271867,101,83,266840,72278,194562
723c79cb276a588188a6534d90402d9d,87,65,182705,54912,127793,87,69,171010,54911,116099
4dc0ccb22a88829ec46bd5074cb645c8,97,62,130096,27294,102802,71,60,90603,37598,53005
b142e6b7611c0f6ad96e70d18d9af1fa,76,59,132869,36723,96146,83,81,146751,39398,107353
76ee6d92f13b2dafac652dc7ce060d37,44,32,52387,15229,37158,39,27,35413,14664,20749
903dc1608a713c659be88bdabf442de7,117,79,187073,33184,153889,84,60,97400,44978,52422
7f8d1aed00fea478b60fac025bc45923,158,114,540801,90708,450093,149,127,453895,117276,336619
a57adee21a605d8509ea9b263587eed5,28,24,19017,7372,11645,31,25,15089,9444,5645
dfb56743002fcabd5d5d16b77623fe02,97,72,122395,29608,92787,58,53,81578,32551,49027
0c28014851ab498a1c63c7b413a25924,85,78,123015,48907,74108,119,68,183618,23416,160202
4cc3921da17122a28970f243d4096c93,35,30,18954,9126,9828,31,27,25159,9153,16006
51441a92ef6feaa3e15da2566dffe100,134,104,350448,49053,301395,170,125,459106,57375,401731
546a3ba7d3bcae2136e3bff8ecb11a01,94,87,163280,41352,121928,91,70,141275,37975,103300
5bdabf4d93025f8202d9e579070543a9,27,22,10815,7529,3286,28,24,25847,5451,20396
5e8455842b02ffc58291019bd4a13f1e,28,26,23797,8613,15184,29,22,22283,7820,14463
27f17d1328727fe3f2fe9ebb36f2366b,49,49,87287,35207,52080,101,78,162974,34566,128408
502f2a8779e0349fc85a91693fe609ed,193,134,653510,139388,514122,201,159,969230,143289,825941
0901976e34653d43ba03d9a94c3176c4,64,56,55526,16949,38577,52,44,57696,17430,40266
170620dd6905ec3410c164ffececbd65,161,140,513968,96309,417659,121,94,298380,84558,213822
c90816e77b27689708c93e6472692b60,36,28,43420,18103,25317,40,26,52934,24141,28793
2935b3a6ccf4ff080062d0d7035e7a69,126,100,336381,85987,250394,109,76,393614,76994,316620
b43e76ce33050bf68ef18356ee5e8826,28,22,8813,4610,4203,27,22,12871,3298,9573
b45ed8d963a4e2baf7ab3daaf380b709,20,19,11552,3703,7849,25,15,7050,4007,3043
b775f8704b1b4b325299a36785ad0d2a,140,83,259223,48113,211110,106,75,207002,58543,148459
817e9d3dfd29334b7374cbc5a3f8c420,85,68,146337,40709,105628,90,71,169247,44781,124466
58af4d7e20bb3d0e1d3a1847309a4ee0,43,36,50483,19315,31168,42,41,47092,16828,30264
c0f6162629c7f513a7d739d538f5779b,40,35,41898,13813,28085,51,33,48537,16396,32141
be42635b44385728729edbf91e4ca267,32,30,20615,7231,13384,32,25,16218,8641,7577
6a3a9c49f43c1c3106385590562288f4,35,28,26344,10708,15636,36,26,33105,10397,22708
c30dbf77edd3606568efcb7412c3d096,99,72,109569,44310,65259,92,68,140872,33364,107508
ba27ed17de0dddd00f3a9707847dac1e,117,92,186259,41346,144913,104,89,166500,45454,121046
f400803e70ad136715516e01bafe5563,57,33,44642,20400,24242,52,50,102607,22332,80275
cf1d21a20aa29d1d78a929b767131551,91,70,173797,64054,109743,108,84,184446,67827,116619
04687d2edd7f3f9075ea7ea77aa82738,43,34,54921,12887,42034,36,27,45063,10857,34206
c62f24083ee0f3596e275392255f90e5,110,65,265313,40906,224407,97,70,194198,39755,154443
f298634a04e298cc381ae5bdeccaa2e4,183,142,1181259,248748,932511,238,174,1105086,256049,849037
44e24860a96bfa8b09697a68258fbcdd,166,119,519071,113878,405193,126,102,334038,108829,225209
3ae1ff8f1e7805d37c863b32add55216,10,6,1544,996,548,10,10,2085,941,1144
78652f565435e6f7e2016bb2c9c919ee,153,117,733339,149129,584210,204,147,693245,170258,522987
fe81a40d086683d21153ed2f829a6c38,70,52,103450,39204,64246,103,89,232886,46770,186116
20031d083e5a66d1c201b0951fa332f7,18,19,5190,3341,1849,23,16,8218,1702,6516
0689133fd2b2bde4443a82d128e576f6,164,124,492611,95750,396861,104,78,297438,80386,217052
693bbf634ea2c3015233b45e456cda64,89,66,185808,53245,132563,133,108,231335,59682,171653
c9c06362060bf49ec50166fda9adbc04,58,41,71294,13588,57706,47,38,43344,22015,21329
ae676197b9c0fdbb46fa3a7b797171a0,99,85,280982,77310,203672,125,99,234651,60122,174529
a37f223145837689ad7d3561a39133f5,12,6,1696,186,1510,7,6,663,303,360
02ccc85a295b9c1c93ba9598092cffc4,28,28,22020,9009,13011,37,30,29456,9757,19699
fee20b04c4ce1c63dec359aed40006a5,114,82,227704,35889,191815,105,68,140357,38607,101750
70df68e5c46f6581986a84edbe7764fc,89,70,181606,52769,128837,78,60,176525,51906,124619
266cfca9f8a09cc8fcb25580b459111c,23,23,12790,7491,5299,27,22,20611,5984,14627
a534dab497673f47c136dcdee3ac0817,124,105,309924,81799,228125,140,103,415449,84580,330869
9cf800ecc5d4a9b57b5997331526f4a2,123,94,256265,52124,204141,141,113,400399,51451,348948
2f2593314223873287b5f8fe3e957b96,93,83,224424,71473,152951,150,126,371207,93871,277336
9e755818c0fbc5476d6706ee8ee389c2,139,82,222434,62277,160157,101,86,176450,61051,115399
170d28a7febcaa4df07f4bd3b8c69b81,62,39,82470,20689,61781,83,60,136228,23593,112635
a265e7d5e696e51990a3699648e1aeef,144,119,467355,86896,380459,126,94,319733,112062,207671
af9aabd83246c46ffacb5cb35589d90d,133,110,289355,94528,194827,142,114,365301,113620,251681
ee92efcb020cd7532ac59b9a563a3178,137,96,357536,98725,258811,173,114,476112,67537,408575
9fdfce7c436df97fbbf4f26acc6bd8b3,30,24,19437,5125,14312,26,20,12136,7516,4620
0bc0860320eb01753bcfdeda211f32f9,201,147,691941,147861,544080,168,129,649344,134736,514608
f6d70af512dbf1bb7609d29d4e337b72,62,54,63452,20685,42767,66,43,56692,21024,35668
23ddb30f8d45ff9d0c0ea06c258b363b,52,43,86152,21569,64583,58,48,85779,23997,61782
268e5e26e76ebc8fa1a31bb1bb286c4c,84,80,164459,42966,121493,97,76,168175,53984,114191
d323e94fc5f2775cf31cdff5195dfefc,72,69,112260,44825,67435,63,49,95944,26872,69072
844f24c91bff98893b636a35390a1b29,218,123,814161,172811,641350,201,140,1012900,185412,827488
a4c2dfd52b5f0402955e44e3bf335215,232,155,895985,217341,678644,213,160,1071620,196503,875117
b5189900de789d24d0fd1388a5855803,99,84,150594,53128,97466,89,71,144073,35645,108428
15e787a6d0b543ec653807fcb38e451d,5,4,628,678,-50,4,8,710,497,213
92db6b1c80d0562a3617e5f4944eabe3,114,91,223821,50919,172902,126,79,329467,34443,295024
d78c19d833e1602a21f79288f26b9299,169,139,699335,245336,453999,186,129,733568,181896,551672
6647e8abf2f4f2ffc9635261a062038b,99,72,301583,97504,204079,146,123,446505,94089,352416
1a2b16322408953c03edd86bbf07630a,22,19,10713,5742,4971,22,19,13161,4621,8540
ff80bd1276a08f341edee8649a781493,31,24,18895,5119,13776,32,27,11756,8073,3683
06f3cfa60a65df740bcd2b1b35e6a279,42,34,50003,14854,35149,42,35,51084,17208,33876
de1fadc825e21703600f9f0eb91b0fbd,112,80,197114,38912,158202,101,81,181438,50470,130968
412156d800744231c5d22f5cf2e5316b,133,109,354591,87939,266652,175,115,534741,73278,461463
2e8edef1409d4320a28303243abc8f00,214,141,1007254,235818,771436,205,157,1279487,196529,1082958
867ec3eb7d4818971cb72b9b02182922,114,98,213769,59675,154094,102,86,221454,65868,155586
ddc41a7c1eb517b666272d028bc4cfd2,140,123,493791,92980,400811,151,120,515600,78863,436737
9668fbce00abf50a3807df6829af3bd4,130,108,456722,100581,356141,131,107,619732,84740,534992
5c87b632ffe85e74c3f93c4489daaf2c,183,138,569683,94479,475204,167,120,504510,109206,395304
21e082a7dbfd0337956216121eab6159,119,96,261756,73490,188266,110,85,277455,59282,218173
f6503bc7348a2c63e8624998f6c6f52e,113,95,223427,41998,181429,98,81,199391,59832,139559
e5975033e435af3e4d3bdb3abddb4ccc,148,117,271811,86323,185488,159,99,333288,39752,293536
02368d70de1312c29776b51f539da917,2,2,76,259,-183,2,3,259,84,175
6ee9c33d3ffe5df28c26fd9f83a54d84,30,22,17882,8583,9299,34,24,21826,8923,12903
e5748e16b99cf537473cb6fd68306d5f,58,48,89594,18479,71115,42,31,62557,16164,46393
8bbce7ba2a20fec956ff55b4d8d4b243,82,64,154222,44863,109359,73,54,139255,27215,112040
28efeae6189a3d71b1d6dc7040771560,100,71,143776,30269,113507,88,82,118051,42066,75985
7f3d66ef51a15aed7f5d0f7fa6648454,172,138,786674,154053,632621,219,158,838677,229718,608959
bd5f74927fc41913c64b8e32f90829b6,154,136,561464,161564,399900,180,152,685443,144084,541359
e456e8f984a7c3de01c62712be77cf72,36,30,38702,14372,24330,40,25,47953,13221,34732
4b8d80c97f976792de19ba2af7022c58,123,87,320145,71474,248671,148,126,366833,78673,288160
2e3c6f3189e16a982b2eb1f4d97d2c03,91,67,116904,34685,82219,121,90,189858,32805,157053
72ff208d733ec08bfb70ef7b1a8f189d,30,23,20157,12108,8049,28,23,22809,10819,11990
c79a35feab4beeb0a852ecdad73e2641,77,70,130391,60381,70010,97,68,202391,32295,170096
1b35c518f79840e51cc40249428a4ab4,145,106,595657,114363,481294,185,141,605904,100996,504908
3633a54cf4a6fe78632fdf34ff02b76d,30,23,17635,5800,11835,30,26,12960,8901,4059
52e84a965a7163478107bef3d22fcd83,83,67,127493,45486,82007,83,74,149960,47107,102853
c3590958ac863bdecf7eebce6c663c8c,7,7,1392,1175,217,12,8,2382,906,1476
3bbdda0a4d8bd1e1c049b029c89e8a9d,170,103,570371,130181,440190,181,116,709258,157268,551990
926fa5ace8ee9ca8cc7fab80b2a3a829,168,126,618132,153080,465052,191,120,462752,139662,323090
22660e5a8e4c90f73d91bd52c5440ee9,175,111,569402,113782,455620,185,137,546140,107137,439003
19fa98a451230bf1ea92b4de82e5ef82,69,48,43240,23572,19668,74,53,74586,17162,57424
a780b9a7b5da04f4cb0c60b28d746504,48,25,46980,10055,36925,36,29,21513,12869,8644
6d8c8011026e4a1ea9f2c1a0bcdafb89,61,47,63435,17708,45727,53,29,58168,14159,44009
418fd5436d17b4ec606da902cbc2696c,115,90,245464,69108,176356,98,77,193069,58808,134261
00afae319142971283457fd7227d793c,58,36,80516,17268,63248,44,44,55936,19096,36840
5eb4e58c3cae981fe89208e616e59e64,34,27,40358,10764,29594,29,23,27991,14669,13322
b68fcff417ce52a106d89b1ce0e7ba2f,127,101,412166,84691,327475,129,104,374525,110917,263608
082d4b0818cafce7ec3844a1fc442060,110,80,186221,32411,153810,71,62,104344,34988,69356
c34806e05416fbaa63db1b4a4c709fa8,82,66,131925,32926,98999,120,104,160795,34929,125866
944eaebc4f03ad3bb04460d6c678a9b4,21,16,6879,2198,4681,16,11,4420,1638,2782
b0f1b7db331872d74ba93893807f8293,121,89,186035,32957,153078,78,53,185663,27764,157899
5b9933304644d630acd74e5aee685695,205,128,950893,241884,709009,180,135,1022785,252356,770429
f634946d384c1a6117107f00c2de93c9,4,5,605,461,144,2,3,193,148,45
4e3b4e6a225227a7770c1a2551a893bc,90,84,244615,66997,177618,126,103,346483,68987,277496
3f06ec4083c6c96dc9236be68fc85685,33,18,15753,5702,10051,29,27,15629,7421,8208
81da0dc4bab9a6f61fcddebb88d3b546,21,19,31070,4192,26878,37,29,38077,10311,27766
93a376a5ba75d655f3a8df71cf5759d1,49,42,71966,29395,42571,47,36,85925,26853,59072
8b0a2cfdb7d0a144c68137632a396b0a,102,82,206093,46600,159493,112,93,237952,50085,187867
2edd2557b84df5e6ac7bbbfc85b84610,20,15,9479,3419,6060,21,13,12959,3132,9827
84a4d8b4e73cce0cdd69255348c2fb4f,31,24,19587,9751,9836,41,37,29167,11937,17230
64e107190267d347b9e1238299eb208b,158,128,447491,110765,336726,122,99,365224,78036,287188
9a4d1cc40c4b52f394880781d19aeb73,13,11,2540,865,1675,15,9,3459,741,2718
ddf84787516c094b87e4ce2bc7c99270,133,101,287829,60380,227449,137,104,312502,48106,264396
ee277b286d95e4e46e1852001d18ac40,69,46,92622,23751,68871,92,72,141350,30872,110478
5c4d56295a4256a46d49370bf0de24c2,175,112,490620,96550,394070,124,100,456023,100684,355339
b9f7be86195615fdc0bc0c409c6c4a24,173,126,778152,127425,650727,219,176,829655,263008,566647
70f914dad751b77a8cb3e9a6890785cc,83,66,155796,38948,116848,66,55,125686,44343,81343
5a8270fe4e2f05b9508a8512ea87309a,55,40,69607,19990,49617,58,52,68426,20797,47629
6afa09eb1c1e12e53c3133b692590ee4,108,75,245155,68714,176441,127,111,344607,83038,261569
85c41ced90194649747c351a5678e483,79,65,131259,33128,98131,76,55,114952,33940,81012
f54c3c5f52877d41b7cb59ec061eb091,42,28,43373,17168,26205,48,33,44081,17887,26194
3f8f7f19ca8769efab076177f136bfad,37,36,31010,12230,18780,39,34,32413,7672,24741
479d1c6d12c7667c1879ac93f5b2fd49,105,91,168440,42493,125947,70,56,117098,61434,55664
35ab988880de05e46d93e97b7db3a60e,135,97,341929,91199,250730,130,98,376645,87479,289166
b2dde9d5f77853d3c50fce417d904192,161,124,369278,71967,297311,102,86,239921,69929,169992
06289eb1248b1625e0307ee6388a22e6,98,71,224828,42220,182608,108,87,214051,51454,162597
c18e35e53d9d78b97d9c65ee2f6cf431,81,61,163072,37790,125282,91,76,135202,50621,84581
3c76d90311d98c81b45a42a728e79df8,105,89,218908,61230,157678,134,112,271817,74716,197101
91a2eae86174fab7324e5395287e1634,42,27,40061,9365,30696,47,34,31797,12565,19232
f34cbac141db1e3562e57660a9c7ab2b,121,96,231393,61264,170129,110,87,251589,56002,195587
0ca609b93ce3af5d24093186c67b2f74,50,29,72163,10284,61879,39,29,37995,10431,27564
345893588a5197416f31b211004e360f,35,27,26536,11471,15065,39,30,31523,10850,20673
60538da9fbe015649619ab726cfb57e6,150,118,278755,93473,185282,144,101,315403,85881,229522
73fd28f153aa82aa473d01058a09d06b,128,90,457742,88734,369008,176,120,491302,107062,384240
aef60e4dbb2253b67b5572cb7beb7dd2,89,72,144511,51145,93366,101,79,207646,53102,154544
903c377918afa64f777162d9e0dd1fb1,127,80,299918,73629,226289,156,122,327510,103561,223949
9939360eb3b5c8caa9723cd52e939a74,110,86,187379,37493,149886,105,82,203343,36092,167251
f890d73e87960031aa96b73c35098c6a,138,109,201159,51428,149731,125,102,197552,38815,158737
8ae0804edbaa864ff762d9dcec5b0c0a,36,24,18596,10643,7953,34,24,25238,7932,17306
79f1582073680b25946a2693f41a54e1,55,41,59688,20667,39021,47,32,67881,17790,50091
3be88280d68404ac783d1f69ae7c55df,113,82,198433,46838,151595,111,87,251667,57946,193721
0254eea2593a20ca9ef8c49caaf94de6,15,20,2642,3059,-417,22,15,4218,1896,2322
a5b716391279653c2b1fe5afda22c647,92,83,146164,41831,104333,71,52,82568,29451,53117
97f2c79e5003319f0097dbefbf9a9d5b,13,8,3116,937,2179,16,11,3107,965,2142
dac0b383fcfe523b47f1bfd64592d7ad,146,108,429607,78149,351458,120,105,260136,93527,166609
ca5a6c1e10a0b407da2b4a63a65a8053,31,22,26618,9597,17021,42,32,36436,12278,24158
a84a8b9b4b033825c1dfd211a2c56b16,74,54,142060,33978,108082,53,50,53413,50233,3180
d84dc7e9185a8e21726be7b1d7275c9b,106,85,162894,37521,125373,97,83,170009,22198,147811
f776969d9af18b89bd490b283e052775,158,124,534903,97918,436985,150,118,407734,57030,350704
6661c79e84ee20bcd4712c77e4c45c33,24,19,20598,6145,14453,30,23,15208,7093,8115
05bd945e7731af5bdf18939368e72161,23,18,6804,4876,1928,22,22,8810,4944,3866
124eadb10412fe1b4d2d07bf16c16eda,21,20,7720,6210,1510,25,24,12009,3860,8149
b1e530fba922f70510094a9d1273d858,45,49,73702,33544,40158,70,43,80956,24408,56548
df15714594f6a555ab06a0120c206bf8,173,131,813931,172538,641393,243,160,748177,131276,616901
e0bbe1e1246ac171626445e23bf17084,90,71,138732,27221,111511,99,79,129823,35566,94257
9b7dd9c8181721bf6bed3ffd242f8800,27,28,22772,8601,14171,24,22,14444,7983,6461
378f89d066a575b6c06f2955d7ff030f,62,53,154961,91432,63529,107,98,319710,85213,234497
ffc81fb21194bd6deedbc977eb30ce02,123,94,229894,83687,146207,124,94,248810,74875,173935
abb4c9a59daf63d66ea5fe8878a34586,39,29,59716,16345,43371,61,45,71531,16626,54905
1feaabb0d207416ad805dd91e21ad389,156,124,462234,110297,351937,162,146,612417,142964,469453
519a562defe8b1d886ad5d3f59747cf7,164,110,608835,135229,473606,194,117,514813,121716,393097
0247837433c4e0849393763b221d0a25,135,94,479868,119823,360045,167,101,483217,121219,361998
85d0e9a66ab7c14a9a23601ace585650,18,12,6309,1365,4944,13,8,3676,803,2873
4f76295e0bac0dd0a067bf583ed03dc6,100,76,207436,59787,147649,108,81,199225,69878,129347
ef154b6b8e693de906f2d355285c38af,95,58,160055,61243,98812,137,75,194926,53879,141047
02ecdee69c1d3a5edb9a52ea8ec69128,150,112,643578,141244,502334,194,134,681474,106607,574867
d543663b0251446353ebd623e6794c7c,30,23,13890,8291,5599,30,20,16917,7796,9121
20eeabd5a79e39697c4d0dbee6140fcf,95,78,171285,42361,128924,76,63,135947,42248,93699
3e40f939caef3dbe6014f29895fb57a1,96,73,200932,44279,156653,87,67,163981,63585,100396
63c642af6ec7a4304fdd2eb8577a67bf,11,10,1535,450,1085,13,9,2008,824,1184
e72ba901cd6555fbd991ea1181d8702f,90,72,122320,41470,80850,83,74,214185,46262,167923
aa5d1ba50ec167ac4856407e16874b68,1,0,156,0,156,0,1,0,156,-156
a751c8333bb27775fff464e5689ac0b1,136,83,189504,37070,152434,114,76,166916,52568,114348
5e9051b8fe51fb03cacee6ca31b27ae9,136,98,317027,53736,263291,124,94,348555,74242,274313
6c829ecff0a6e455469d55ab20fa51e9,140,79,391979,74248,317731,155,113,428580,116167,312413
61fd10d7c30ea87fd7a30f9eea9181e7,141,126,391209,109215,281994,149,109,412764,97970,314794
32038e551312b2e8ca82b5e87bfae742,35,28,28614,9418,19196,32,30,23489,13668,9821
fbe80d029450f15cbe0b53168d2ccb55,80,68,196586,51583,145003,78,66,139807,37669,102138
1f836522cd482b98722f8068aeb42ce1,23,28,11921,7095,4826,34,24,14564,5300,9264
8548cc31c679fe41c6ba91830e4956b2,70,64,81778,30961,50817,68,47,80916,22782,58134
6b9c5b869e11cdfc2b05092522a69fe2,16,17,3589,1937,1652,21,16,4263,2497,1766
c8c716d00310bbb33a23f67140b23e06,111,77,175298,51224,124074,79,59,147335,48971,98364
ea97b5caf9b6a82713e8bf68edaee818,96,83,221766,64512,157254,112,86,274929,87408,187521
3a62b3ba2db2f485a9e2d0473a55e70e,139,124,311838,90253,221585,117,97,251898,66367,185531
6618de4e39cf48fa3c4be845bf01d9b1,48,29,46048,12715,33333,40,27,42955,12822,30133
240966366e9e42c3c9d6cb4596790fb6,181,139,707134,142075,565059,199,158,762164,162920,599244
d98172594a65b72ffa43f4af3c62e412,98,88,192785,50873,141912,106,76,186653,33498,153155
43b00755b409c2f469799b69b68d7fa3,38,24,35680,12842,22838,43,38,54094,19100,34994
9568ce71c56487c22b5ff43c0d167f0c,83,68,158702,40209,118493,60,52,116507,38813,77694
1562f2adfd3be8375b8c6f9f25a64419,78,74,191928,32734,159194,79,64,145794,48182,97612
ceb689fa50b228420843eec22594fe48,23,22,8481,4529,3952,22,19,8836,2816,6020
dded68a5a32de4eb1ea5b4e99cb5e9d6,107,87,217456,40320,177136,125,103,207446,47395,160051
3852c2580f5ec9bfe998d69a3456b1a2,26,22,15532,7819,7713,36,29,20743,9186,11557
cfdedd1614c42730fcde14265b884cfd,39,30,22125,10558,11567,35,25,27093,6073,21020
f90eb7454387822424dc210758ba061d,42,34,34595,9516,25079,34,27,24138,10170,13968
c8e1c5ea16442ebb78718fef57ff478f,57,47,93610,27465,66145,48,36,81078,16721,64357
c4eedbc1a35c900e182ab5f2991f21eb,92,74,232245,41154,191091,103,87,201868,48365,153503
873060026244aca3a6f0a81f5a5fb115,80,62,133366,30638,102728,64,52,77617,25857,51760
acb6f34c6a3b3e94a1ce12a1c0f2491a,111,78,236945,33780,203165,124,114,217706,71741,145965
5684757d078856eec7e404381b530643,25,17,7460,4965,2495,25,17,9997,4847,5150
ed1c23cd563198078697f33083128c42,98,74,173637,60170,113467,143,83,284670,52576,232094
dd07dc1085f37ad5c613790095b4b2ce,139,116,390521,61472,329049,133,105,363207,71136,292071
0c64aebee103b660ece7f0de5857b934,112,78,361813,90190,271623,127,106,412725,93662,319063
f9726c9beecff85ee12a3592dd49ff6b,47,37,43896,18051,25845,35,32,33265,13784,19481
36ffeae9ee43c349e30cc3a838a18b5e,200,112,758868,144711,614157,230,158,805472,174398,631074
e6afcfc1cd16baaef27f3cabc563c702,140,85,250637,76753,173884,126,87,284425,52833,231592
9556349f6ab137e159bc3f5fd9a77c43,30,31,22501,8589,13912,36,28,20606,11839,8767
af95b9354655fd6e811c6f5b9e5f968e,156,118,590326,104940,485386,158,122,517641,106285,411356
8bbc5a6864bfc045756ca5aa45d9adb9,172,116,549255,124910,424345,158,123,479973,129255,350718
8b2943ab3299accbade76f719155a2ae,30,18,11802,4801,7001,29,26,15464,6806,8658
15186fd31c95c1ca85a87d8a19452915,119,99,233128,45059,188069,84,79,168028,67265,100763
3f09de3e99224e4c7a8baad4845c07b0,159,107,502318,114985,387333,194,122,520609,79155,441454
a18dbf169e130a4ad7801decce265f41,42,33,62205,19610,42595,71,62,100842,26232,74610
6690e82fb8c607dd72b9d65fec803e62,99,77,169676,33081,136595,79,60,114172,45199,68973
5a6bed34edef0f5d31554177490e4ce0,51,39,40242,14857,25385,51,42,33865,12784,21081
693cf8ff9dd7aec0391c2658074790ef,115,105,226487,66175,160312,136,106,231644,47590,184054
824be1a8aff631a321c1675f3ed890e1,140,117,445503,110517,334986,130,106,427804,117402,310402
4d8bf5435339707f7509f97492d902f4,38,23,25691,5847,19844,37,21,19095,7202,11893
4e6340639bf941d9e86c9da59a2b1564,111,98,235474,63059,172415,93,78,187910,59970,127940
5269d108dfda88059b6735bf202659dc,52,33,90061,30257,59804,55,37,102576,31342,71234
70068652552536ada00f04ce71c4e2ad,56,48,72343,24069,48274,67,55,81226,18297,62929
43ed827a7ce10b89f239a828a7d09734,109,74,192572,49980,142592,83,66,123691,61040,62651
3879d0c5dd5bfc0c31b45d216b18a09a,26,17,6776,3962,2814,22,18,6752,3315,3437
47f4194248406823fd1a39b84778b084,104,83,214363,74973,139390,121,78,304590,67482,237108
ce8663e1189e008cdaac3b5b47c3a3d6,52,39,56787,20920,35867,69,68,79254,31169,48085
c0aa84c04cbc1eb67efc2d7ee4c8009f,76,59,105741,19863,85878,82,75,101362,27784,73578
11404145bb882ddac750f9efe68ba2f9,35,23,31002,7441,23561,31,29,20933,8366,12567
55d006c834b0156bb6f70d05cb22a33c,100,62,169410,22274,147136,76,68,88312,47081,41231
7e248cf11caf6b1f18914d60b785e6ff,48,36,55110,9399,45711,44,35,41359,13946,27413
d7371783d259a679308f41babbb07886,20,22,7691,8245,-554,31,21,15860,3828,12032
e6171f0581fe765f1ed340531b651d7e,32,22,33662,14179,19483,38,27,41398,10443,30955
567fa3ee263accb01c171cd8e23422bd,29,25,23444,8909,14535,35,24,20882,8433,12449
cb6e15133efc9320491b56e7f39f3d19,138,95,317095,84850,232245,131,97,321309,70594,250715
1348dfba237e075d32ba01cf69501643,58,42,96034,20776,75258,73,55,129490,27476,102014
6da2f7a236b7f292b8fb94f8b4d5a2a4,132,97,350618,73365,277253,116,95,289932,54909,235023
14f90e8ee1b0fbaf5bfa84010dc509cd,166,137,500198,67348,432850,134,68,254262,55805,198457
b5e70c56fa677341da905f9daa96f013,174,135,391840,68571,323269,132,101,216298,76956,139342
8791d79621854704ec623f755973ff4b,48,36,58050,23792,34258,49,43,61760,24360,37400
571bd4f1fdd90fbe843eae33f64ffcd9,59,50,85230,22400,62830,51,45,85088,22796,62292
35e3916207e90e0c6761e4a659d830ea,75,71,105119,47179,57940,89,67,136807,36516,100291
9f640835078e13756b678c1e1e456bd2,129,69,211524,49670,161854,87,73,134385,42916,91469
cfc1152573b8f52f178a20daff18b0b8,59,46,56178,20619,35559,95,72,136425,21241,115184
df96b32a3bd23f19189865291e7c6aea,56,43,98437,20541,77896,47,37,56669,14145,42524
0ea51a2ca987a107e43c3b2d2e2df43a,164,124,660417,142119,518298,187,140,607723,136597,471126
d56adf99953993409d5fa5ac09168227,171,133,743895,202684,541211,174,145,943787,296338,647449
8d9a2eab6f32966f39d8b9dc48433b58,66,49,62049,25918,36131,54,47,56397,19760,36637
ad25eb7af7ba7496a7809a713135b408,144,113,450348,75061,375287,132,117,480403,92837,387566
6fddb60953be27a63fba31d5d607e95b,74,61,125817,24064,101753,84,68,116639,28232,88407
2edb64939079fa32bbc11b03993ff20a,112,96,600405,129395,471010,162,98,562879,119328,443551
6d7eb1e7e4bb243f3f1e78ed10c8e8d1,215,140,617742,92554,525188,158,105,366833,117700,249133
a0ae17153f271c495cd2a918b633220b,112,87,225271,54987,170284,95,75,197753,51612,146141
679b8fb11d9b0468f6f2ed560e9e6d60,70,59,88490,28212,60278,77,65,101023,28172,72851
62e0e2c4c04b5ee3f8faaa077b488b87,151,117,340004,54031,285973,143,130,357286,57751,299535
804bcfd53924c171d761dcf580c462ed,90,74,188865,45564,143301,87,57,152907,32653,120254
75170954797819802208b407596a2770,82,72,102282,35994,66288,68,49,108713,27399,81314
d0a7533d74084d19d2e8e2d25450a937,117,86,224893,62190,162703,163,133,344049,65366,278683
8596cb5b38f81e8c172dbfd6f0025878,77,70,153374,59849,93525,116,81,247880,54660,193220
d6c413b29ff90c6132a1f32d8300b5f7,83,63,115861,27805,88056,87,71,118497,39696,78801
01e7939e2dbdd1d1b2f3cafa276769e7,139,104,253387,52601,200786,93,70,179871,50589,129282
74820efef27169e1fb2a1dfda1a268bc,7,7,924,272,652,12,3,1916,82,1834
fe2e5fd7af76a1cae5909d1a4bd6aef9,28,20,24845,11851,12994,27,20,23032,12217,10815
711d5dbe727e3d1e2be42d3007b195a5,45,32,35298,11902,23396,47,41,28863,14954,13909
1d38b62fb5e490e59ff178d6d0cf59cc,70,58,125155,35394,89761,62,40,60573,34113,26460
742ad7f0400618995e0edae09ecb24cc,78,54,94410,27828,66582,66,57,84503,30022,54481
64ae385361a160389b8dba318148e301,193,141,629295,146759,482536,186,117,493575,146098,347477
3b6f5e751e32f5e75a0f316599d54d22,8,3,1651,521,1130,10,6,1505,335,1170
97f4b293e93804e9edfd7e2f4b4f0def,45,33,46356,15417,30939,48,37,50774,18852,31922
923bd07ba9afcb1b01ff6c10be4bc3f4,87,66,202004,40481,161523,85,62,137510,33816,103694
65a1bea5c1019e0fd6cfecbbd7646031,74,63,113204,23926,89278,80,60,90987,27264,63723
89df1335ab9440cb1d788f81747b58e0,40,37,88797,23725,65072,44,35,68797,27821,40976
a7bc95f9ee314dc2ee7d5b86fe6e722e,52,41,104475,24830,79645,56,48,123305,26900,96405
1ebcc8a55813abd833df34a38bb9bc9a,132,86,302836,68281,234555,116,88,331035,91975,239060
66379182f2a8bfc4dbf8c61218b9a3fa,118,99,356588,125628,230960,143,116,443800,83529,360271
a31a9b02162bbe0999f27b263134acc6,149,109,461187,98233,362954,166,113,453623,88734,364889
643a02a68952278313ec20579e8fd0b3,23,19,11106,4123,6983,29,25,16292,5513,10779
2c6f79eb7e7115e15996e2bfb40276d0,114,91,236463,47389,189074,116,86,251024,43603,207421
3e663589575887a6dc0b9a570a7b99e3,131,99,300244,93138,207106,112,108,287160,108878,178282
5cca73c815dd2114a83b1356ea3a1d32,71,63,115180,35925,79255,74,60,110316,31778,78538
182bf15903d9738f246076a9e90241c0,95,75,153785,44780,109005,90,63,185513,49845,135668
d304eefb5f5e523df6f2fb1362475f0d,29,21,19061,3126,15935,20,20,8939,3757,5182
a263cfe4b608c6edd0d12cd1e04cd331,93,79,142726,51199,91527,74,60,118278,33980,84298
8f4ad155a1cea037d6c27f3b57fa3d54,54,35,71564,14166,57398,44,35,40270,18921,21349
50db5b1c707b59f2a6d6bdd37544ad3a,113,84,313175,55878,257297,114,86,216887,52251,164636
1828de0f202d7a001ea1533a1f7ce3fe,31,32,25716,10770,14946,29,25,23128,10335,12793
f5d2e1e939e02f803d6540113edf8311,108,86,268772,51338,217434,106,85,188554,64694,123860
704b4d8e93e4ae4dd9934813ecd8998a,54,56,84977,37927,47050,88,54,101998,30386,71612
d67d9962ccf8454c59240a9be024f918,37,30,32354,8038,24316,35,29,20899,11597,9302
192c2c762a0992bd108c946c54377c39,98,80,176346,47461,128885,113,88,177459,40197,137262
99d222ebb535a4e8bdc6c8f8b98d3a20,65,44,103890,36174,67716,77,62,113735,51404,62331
c5115eac8db2949c0f8ac710829d19e9,113,90,267221,54957,212264,95,66,190198,57408,132790
fdd75023dd06af36ce3505d450cf0143,5,6,785,1207,-422,6,5,1207,785,422
d7d219a656b9d9185d80ee77a05188b7,47,41,33186,11999,21187,40,32,23597,12261,11336
625f4d9f2e441564fbf6e647d540aaff,131,105,270726,51399,219327,124,92,298135,52997,245138
afeb1a8548838bacd764a343e8153f5e,9,10,1400,1217,183,12,9,1781,1746,35
1f35e9288b00ab3e681673559e2d6150,32,25,29861,13183,16678,44,31,33319,8319,25000
475fc47cc64824b586d2fbe3eee63ac8,136,101,394028,72253,321775,150,125,394523,59357,335166
10e8b85c6d97486bc1fe78ab4ab5a420,108,71,225147,35244,189903,99,82,165606,55671,109935
f12c6b371775eac636a1d7937ab53120,10,5,867,294,573,11,6,1074,329,745
ff5e2e5514985fb905216141e34abd66,115,82,245445,45061,200384,101,79,160649,66107,94542
1e72eb48608fa092b58316d3709cc820,112,95,231006,67703,163303,133,102,257230,67665,189565
bedecf25f2bcfbc990da74fa6933f78f,199,118,676014,134461,541553,164,119,613577,124144,489433
0b47ed133a624fc9069706810ceb740a,17,8,2234,709,1525,12,14,2081,1197,884
e2e1f445d70c8113b60a31ce3746beb6,53,42,76160,21871,54289,47,37,65091,19503,45588
26266d8276e9831ce1eebaccb494c324,4,5,232,394,-162,6,3,506,179,327
fc101336013b417da47d3a99038f9a32,104,64,151645,28869,122776,69,64,90275,46335,43940
7c80380ef982800ca85457cbba844238,87,72,111424,35172,76252,73,59,113414,40714,72700
5c644bc942914e76dcedb00f963a39a6,29,24,27478,9951,17527,29,22,29645,10704,18941
0fc1fa347c665ac06e2ef521de8223ff,79,63,95687,32402,63285,69,65,102311,28395,73916
b0fa844742b92a313dec4ec3bc388f4e,121,88,336151,82980,253171,171,141,435748,84948,350800
7feb6df793e46803e55c63430cbde301,27,22,26732,6566,20166,25,19,18355,5342,13013
c50ed32c6d8758d1644ad741c554094a,144,97,457887,106306,351581,161,126,531880,118538,413342
c2425ff339f0716e38661f48dea79c3e,5,5,577,452,125,4,3,456,334,122
150ae5c807d2510bd8854e45d81c8f95,141,117,601499,95740,505759,130,114,342919,105534,237385
fe89877d1959fdbf9e3fc4104cc53358,93,67,99675,30208,69467,74,63,99065,30776,68289
588be12e099954c30343337f58a1b875,98,73,243714,76091,167623,179,126,447622,75624,371998
2890f339f65d0b3f81f55e6183eb3969,156,104,367209,81164,286045,155,134,491129,96091,395038
57bbf84616de2b6293096edaebcf9e95,210,174,1020058,212089,807969,228,149,1139326,135187,1004139
43b7619fac50c27446aeac5a619b544e,176,141,437505,70702,366803,168,135,462939,88680,374259
57fb08be0818b7cc4ef1399820141a0f,193,132,647601,110031,537570,158,122,573526,133974,439552
122f5e4d53c3779f5b7a57e97c1214bf,84,60,145516,33869,111647,101,92,179468,35129,144339
513f8e4a7c3ef2af677f413adfc64590,81,67,65278,19397,45881,54,43,59245,18354,40891
c28263cfabbc10feefd1dc34d3f8e1aa,125,101,356514,109980,246534,161,130,675025,89403,585622
9106daed5673781859413950551bc775,68,60,134780,41765,93015,70,51,95665,31042,64623
5522e95634048e2ed20d3428b8d7786d,45,38,46063,17418,28645,57,47,55185,19241,35944
a079655f92f64076c93876a36874eff0,42,31,40373,9229,31144,35,32,25425,16432,8993
4d4220e15bbcbdd7de2f41066a44f943,68,49,77259,17118,60141,84,75,127400,29459,97941
6d1dfcdcac636b1fd264ac182f7a35a7,28,21,11285,5151,6134,20,21,7882,5792,2090
a46e85fdc245c7d278553d801ce7216b,112,83,221116,40549,180567,111,94,183380,50374,133006
77e395f712f26583567c199dc68d6c38,64,52,174659,77330,97329,127,91,327647,77026,250621
b596fcac18881c5af042da5154813f7c,173,124,564783,142939,421844,160,106,559084,89523,469561
2e32a251589f098c8fb117b79ac8ff9a,178,126,592535,159633,432902,206,151,701017,181634,519383
078bda9631c253904f3a3fde2823010e,96,81,188273,51433,136840,88,64,117826,49343,68483
150881304acd96c91aadd32fec481cf7,73,54,89749,21326,68423,61,51,54983,29393,25590
abcf2da3617275c960a0d89f6150e8d2,148,103,315558,113829,201729,124,93,324686,93983,230703
5fc0ff759a0d63bb1a0c1740bcd6803f,25,18,6441,3594,2847,23,16,10746,3553,7193
325b8ab2051f3bdcf1fa9d7cb9371e96,140,97,410160,84774,325386,187,132,518590,66944,451646
be26fb72bff0783936afc485f74ac475,151,101,285263,59809,225454,146,111,297017,77463,219554
977ec166315cb677d37b40c476126904,89,78,141750,44834,96916,77,60,104521,31517,73004
b400c41030f3f3cc8fbf6c2bb0f38f1f,84,61,110918,29410,81508,55,45,80864,22950,57914
7780d5435b7cf866e65b151a0b4034ef,83,67,155075,28937,126138,73,56,89559,35473,54086
8985ae61bd49b76d04d345f4e7e50476,150,134,432267,101104,331163,158,124,542482,104344,438138
e2c1717fc8ca8786d7de260ee7189b4e,44,40,44626,18846,25780,41,34,33576,17391,16185
5bd844e04310d3336b67e4ec45881444,179,127,452657,77961,374696,124,101,333539,100135,233404
fe7e83f661581df1facecda0cbaf2609,55,48,88264,41145,47119,69,54,111987,41777,70210
0dd6daf5dbbdf54107111b2a86f53756,143,106,456838,108719,348119,169,130,712058,105849,606209
59ada828d5aa22822a616ef82cbb17c9,49,37,41730,15032,26698,41,32,43512,10287,33225
14caa07e2e690032b9c53e5b631caf2b,74,52,87196,17904,69292,80,58,122696,26475,96221
d9f6215e7d3692a4da3f91326d45515d,52,47,80791,33343,47448,58,52,78522,39126,39396
e095f9be98e9623a452a1b50a711f18d,47,37,76004,14464,61540,65,52,71562,25787,45775
36adcf5dbf0905cecb617b8833bdd269,42,34,40665,15090,25575,37,30,40710,14149,26561
946b3a652f265c373809e236999a6498,47,28,44236,10507,33729,41,33,33948,10015,23933
50ec74c449f36a835b4239c71423cb29,84,68,158710,36445,122265,110,47,152381,24118,128263
38ba08011d9fc8187741206e03d91e21,64,43,87301,22662,64639,50,40,62826,20997,41829
d1a923145902284ededb8613a4a5ce55,224,103,863421,148131,715290,209,114,626721,164054,462667
ca4e2b4662f28076298df797ff69042b,54,46,77541,21332,56209,79,74,100701,38213,62488
b50efad349ec33f74b406d566d7fe8d4,159,130,452158,133644,318514,116,102,308340,116282,192058
4c1f2aedac49798306c7eb026f9cfb9c,76,61,135122,54357,80765,71,50,143135,31310,111825
23019a54ded92f0f14eca5a2176ecfdd,144,103,380982,82795,298187,152,113,335155,72373,262782
cdbbe762ab907c7986dc13bee7d4e760,236,190,1165560,245450,920110,196,154,873982,158447,715535
7e0ecfe4b2102dc63e0cc0e658c7ab3a,137,121,263890,68008,195882,115,83,183764,51186,132578
29cfbb11242a204d9a986d4eead657b6,133,75,540838,82173,458665,181,137,681774,112560,569214
91d010b32534ee063c5923ce593c4e99,34,22,20913,7296,13617,31,28,26523,10310,16213
49c3278735bf7866a221d14af9a4d9e6,43,32,31787,8201,23586,29,22,21509,7481,14028
be859170d99b76fc06c544ac757ffe3d,112,84,231867,71788,160079,98,67,209358,94425,114933
33eec8a4ce35ebad91be3ee5f1ce1393,91,68,293760,115244,178516,141,117,433482,104807,328675
428b7bb38d7c50aaecaf2f3cb5dc12fc,93,80,161058,68928,92130,123,91,252877,75201,177676
859c1fe248170554cf440e75c2e045d2,26,20,11085,5491,5594,26,17,10591,4035,6556
355be66d9862b86c9c7ec927a87d0c6f,36,22,21753,11388,10365,37,30,36950,9530,27420
64c1bf373b6867e025ba3f923b115847,62,55,94743,35907,58836,86,77,128979,37502,91477
3e36c600ba5f3653ba7718035960fbc4,47,35,43103,19899,23204,53,40,62504,18529,43975
9348d96893b4b603b70b59f53bf5ee81,164,120,457990,88282,369708,149,125,438953,96348,342605
c1844d8a35ab14f0fe43edb20d145f53,117,86,140246,61568,78678,108,65,147342,42539,104803
63511c60828e22dc7e4c3c73949c9e93,53,37,55844,24741,31103,43,38,55880,19829,36051
d0e52c09291109c7fcdf4967e5e6efa4,21,15,7863,3648,4215,15,18,7868,3800,4068
bce929083af550aa8441adfc97007470,91,73,181599,67334,114265,99,76,229490,48398,181092
aaa40a96eeef523ec2e23d1c5cd2b9d1,173,130,422193,70240,351953,149,104,341039,52132,288907
640c893b13e4f163c558fe18f1aa82d9,139,117,366564,62363,304201,121,83,282186,71598,210588
f0dff54cb3f35c1e8106833496dc7de3,34,23,8548,4833,3715,29,26,13829,4219,9610
c8a21ce6938da17458d289607676e17e,102,80,169903,61112,108791,137,111,389089,79155,309934
98c1a87fae55605ab0e0cd544801c75d,117,97,216907,37611,179296,91,81,151076,34285,116791
dad7559b4ef1bf24fc6586385dc1a325,107,81,187526,48959,138567,124,109,256802,59118,197684
4f80b39d2c27ac1de317295eea0d4dd2,50,36,55538,15244,40294,47,34,45162,18810,26352
88da6cee330afdaa6f3664a29133c8d6,68,62,61277,32256,29021,61,54,71662,18197,53465
e0cba546233aca0ba017d4610ca99bfa,95,77,221625,68558,153067,149,119,316228,106376,209852
3fc523125f0a730f164bdd20d606fa3b,57,53,59428,33171,26257,64,45,80332,23304,57028
78811a9a33ce0fa166277fc9bc169e5c,58,52,108294,69440,38854,82,71,224414,57894,166520
dbb86c17f9aff488b10342d142a70bf8,137,96,306468,49383,257085,120,96,334002,51524,282478
b5178bb1f3ca90a019a75c3fefcf25eb,120,85,245446,33187,212259,96,77,164443,28799,135644
41b4cf93ce322e5e3e002864e2b6dde7,124,99,447792,74832,372960,92,63,164037,67864,96173
2a568bc1fdbf70b89ecf42fc07f1f59a,90,74,125971,41133,84838,81,62,137155,27377,109778
e326f37cce41b8dfeacf0fffaf8abb8f,16,17,8401,3763,4638,21,19,5551,3270,2281
a6d50117f9681faab4579c0544face3d,53,37,83503,19549,63954,67,53,87474,22660,64814
d697a48d98d4a345bed3d967c3562278,152,121,575107,109698,465409,153,103,459670,80895,378775
e4685b99880eddab5ed685bf26bc4014,73,62,96972,40200,56772,79,59,140481,29286,111195
fccbbf77012d262feac575c83a57add7,36,33,42411,12951,29460,31,23,23953,17997,5956
4a1588f1e251a4d6b1a1cfe3784a133f,148,108,305487,72892,232595,157,109,352880,75179,277701
4177822ddceac132fd13f08f73c5aed3,136,115,313315,62426,250889,142,119,370608,75475,295133
c18c44e2c300ac9e36ee71b8dbb06ea2,26,24,6694,5178,1516,26,26,14344,4375,9969
f8fabbcde506cb5874cf6d229f76e912,113,88,259177,56798,202379,94,81,215725,57026,158699
6cee398b120fad8f53c1ba31ae807caf,87,55,179232,52962,126270,98,72,181530,41351,140179
53faa020625c782f83cd4401d07a4be7,79,64,120723,38363,82360,112,92,191856,36232,155624
f631b1642f1a70f0ebfd6c46e5e15106,163,88,298400,93452,204948,163,111,425395,103260,322135
d669a82c93ca71d2985ce5dc89a92997,58,48,105457,33775,71682,73,49,76122,41097,35025
df4cc94d257f7ef3d56eb79f62cad60d,78,54,96846,28038,68808,76,63,83832,31438,52394
dbc2c3ab002735075e2dc936e4eafa3f,4,5,919,716,203,6,5,800,1003,-203
5b95f7653e04d2ef64ea1f96bcf922e3,66,49,80229,20897,59332,62,54,91850,26579,65271
c811717153936c1f02214ae20ad2ad77,94,76,148465,28365,120100,74,59,108212,26274,81938
d0da099845d53295d4b524e7d9c9b361,162,107,607188,82984,524204,155,130,518559,141225,377334
4153990244cbb1f97d2bbbfaafb4b48d,26,18,7968,4088,3880,27,20,11650,4358,7292
ac384d12568504616537cd78592dd844,35,33,26828,6438,20390,40,27,16943,6137,10806
4c078387592d4223e889f3697dbbbbe4,44,32,34060,9608,24452,39,30,26499,11667,14832
5d31b11de38271a1723fa12924efe315,136,107,402256,100412,301844,145,107,380708,91309,289399
85f84b17af38d269e7d0de340be1de12,121,89,275540,64638,210902,120,100,290697,78234,212463
2961b797225a0b07bee24e75536799d7,51,45,57608,25273,32335,47,32,50078,22996,27082
0ac6222dc8435c5278291e8d93730c96,25,23,7459,3620,3839,24,23,7111,3772,3339
146e442f0627879a185058d098e4371b,111,92,425506,111370,314136,169,154,564091,103913,460178
dffc3e194bafd1d78ca546ad8011d1d0,22,25,16163,9649,6514,33,27,20963,9857,11106
1a7198b2f2dba020988f875e3ed71144,42,36,38998,11787,27211,47,40,58122,15747,42375
b56d704d64fcb95edb56d1c47e5d9e19,133,101,282360,41346,241014,124,104,236223,48018,188205
a9ab3609c3d6578562b2520f283dadab,137,108,370875,59608,311267,109,82,190176,59467,130709
2e4ba019bdaa69ca4510d64cc515f51f,41,31,22338,11190,11148,33,24,37585,8031,29554
8288058727899f984454905409bb1838,39,30,36894,10754,26140,50,31,54754,11448,43306
988f34ded17deb7b1eff9352dc3f60ca,92,78,180372,50325,130047,103,81,155314,50493,104821
4461477c0fcccc44d9acf57132f6e534,50,33,96180,22478,73702,69,49,98981,27476,71505
41044f981d2aa9354355c3f430b2a740,209,140,866518,146376,720142,176,125,770141,202468,567673
6091fdc8d258016125aed26d4061b3d2,121,99,299702,62038,237664,119,109,311006,62289,248717
f1ce119263320aaea6431c3743dc9c8f,61,49,57680,19435,38245,43,31,35447,10357,25090
74d489503f6d5d6451dcd0d62bf555e5,42,33,46290,12684,33606,46,38,30776,13015,17761
d9ad9eaf07b5a6a2834fd5ebde3e2654,119,89,299709,71859,227850,150,134,430862,87306,343556
2208003e3e06f9049cf8a592694cc098,139,121,324797,69744,255053,118,101,256234,72350,183884
d77ed2fe81ad2b820ce1168b7e399a1c,109,78,261388,44178,217210,142,106,245526,40094,205432
52cc79fe3d65cfba1a7044e62cbc9d13,164,116,276628,56671,219957,124,106,269461,48962,220499
228360704330f79a2f2b2571c8af6909,37,25,21549,11345,10204,39,29,38381,6994,31387
111aae820eba6dab7bb98852baea35f2,40,32,66139,17197,48942,51,48,76870,25814,51056
4fc6dbc7a1d5906e117b02e6270342ea,130,101,357478,82763,274715,123,88,265691,83922,181769
ec47d886b6a0a033c80c556eba48922a,121,92,309064,54727,254337,145,122,335988,65570,270418
94f0aa9d6dceb2fed208af8f85bad170,58,53,87468,27919,59549,86,51,104436,26955,77481
81e26119ba2d93a65e4316cc1c1a48c6,37,28,14843,9117,5726,38,30,36228,7556,28672
2e69e53f33ace3b9e7adf9670b753e0e,170,108,406361,67963,338398,107,79,235590,72790,162800
2ccb021ecf071a7f944fdc91dc55f6f3,155,141,580829,237769,343060,197,138,746096,156683,589413
b265be461036b4b00c19c29dd0a522b2,79,70,140788,41683,99105,64,56,128401,41134,87267
e7372409a0e0768759090300f2b6ead8,24,17,9332,3549,5783,24,21,7949,4294,3655
ef10ffd25335c4e21d03a72ba3ac0d2b,135,113,384174,69330,314844,113,83,319938,86611,233327
aa253df372e291d0d52a3938ad01500f,27,25,21539,9683,11856,40,27,29776,9860,19916
3de79d1659bf7945cf752a46bda8ef77,34,24,22170,9310,12860,34,30,23620,9646,13974
43b29f382cf4691aedb2dff2122387aa,43,35,49094,12293,36801,50,32,37015,17880,19135
d00ed168d0e6ac222b255c8db77f8269,32,25,22657,12315,10342,50,32,40255,11064,29191
7c79a2a484f2eba8eee2005dbf348a70,67,54,145508,38014,107494,76,73,119129,50127,69002
f3303608287ca703f1845667518af816,19,19,7677,3597,4080,20,17,6533,4582,1951
e694c3fc9541b201f78462dce0e9a543,148,125,291681,64245,227436,135,85,249793,53107,196686
7425e614fac76ca2150f17daa433d7f0,167,135,421315,119526,301789,176,131,592568,109223,483345
fa9a11ce51a2f485e361f5cad4f2a80d,49,37,54825,12293,42532,39,28,40299,12988,27311
889c15c6112fa2c6514b890e7944df1b,34,22,17005,4938,12067,26,26,15673,6838,8835
3ee3bf69f07400474d56ed7db1600ccb,104,87,251702,87862,163840,132,111,288423,95476,192947
412d14890db654500296e517ba6cebcf,21,20,10762,6418,4344,27,19,12738,5287,7451
091b3eb04050f9873087f48b167bcdc3,46,35,35617,12621,22996,52,40,54972,9988,44984
efdd7e41dd0a6feb9ff8c428c4490f97,68,50,46567,15900,30667,50,49,42434,15636,26798
2f8e2c87a3059fd0df0f7750cda6304f,22,15,6079,1919,4160,19,19,6508,3974,2534
852d108e7b6e1f2e3a9d20de6f632449,40,33,55351,13686,41665,38,28,47063,21425,25638
ef7053a2a4487eff5499bf389112e7d3,35,29,24661,15245,9416,48,32,38719,13393,25326
82a05b532f614e7f145360261af97c98,40,40,47195,18869,28326,46,31,35776,16419,19357
7c48e1cd1c5d3e2e7bb24c5b7ee99c51,44,28,48981,16610,32371,38,28,34025,13830,20195
3aff8896aaa0d5a06192bc057a0b1830,50,44,59997,17130,42867,41,31,33801,12621,21180
dfcc8b4fb146d5eac429114397984393,119,95,295924,70329,225595,162,122,429981,63506,366475
12865513853cd807d2a399b66d692584,73,39,100522,20580,79942,79,44,107073,23086,83987
eb831bfa06c7271d04d4952c517378fd,114,89,220502,34348,186154,96,82,154452,47832,106620
e9b7d7da7d9ebdbe2ed6773a03933a0d,74,68,154401,51609,102792,66,58,131166,53360,77806
751cdf16eb349525150878d31bdca9a8,58,49,102701,28878,73823,80,71,103207,27595,75612
530d94c4ae10de3d0731d497c8d57ad7,52,35,73571,20274,53297,58,55,66868,23054,43814
a99e1d1a26e4e7344ba14cdb203fa9ff,85,63,117665,31001,86664,82,68,106642,41951,64691
0dcd53afae1754d3dccc1125ddfba4ef,71,55,82314,31545,50769,65,50,91130,26331,64799
ff4fa740e8af7da3262a7c46479cd502,139,102,381396,62330,319066,132,113,273072,98233,174839
443df6f304d56ee466242e7cd9f4c1fd,107,69,208063,52197,155866,126,80,291658,51670,239988
ff5156d1918a29591668e8be07fd67ac,125,79,295993,48506,247487,140,126,411153,109669,301484
19a731d220d7ff5e69e943db84847a6e,29,25,19554,6557,12997,27,26,14602,7167,7435
5fff1b8bf067e56eff1f0ac459826a96,85,77,100091,28890,71201,74,64,116211,26607,89604
5d57d37528baec7ac5db71411e386fab,127,111,268109,51775,216334,107,80,181855,38667,143188
663e84eb6ef08da84f68c736042e7f89,146,119,421718,87510,334208,114,100,287855,106235,181620
f76d6fc32fc0542f10719f35b0dc3864,45,37,35862,13715,22147,43,28,30809,6178,24631
4719efd673882c23a9d47d086d08e884,110,94,333697,104291,229406,146,113,468253,94132,374121
9c3e11d1092b1d7fa780e027fe1ad073,50,38,42807,14324,28483,45,37,48556,14787,33769
a05f1a6e087ae3b25c229f3a60857cb3,207,159,1388575,223629,1164946,241,182,1361880,205542,1156338
30778825fc31ceff5edae448ccf149fa,45,36,71739,21143,50596,76,66,97272,24017,73255
eb3f7c67dbf7637ad108f6907ea4498d,212,139,1086338,124441,961897,214,140,1059781,144296,915485
937e90aef63371d7c52b76909a835954,194,116,768374,140956,627418,175,107,589970,130627,459343
3214a787c8033ad3c481a4074e0766cb,53,38,48952,11925,37027,48,43,57115,20709,36406
b1edc7ed6d7dfee514d9df2d9ac0f5e7,50,33,51609,16180,35429,50,39,46228,18623,27605
e597e9d6abc78d369bf7e66e824c7abb,43,30,49552,14446,35106,36,30,34231,16803,17428
8beb66dd1c42ad20c1242883686de975,82,52,105165,30499,74666,80,71,124892,39154,85738
44dd55c8b94178a64141b9d69d16b924,29,24,16912,8492,8420,32,23,27571,5600,21971
84801dfea5e7d1a2bdf0cda8bb715e01,93,80,139158,37283,101875,81,63,91758,33585,58173
527885f5838de1bca01d81da38e7f830,39,30,25351,10431,14920,35,36,17608,10304,7304
79f4e65be26b1c14617c8de51229bb99,167,116,710233,130766,579467,153,107,627264,154105,473159
e2e87c80fed13407588daaf6516052ab,82,64,122762,35012,87750,56,41,86572,30424,56148
8c5d2d565cdc7779f579f7284b644509,161,131,397537,89043,308494,107,92,247118,86349,160769
a666767e689ac87160c964f2d9c816bb,209,163,1429114,215630,1213484,226,158,1125182,240132,885050
5fdb2c8193dd1781917b9cc0ffdb2443,20,16,9921,3245,6676,24,18,13154,5770,7384
9906ab41271d3127715c2db5986a4fbb,93,68,142676,31415,111261,94,73,145021,43465,101556
4f526090993ed36e94ee74f7e4abf4dc,67,48,109271,36132,73139,51,37,77488,27964,49524
6743cd8c4ebc6716f935c9b0fc7e49e8,120,95,286203,45758,240445,131,91,265460,46135,219325
39440ad22e94b06e38ddc39b9a22d549,167,116,523377,104108,419269,181,141,438287,67882,370405
06dd7e58b2e9d2693e1e91d16801c2a3,173,133,706598,132230,574368,174,137,734845,109015,625830
f2febe99d41dd0da597a1b42c7de03bc,92,59,128100,24769,103331,94,68,106472,32155,74317
4723a0b24ddcc7de7e202f1b505278bd,27,18,12795,2539,10256,28,26,10274,5172,5102
cd5a591dfb23693a870e420cd5bfff2c,70,53,102513,26318,76195,82,59,106016,27383,78633
456cc61b275790a8b56cd2d9d3924147,143,104,324687,69299,255388,149,122,366865,92061,274804
f16dd3353d4e8237fd1e9f5d56595bea,136,100,407736,122707,285029,160,120,440283,123894,316389
b7c9d0df31a6e4e232dce53d448f2e4b,163,126,795125,160220,634905,177,123,699397,149729,549668
5d620e830ee2602490ff2f04ffb6314d,29,20,17724,9961,7763,30,27,22013,9025,12988
2c6042ef571958390e2331658ae8e15c,224,119,544389,125435,418954,211,160,863986,191046,672940
a45ae232f74dade34aa64ca715f31802,81,72,143461,43083,100378,85,61,120329,42907,77422
733154e86ab57c35c4514980502ec1f9,50,38,76775,43034,33741,59,47,124684,33486,91198
9fe113063baf98d6a66a124d287ddcf1,70,60,107511,22897,84614,54,36,116279,16017,100262
a374ed43ed6ac6d79c41a58ced918791,24,16,12381,3831,8550,19,16,8052,4902,3150
9673e08ce694d12dea130009f1fddde5,99,68,193429,58076,135353,163,116,371875,41696,330179
af0ed073dc8d1786eaaaabf00356b95e,98,72,133807,34685,99122,79,60,111630,32391,79239
026b034660d1bc1ceddda4b5b5c2e7ad,21,15,3560,1683,1877,19,15,3544,1248,2296
a911a05aeabb953fe90e171c34c3410f,65,41,56841,17339,39502,73,64,88293,28225,60068
4f622d36eddf4b9f5cc734eda9efc44d,1,2,76,295,-219,2,1,295,76,219
63775f2edd394f3a7cfe69f0e0aaa57a,63,52,79862,24332,55530,62,51,70349,23715,46634
d5133dbbf632fc49158e5046bea42cce,164,110,422899,129768,293131,190,133,626380,89708,536672
702cf88052f2f4200860da63f46b14f1,1,1,151,86,65,1,1,86,151,-65
caa757d324b137249268ad585e8645b7,190,124,543201,119946,423255,200,117,711295,139671,571624
3ec1244222234d9012971837b0c496c3,46,37,47647,11896,35751,40,29,31545,15122,16423
1d64c3001052710dc8edfe7a64fe2848,36,30,28992,9339,19653,34,28,25188,10981,14207
e5af94360a2b8c61017c704503ebb552,177,111,488894,107640,381254,187,128,726605,112858,613747
a4667d8ff5a7842ba476fd39be897599,37,32,40270,18155,22115,38,31,30974,11587,19387
86b33570aa73795ed59c2aac748807a3,82,69,138720,28353,110367,84,75,100955,28096,72859
08a85879500ff3225a5a424b2af75d0a,132,101,500921,136778,364143,180,135,671799,165738,506061
9b8a660d455b770e3e554e7fb67e1e28,31,20,20985,5788,15197,21,24,14166,8111,6055
813fd737d850280c7e3b8a72bca263eb,80,51,111465,38391,73074,106,76,190257,29027,161230
2b04f3569f834f2ae5ba789b7fb7797a,133,90,279358,66990,212368,151,120,312819,55648,257171
4f51ad15e7eb95014ee2292aae2fdfd6,100,85,217887,66086,151801,98,71,217981,61290,156691
b2a5af6fd440ceae48b754b878a41858,63,55,105189,39621,65568,82,69,147387,34041,113346
86ecbc565fd77ca7e6c294afbd5cadc8,113,88,228350,39972,188378,112,91,164055,37795,126260
99ebcc766ccce6372e56d3cfac6e1531,94,77,280682,45669,235013,140,119,439188,61399,377789
3ff922dbab483ed25874cb3f6159d06c,184,150,622700,139396,483304,127,101,327802,104580,223222
645140a1cf3a0ef2e09996ffc603d2d4,135,89,515916,108650,407266,174,110,526110,122347,403763
a77c4d910a771bd41fade30752be8237,114,99,282988,57153,225835,86,71,188694,63292,125402
4ff42006cf8d7512d63d4b100645ecec,64,52,86766,30601,56165,68,46,110376,16776,93600
020ae81b8d828e38a7c4eb6f9b5892be,136,96,355454,82585,272869,151,124,491774,92268,399506
ca61ade80c3b4eacf177a15787ec29a9,146,103,424675,118800,305875,177,138,499071,124192,374879
1b8402901f2637ae31ffe1e62a8a2038,70,51,122614,26982,95632,87,80,136198,42661,93537
15730e3a39b147d5955517a27b9ed597,84,76,133048,31807,101241,68,56,95498,31380,64118
c8ed372218d4a5be0250b0b63030b518,36,26,28295,8273,20022,35,27,20155,12417,7738
353252ca7a7306dc26f9496d7f29d0cb,106,76,227917,48888,179029,80,73,164438,74390,90048
316286cf42523387c42aa5d172a3a942,63,50,97752,26003,71749,48,38,74626,22332,52294
a734c73af92f510503d43217e3056350,164,113,582259,113615,468644,191,150,908397,145224,763173
1a2ccc3b91009987be1ae8089d519326,78,58,114526,41159,73367,73,50,107287,39031,68256
2c10591ef4a61801a1fa1ac3dba2432c,208,135,1037862,134318,903544,201,159,1177020,129039,1047981
fb4096975819b521476f98a01c946830,34,34,26789,9356,17433,32,27,18746,11460,7286
8a932411fcf0ceb2b0ddffd2bab08f67,19,14,8952,1322,7630,16,11,4932,1853,3079
abe815d6ccd9b3c0175e5c4a7f89126f,81,61,156694,28172,128522,107,89,146445,45885,100560
69d34f5486d648e4b96c62491bfb4e5f,76,70,135793,35566,100227,101,80,203170,37920,165250
31dc197bac936c06a5a3970a1d41fdcb,187,147,617808,143095,474713,154,97,403144,126374,276770
98e1f3ef966e5eb7ae03b904dc827c9f,177,95,876486,191654,684832,189,120,1076720,135607,941113
eea91aba56afdf180ed5c666faae08d6,133,105,360307,92965,267342,160,133,412249,85909,326340
c4e9e90c309e0d08034b7db6155e4769,70,58,171855,58192,113663,96,61,168611,44569,124042
a6ae0dea224ff94cbbb8a7b294572c08,215,157,902090,124552,777538,172,123,795332,92423,702909
f8027bd4eed98d16862d668079761d60,89,69,124557,39531,85026,75,57,139693,31581,108112
635678d04f623f1a284db664ecdf163b,46,39,63311,20110,43201,62,47,65791,20635,45156
e8a3eee3806669021901b29032fe15ce,151,114,636194,102094,534100,151,124,663592,116593,546999
6c39bb7cc702f990200c84bd7b60f5ea,107,74,166921,49282,117639,80,71,148109,42829,105280
3669634cc8b182b141d8d9fae09d3b7e,54,43,72016,21737,50279,50,36,66077,21651,44426
3b7d0c6383ebdb4048257c289b1ef4e1,73,51,114311,23235,91076,69,49,112242,23091,89151
1328e1ac91f175cd522f68f13830934d,58,43,70966,42684,28282,115,87,266514,43809,222705
4d131836015e57fdd1a434ee8af868d7,63,45,81269,22064,59205,69,56,86844,27353,59491
6e9294169cce962ed8812fd7af61ded1,60,48,66587,27835,38752,82,64,122382,29977,92405
94066021e3d0507d173efd18b45ccc47,91,75,119510,34356,85154,92,67,140863,29015,111848
d007c37ffa730bca9f184161a7146bf1,57,43,54697,31266,23431,55,49,79100,24332,54768
c586633b77235d167402f9aa3c441d42,222,131,1049357,198227,851130,181,130,983137,207196,775941
13bcc703a68c6792488ba206fe3b54f0,88,71,174446,34951,139495,79,55,134721,32085,102636
44f23cfb78961aef70a0ca30bf99bd4b,31,32,45445,11489,33956,35,24,24639,7986,16653
1fd0f7d873bedf16e1289da3cbabf645,53,36,43439,15802,27637,64,42,70055,15902,54153
41f082233383e4cacdc9b45520ad2a78,12,11,1822,1896,-74,14,13,2269,1195,1074
734f645462893d04eb6724eadc04b3ef,61,44,135937,37495,98442,60,49,130982,32610,98372
01fe14ca63e2afc3ecbae23805bc353e,66,57,78893,23650,55243,70,49,90064,19724,70340
ee13bef7634fd4742c8bfdb0ec49ae0e,51,38,66412,16026,50386,41,34,43939,23492,20447
4bbbccc8f7c36c0d7b93c3a775c327ab,98,80,184217,64800,119417,151,97,226339,52371,173968
f30d20a4caeb8b615821e1e50f7b0765,161,94,353140,33507,319633,118,86,375407,53930,321477
dbdfb6db532e2578408a84a06c0a3e81,4,0,700,0,700,1,2,44,356,-312
21ed39645ce869724d09301e14ccc603,2,3,131,316,-185,3,2,316,131,185
709ffc61f216d3de4a516be49322c7a2,56,41,75757,16861,58896,44,36,61590,12764,48826
607b6785ebd831751f71b984399366f5,163,92,308739,60473,248266,132,97,249940,75777,174163
5692db04064551dad221248bd7516845,134,82,333424,85795,247629,167,126,494246,86094,408152
586900c8709f61b07b8a7698ac7319a4,49,40,71524,26925,44599,46,31,39604,19642,19962
7b06fe3080a62edc733ad1e0a3719ecb,160,139,684273,139556,544717,181,138,660815,96244,564571
ea880cc6ba6fb49cb937a5571a1aec82,70,42,81065,15748,65317,42,31,55488,20461,35027
fe594630554d388fd633ea479f288da4,92,73,215358,72133,143225,103,71,230184,87564,142620
5c74256c6f5980c074bb21175b42d91d,100,77,152668,43404,109264,90,73,129279,52939,76340
d7bca77d434907ebff0a868fa13cd4c1,27,21,20786,6664,14122,31,24,14780,6198,8582
655061211a303c5ff1d05184f8e308f3,24,24,18643,8755,9888,27,23,18085,7557,10528
1ed212b4b044688dea6cbe0efd7e2654,7,6,1357,1560,-203,7,8,1673,1642,31
fc9e18470f0ba9aedb0d875ed9ffdb5e,64,51,70061,18497,51564,51,42,42552,16433,26119
0b3c280dfe2fcae3ada3183006cb3985,160,127,479289,78725,400564,150,122,425869,63262,362607
e73a651a57a51e1e88f3a08da15ba393,25,21,14318,3279,11039,24,20,12738,5102,7636
d1354175b08a58c9f9abc6ef0b862cba,72,42,92325,27688,64637,98,70,122873,28786,94087
6213c331a18cbb97ae6e01926aa1ade5,129,92,501843,111366,390477,146,115,502304,124458,377846
df47a7c4502e936378cc9e7755d87d67,129,107,302235,65223,237012,102,98,266360,58528,207832
61b4ccf52a0d200dfbbb85ae6d986c6c,197,147,1122678,176503,946175,181,128,923417,175465,747952
d024b9ba3e35b24352ba12f905b6a1ef,137,96,301267,86377,214890,87,61,243886,73809,170077
d328f70facd583f895cc8cc58f944964,136,98,314712,72373,242339,132,99,276042,68984,207058
4fee7d7614a6bd95a2bcc20ffe055316,31,23,45819,16873,28946,46,30,77344,18894,58450
db2f2d2ce80e502a13ab3b0d569970b7,137,118,432087,154592,277495,188,120,430872,103074,327798
4a02f97475873ede01346be9a1733262,243,156,879118,241955,637163,181,103,1037927,136280,901647
c9a1b37227b332f0cf2d980972c4ce99,49,46,75444,24482,50962,40,28,52399,22336,30063
61048f4d4c9f90ff6f5d3811acaeb827,179,143,948170,97458,850712,202,160,1299002,143492,1155510
5e55da483dbed943344387668719d3d6,40,33,32716,10702,22014,26,18,22915,7164,15751
aea4ac09c7d407d76a9a2de74cc428dc,6,4,1202,217,985,3,5,304,846,-542
ad1de372530b8a871080024f4ef5d462,120,97,273569,56562,217007,122,110,264493,78065,186428
3cb18435f03faab19f9d14d15a764950,120,97,393870,122745,271125,126,101,397003,112354,284649
08294fb69a4f6d9142809c47717f5681,158,111,520052,72612,447440,157,130,386341,89345,296996
580da58a4037d4bf0fa203538ca9e6f6,146,111,1035192,177664,857528,173,130,923490,117483,806007
f4497d3c15464eb49a3de8febf8412fe,93,71,173234,42129,131105,73,68,119537,58063,61474
e5d85d7836675284821e443f1ba3cc93,24,20,11514,4181,7333,27,23,11642,6259,5383
26ff4ff91808c5e277b7fed0effbddbe,106,91,229024,36990,192034,101,69,165176,33290,131886
8fe94ab2408e0b17dac1641169bcb4ee,91,82,197155,57581,139574,81,65,231660,46436,185224
1d70e5058a573e8ef58102da9bbcdc6f,42,40,62689,30139,32550,62,48,93497,17815,75682
556063b95031d9df50ce52c05353a40f,69,57,110662,34562,76100,73,60,135741,31632,104109
b8d7419910c602800a88ccc4b30ddbe8,85,66,206275,73401,132874,121,90,279998,87470,192528
9e63329294fa57250c8f62ff8a93f0d0,81,62,110325,36142,74183,81,58,105321,35299,70022
f5bea60250e7a392a0772359e413abb5,186,127,453712,110384,343328,144,118,497752,113084,384668
784ac4626686d7a44603b154dd918697,119,70,195980,41672,154308,110,85,173523,42936,130587
fbed97cfd8063fd821d395c2b905ea22,108,86,292049,70173,221876,168,129,514108,101960,412148
f0aabe36c09c987073f3cc77e53b1163,62,53,69109,28977,40132,54,37,68834,17242,51592
bea8addeb3df2b3db70bfaf82572d316,32,24,25858,10501,15357,32,22,36174,10149,26025
37d2404fca972213e49fb211c89cd969,52,35,54350,17187,37163,53,49,80843,27880,52963
ba412c877443291994d89a67e83fb252,149,107,369889,87379,282510,142,112,455895,82633,373262
bea87f41ba616a5fd307e4b0e7325def,90,60,107279,32626,74653,80,55,139838,26422,113416
f83fd136f24d87d19b01f913ba35c48b,13,14,2107,893,1214,15,9,2397,1062,1335
e135adb4be7732d26f0389dd470f327a,104,75,297986,82503,215483,146,104,318094,76196,241898
576b1f602dd8facd458959fc1113eef6,107,79,223400,83976,139424,111,98,273233,91035,182198
d3b1c8ef8054a153432fe2a84e1e54ca,117,94,176593,60164,116429,103,81,162834,43290,119544
dfa74cebb27a62a0846453b0ff528e60,151,94,264063,61621,202442,111,89,254590,68875,185715
0a7b3840834de3fb4f1c95592476196f,80,69,129957,33725,96232,78,72,144093,39869,104224
89626588b3d46b473c3c0b455280cf1b,114,77,216820,30858,185962,84,69,168556,54841,113715
33daedaa4a09cdd9b9ad1d4e229f64fb,69,67,115785,35758,80027,100,60,122160,34511,87649
4fb79f6c7fd259b9d28867aae5b3dba1,32,26,17909,7435,10474,25,21,10732,4709,6023
a5ef1c1b5a2e25143ff2bbcd97d3082a,161,89,250539,71035,179504,168,101,360382,58911,301471
719b20f5ee0261de694c88cf609bda27,26,23,14082,6836,7246,33,23,21812,5445,16367
b13f68c9f8134b032a770606c4751878,41,33,38939,20668,18271,52,39,71288,15514,55774
d17aacdad3eea079ecd1e292230decd9,40,37,67127,21427,45700,58,41,77947,21206,56741
772f663ff31e146d4c451d4b4edd8dcc,38,28,38684,14061,24623,46,28,37919,11097,26822
536c4eb6ed5fe9a8db82bb38a9f89baf,141,98,430397,68531,361866,108,87,320896,87589,233307
8d5ab828c14bb3f415bbe5f50aa8d484,162,139,665030,121161,543869,176,108,611735,93211,518524
499eb12c442bdb574aa881eb7d9301af,135,105,456896,70353,386543,121,96,384336,82063,302273
2043fe1b7e7bf301d3b8b67bcea3c4e0,23,19,20655,7476,13179,26,18,19233,7107,12126
0fa9aa79d6e304459b8a4b03ee8e3d84,187,147,891882,165364,726518,202,162,938885,273379,665506
a45df208e5805ee32344d47c87f90403,54,41,56951,14417,42534,49,35,71937,14956,56981
97dfdee45558e8d6935b9aabb6a40367,203,147,768303,111089,657214,220,164,852264,90306,761958
099c07b6e6ab6dbcefb15e6fd286298a,195,152,766780,190062,576718,220,137,855658,157362,698296
665e2b514aa6d12bd974699226e5dc9f,50,44,47368,17088,30280,43,47,56733,20931,35802
de0cc36f39773353ebf4af81088f064b,192,145,597084,97435,499649,142,113,481469,86127,395342
fcc1a5ac7532c558224f29d5b710ee42,24,18,10862,4400,6462,23,17,14082,4723,9359
e58d08c1ab960b132de86883e7c157bb,105,99,222893,37679,185214,124,91,246164,46363,199801
ef8d4278cccc960a48ba8726b2a8f007,38,32,23813,13022,10791,40,32,30216,9565,20651
e4503722628b2941325c575e9763e668,24,20,7357,3380,3977,19,17,7308,4204,3104
257bec75300503247b46ecd14a45bcf0,91,78,410436,154198,256238,172,128,638266,150436,487830
b887cc4a8b1ecf0d0cd378358f589d73,114,83,237323,53053,184270,100,73,155202,49763,105439
ff551c213113960f86d78416de7e10e7,0,1,0,162,-162,1,0,162,0,162
558cffd98e6183e7308b84e70ae8df0e,22,21,17636,10219,7417,27,22,24358,11490,12868
3dd3dec77529620ab400ae8aa9a67a7e,46,28,43786,10774,33012,41,34,43830,12332,31498
f596d3afb3bed65b167adabafaa24dc6,170,133,917067,170136,746931,165,127,1004902,221605,783297
c8df8f1f0e194703425ced26bbd14575,156,113,417472,83616,333856,134,112,375364,82559,292805
8a6521ea3b1564f8761c7dbffd6664ed,214,168,682711,119646,563065,174,132,524900,119013,405887
1fe18bcaec22915e8aad583bbf029313,114,87,152262,50852,101410,128,86,187668,41567,146101
da8e5245f86de20d653fe2b35d9451e6,127,93,407919,118234,289685,106,94,415216,149905,265311
414f329ee4aa6c23231a0d48351e79b9,34,27,35842,11807,24035,37,29,29491,13976,15515
3a30aee337b30c6a0a0cc0b9370128c9,5,3,641,201,440,6,2,428,216,212
2a425bd97ecd7ebed2596482e6e579bd,144,95,281712,68004,213708,142,119,281612,80544,201068
e15746eed48de67cfb5d0c62025eb764,21,15,4030,1367,2663,18,13,6211,1573,4638
1bb6bb5aa96af8a3d72b9cf19f64c7c6,122,88,327890,53756,274134,92,58,166351,48443,117908
0999747ffa7c3207972492d0eba32f41,116,109,231996,47872,184124,83,74,118392,36426,81966
e5b7217bdba37ae79e6593f952f91924,39,29,45736,19686,26050,38,31,48759,20858,27901
ca18de9ea0ca3db2944aa234f98bf4a5,106,93,202832,45130,157702,105,81,224772,56677,168095
ca495585b6ca2bc3fb2cceffdb94a8b5,48,35,64774,21847,42927,55,51,93825,28518,65307
cc0f34ad6deba9edcebef03416c3b3e0,21,20,6640,3375,3265,20,17,8782,4084,4698
c9ffaeaf6720c297f92fc83b20bf6916,72,51,104169,27141,77028,63,47,96431,17274,79157
7528b3ec718b0c993e469dd432dfe760,130,102,399655,89611,310044,98,80,247644,97580,150064
2d5e5be27d96aa5906c2532f454e4415,89,58,136890,25386,111504,94,87,155201,42586,112615
caedbc5605595e12f2d04e203652334a,62,48,62670,23397,39273,56,43,57612,14001,43611
d02b9a98532fb08e5ed3ddf4ac124c72,149,105,290254,51549,238705,108,74,158001,54684,103317
8e126576072ef66933c33b2d4a054ae7,30,18,9126,3962,5164,24,29,15274,6311,8963
89332b061fd63e3b5ac53f2bd6785520,81,69,123334,58629,64705,115,81,196057,54139,141918
68c3f4d9b96f59e18296dba4936c508f,151,101,444175,131825,312350,158,99,497880,120796,377084
f6da7bbe8fb5b63ed38a8fcb0dd6e606,173,116,637115,76954,560161,223,152,633439,95948,537491
6e0f1fa1472a3399c52fccb094c47e3e,104,90,158723,41273,117450,115,86,183963,39334,144629
71abb54109da4b34cf209df1ccb1c728,91,59,212517,62019,150498,86,75,195331,63493,131838
aa965a2b405e24d71abce1ee1b2449e1,158,130,633406,121764,511642,162,126,523800,120240,403560
78c7d520516bfc4a55aed1cb7b257b3c,139,104,359360,81162,278198,145,124,442274,88700,353574
461fc4047736020ba2def9f97ef0dc23,60,42,63723,30332,33391,56,45,100553,20097,80456
14cfa960f45f7926889fa0bc01fd330b,133,76,318281,84510,233771,159,124,433786,82008,351778
ca464dece86628ab7d7196d19cf9ac65,84,73,219675,63486,156189,128,107,258514,63798,194716
4286ea559b198e3d6d81ba764b65e2f1,61,40,92257,18783,73474,70,52,74721,26629,48092
2253952f28eec37a4489c73ea4ffca47,27,23,14013,5102,8911,31,19,12490,5717,6773
6f7c968e0829842b67d212e5831da148,41,44,35177,15367,19810,52,43,40283,16668,23615
b291674120625fc42a3161a961d2b801,13,10,3150,1408,1742,17,9,3715,1757,1958
8f3a0a0baa376e9aebe4d9a68f48fe54,140,107,363986,102213,261773,137,100,468175,85712,382463
fe30cfc5d2fcb0c461882a8d4314fcb2,34,27,29137,8499,20638,32,28,17826,8241,9585
afd906f72f3c3bf9e076daaabaf0d38d,61,43,80162,25007,55155,59,44,65446,16711,48735
de9d42ceb79cd99a138927636a14873d,45,37,46149,22019,24130,46,37,53983,14483,39500
cd19547717ed499e9923a01eb91f4b58,26,20,14225,5215,9010,31,25,14134,6588,7546
03eb9913a5ddf2cd9e9f17354f10035c,103,66,216544,69163,147381,93,71,263309,61756,201553
daf206f2edd26a63a89b5e30b2c8fe15,83,73,239398,49445,189953,127,104,285033,58711,226322
15157aa5901e2ab51fe9299a63161005,6,3,1103,1343,-240,4,6,1351,1254,97
072721bf1a8242bb6f8c8ced21ad6ef7,97,77,274159,92417,181742,151,116,362459,107794,254665
4719e62d53a3160778ac220057729359,59,42,73837,33427,40410,65,52,98635,27707,70928
eaca6cbc0e90392f46ca4502a8b7e827,61,47,87733,25587,62146,60,52,59413,28754,30659
d0d39af5941688f00b95d2a16647bd93,148,115,374606,71224,303382,149,111,351365,62120,289245
095cf198008fd976a17488f846ab6cc6,136,110,316449,46036,270413,103,72,169732,73322,96410
3cf81f1351ab18ecbf95e0a8ea650ee6,198,150,558423,144655,413768,177,127,605961,97438,508523
7e71b05f2d44022197c6f370f9213fca,97,69,170538,47736,122802,67,53,131554,49885,81669
5febbdd6893811b976407d45292dd272,132,87,199143,52755,146388,98,83,203917,55621,148296
2641fd8006e99231f41b9accd783f9ec,62,46,78732,24329,54403,75,49,102532,23048,79484
10dd5d2c1f5797352357c644290501d7,24,20,13137,5653,7484,23,15,9190,4907,4283
0facc4bfe866042ea29bc122821ee13e,129,109,315561,64052,251509,106,85,249107,101418,147689
c4a824867355ec777fb93ae6002bac4e,35,24,25293,10380,14913,41,28,35018,9762,25256
bc0676ee78fe800b0044ed15ebcaafe2,154,134,576689,140213,436476,134,115,502046,130123,371923
a35bc11c49c0f40a3f8ad7cb885a9d8d,102,78,173767,41719,132048,108,75,173513,30771,142742
c5e8e4d551288b5f61c2f439664e2cb5,125,85,365033,72513,292520,187,127,532273,72838,459435
342569fca4f4bdd29d693848354e85b4,67,48,76957,25658,51299,60,48,80362,28626,51736
becac755768ecce8f22b710f8cbdde9d,13,12,3869,552,3317,19,11,2372,625,1747
6c24e77e7fbd967d751cbbb20854070f,170,113,397874,70518,327356,159,114,378037,57686,320351
4c96e6a6cbdaf78156777afd3e71ea82,92,70,170817,48619,122198,112,89,301858,55077,246781
1d632685f3600a4052fcc42ebcc7a72e,109,92,265018,63181,201837,134,102,272686,56058,216628
229f127e1c5beede96c0c6280762739b,47,37,44802,20824,23978,57,45,73969,13767,60202
9ea32a28decc6551904fe7919b7badca,87,64,131188,29092,102096,64,55,107009,23533,83476
e79a9e96e49c243aa71a39119efcf93f,94,73,255652,46778,208874,151,106,353986,47098,306888
9f938e41646798d1c0652a52deddfa39,169,85,480865,89632,391233,169,129,546812,156049,390763
b5d3ba31b957b3f33bde56d7840a2add,83,60,140097,54607,85490,113,78,170362,43527,126835
625eaf5e194309eb9401c891ac5fe305,172,116,519218,123069,396149,197,156,766349,163830,602519
0b9e775c262414f0a4a719e120ee2a8d,196,160,1290492,153333,1137159,200,139,887120,126959,760161
8a7dd5baedf751c28031e50c59057986,178,133,634545,102924,531621,155,114,563513,75545,487968
0987e1345861f20b420b82fe35d55661,101,79,177968,40420,137548,114,69,168464,54681,113783
851dabde7211c76b4903b86ed2484e10,191,144,961438,226254,735184,239,187,961072,237122,723950
4815a0c7de16e4471cf8ba1725fb5fce,115,105,257426,114673,142753,141,125,464934,93766,371168
02a8216e41901567d620e0c74bd5ac41,31,25,12909,4983,7926,33,21,10153,4878,5275
fdfbbda94347549954288d828979039f,156,121,587194,112131,475063,169,122,572913,116092,456821
65fc0b0c482f71d6f47364bc7c0750b7,104,82,171240,41191,130049,119,87,158984,41978,117006
ffd22b402f6ac73beb4baf768575732e,130,111,210497,43182,167315,103,81,164470,53291,111179
8c5aea5b60af5200ea2eaeb101f8c978,53,36,132330,35194,97136,73,67,147887,41143,106744
660efbcb7966eda1d54f9a2438114633,89,65,104495,23243,81252,58,46,88070,24367,63703
9e6fc107f44799d8d3346f9c71dccc22,73,58,141992,23235,118757,92,65,143832,32661,111171
2b396563600196032bef7161543d3594,120,102,457517,96107,361410,127,123,415725,113546,302179
f4e5914094a27136cd07998b5b0dbc66,170,127,528207,132673,395534,229,136,537604,115343,422261
6f3fa918c1a39638c57c733939083b30,110,62,264676,76212,188464,187,147,499584,132842,366742
f73f51e8dbd9c49536ea625ad059be4a,154,106,310264,96057,214207,147,107,393190,74400,318790
bbb3999591d6b3a6de259796f254377e,89,65,224838,50253,174585,109,98,232663,78452,154211
99bd0ecb90655feb010f1265965ac911,64,55,250654,58231,192423,62,55,149818,65009,84809
b896e8127ee55faca76958ec4dc2da99,12,9,1735,936,799,10,13,1268,1369,-101
1b074cf4756c7105e2264dc1d0861f93,107,87,233855,37187,196668,94,79,167700,63678,104022
01548e5f2974d4f5ebc6573c5a68158e,94,87,227877,65539,162338,67,57,123387,63761,59626
ab209485afaccc52b6deba2a55f9b652,129,103,273899,78356,195543,147,97,401151,56137,345014
f5a58b316515d4c6ff6f9f1f58271d18,108,79,255201,66907,188294,155,119,305912,87813,218099
9d8c6dbdfc520340b051be403a623278,68,53,96186,33399,62787,86,51,95940,26796,69144
c6fe74824006f23d44f0006a263babf5,174,133,558418,91245,467173,137,109,344491,79155,265336
9db1b32bf555d364d0dcd8ca4a2026ab,132,103,378941,56835,322106,125,89,272846,94939,177907
e4d408fce65a17ce077e84728e56e045,64,43,97252,25705,71547,58,49,81843,27831,54012
17e9aa380c4da1cecdd2240c590ed55f,119,108,254081,54714,199367,106,74,158562,30546,128016
4cadab5e66a60f7ad143cb303bfbe845,72,55,102483,35496,66987,59,50,76825,26781,50044
0a33b34da7bd948aeef00d11240d91d4,41,30,37564,12278,25286,42,30,28587,16979,11608
995ba93d55f5520d6c0314a4b9158b67,67,49,72768,20317,52451,68,61,54541,27503,27038
b49fdc8eefd76647a956129f971bcc43,143,84,387663,111803,275860,163,136,516266,141310,374956
9b1a4d636b6dbe8c7ec5826d5e99f136,108,99,238463,61629,176834,137,114,295505,62747,232758
aa2d9cfdcf0caf6aaee5214350b59077,76,62,135524,25477,110047,57,52,67588,40918,26670
948ca34c4e27d7edd32fd6b504a10938,7,9,510,923,-413,9,5,1087,365,722
c3a71aee37f8f2b735ceab57bea72379,127,91,300916,66864,234052,104,81,226752,78904,147848
be67576fddbb4693181df8191b147766,30,24,16932,9307,7625,36,22,29601,9172,20429
3da4285e55041c414d214242f9e42b64,39,35,27399,10403,16996,25,18,21038,6140,14898
1fddc09e41b27c7cbc21a329d3129faf,32,22,20381,4714,15667,29,24,16000,6580,9420
d845720cce9c14c8447e6df48c297c4e,111,85,177689,43031,134658,86,64,116806,36338,80468
9b19f5f4b48babf3015a11e73337b1fa,120,87,286252,64635,221617,103,79,238831,56017,182814
a617e48a43ac9c1322f3088ab034ce89,141,98,438924,87820,351104,148,113,454902,86600,368302
fafe39eb00f46f40810481d3d0c7727e,133,94,274229,62129,212100,160,121,326591,61478,265113
b5900b424d72cd8f6605d5df2e9f9432,21,19,14249,7898,6351,23,18,19188,6158,13030
a0b33d630add48a7e76818882a2b682b,33,24,18071,8385,9686,26,24,19724,8291,11433
a55757525460287ec09da1c08af4135e,132,82,251671,51814,199857,132,86,310585,67200,243385
254f1d259f50eea8e7634c9e7f3f370d,61,55,97388,33479,63909,124,75,179815,45147,134668
a838eb2910a8e383dfd38976921f16a6,48,30,49198,6809,42389,33,23,20270,13544,6726
c12c6b552a61440a1438106e8254e1ef,77,65,122659,27802,94857,74,66,108432,31482,76950
60c3213e1c59043d39c89444a15065b3,90,75,198445,36092,162353,103,90,180634,62076,118558
55b2567173d49dfef039d76427ea6ffc,169,126,347007,71936,275071,146,119,324850,79498,245352
95587e53ea032f53c4b430da9fb37521,9,5,715,599,116,11,5,926,426,500
0daea9b1980828f8e606f7ccf748e1f7,109,83,271130,86365,184765,133,92,330501,96768,233733
5e0c863d19f681046982cc606c62f054,150,118,323705,76965,246740,179,147,461379,49108,412271
986ddfeedf95c6cfbe8cfce3183f0d68,4,3,282,699,-417,3,3,699,186,513
f71b99ccc13bbcdae9ddd207c5e40a5d,51,37,51381,11707,39674,38,30,29564,15848,13716
cbe47f32dcdf4b3ee4c39f2a6de2dd3f,67,53,96771,36600,60171,78,69,108440,27549,80891
b06d4abdc64b6d85a94aaeaece707966,93,65,167542,36481,131061,95,77,149623,62060,87563
41d552f22ecd64b76da2e34db317f972,140,114,503474,128200,375274,129,95,401587,117726,283861
dfa62d6172ba8a2c5c3c699136984fb8,123,86,325468,69479,255989,181,151,606233,93031,513202
d89986ce86506cefd3c3d52ed182b4a1,123,96,344293,94264,250029,150,115,431815,79394,352421
e82a25d797d013e6a2d9cdd6e9f2a0a5,27,21,11521,3681,7840,27,21,13427,4580,8847
f82b86110a0886550bd4198c7cd78cb9,77,62,120846,37552,83294,74,70,132676,34196,98480
49b848d488b948412faee8ddf3f98d6c,39,37,42591,15325,27266,39,29,40796,15320,25476
570d5494c122f2e7a0078a515811068e,143,104,409479,116077,293402,147,121,486401,150966,335435
2426225006afbc9b5c4dc7ca4df92c54,181,115,667574,166976,500598,222,197,818915,132479,686436
14e716018cd46e64df0d922f6228699e,89,64,203379,56033,147346,117,90,227508,65270,162238
77429c2906e4076a7b4ce0aa3bc67fa2,125,111,264985,51536,213449,130,115,295816,94034,201782
dce229af8a9d65c435fcc6afdbdc96e9,125,93,353175,100048,253127,110,98,314040,122021,192019
5d80e8473d81ec694bb0d770915d375d,58,45,68211,23089,45122,52,33,49348,21034,28314
841bb5bb170b50209235ed87387ad384,173,137,464767,116245,348522,140,111,360244,105530,254714
059fe883f77e72f049e2c8a9fb0d296c,93,76,174611,25927,148684,86,75,112453,48695,63758
df9c664c78d708daf29986b220c06cbf,33,23,25455,7872,17583,43,27,36038,8329,27709
0111b0e376d8f8915c96ce2090ddb4d0,102,79,206433,43017,163416,103,87,226931,65556,161375
0479809b27037fb2b754e8b7a43e6a45,173,122,550803,160805,389998,210,156,896313,142739,753574
8ae5d8a94818b72f4e3957150c1f1813,114,91,249533,34621,214912,136,109,255796,57716,198080
1f41ce5bd0674bb1ad5563fcf5868942,183,143,867896,170277,697619,195,153,1275956,186384,1089572
6864045263a322efdf27ea985f8da592,18,17,4462,3332,1130,26,18,9762,2431,7331
d28845f061c4ae0de15cc5f69df65f68,95,78,162647,44923,117724,86,67,164382,39589,124793
81006046b40c1fa47ab48f293fb34466,82,72,153866,41581,112285,93,78,142211,53168,89043
dc909461da3dae1621b2e4da13399f0d,139,97,431879,102821,329058,201,122,645895,112280,533615
b8b0ef288baf21fe29a50ac3f2761553,129,118,399043,105677,293366,144,119,522477,124532,397945
fe5c7ed898ba311f2481b3fe1b5f9a3e,181,120,505462,110192,395270,105,85,358585,106530,252055
da6757d4fbb4835c7de34e465382ef62,106,75,158125,58635,99490,61,48,121042,45948,75094
6d6943079f4c3a2b30c080d9d052285b,42,36,27188,12535,14653,53,36,35638,14017,21621
c8015bb022a89064cecc7d0468091455,38,30,49481,8563,40918,32,27,43808,7198,36610
7fae6f7db216fdfbeaee3823f74c90a5,97,84,143887,36737,107150,55,58,111429,56474,54955
cf0cef467f227e823342c8acb60c616c,124,110,291149,73372,217777,159,121,286267,61090,225177
12675599fa937b69c57703d749fe27c6,145,122,572359,82543,489816,195,154,753934,142696,611238
ade8341f623981d4a64bf109691cf246,22,22,14709,5819,8890,26,15,13826,3917,9909
06c54c2f532259a53db206b07eb990ca,180,110,300853,79370,221483,116,91,290624,82002,208622
61b03cd4a221d68104255bcb5801619a,7,7,904,450,454,7,6,804,506,298
178e624a5430297049ffd7991d1f8380,134,78,258289,53564,204725,118,83,277573,62014,215559
d9b4dbefc01cf0f34b643fb7ba26f49f,128,100,470327,151822,318505,183,122,591034,122858,468176
c541ca510ba4e2bacb93982115475b15,71,60,115821,35675,80146,94,52,117619,31287,86332
72c06b765014245e5560625c0e5be2e1,52,49,50180,22610,27570,67,44,63531,19005,44526
9befd9230ec68c6466db8d5a588a00f3,122,107,307325,48770,258555,152,110,300152,46700,253452
67b8256541da7c772b996c7965af858f,39,29,46316,21000,25316,52,46,82763,19877,62886
f90d73b7a278092eae6ffc8156bf9adc,113,96,290942,59145,231797,111,101,331882,61282,270600
a06a9b7a2e32f6d667283b2bd0d013f7,11,10,4479,1187,3292,22,14,4738,1854,2884
d25a6cae5d663c2cc21228cca8e0858a,200,141,740201,126817,613384,151,96,510692,127415,383277
4b036d77647f4ca190815d6e1dd96582,30,25,18058,3696,14362,27,23,12996,3640,9356
60a673e2a1e4804b68a91988c2893627,33,28,28211,9616,18595,35,23,24212,10828,13384
8a1c00af072594f699ddaae66d5d29cd,58,51,72335,37405,34930,78,62,92291,29463,62828
fcbf8d54e02291f508e45e6311f89cf7,43,30,36751,16737,20014,42,30,41181,11042,30139
3dd2e3348535f86d9ac0c653c14ba652,45,38,39789,18951,20838,41,37,39271,14333,24938
37352262d34c4bad1b5223dc12bd92f3,15,14,4387,1410,2977,10,9,1250,1819,-569
6cd0df688612795aae790f03de34e66f,187,120,778491,129347,649144,175,143,590878,120014,470864
1816caa5c81660192bcaacdbf1659249,138,107,367965,113345,254620,125,101,316812,106125,210687
0a664c9496cb372e7ddc81dc9c687b3e,130,106,257442,71094,186348,119,97,235728,57816,177912
9a0d9a4961f9ca4002b2581994fa9ed8,161,122,544714,116128,428586,181,134,641688,129276,512412
1136a80116a6b3759c4bab6aaca78acf,107,76,195718,45771,149947,106,69,138371,55993,82378
4a3c65785b3de70e83c04d08c2304213,57,39,41902,12510,29392,36,25,35036,14481,20555
8bec65b11dd2897102ca1fdedb3b240c,127,97,258855,58148,200707,115,98,222878,70056,152822
fb6a86dfac778054133a84aa8e92515d,34,26,64231,20493,43738,33,31,52395,27270,25125
10a9f755fe3d734365a7e98cba653cab,82,67,124114,22991,101123,82,60,130459,25282,105177
b3d92e299fe08b3a31fff010d0e18188,58,41,76186,22213,53973,42,44,50822,23926,26896
059917c34d8df6eb761a4815db9a4a22,33,28,42669,11090,31579,42,30,24347,18304,6043
9972132e9c1a622f2d274b30861497d5,142,113,299059,85334,213725,140,105,281075,63497,217578
03806e8113375888dfd611de6a6f7849,99,74,162590,47862,114728,103,88,185793,54001,131792
e89ae8dd762bca6270f79f80645d28c4,69,68,191232,67501,123731,110,87,213009,64115,148894
857651987eb589ada4835a57d7de86a0,108,86,250844,49103,201741,112,81,218245,64274,153971
f60b81297b7023b464392a2a3d8964e6,132,108,377072,87792,289280,155,113,416251,135198,281053
b9ba0887632861d6c5bf2a489c5bf9e6,39,29,27866,11575,16291,36,32,28536,13870,14666
21aa7284a40e6fd60f819c20f689ed52,114,101,206932,37508,169424,110,86,200535,42731,157804
220438bb86ec0a952d245c1caec93ecb,27,21,18529,8627,9902,43,37,35776,7469,28307
576f3e7b288bf103f2f01446622cf46f,32,23,32700,9938,22762,29,25,20856,11925,8931
4a3da3a4a582716d781968b8ad3f5922,88,65,193662,38916,154746,83,98,133747,54953,78794
2edef25c1777bda9c22224cbb6c00962,15,15,3057,1488,1569,13,14,1918,1983,-65
0517fe85b916dbdae6396d1a240762d8,100,91,224819,32441,192378,89,73,153400,38435,114965
d0ddf0a9c0e452e64ed3e560abf06d8c,35,35,30490,16793,13697,44,36,58550,14808,43742
c3905eeaf96c922807a02d9e32508fa8,26,21,11239,5112,6127,25,22,9122,4874,4248
5230a18b58113e07de5cf1a03451ef53,18,13,4953,1434,3519,19,15,2826,2031,795
f4c1fa697c1783f51c310788c34e67ea,31,28,28174,9273,18901,34,22,14125,7676,6449
f9efe45f00e50fe554e63e1844a115bc,65,51,77276,31810,45466,103,56,129599,17594,112005
7f73caf423c519488c4d4c94f69a7e7e,135,88,404282,97415,306867,129,113,514055,91645,422410
5db1379d5508afa7b14e424b3beba962,165,120,421272,63038,358234,141,118,318197,85254,232943
2bc4631683c68b0935c04c60e252648c,65,55,89842,28521,61321,92,64,128130,24354,103776
eb04ff125ee82d1c8cb083235e381f71,28,20,10944,5098,5846,31,29,16492,6770,9722
c1b43376d0ac3037daf69a64f9e9c340,116,92,278166,63903,214263,137,104,368898,66633,302265
791aaf5a0e1789e2bfe04cb498aa7b09,179,127,570183,77798,492385,161,141,478147,112570,365577
c8289041e9d1a105a4b2c8fb8fce6d53,58,54,110315,29677,80638,57,41,84772,25920,58852
2ceb59320168a0974c76d60b3c0f0062,150,115,494705,125705,369000,132,106,459333,120374,338959
d76ebe333f20c7f10649889c17b6f653,31,29,23042,11148,11894,33,24,22030,11383,10647
9c1025f324b3fc236718cb92bddb463e,29,21,20760,8766,11994,29,26,19906,10738,9168
23400659124c88bb81994e97c25a4729,207,131,943168,150899,792269,199,149,703951,152486,551465
98cccc76c5a71c43775da623c3592233,51,34,43147,19053,24094,54,40,65951,17685,48266
8d1af216bb74a3a86bab1ae160c60f62,24,16,16078,6178,9900,26,16,18559,7090,11469
73559c763a97d44379bd50c2ae9cd160,84,61,138777,31353,107424,71,61,120215,27259,92956
f074cccbfc539185dec1ca6dbc41e092,35,33,23969,11478,12491,33,23,19798,9347,10451
5195ee0b0e473cc50c94f413f5209323,159,110,371957,78660,293297,94,58,213712,63575,150137
4dc6db9dca46bd4f9a0fdcf7d98b997e,127,103,351771,112898,238873,164,126,474595,83459,391136
4c390a2e12360f0484d708e2a1816702,61,44,75284,27447,47837,79,60,77740,36754,40986
59b74eec9f2bf9e732e50079bebd85bf,143,104,385934,146944,238990,159,124,437832,114197,323635
3f0e85e2df5c28877bb427471946fa3b,140,103,321116,52451,268665,141,100,331564,64305,267259
64cc990e6ebbb6f65663cadd010e7396,169,104,621711,126791,494920,216,156,796450,146519,649931
222dbe171764aeb53c44ddd2fdbd246e,146,96,363782,99399,264383,179,90,377504,77540,299964
ffeb30c4cd9ce36b99b1e83ac790c89f,78,67,94406,28811,65595,64,45,83322,25819,57503
36afa77a1398a3a50fa575064aa6d37b,72,51,111376,29714,81662,52,42,84633,32664,51969
94f5ea4928f3fe55cb228510e4fb4532,96,77,181384,41390,139994,137,103,257284,37623,219661
1467f0f47964a13219c8c065ce55bd26,28,21,12832,4921,7911,25,12,10126,3998,6128
2229a510c373dce82f4a438e1f195842,112,81,176035,56015,120020,103,80,165055,54275,110780
616aaeb07e6b03797a6ace192d4ecb6b,173,119,541118,72998,468120,117,105,304551,85661,218890
c71e1e45f1e8617d97c2095beabb98f6,45,36,45965,22071,23894,64,45,77774,18681,59093
ca0b4afb6ef19c5a74c4354e3e629203,158,114,443092,81880,361212,117,91,408682,63159,345523
69bfee8ce96dd1b0ef18416547ac843a,17,12,7506,3067,4439,19,16,10085,3640,6445
62f2ae1a1fa5766f746c207b31316730,63,47,70962,22285,48677,55,49,62206,20305,41901
6ea012592e1ec018a52559d86a9cb60e,158,133,560603,147602,413001,164,114,569231,111275,457956
c9b81a5e1c47d42a25c9e1a858a75e48,22,20,11422,10461,961,27,22,23641,8320,15321
65ad783c9935ae5022d5d7e3626de499,94,72,149879,22748,127131,90,66,113943,23649,90294
a6a608a3272572832cc67f5f938560f8,93,85,162788,46838,115950,101,75,153466,49882,103584
8c698688963ccfed1a4c0c634ca32cc8,179,130,505555,135573,369982,110,72,310330,111529,198801
80b20387ed01a8819c2abd783025dc19,171,130,926945,231342,695603,185,144,865186,188930,676256
c36fc56f589c3e35bf345221f16fc1af,137,93,427759,62480,365279,136,110,439348,93883,345465
d240d0ab121251525f84995a015d40a2,71,60,115489,28666,86823,75,56,115475,15233,100242
11fcd17b3d3c34b3f87438e88f9d534b,72,53,103169,29108,74061,103,76,144258,45359,98899
48224bd13efe7f21ebc098c3923a65b4,101,79,179226,36353,142873,113,95,234324,37017,197307
9e459c02eaf1040829709d55e4a17b7a,74,61,120289,36136,84153,87,73,163917,25638,138279
0169aed261ea7fdc117221882afc4537,64,47,111589,27894,83695,64,56,103446,35818,67628
8d82c4437afd8676d16a8fa00a2a19e9,142,104,409390,87617,321773,177,133,556763,101775,454988
da4d36a57cffdd7701dea85f10beb16d,142,86,321341,116406,204935,125,109,317726,68617,249109
4c41e6f8aad462133f1e949c963822d8,31,26,19172,6551,12621,23,24,11445,6037,5408
b1c41a92b5fc11b11d2b65a302d48810,101,80,228895,71007,157888,116,101,324478,66741,257737
0f323b7fb4c806272a307d44acf122af,240,173,1455540,335770,1119770,234,162,1349004,297043,1051961
3ffff6c93f3cab7af29b9a7f0f515cdc,57,56,70448,19130,51318,53,40,45480,16780,28700
a426a0ac8256845f62e3ed917bf7acc0,36,27,26561,13293,13268,35,27,28513,13309,15204
8bbe15fa46f7d5d3b6b9c2500fd63326,37,25,25222,8397,16825,33,24,26808,9263,17545
ea366b0626515ccc9a515cd928673365,181,122,829322,115614,713708,184,146,963153,193921,769232
add7e591b7803ac481903d431794a33b,31,25,23422,10878,12544,28,21,19829,8450,11379
89bcb9d0b1810cf19513da7f3fe2e36d,37,35,23604,9620,13984,36,21,22324,6332,15992
1aa4d5e14fc41dca8af66a0e7c08510e,84,69,130386,50936,79450,130,77,267501,51564,215937
ce6e7e71d48b99c0112c74ca53aea65a,140,110,355568,92091,263477,167,145,525772,111818,413954
910abadf4518369f8bf5796a50fc7730,34,24,14465,7276,7189,31,21,16338,5896,10442
e6a0bbf8231e566aa371f53118902175,152,92,383955,127143,256812,171,131,545422,125565,419857
0f2f5740ec9349fd31d1d6f358156fd5,27,19,5943,2672,3271,25,21,11326,2991,8335
d0c1075db1d6240b0795ca6ab01c4bc0,155,120,443340,113706,329634,130,99,353783,102041,251742
c899780408409afd5f033d4fb078bb1f,54,48,85814,36973,48841,51,41,88993,27262,61731
46bd29f0850e3499758d7a943bbb86fc,134,124,284839,90131,194708,161,131,429415,74110,355305
1ddb7b3514bb8157dbe43c6333dd0eae,73,48,162274,40716,121558,83,68,121554,46662,74892
20dc99ae419976a1dacbffadd13ec381,59,33,67681,14300,53381,47,42,52471,15228,37243
dc492eecdb24a32392132ffb9c33f70e,51,45,110585,30184,80401,57,45,97403,31427,65976
bef2fd27c4fc985448915075b3bbf3b3,132,111,338960,86884,252076,162,118,484400,66388,418012
e34797d4670297b3850f9f4754a4dbbd,59,50,94045,29008,65037,71,60,66247,30575,35672
c19c00b809e8581c9de3880e9c0d6d26,118,94,303219,62205,241014,73,56,194323,60217,134106
03eac33465086e1581af2d7747ed380a,152,95,284808,77274,207534,130,107,279674,74497,205177
d0ec12618647837dfc8933d8d8a3a537,40,37,30552,11045,19507,42,28,38709,7946,30763
9055620d61e0b3cd0217793a2749f76c,27,26,24690,11723,12967,36,27,25870,14575,11295
5086e0851fda88bd4ab0a4b5300f861a,154,128,567094,134875,432219,154,111,733130,162460,570670
3e74fe3522c8f64dbba2cd6f1ae40042,142,120,464473,74807,389666,114,91,245354,64683,180671
c30cf2b64319f60ee7f47a3b40ff7b3c,111,75,170588,58060,112528,94,64,156975,49890,107085
a7e158345031d2515553dee3db51696f,73,62,141131,34812,106319,115,70,150402,27852,122550
4e87122147903c5034c0faf9f159ca38,39,26,28238,15286,12952,36,32,36030,11745,24285
823c042ce9ad63b98cd7e5302f12d119,19,17,3203,1774,1429,17,13,2077,2181,-104
22e9936eec348a6004ff7d4fda2b8bba,145,112,411745,99486,312259,129,110,355527,86497,269030
e5808b19e3645b718177177f12d40950,113,65,224651,64118,160533,163,122,344342,47253,297089
01bfd78887292f169bdac076cbc02b6a,34,30,39413,12115,27298,29,24,32165,16062,16103
e771e108dd6313804f5183c6e2746122,152,90,414379,116607,297772,134,90,393502,108722,284780
2d22317899790364d65cf6840db12b75,16,21,6927,3989,2938,23,13,6296,2537,3759
ce3e5ab57f96efb44bce7c83f5215f62,87,73,103679,32169,71510,127,98,173739,39028,134711
cac456ce9f10a394efd9c4a58538669e,161,104,329492,82417,247075,107,92,264598,84646,179952
77d6bc56cfdc0506e3c25736e439d6bf,126,113,286668,54640,232028,126,109,260202,78445,181757
e264cbf5372e741c99e709b3ff1dbae0,2,6,211,870,-659,7,3,1062,403,659
4794421d09f18028c7bef4826906ad2f,19,14,7615,2024,5591,20,13,5545,1642,3903
0f3ce143b1783d7f0b33d4ebf7cd5b03,131,112,341195,58523,282672,135,103,322366,50185,272181
d3c6eba9a79cf3addc1594c432ec7b9c,53,49,61732,19385,42347,107,88,147046,26958,120088
22365bd0fd24c511ce2c5ebed86728fc,78,51,102457,32161,70296,92,62,119009,29369,89640
6ea002b7140e6a077f629b1ace8a0221,1,1,103,192,-89,1,1,192,103,89
7c986509b2c57fc1624fa2d3b9be6176,155,134,481367,114500,366867,165,145,493694,97431,396263
0561358a1a896d598c4009acaef6bbe2,130,102,285706,52185,233521,108,89,285595,69469,216126
7ad640a12eceecc4ad64f5edb3b5a7a7,75,48,74611,23344,51267,62,41,79683,18913,60770
b21c3a3ed06d624259527ffab3613f8b,35,29,22313,16307,6006,35,31,33708,10820,22888
3e850aefeaf5646796181dee22251b75,121,105,384385,83488,300897,154,121,388335,76716,311619
a261c3203723930541340b1f35fab35f,144,113,401838,90179,311659,208,147,632554,108042,524512
c5cffa32037e86517f44186b4db7e267,153,107,466683,172625,294058,162,127,582190,144307,437883
66093eee1f1a03c53eee2e6270c11d35,107,81,232553,54288,178265,107,79,243519,42408,201111
d8a6357f72e833b26fc847370e8e9726,111,102,261566,67563,194003,94,70,221028,63569,157459
a5cda6d6956a782fcf041e3e76bfede6,172,143,717133,190806,526327,178,142,764236,155351,608885
8201f57badf45a252963180d33f97a6a,108,98,208508,72594,135914,155,123,331654,50887,280767
c60645441f5bdaf4e8144a2bc8df0535,75,54,108090,74795,33295,121,68,199196,36292,162904
c886c9de1a1c5002e3cdf93f003c0f34,23,12,5721,1431,4290,16,16,6080,2292,3788
364c491eec448abd9e30bf4b4ad86937,49,43,55747,18641,37106,48,36,59496,20854,38642
32817c2ca6750e0ddb6f4cf7145be0a5,13,8,1461,531,930,18,4,1839,100,1739
9b9a3be5f84387011c4e565e81027ae4,192,154,698081,164955,533126,173,125,727753,118711,609042
d4a7c5841f18a3c4c4c118f283846766,46,27,67800,13898,53902,52,39,60162,19163,40999
43ed7e84380f2731fd17ea3cce5885e4,161,136,584302,92351,491951,177,138,569470,121998,447472
89c133c9dcf19821a3db9bf7a5045fa3,74,60,87024,43907,43117,76,59,131927,33382,98545
6d4558e63f434c5f8621e8241eaa8b28,57,46,72792,18138,54654,50,35,54679,13359,41320
767de085cea2eca14d0ab9781f73358b,154,121,374647,83563,291084,164,117,474461,67771,406690
6c177d7ec2d56ddc7caf0ed3077d34e0,93,71,154174,52209,101965,77,60,99117,47104,52013
3195a230a151c2f4029df843c8d1358c,173,128,1198834,227652,971182,234,191,1044224,273611,770613
7ce5fd264f4819689a875e86f1a29f13,187,144,637790,131184,506606,138,113,387602,125638,261964
2f770ba06fb0e95f4e0e4a704779d6ea,63,45,125361,44811,80550,78,56,138519,44870,93649
50a7f57b24a07e9b85acdb2c18f20758,72,64,113473,36458,77015,52,40,76832,30652,46180
1a9c28cbd633f0f4dacb4170e4fce8dd,142,104,373422,100408,273014,120,96,349305,101052,248253
fc67b6ccddb714d08299d630cca98b19,38,26,12328,4179,8149,28,25,12792,6083,6709
cf709193941d6782473ad90cddfd29c0,31,22,26848,10179,16669,30,27,28171,10043,18128
c34b8c361e0321a11800090ad34b3e10,129,91,313231,66270,246961,151,115,393560,74686,318874
6b8a4537e199762d75e7d6106239b654,88,72,164353,44069,120284,114,92,195102,46220,148882
d75da5a587ba97b4b6cf5cf407e60f85,141,96,313095,72597,240498,109,76,225765,66848,158917
10048b7ad1ba088f8d2701cb6934cd34,21,16,8651,2829,5822,21,17,7880,3990,3890
76c6d4103cfe5583209a4c871657a83e,0,1,0,103,-103,1,0,103,0,103
19da236ed05709b8cb138cda91b682fe,108,98,239472,54164,185308,115,85,235514,58956,176558
6372e88eed01bd71c135489f4dc4adc2,38,19,35561,7660,27901,39,29,32153,7799,24354
5acaf4a8076f6c862f3286b1f23d1846,111,66,144121,25370,118751,80,63,89204,35321,53883
a43a6e9bd11c6b06819d676879a27a9b,184,141,511998,113668,398330,178,144,728788,92761,636027
a6b2b716464d42cff5aac0c44545a0c4,116,106,285810,100930,184880,82,67,199782,93198,106584
137050e6c3e04df768a23b8da991b464,209,158,957841,193703,764138,221,156,1223511,158919,1064592
ca1026cbf45e5752ef884907f5f1dcce,47,43,72769,26643,46126,49,44,54558,29153,25405
665c7a47571c61d957eed04f1a1b1936,98,66,177565,53281,124284,107,85,188177,64720,123457
868cef93dac445cedbc53b2c73e48fab,51,51,77790,32899,44891,51,41,73161,22547,50614
55fead6f88656a77de47df0d3993ce54,42,33,37649,7561,30088,33,26,17395,9261,8134
d185b3f57bc3c16452975e6f0d8cca72,92,73,157445,32562,124883,98,79,170701,35109,135592
8fb1a1f569de794752f64407016e2d9d,146,102,254672,47455,207217,116,102,223687,39665,184022
2401eeda5f5d1447ec7ec0c9a4226597,49,49,57078,20305,36773,53,31,63848,16747,47101
fec741a24b36e778373e885316740216,177,141,449701,109841,339860,155,126,424471,108743,315728
56c31a7d3ba7c6f99b9cbaf66384d57f,96,62,130989,34546,96443,121,86,211620,34930,176690
ef0e6a6ab19093417756c9d7a9974493,62,48,76067,16186,59881,46,38,38603,17210,21393
61f513896f0fdd2019287233a23abb4c,66,51,93342,28085,65257,59,38,86138,28827,57311
b547ced13d310f968874ac9858e49caa,121,73,230983,61664,169319,126,83,290299,79519,210780
cdcebeabf826657f3fa0d1e8252fb136,107,77,268488,99753,168735,90,68,126773,90548,36225
2bfe16b2f15310a7ac27541f3612f145,109,103,254466,59527,194939,98,64,185311,43211,142100
848cc9eae542830b3a32aafa868b146e,59,39,56158,22621,33537,70,54,84294,25784,58510
9c9653c49157def1762d83e2fc059bce,186,141,702616,116898,585718,201,157,1116948,107209,1009739
6afc0cd70c7f3231e470e19d9a537d9b,80,65,151994,69767,82227,137,71,231918,52158,179760
3c0944b0ddd24967cd7188b24f874513,8,7,780,603,177,9,5,1008,569,439
173e970c6862dd5383b71eb0334be88f,30,27,34755,22567,12188,45,32,51668,14838,36830
c722ce92e06e7aeda6a35f584f698246,17,18,7248,4266,2982,20,18,8592,3062,5530
cec0f9c455b0ac487d8915e380a56395,150,124,569912,116461,453451,167,131,544529,97454,447075
58167ce43c789ab358c7b11369d0058e,27,21,15178,4889,10289,25,25,9171,4628,4543
39d7b20380c94c21f7a4f0b16ac0a259,47,36,74211,12637,61574,44,39,35207,23429,11778
7a83529986e8570b11d9256655999e61,59,47,91127,27920,63207,73,45,65264,30585,34679
8fa39f77f780e6bfeb7e99712d412db7,69,48,66990,22568,44422,57,51,67344,23142,44202
400dbe43b0d49e97dfcb5930b2e7f214,70,48,219658,58928,160730,94,77,259730,61787,197943
e69171ec82230346d0cbb30f832cb87a,56,45,100358,25002,75356,82,56,107299,26407,80892
5ce4e97fecc5936cca410888a74b4f07,90,64,224839,59253,165586,113,88,277374,56107,221267
9ca9467414f5b3799210b99c68c55649,128,108,437779,110465,327314,137,102,363122,111560,251562
7b77ed91ae594ffb4c4db689580754af,84,77,199084,43390,155694,83,61,178021,33328,144693
008a17ca28ce53e76c340331dbd0768e,56,49,73334,23329,50005,48,33,63022,18310,44712
679af613428382a58a801983acc68f69,113,87,219213,62614,156599,120,78,268123,49407,218716
c1b04d53bc81764044e4b64a4a071ec3,81,62,151049,39746,111303,94,82,130193,41273,88920
c0de1746e76397dcb6efde287c412596,177,133,590876,92512,498364,198,124,651060,97794,553266
a0386d8e88fcb449f7d1b76731bcf2b9,102,84,193245,46556,146689,131,100,300244,50584,249660
f8ca6333bba6e7aff6ca78f9039b1216,77,66,123389,40440,82949,60,45,96564,26698,69866
ee664cdf4f03189c8ef06c6f00c9befc,175,114,313062,59013,254049,126,98,234129,74132,159997
3869763fc3c78c54a74e9bc8f18c1fe5,74,53,98474,41246,57228,112,78,137409,40466,96943
0ab3e878b73dbb38c23332d6d630491e,49,43,86174,22285,63889,67,63,70141,24549,45592
a6c27c9323faa85450c70ed8c33fda33,151,95,511895,93680,418215,178,159,634645,102423,532222
17d956fd36ac8d1cb3268939e6f4ba9c,135,102,265930,58760,207170,134,117,223547,69793,153754
7410b521718ee65920cdae778c149418,112,92,174253,49737,124516,93,76,212766,39207,173559
94b8df7c57873251d1dcabfc68f203f4,22,21,35975,10661,25314,36,23,29320,9258,20062
9ae97143a0289b3f3c473125ca0214cb,105,74,277812,79275,198537,165,97,357898,63370,294528
f8695b36139f2b970da444b4038841f2,46,30,61983,27075,34908,37,30,65868,23538,42330
eae30643d83fe916a04d66431b14e4c3,79,63,161720,42431,119289,77,67,146066,42609,103457
c54b1bb4386464ec6f37fcea3e427d6c,58,48,95483,36204,59279,77,57,149952,25094,124858
88e3512f79e3f1a3bccc6d04f79145b9,75,58,101127,37960,63167,55,46,85909,35825,50084
46318aa477acec3b6102f18f08e5f52a,210,148,957516,141904,815612,187,148,960466,187569,772897
71a53367cb5d8c481e87badd6a07e451,36,35,25056,8724,16332,27,19,13113,6738,6375
a0398eda7d2c852df5e943a57f020934,193,146,699697,114401,585296,196,130,608703,124153,484550
7d363012ef46f12cb8a1052fc5bf5156,132,114,341023,79079,261944,148,121,427205,68969,358236
d41a1854ca029b4278a1b5a8802846ff,23,21,8073,5727,2346,24,21,8327,5935,2392
2a5296d24a464f00406931ca6482b834,212,147,794908,167124,627784,224,158,1109417,131170,978247
1258687b933c19030508c3644cfe8069,38,36,32327,12566,19761,44,34,32032,13190,18842
68e649c8bbfc853aa7a0adf42fc8c115,94,75,171824,56727,115097,78,68,169130,42642,126488
29a05252b1d066f8defacff358769be5,150,107,277078,65495,211583,100,81,243000,78728,164272
5fed3c9ddf9f1d4459012c0cd4d033e8,64,61,100596,30465,70131,79,59,126894,22068,104826
cb19507f7ac0ed97890995a50e02e4fc,196,143,810520,130509,680011,159,122,646003,135897,510106
2361912c417d5f336fb7953e30808889,210,191,1096749,178646,918103,202,136,906798,188848,717950
30374486221c315e30e9f4873a4ad241,107,86,180669,42519,138150,94,79,167702,37324,130378
8a372e400c9c79ba26d1dd717e62b689,52,39,56995,19136,37859,75,71,127075,33945,93130
78bfa8f1476a93058f9e609ea0afce0c,135,99,330186,93051,237135,123,92,273208,89004,184204
60a0df0583fbe7a8e6810929a15e25dd,37,28,41625,17975,23650,48,31,54812,12062,42750
3853cbef7b1b59f8b9505d18b883c252,74,50,114295,31916,82379,106,92,180651,35971,144680
c7771b765b072821db1539c4ce8f621b,78,55,135621,48695,86926,84,71,243801,44874,198927
5c9c6e869820f5eac0f58b3469d2358b,108,74,195063,29864,165199,113,88,203838,41289,162549
c187d46b980eab8765f48e2e086cc52d,93,79,138115,51213,86902,108,80,182423,49849,132574
bf9b8f5a348966aacd56cf2b98944e7e,60,52,66940,17522,49418,43,36,40459,14360,26099
22721a3ecb4b6bfc01daa88d46429ee3,129,100,285954,56676,229278,95,73,182601,62301,120300
a90fff9546c76a7c1ab3e0b39433694c,63,48,115682,26054,89628,52,41,54468,30112,24356
8e37e1f7cdfd48b6bac7bf93536c838f,113,88,244316,66615,177701,115,92,244353,49795,194558
252b3e241cd7bb6a8309044fbb7f1060,119,96,347312,171123,176189,113,74,303235,104228,199007
28d4d77ac4dd8b06f5a7f44a46d4650f,98,83,176622,44008,132614,140,92,203279,41931,161348
ec0ac1fa1ad4b17e7e0afc68bd7ba0c7,9,11,1384,286,1098,14,11,1236,895,341
230290143182779b410308ae57ecc307,99,92,151043,33737,117306,88,71,132259,31967,100292
310e4fe6d3c155143443c3abbb8045cb,103,85,197881,75892,121989,60,57,151791,54938,96853
47098448e2e6561e3cd37952a66c41aa,66,49,97674,18495,79179,76,51,69004,25055,43949
9b5dc7c2f4a3f7008d5a5f5c5fa2699b,33,19,20844,5442,15402,31,29,17943,8071,9872
3becc29243c1330987a4438e10fed2ce,39,30,35825,14281,21544,35,24,36068,12758,23310
415109ff8975155c4812c737d53e5ea3,183,132,781716,160327,621389,221,177,811968,132084,679884
698fd5e61563feff19c813a0a4d58b63,99,78,188884,41527,147357,122,107,208309,74509,133800
8326a9e8a6f5e518497c8d0ebffee697,219,146,861133,162808,698325,169,137,743088,140371,602717
7eb71425b9f166f0e5dcf1affb146137,43,42,37687,15304,22383,44,32,32027,11890,20137
6048e7194d863f692d462ff891be17f2,38,29,35840,12046,23794,44,29,29634,12527,17107
726cab1738507235d648b8af1b8b6424,94,85,124405,38203,86202,77,68,175272,58769,116503
b98612c79690b0c351e1aad5e3dc7ded,75,54,165981,40917,125064,83,62,203075,52001,151074
c56e6d8c220123909c3138c900798849,15,9,2724,1488,1236,10,10,1568,916,652
dda213e9f83bb10384d931a264d8682e,117,75,327644,59057,268587,127,97,272971,79941,193030
c7aa9d2215e007889698b564e88cfc12,110,96,205985,95922,110063,138,112,280780,76601,204179
df8671f288cc5daa03d4e470d527adda,188,140,472778,105176,367602,131,89,312104,77490,234614
afa11f6059c84a75337d6d7a1ce92833,109,85,253025,47791,205234,144,104,278753,46083,232670
c4a4da130609af606dcb5092d443d9b8,95,61,154338,67161,87177,97,67,202651,50055,152596
a4bb5340b40da58843949f381ea29014,159,125,525137,120583,404554,160,115,537853,96958,440895
cd842bdcbd806dc3ba4b50b231794726,61,38,77346,16441,60905,52,47,77554,25363,52191
610303669a164388479dfc9e9d01923d,71,53,94141,34134,60007,75,67,126903,38322,88581
cae2060cf87f99cd6a01ffbef182bcf6,38,26,26805,7801,19004,50,33,35346,11076,24270
8867d9ffdbd9bab5a307688871b92d75,113,91,292121,105409,186712,191,126,539102,84388,454714
5336e7372e8138adac05ebe28d38d241,145,87,331005,54407,276598,147,122,343058,82438,260620
bd5ede06255a993b8f945d70b94c6c58,139,95,292260,79541,212719,129,111,364502,77842,286660
87867afe6e676a04d2207db566a1b2bd,141,98,347535,68078,279457,164,91,341256,73171,268085
8925d64ad5fe8be1067738f9aa0c8679,27,23,8640,4993,3647,29,28,10157,4616,5541
b5cbb5532d51af97a3842c2ab840a188,220,153,1279978,228447,1051531,225,148,978551,171392,807159
c83158ad0f8e2090ce22de3dd2faeb7a,151,115,344714,51920,292794,134,99,300881,67765,233116
ea76284f0e4140d189ad98b08f6bc8bf,55,48,69515,33393,36122,82,68,125521,35864,89657
26844cb0fb0aee44ce7a5f23460c4363,76,40,91150,26529,64621,73,51,110670,25089,85581
4422b72e3b0a198afc100e0335a17487,53,50,98673,40124,58549,69,55,113368,38776,74592
ba55374bb2bc3c5f821da96e562cb44f,29,32,22104,8854,13250,31,23,14349,11097,3252
d4806e8152981b1e1ab1b92e67e82370,32,26,27134,10599,16535,30,20,22550,6586,15964
3339056c6c867139b6f1ad1ee6a4e570,40,33,19519,12365,7154,35,41,28547,8184,20363
9507dda98cfa2501cadcaee9ae104c6c,112,78,244747,40823,203924,61,42,79900,30288,49612
e7cf1f589906bd9b188036518839ec2d,128,90,334318,57486,276832,143,129,403939,106164,297775
8dbbddf1c2a56dfa48a7303af1f98bbc,51,41,78046,31028,47018,60,47,87565,26406,61159
1ba5b394237143179570183b0a639e6c,14,13,3790,1546,2244,12,14,4221,2048,2173
572ec6f44b603768c565d07ae612336c,98,72,153041,36660,116381,83,71,152070,47442,104628
a7bf7df12f7d1e46bc83edf4bfb97877,148,119,510669,172046,338623,193,131,533028,179166,353862
f52cfa694a4e08c74f754c30835186e3,154,110,646157,67938,578219,196,148,555447,115025,440422
38fc5e29b2df8f0f01040bd3566a2428,81,48,103803,36968,66835,81,58,116004,33381,82623
6d1187086100cb3b9a895201d77e730d,32,25,29183,14170,15013,34,29,30668,10965,19703
2698185427ed16cffe16f38b44de66b1,143,109,671961,168906,503055,185,104,734327,133292,601035
dc5269242f9780cfe238f3c76313f303,47,34,37087,10790,26297,33,27,28975,10174,18801
8d24957d81693ef55e465b3e483885a9,122,97,260018,60117,199901,121,95,311097,56134,254963
3f3a51c2c6b2f86e5dd10b167d458f47,213,148,736197,103222,632975,175,132,698899,117845,581054
67dd2a9582c8444596143c5ecafe3493,14,11,3072,1201,1871,20,13,4136,867,3269
470d5692c2da8d1f174cc605ea6117e9,54,42,82864,21108,61756,40,32,62689,24555,38134
19188c79761d3a1364aed60414cc2676,34,25,30293,7222,23071,31,25,22138,7459,14679
6331b7b5ef2a667820b0ed7addbbf16c,116,97,276365,85053,191312,114,97,283745,60026,223719
bef7eab124ed9be142c1832de47fd5f2,112,81,264409,64281,200128,118,94,224735,70982,153753
1bda0b08e1ce1417ea6083b3eb38c614,74,61,91485,27131,64354,76,57,72467,27080,45387
644daaa5085647e1735211238ae27872,135,103,327920,68784,259136,125,97,307395,76371,231024
0053a917022de49e1c18852c19bd53dc,66,36,72738,23178,49560,54,39,67871,22064,45807
fb33666685c4bdae68b9b64561d54ac4,16,11,3942,2910,1032,18,15,5100,2576,2524
b8ec1f90b8f130409d839ecab02d4b42,75,60,140535,29211,111324,108,81,165210,35625,129585
1f7ceeb8dce18d3e31deca0e3985bc79,131,95,196415,40283,156132,122,102,238734,39399,199335
d217e37498034d0afdb93f687a97e67c,34,28,27518,8110,19408,48,28,43035,10807,32228
5565a11ea54bffc220545002cada156b,37,31,31240,13703,17537,35,26,35194,11814,23380
e38b6f924e876f93a9e55783e79ff37c,45,41,55729,14780,40949,39,27,35714,16248,19466
be020ccf082de1a5b9214e4461ea5598,36,33,22472,8092,14380,31,30,18652,9736,8916
5dade726f962c1e3cd69b0359f5efb70,20,21,8922,2673,6249,30,23,9807,2586,7221
ce21375ca50a3b7125043bf5ba3d834f,42,34,34777,11573,23204,37,27,28908,12761,16147
023bea74fdff7d666ec7de3055c6a778,23,24,13830,4954,8876,25,27,14263,8627,5636
bff794109d3428bcbdfac6b7a70d464d,161,111,360422,77754,282668,120,82,315186,73744,241442
669c546ff64feaf6fe8e542a91c5c247,66,53,111653,25534,86119,71,67,130549,35377,95172
68cde86408d0be31eb24f47610dc8048,70,57,95216,31273,63943,100,72,191324,27141,164183
408100d708d8409442dbc0a36a05f118,151,136,457567,71346,386221,106,81,310979,64094,246885
36742600b012007d64ea2122c35493a4,86,66,124742,32545,92197,88,79,116546,29414,87132
45427f127c0bb686d3f6aba39835f19d,36,30,29217,11119,18098,40,27,29869,12723,17146
f957e924db6424cbd3ca8b9bff7f46ec,56,43,68430,25478,42952,82,58,119323,16799,102524
1c235c4a9f0e35013a14518ed641072f,98,67,232203,68019,164184,107,86,243189,57989,185200
1998aa0a7c3f2b8cbadacacb6eca6751,26,21,9393,3816,5577,33,21,10918,3944,6974
00fbf2b95f370ae7a9ed6832ed09f255,135,108,293713,68396,225317,148,117,334462,66528,267934
644e632ef932d5d03fe60c30a1718b2c,39,25,43009,15732,27277,49,35,46119,14779,31340
113506b9395da25be4dd61ad5f0b4779,32,24,30213,13113,17100,32,26,43615,9366,34249
6b635e26e5eed1d99c9416806823f8fe,20,14,6080,3022,3058,19,17,5726,2809,2917
684a5a3816d51cd6271336d977cbc7dc,34,26,19537,5664,13873,27,21,11359,4752,6607
a5ec638c3de062268e2c6b09e17b9191,129,77,161863,29592,132271,126,78,164390,31234,133156
3bfa982068dc295f7b3878109713d3a0,85,82,156864,46059,110805,65,38,108040,28396,79644
8e46077f5947fc973c2173e2d8b179ce,132,102,395797,143864,251933,139,91,363013,130113,232900
59b5e010020c35dd8330a15432464a6c,119,94,204635,49735,154900,124,90,189650,60163,129487
f10cc945f2f19f248b8a647b936cdd1a,135,95,408339,137928,270411,199,159,702063,129105,572958
a5010a8ff5958a81ecae50ff4f338547,26,24,12117,8415,3702,32,25,16173,6230,9943
600dec9d3f6f126a35ee84461e379936,64,40,128733,20892,107841,58,40,71164,19266,51898
a23d5e97aedd34815da42755b6116c16,35,24,26963,17372,9591,50,46,79302,18880,60422
0123b13477583d5bfe91c98ced2aab10,124,97,315508,71979,243529,155,122,399921,49935,349986
f9a718d5d39f5b625c576b1eaaaa2e03,190,136,616014,94765,521249,138,112,508788,203327,305461
f4cb0392bb7d94960c3de293b697a355,166,126,427913,121059,306854,147,110,400821,90268,310553
19e59f01c6915135573313c6dc821bb2,16,12,3241,1085,2156,16,17,2616,1761,855
09f893483d4526857602f33cce29e18d,141,125,443992,108327,335665,147,114,516248,104972,411276
28e5fd8acfec44866bd10f2223e4d37f,90,80,174992,51649,123343,97,74,173309,39014,134295
23632c4f00a96790a06b20fea1079398,124,91,232410,59882,172528,123,86,248283,53452,194831
bdc8315fb4a5f830e6eb12128640ba27,41,35,40803,9898,30905,71,57,66316,17468,48848
f4cef71c81ea0db5cd1c0a540d9dde10,100,72,234651,43747,190904,98,88,191352,43679,147673
9587640246910f0e1b033a6c8f6d8211,144,118,451203,89417,361786,128,95,332819,93224,239595
6ef1ab883e3db6add26f32574a61d288,194,146,866591,205096,661495,206,162,835681,198280,637401
1caead6217071a3ca6f06b124ac3fb58,27,21,17996,7839,10157,25,19,15004,9177,5827
3f0e9f80782627b6e6cb71a03b6e8a79,122,101,242271,55620,186651,120,79,196080,39098,156982
843ecc5dccbdc9c98f79802b0c242124,146,107,309462,97193,212269,157,129,482483,90654,391829
bdfb1665beed347346fe492f81d0bdb4,124,87,246351,63800,182551,161,103,301406,44112,257294
441927e22a16867b217b0736cc9edfb6,69,54,92471,26525,65946,76,70,102923,29223,73700
c324400ec8c9d90a7d71dd7911092acb,92,79,170691,51123,119568,100,76,169606,44584,125022
3a31a3e21c314caaa219a898c30f64f2,50,42,62740,13350,49390,54,51,56087,18366,37721
14068c3e86f36a68d7e7f4f17e326be8,142,117,328020,58426,269594,76,62,144703,66831,77872
49827e3839e7200a9b932e8d1757ed7c,113,85,260476,52078,208398,82,66,114647,59845,54802
77804488c3a8ba4a88418b2795ef1d85,190,146,760504,165594,594910,166,128,576259,143692,432567
d63c3a0e997ac78e6a9dde10b0b199ce,61,50,71724,14751,56973,52,51,47819,20757,27062
43d2c50e605ebda9f23ec60d344101c1,26,22,9192,6961,2231,26,23,15266,4863,10403
763f800d580aaca23c771f3f1813e63d,196,131,978435,104037,874398,176,128,668430,126252,542178
3872cea5198bb4a45a9022cfad65b513,111,95,219950,61716,158234,114,99,218543,74518,144025
1f57b8025b937499d2fc4f0f29845f62,219,190,952331,339398,612933,183,124,1218956,305633,913323
6cafceb141068f937d7284f20397a08c,166,121,428391,110730,317661,126,98,322609,90086,232523
04213cec126b48246f1e618ee4039b29,156,130,502792,78781,424011,149,124,471533,96024,375509
d46230494559a22f7522779f966dc447,167,118,409996,84476,325520,113,92,231924,72223,159701
60c05b47f57c9f3c16656d997397d0f3,48,39,61905,27843,34062,61,46,100573,23495,77078
a81cbb6bf607441a69180e1934d4ee9c,41,36,57083,16873,40210,32,25,36065,20138,15927
bac7a8e8859b2d0be6d1c638adbbe14a,36,34,42377,13809,28568,37,30,30140,10594,19546
8e754382ef41cb0b87e0f513186a0040,161,126,500398,108840,391558,119,65,284106,64114,219992
235150d9c1b6536c774c6a090e73c3f3,49,33,41900,13723,28177,35,30,24415,12988,11427
6ed100a4eff7f4b2232ad0282b8035ea,56,45,84921,16575,68346,38,28,28981,20340,8641
43b2bfddf2eb3e14794284789f29bb6b,20,20,17492,8994,8498,23,18,17372,6616,10756
fd38c749e50bee629c0f829a6138af78,113,90,282182,46861,235321,121,91,208763,44073,164690
99c6d2fb2e76cc3abdf3930774c8296b,58,53,73185,29763,43422,71,47,95988,29494,66494
8456ffb7f3c9bbfaac52a5b853e23f24,99,78,361831,64962,296869,141,105,407268,72884,334384
199adbc8f49d9c1cea1d480381547279,34,28,20995,8391,12604,33,28,26085,6494,19591
c4589789b81f022d53f21debbdbb95a3,161,121,496754,89970,406784,154,132,525730,123584,402146
e50dbe15e3aa5acde48bc60540a2d286,215,149,658526,183283,475243,190,160,812552,106561,705991
a9c9656ce62a2dd0e87f25e591323bcc,193,122,436334,86350,349984,76,51,297201,78161,219040
a4d99cb986b17fe42a0b8bcdad65e9f1,89,73,124272,39905,84367,95,72,189969,34507,155462
b4cade83f5f69c6c7db70fcb7ef509bf,133,94,300834,56147,244687,107,88,221027,56745,164282
65498161121b79a2068f41ee530020b7,172,154,417814,77750,340064,106,86,295189,50130,245059
00fa7bd9a11757f599b75e64d810b320,58,43,52349,18085,34264,43,33,53071,14047,39024
e94c5ae461868da75f5f8467b98bacd0,57,40,52216,15461,36755,35,33,51957,12696,39261
5ec069ed672c8befb2b96ebeca3e6aeb,111,99,216730,50378,166352,102,86,161484,42686,118798
56ce148bf502ccfb3f75c99dcc36e662,106,74,189264,35245,154019,92,80,134158,40870,93288
baeb1d83b5634ea91bdd800ad0364a40,87,72,111372,37795,73577,75,54,105181,26181,79000
cfc929e89ea26f7b17c32769d8c4f684,32,26,35819,9324,26495,26,23,28344,10121,18223
b3e09f375cd3218427bbbb17d6d2582d,101,68,191420,39056,152364,113,83,141151,35425,105726
e95f745c586039642448f092ac09a982,53,48,101834,36547,65287,88,71,160771,41981,118790
8dcb5aca3bf394f2e4d3544f07768671,96,73,225665,63201,162464,126,97,263455,66128,197327
89f6c3cdb794004b4009acf77fc47438,57,56,65216,26653,38563,76,55,118130,22783,95347
41895be5bc04a2065faeb67289ec99af,213,171,758879,145732,613147,208,154,811033,121866,689167
410c5e0b039cd9d053df2c69446b18ba,24,24,14763,8199,6564,28,23,24410,7450,16960
d148d357d8d2711de70d5553e6ec4377,34,23,22130,7983,14147,21,20,15555,5459,10096
7e98a45de005c9dfffe6aed394d62c07,145,106,394609,69061,325548,134,115,388757,91698,297059
4e7f8e4973b19e9b97d74adf71c5b237,106,85,189191,59446,129745,100,77,161483,35515,125968
64ea1b626b9502ff8f497601f5272fc9,93,67,212657,37874,174783,81,67,132047,50598,81449
278c28affa803e3fdf59f936c1e31dc6,124,82,205632,48201,157431,113,79,205923,55230,150693
ab7290c54d57c46553f8eecef2b20a3e,70,66,125832,43306,82526,83,65,160884,34043,126841
1d5b8b8bb5895108198d2477d7ce8701,25,18,12904,4119,8785,27,27,10774,6755,4019
74db7af5625ff18735f4056cc49b186d,70,61,110824,39846,70978,85,57,128614,28756,99858
4120bc75fd006cba039f94174d18bf3b,53,38,81038,21219,59819,43,35,49008,24860,24148
62dd5bb65913b8693056c9978f7bc666,74,55,97645,23637,74008,55,33,71499,13782,57717
7acc9647f12f8ffad4b2466f33855783,22,18,6009,2616,3393,21,14,4335,1918,2417
87aa6727689eff305a403b1996c4e817,36,25,43508,18306,25202,39,29,42496,14373,28123
0bec0a580b4e0a22a02a27734cff76ce,60,60,144159,62014,82145,54,45,126174,65627,60547
f14924d2b7f0f76cea49ecbfb1839dd3,144,100,273421,44950,228471,122,109,249732,59357,190375
171de08db82632888d49b44952c32776,50,33,73994,12558,61436,68,64,106401,22270,84131
e33fc37637f8c86b2a51a142667b7803,128,96,265261,37414,227847,136,105,284858,44952,239906
8b53a7519a2c93c744df923cec9bdac0,26,25,15868,7292,8576,19,14,12106,3789,8317
dab78ce766ba90bd47ae30f559f78cfe,221,172,2165743,306993,1858750,232,173,1533318,274564,1258754
f34d79b62a784df254f4aa170fe2e5b6,74,68,169826,45382,124444,122,102,241298,35453,205845
c34d848a5a83c129f2512bb52e75918c,16,13,4381,2233,2148,15,14,3084,2967,117
dd862073c13514df1db8d7be2aa93960,147,83,333484,69211,264273,153,99,317280,92010,225270
2811ce0729fa0fcb5b2cb3120ad016ba,183,128,543004,90279,452725,152,126,451397,99130,352267
47bfffea01eacb2c11a5a3660bb60a4b,19,19,7146,3322,3824,22,20,6009,2458,3551
f4250b3d70003c63fcad31993d48f82e,40,30,41928,12643,29285,36,31,37068,12570,24498
37c6bb4150fa292c564cf8cbb135e3bb,107,89,279778,57240,222538,145,110,336342,81002,255340
811ed36c3a98b4765f5ba6da55e575ac,94,82,222009,39888,182121,106,75,134116,47083,87033
32f9ba436df954295ab6628dc64f3fd2,31,26,24736,9269,15467,26,22,16771,10394,6377
341ae0f55252fde6215752878bb3601a,69,56,109274,38719,70555,81,59,144311,41652,102659
ad8e9b15abcef3bfb15c7e3d222a72d8,29,22,21579,13243,8336,71,59,123901,27310,96591
306b8e394e75de83b94bd1addd0bd77e,42,26,44494,10269,34225,68,59,86350,14674,71676
297067f553389a1959c6fb97278cd393,132,95,333847,59214,274633,87,74,164765,54443,110322
c05bcb7a47b82980527f53507f8d7f95,71,53,88143,34145,53998,75,60,84226,34699,49527
c6407ae2f7d30b0f69becb81f08d9bc2,125,103,348630,79751,268879,137,115,317614,52401,265213
dbc93fdd7c32018652af0db05faf5a77,80,67,134955,33103,101852,98,62,211169,41811,169358
d228ca57970d1ed14bb27c62b86db048,124,102,260098,59762,200336,109,87,240358,97166,143192
9bbfd196e9cbdb443d9ec274b4d964c2,18,9,3573,1135,2438,12,12,3808,1752,2056
39ad4e0ae1b7462293ea532e0fb29ff6,93,57,170912,23864,147048,122,101,205012,35179,169833
ba2a163792eda0b5c93bc0f1ccb125ad,41,28,31927,14258,17669,50,44,51907,13623,38284
f6291bf9d3c8f7d2b692f60c0cb90c01,123,88,257265,37503,219762,104,98,167951,57159,110792
dfd18cf579acfc0b9d094bdb159ccc5b,27,23,28609,12681,15928,33,25,29319,11810,17509
35c1fba770aba8c73dc547a58be849fa,86,74,157483,45994,111489,107,90,216977,53914,163063
fb5d69ab10554e51da31946569a2cd60,123,80,265195,53603,211592,45,43,65016,45332,19684
cc321c93dc6deec50800dd0c2f839d7e,155,118,489042,103384,385658,156,116,503792,130556,373236
7160254827603dd935400e2936f677ed,89,63,161082,36394,124688,82,68,139032,39558,99474
33f70a4b4e602f57a148feb0ccd58a0e,91,72,140846,42359,98487,72,58,150574,37671,112903
7197d58a2ee96b78f7550730ff976e50,116,82,204270,68269,136001,76,61,145864,62804,83060
ec90d7f64541bea8567f68ab9ffde518,126,110,438008,88382,349626,150,119,454102,131174,322928
ba89b8508ccc3006fe6cf037a98f396d,23,18,5136,2623,2513,24,20,8125,3045,5080
10f025d247200a6d10dc2be519448d53,49,35,51642,13482,38160,49,32,43033,10144,32889
1178f11b56bbec4b487fa084ba99421d,32,28,15969,6552,9417,34,31,23529,7371,16158
1e5b018637ffc081e445e3a257fe6d95,111,78,187989,38686,149303,110,80,199687,45748,153939
670ffb7b2914b3acd0f12a8fdcffdeb5,43,38,41004,15061,25943,52,41,49474,11107,38367
3346b976d9ae74873c40355dd16ee3f2,57,41,64695,23416,41279,68,59,72545,22584,49961
9066aa141b6b34673778530d63174aa6,130,98,491537,117478,374059,182,119,695764,89671,606093
d95740692594d51a0eb159d9005b61aa,157,110,374573,67889,306684,175,118,390714,79572,311142
43024e94d023f9ecf0820ed212d4acb3,129,97,232226,35569,196657,103,79,180173,25886,154287
5479bcbc8ee1ceb1de91b5b4039e8481,79,58,122875,45233,77642,81,63,153725,45882,107843
6e0d66690f5bb1df9462e3504908f02c,60,49,66481,22455,44026,64,51,81178,21191,59987
f4444bef523d9866ad9df9c48bbe6959,135,109,379362,84625,294737,159,98,304198,64142,240056
cc8b00e2dfa8aef42aa622082e18e6d1,114,90,308789,67129,241660,119,103,282724,52658,230066
b8d6eaf58ef0ae42fd7c20592acd6fb7,79,58,122077,36825,85252,69,52,101743,28107,73636
5b0a17bce7bc784d37d3d4af945dfab4,55,47,62814,15059,47755,45,37,33380,17150,16230
1acbc11bd2219d4358194cd8fc524316,175,147,625084,212692,412392,171,108,530805,129229,401576
586e756289a52a87f2a38d1ae921c729,106,80,170115,35194,134921,106,92,176203,43256,132947
686127dc239bf9eb3acc8132e0ddad27,134,108,321852,52173,269679,86,74,197776,63906,133870
80cd9b6d1854279a8f419d8885cbc323,223,159,1250177,225889,1024288,227,152,1178037,200653,977384
7738e54809e790703cef9e4ddb18ad3f,119,92,290827,90145,200682,130,104,405700,68079,337621
9ee8c9aeca0c2f8f566f7c5a3e6bd7cc,187,119,684464,124761,559703,189,116,597406,133567,463839
9eab1cc80a6ea514a28c956d1d2ad2cb,167,139,491671,66497,425174,117,82,317319,62014,255305
b63e2017db9bc22ee8fa16325f7f4b02,76,61,118109,23949,94160,84,63,101297,29581,71716
5c7e9a9cb003a6ea64fde62fbb9c0858,31,26,29860,14151,15709,33,19,38888,10718,28170
126ccc6bf4665338f36715177170659c,118,97,271535,76960,194575,149,110,424878,59453,365425
dc3c475ee59933d0f9c9c6a47e59e9a3,109,70,172964,37103,135861,100,80,155191,48106,107085
909966e95b6da89e000339a0c2a834a9,175,117,454167,125850,328317,129,108,372089,96125,275964
84eae2e9beafd1decb151ccb02a8a5dc,95,79,144703,51425,93278,84,80,146996,49453,97543
da8aed185016b3335c1b174851257660,142,111,356375,102157,254218,151,123,423367,90390,332977
622225df8980fae9be161e4941c70799,81,66,137417,55765,81652,75,56,137734,39034,98700
2a4b534385e11de28361d2e48466baa3,134,91,424334,105740,318594,190,123,423111,123369,299742
3664b574aca5e9c0daa3e0cf641999f8,54,38,52571,16525,36046,52,40,63406,16024,47382
3656fd7a6145848f52b3db8522417b60,153,105,410452,66652,343800,177,150,515546,84893,430653
b6d9dfa6ab3aabeede791bfa41a99314,165,121,452169,95391,356778,153,115,413869,98580,315289
8101fec5cd45b740a4f7b47714ae9b22,42,33,22828,8176,14652,28,23,20565,8167,12398
edefb2258267222162dae7d5058f937a,108,77,207466,53900,153566,82,64,146022,70458,75564
d2a491c4915023be29f1cc7170c294a1,36,30,22061,8646,13415,28,25,14873,9084,5789
d2881bc429a94996d5a0796124222946,18,11,1974,2128,-154,11,16,2295,1969,326
a363534a6344f1b0be1d7ba2c4047d9a,68,54,119749,25121,94628,68,63,93689,35824,57865
7fb4954e720949f20c643a2eee150438,83,69,175351,42164,133187,73,51,135981,44008,91973
dd85cfd5fb0ea3f59006c11960f625ad,94,72,245539,39705,205834,95,83,169387,42004,127383
eab78801e929622a914aa3b6536ffe9f,7,9,1237,1413,-176,7,9,1476,667,809
11d26febbdd1470b49c1c47bf4284699,110,90,217768,52465,165303,85,63,165199,46411,118788
4ce8de34739198db171140ee3a7bc961,130,95,321077,102933,218144,188,147,564622,88738,475884
64c1073802d3a7f245a8d4cf587caead,2,2,204,240,-36,2,2,240,204,36
ad32b87a0485a5c9b050ce101eecb58c,91,74,207212,73063,134149,138,93,298844,52319,246525
4adcfd95ef80aedf6dac3533448c914a,148,107,502002,114707,387295,183,147,569976,109580,460396
89a011193f5125551450118be446f75d,59,47,73173,14947,58226,38,32,49212,16188,33024
cbd77e3cbbf64df4d88e72e2444c2836,74,60,166391,67500,98891,110,96,228530,57344,171186
2b8431735d495d7dbd5ead1dddc9e790,122,70,195152,34066,161086,101,75,186176,38261,147915
4f8610ac3f97c940414754ee3f01ce7e,56,52,121173,34374,86799,66,49,105881,32586,73295
251e4ec17c42964071ac569e39aa5f87,85,64,190817,80176,110641,148,124,454712,98961,355751
dfb14688fe7043fdeb885bf9656873ba,57,46,80449,27663,52786,68,48,86735,23627,63108
a5310795e9f6695bb5641bb9639b0e46,54,49,83513,25039,58474,47,38,53774,24349,29425
e5f4d2f0c6ec2c08c080f680d718b82f,46,36,78865,17049,61816,67,53,99988,27816,72172
8d675f538238f20788812db892c749ac,42,34,58837,14967,43870,58,44,57629,17054,40575
9ba818470eb52c95e62b7ade7649102d,72,54,155051,31490,123561,52,42,82841,31966,50875
db841ebd11f749143fd59c51a1cf2e8c,45,26,47592,16820,30772,37,39,44152,19237,24915
b7d2c95dcf33dcc974e250cac1cf03dd,81,58,211036,57611,153425,138,76,290121,81189,208932
7ffdc8fe45ca94601081818621aca223,49,41,67350,20287,47063,74,49,134455,20129,114326
72191263a9e7a23261573390d95a9086,63,40,65915,18768,47147,60,49,78301,22167,56134
b17461eaff02a0263446ae89f2cf4ad4,24,22,13511,8216,5295,24,17,15229,7456,7773
20223767aa1e23cad5b47dba53b5ac87,138,96,237884,52196,185688,146,111,256779,56462,200317
94f03da1d49d98b1edfbf12c1f706461,53,40,58246,15951,42295,47,30,71386,20026,51360
8c4948411b8c6f7173bb9963879a263a,56,35,47358,16398,30960,51,43,62014,20912,41102
7b23b5e3396a873c39a13f877031d9d5,162,111,332860,104795,228065,136,102,355996,85292,270704
918280b9bcec2e6ec28b4d485173a925,182,131,629978,170218,459760,181,139,528354,104171,424183
70d73b1323c58b5c35843f13bd1a1a9f,134,95,237773,42868,194905,136,78,245312,42341,202971
e510bf2a455bc2d3d84b161e38555774,34,15,27902,4754,23148,24,18,14636,4296,10340
271a0ff459dc53756aeb80afab96694f,60,54,88505,35715,52790,65,51,113779,30285,83494
8cad60a455036f946802851b171fe5bf,115,89,264058,54611,209447,123,90,248064,55544,192520
b6718c71b77c2e78aed028102094c19d,55,40,52968,10770,42198,69,53,76003,17827,58176
34882ea2ee5f6a4d3806bbcc88a7da84,79,63,123621,24435,99186,77,62,114583,29739,84844
5a1b10aade6b99aa5caecd6d12922220,39,29,43056,11887,31169,44,31,42534,15523,27011
7efeda4d52d1aa2f67bcd8570a9ddac6,42,30,43637,18201,25436,38,33,39974,17486,22488
46d14a4c65c92e501427256e0492276d,0,0,0,0,0,0,0,0,0,0
8bb988b7108f16ef8db61f039d331714,135,112,525759,114542,411217,157,105,502394,114833,387561
cad5f70a87f6636d935402afb3a8fe2f,33,22,10076,4102,5974,26,19,7326,3081,4245
918ff6068742d42a99b1e76fad151b0b,26,26,16961,6346,10615,32,25,16596,6545,10051
9c617ca8aa31a174ba369b8b66cb6102,71,61,86220,27628,58592,74,54,95454,27021,68433
f7cf50af938f0e02ff9f715032208161,51,38,63414,20869,42545,34,31,36210,13499,22711
076d13b8c3fdf5a1a5ea451aefa09682,42,30,42781,10897,31884,41,39,49588,17113,32475
9bc2720cef88cdf6fd1c3657f1747360,92,80,133885,39666,94219,115,102,233557,41205,192352
90aad308d3468bc44a6afd046a5348f4,77,64,103963,33433,70530,104,83,144006,36138,107868
9a8980f86ca1d26348893b7575176ff6,68,53,116365,28830,87535,47,47,53265,32258,21007
cf65f8927c009acaf9e4ac283fc35594,163,117,682586,121118,561468,183,147,693186,110576,582610
b23b797a41af2fdaabc74b59c0075c60,34,25,25277,10000,15277,49,38,44709,14916,29793
f7318c7a0bf709005a5ddefde945af04,136,84,275527,70814,204713,100,80,214024,71694,142330
36c9acc364f76d3ed3d00ec43027b444,45,33,63111,10772,52339,53,42,67028,20278,46750
1e60d596085d72b3c71a7f49a1b12908,183,148,683713,92115,591598,148,120,462717,127501,335216
1ebb87b418dee37415f78dca2795c3fb,24,21,12133,4546,7587,23,19,15310,5209,10101
f2d0bb4bb6c60235a009a0e8643c86d7,104,80,198903,63177,135726,70,67,162650,64914,97736
c5ed57d1bc92a0f8179b470fd7695be4,46,37,90690,22556,68134,59,45,78696,25228,53468
82e6d95fc0f7cc9b85e4f99c2f8ff49d,32,26,25783,9978,15805,41,30,30627,7570,23057
81d93038a507ce8d739d095530de42b2,176,125,623246,99555,523691,150,92,478433,77649,400784
117c7c752e0190da082cf7542c2ebadf,85,61,117342,29731,87611,108,85,159164,31380,127784
a188116e6787ce07c5c4e22f948ebf93,43,32,52767,23817,28950,51,41,51904,20974,30930
00dc29c7898736b44f81dbbd3ee485bb,43,39,64373,22885,41488,52,36,62753,26981,35772
c91146c61449c57f219e3565b24639b3,77,58,123689,39869,83820,72,65,118012,51562,66450
642270c1f711f3e9ea61f422434b4456,89,84,176118,51979,124139,104,84,144175,42993,101182
a0e065091fa524e49de89b48ead52ea7,42,32,52518,14079,38439,40,37,37086,17681,19405
9a5ec043c515391e09934c67d2a991c0,187,148,820265,171752,648513,175,146,1326975,245484,1081491
c9717f021bede5b52b2159b927f73b8a,101,91,226660,71778,154882,120,87,288310,46780,241530
3b90021bcd08082115f40855bda06666,117,96,272563,61690,210873,147,109,337738,46002,291736
47dcb8bebf8cedce7f2d1f2bea203d6a,29,24,20719,10538,10181,28,22,20513,9819,10694
e74459f027069892a5ef0fa0aebade64,116,88,252644,29216,223428,115,88,191246,44191,147055
1ffac0dd792327bba94a5323e40b5b8e,79,62,155876,48952,106924,117,89,207370,48897,158473
ac164f27234476941633a0832468a215,101,78,169702,44614,125088,87,59,121194,32984,88210
6244231b456b785d3bfd944ca9933eed,146,115,441612,150879,290733,163,121,540618,129948,410670
09446d1743dfff72929fceb265880b40,128,108,347493,72190,275303,136,100,292659,57776,234883
2fe91ae5ce4fa7638a38fd0d6983d515,16,12,2810,1116,1694,9,9,1824,1253,571
1c5683e12ce5fe5f27b1fcdcc6670872,92,64,123308,33534,89774,103,90,167872,37001,130871
9b470366810f19533514bf3d87c686c9,111,85,271562,122035,149527,150,119,383042,98517,284525
83b3221ac6ec52c8ed450ee3ed22c36f,90,67,206578,37938,168640,171,88,257286,39858,217428
8906f24f88b2c5ef392ba6f1cd1cf158,37,24,41048,16304,24744,35,29,40251,15246,25005
dd563ed3d972cb6a883b753740d5077d,44,32,36322,13784,22538,44,32,38556,8840,29716
bf4cf96c1d8b58c6a459829e6b484d11,93,78,197710,51309,146401,95,76,173625,67453,106172
67b5abee18da8d08ba40291397c0ec88,182,144,654282,103900,550382,209,150,691670,113912,577758
bc2f0ab8759ff0327f753d3e8e73ea58,40,28,37156,11415,25741,34,26,29369,13931,15438
a46ca52da4440660aea8741418ee9265,53,49,65251,25643,39608,64,54,68744,31158,37586
8028dad7ade6fd4a792c16f5fcd7707e,124,87,263664,38326,225338,115,92,229347,42193,187154
af654c15bd94bf53d8ec9b22e7d4f1e0,96,77,183336,46033,137303,128,109,227503,57504,169999
0c7557d3db7b0b101850cceb5c1630bb,48,38,60094,11975,48119,71,62,78690,24578,54112
e819d3dda84056ea377b6a210fd19c8d,34,31,27350,12839,14511,37,26,34506,8841,25665
f523820ba119c63fc5f91b84b3d1d238,120,98,253702,57404,196298,130,94,247296,53649,193647
298d566dc195a8f242b1a076c546f27c,85,69,208779,48232,160547,88,65,191641,51807,139834
f1a35398b2c69e4b2db962aef46a8ec6,209,136,541668,89798,451870,139,114,578362,89180,489182
1a62badc2bae0fecd68292c55db8e3b6,144,100,275814,78816,196998,129,94,355737,55217,300520
420ffba90f177f7e245ae2b948d8b305,148,119,516941,123435,393506,200,161,599854,113015,486839
070b87251beae2a288d14d003aab47f4,45,32,29190,5859,23331,38,26,18122,7205,10917
2137edc821ff19fe1aa0ae324fe7bdac,38,30,39113,15035,24078,34,31,18993,12458,6535
9d99359f018e6878b306c8a864df6b0e,87,63,204819,49812,155007,82,70,206228,40944,165284
378de12351f592ef5a66250998b69feb,33,25,34360,16010,18350,33,26,35990,16818,19172
559b6bb855ffce6670cf3070f4b7fb23,189,122,623650,172763,450887,216,151,777147,182621,594526
8332a2a25d7ed02c43d32bd7dc9be35b,127,87,288387,54104,234283,74,58,123144,57063,66081
c86a61c2cd9bbceb0d206f70f9a180ff,99,75,219768,55880,163888,136,105,303311,64434,238877
33df8173b6d26fff187491bbb367cc34,38,24,36350,17305,19045,46,41,50185,19004,31181
0a19820b3018ce4c6b10e10d7bc9437e,143,117,354692,60424,294268,138,106,315858,37433,278425
e32e899b250b43a3af90d1bc3f2bbcb4,70,67,171686,64013,107673,139,122,385211,61314,323897
9999be49b2c764db0be2cb12298434ec,127,114,519413,141487,377926,168,136,669805,120765,549040
8813c4a45eba7438e9de9b81e60b5b15,122,102,275170,65104,210066,97,84,217105,62388,154717
2eb0baa4f11dae0be4e8740a33d1a86d,156,106,609767,155024,454743,184,138,826592,212375,614217
071c01b6b4de161d7ac4d14adf7b9711,91,59,142166,21277,120889,86,58,112609,22778,89831
660a0256a4d2a68bf5960d1bb48ab03a,171,115,357888,58860,299028,130,100,348774,73365,275409
2005ccb2a30836d96fcc37a5f94323b9,92,75,183044,38563,144481,138,114,315627,52092,263535
b5872af34df09f08c05e31ca2f1b1363,135,92,321405,85574,235831,153,86,375934,139711,236223
6da8e5452d67e5de3f9ae4f1b4a932b8,131,110,361272,57241,304031,162,110,371819,53110,318709
fa942d5e464c453cd798a901d92ea6d6,78,67,139086,46023,93063,90,67,145948,50739,95209
7d5359084204fab25c99a2245770cfba,80,57,210582,54203,156379,130,106,302230,70787,231443
23260de604da50b8f8e9895469542499,39,33,44592,17307,27285,52,37,51582,19441,32141
c36864e8b3984af2f89f6cbb71dc7f42,36,28,54852,10300,44552,54,37,112080,14617,97463
8f8ae005327559f1a83e6afb71ef1f5a,62,40,79290,29618,49672,67,52,70361,28375,41986
05b34e94116fd3b8338b7c3d0c27430f,149,113,654466,174082,480384,148,135,726112,166954,559158
37960b42db22d80650099a9634d45b6b,67,60,101602,37403,64199,67,49,94055,29957,64098
a671b5461353dfad8e95e357cdde66b0,68,52,94722,37818,56904,73,54,106281,30879,75402
44e92d2600434aa6ebe0a969e223a6cc,119,91,347040,63628,283412,123,99,295809,107038,188771
c60ebdb708de280673061641143550f3,85,70,155509,46137,109372,123,103,208678,56526,152152
a86635d8a56d48fbc25e6d60bad05c39,103,94,222253,69677,152576,127,109,384772,56937,327835
e5e5f5a3bf51470334f5802ac92b3ed2,131,98,442108,84949,357159,130,102,451093,95994,355099
2272a0a465aa8d31b3e4cdd1d43462cf,154,114,237925,43913,194012,118,110,209780,70358,139422
665cfa4e65386c72898318a2d270c0da,97,74,193163,62466,130697,120,91,196725,72703,124022
26c373aa7c40cdcae02d0196584f2bb4,3,2,278,306,-28,2,3,306,278,28
3093b7afa92608935eb19a12c3e310d7,126,110,327404,71280,256124,160,113,410627,56488,354139
54e1b90cdd69eda21006a92788105c4f,49,32,40233,12687,27546,44,39,46477,16498,29979
b48d4464841583045862f3cde3088577,61,45,83416,29604,53812,64,57,114386,29077,85309
789b5bed541e974ece83ccc058ef3263,198,136,745814,85421,660393,155,131,675275,159103,516172
ba91627be6f246cc8b58bd062025aa6f,78,74,108742,30809,77933,78,56,96028,26800,69228
a02156f00c51891dc75b4c0170a019e1,16,14,4318,1805,2513,19,15,5584,2222,3362
9142b16c5d256db3baab5d6bd19a59cc,44,35,41550,17775,23775,47,40,43407,16218,27189
be05943e5e40d9ff9fcc903a8e7fbf73,109,83,252303,53827,198476,117,102,271474,61241,210233
6aa6bcd0e2856390cbe547a923304074,43,26,41116,9895,31221,48,38,52211,13531,38680
8fe23b7b651660e27be31faf8513cec8,37,28,26974,14907,12067,45,26,36036,10337,25699
d42077bf02669c43576b90e75c227a8b,73,63,210037,86291,123746,125,103,279817,92984,186833
efc1ba9691734e60ab77c107995710e6,21,19,9992,4087,5905,19,15,8644,2812,5832
2aec2feb37027715cf54c66c317cb81e,17,13,2941,1270,1671,15,6,2497,723,1774
d0ac621cd5bad618b6b42d77b29886dd,31,25,18290,6922,11368,28,22,12705,5253,7452
ec8dbb12b1b4697161320fec24692647,189,129,571158,87879,483279,190,154,652789,131147,521642
54346fb907d2be47226f7d2d685e3a77,201,137,752701,227718,524983,195,130,801460,155684,645776
89de2c7f9d124aa5be4b89c17e80bf8b,28,25,18815,7791,11024,33,28,18863,8723,10140
8788ad7309132cbb0b22374696d3fe37,41,33,44763,14720,30043,31,24,27270,11581,15689
6288c9f24d61820f24e9afe854f9c478,20,14,7777,2434,5343,26,20,10717,4275,6442
801c3d1583d46d770ef00870d7b3efa7,106,88,189866,50704,139162,77,57,122297,36426,85871
a522cde63685a3b35c1239435af50829,127,106,378506,56859,321647,125,93,317625,74585,243040
8a092b29af0c1a24452f73993400aada,24,21,9972,4221,5751,28,17,8727,4050,4677
98511349ad02e0a01193319c1df85c30,24,18,6849,2317,4532,24,15,9018,3020,5998
563db21a93b524ac504b386a060941b5,189,133,667168,155223,511945,179,133,612179,108064,504115
b39761e01799074adba4d8711be12262,114,86,245326,49366,195960,102,80,191323,47880,143443
9a20809a92d2b205a9329597e7e59839,22,17,8497,3520,4977,25,20,14796,3453,11343
87413571e20b0216be331955f539c4e8,49,32,65955,27858,38097,56,50,108652,23383,85269
062d69a7bdd5fc2c88f15a5edcbd6583,125,100,407593,92691,314902,120,101,470522,142550,327972
699ca6b5d6e1a7bfb8f3301795976539,34,28,35048,13461,21587,37,25,33624,11118,22506
85439a4d41949481f508a6095051193e,77,60,95278,22441,72837,70,57,87592,26461,61131
9101adf011e0c5268665d4838c382eaf,99,84,183846,49878,133968,105,77,206677,43608,163069
6691b37137e22f323e472f1e072b8952,230,154,829019,145225,683794,230,146,976172,136094,840078
b4c1b287d8b19fb438d0d7136fe18688,47,37,58326,17591,40735,55,38,70877,15411,55466
97b86365706c77b45b1bedc8b57df84b,49,42,43709,20069,23640,67,46,89037,19333,69704
21a5cfb690a617a64c5fc3f5e42b1926,167,116,526331,118404,407927,165,133,605238,94411,510827
e3a09d7f316e2361a1befde50318f920,55,47,78010,24438,53572,51,49,51597,24429,27168
d503a89bfba29665cecbefed2a583a41,32,24,14516,5726,8790,29,24,9288,6800,2488
b542e9d81298bd106907c0c5c686f846,97,80,221312,96942,124370,127,106,326732,99989,226743
ebf0e62c6923fe3c7c62e84dd2d374da,31,23,19327,4528,14799,32,25,15341,7762,7579
dbc78f72136948de4f6fd64a7a91063e,135,95,288813,43553,245260,144,108,286391,61416,224975
130d0f8ba2faca62d52fddb46e36a6aa,45,36,44948,17773,27175,63,52,75586,19753,55833
657687a16e6bcd039ab77aa663b13c5c,76,62,108646,50298,58348,97,83,204139,32443,171696
6c4d295925875fc00278500b3456d450,188,135,673880,120386,553494,128,110,476475,99058,377417
be7a43e69359132bf4b4f7edac06ec69,152,118,484958,109316,375642,167,151,680647,196437,484210
c83ad2965e14fed41d833a6d9dbcd0da,32,22,13309,3668,9641,25,20,9617,4459,5158
12d6abae4887de78c1a268f3360b8645,18,15,4014,1088,2926,17,14,4342,1908,2434
51559cbc0495e5afeebe326f0ab73b19,114,93,239658,46202,193456,109,92,212606,38839,173767
346c20236392a40bf7f969cbe16f5ffc,53,52,71994,21437,50557,61,30,97680,15321,82359
421db68eb6da1e3c7c35db9e9315e4e7,67,61,112996,36996,76000,73,61,109873,36699,73174
9ef346f495c7c53a7c8a5fc8de44424b,90,73,121846,34258,87588,55,46,90342,26240,64102
f98c21af79562fa03acf166b95b10d1b,107,89,244275,49594,194681,101,79,217853,37304,180549
f87f43f6bf3ee15dd5f3db69d25b7522,153,96,378650,59140,319510,123,104,309524,80869,228655
665c34bd739dc87b208dbe14178a19a0,203,144,664417,86830,577587,168,125,504814,89384,415430
5f133ab6ce458a6fe6bc95251cbca1f6,40,32,99657,17184,82473,47,42,50442,27865,22577
5d667e4053b0fc60f560fe31d285cc9a,146,117,641831,122631,519200,171,131,589873,124544,465329
c174d45cbce6023f11cf86301230aff9,68,50,109992,31620,78372,79,61,111196,28579,82617
d7d45cdc672a8d21ea87e4f3c2061b5e,89,70,170496,41037,129459,102,83,197869,49858,148011
2e3d983e708236331bafc50d289d1350,48,47,100180,28784,71396,53,39,71297,34086,37211
70802578faf1b148d580ff7c0a8ddda8,191,144,543013,121980,421033,107,92,325832,102176,223656
0becfdee7896ea89dace508a8b20cd5e,213,156,743654,133576,610078,145,107,489346,109735,379611
76fbb711fbb0ea5bcd73cdab6a04a700,35,29,19933,9703,10230,35,23,26627,8417,18210
2649cef9936eead607de51a22d48f36f,13,10,2714,821,1893,10,12,1945,1486,459
eb2925a79b95bdd1b52a69c4ce288c2e,94,86,167609,40320,127289,102,90,174470,47069,127401
2af44ec8285eda0a3e55d28afe8cae05,107,78,216647,53402,163245,121,98,246386,54764,191622
7275bf530b516be18f4f450f7c32edc5,28,17,22213,6207,16006,24,16,16574,6301,10273
e874175a64de521c893e16dcdff906a4,75,70,130061,49698,80363,55,55,85795,38973,46822
6cea2a8a0f6c00895415a233126c8e2b,122,104,209642,59873,149769,100,97,167582,46414,121168
67fae0c3e1f27811d5f04d5a15ce548f,167,119,415078,68973,346105,144,117,369427,86947,282480
db14ba30176c049bad6dfc3df33d7798,105,75,191318,38690,152628,64,53,123081,50424,72657
a4bce1ac1f6c585c61c9987ce0c7ca83,63,43,90622,33945,56677,54,47,86115,36150,49965
b626582477d231ceb22218fd2b19ddd5,159,90,330308,57057,273251,155,112,328768,64682,264086
fec3d0adc5b20861b19a8568773bf79a,121,100,296491,43935,252556,124,96,330943,48602,282341
d2740aa96f5e8091deaf725b611e562b,6,6,940,728,212,6,10,622,1054,-432
743503b117887f759eca992c11e7cf76,18,15,5255,2720,2535,21,17,6565,2748,3817
58c10394760066a4547c2703acc00b1d,112,84,211257,44470,166787,98,81,160518,45796,114722
1d5833dc513dc155695d3c1408863fd0,73,49,87225,23489,63736,61,49,64798,21920,42878
6f2cafefbd73b4b47a319d8654d577af,89,71,122025,24796,97229,80,61,116234,28308,87926
0324a612d7ac26c8ab1a93d6ad994a3d,33,25,30588,12063,18525,42,37,44791,16108,28683
89d7739703e8fe0a33239d31ecef55d3,51,39,79403,23748,55655,39,36,48553,16455,32098
b50e70fed450f5dd4353fdf3746cdd6c,147,106,478258,114804,363454,118,98,360586,113360,247226
5b2885f6685f9fba13568fe11c57fcae,122,77,190013,62718,127295,77,64,107876,73084,34792
ed3725375eb25220637286c8a89cd2d4,39,27,24990,14274,10716,42,35,40176,10734,29442
445d98ec0e536d91361ab0cab16bce10,73,67,139424,42743,96681,87,61,145121,29278,115843
c656481bedf3c16ab08dde3172e14bb3,154,133,364874,68340,296534,108,76,242640,68369,174271
42eec2fb2b810502f7c0ba48395600e1,110,81,326549,97142,229407,182,142,540146,129801,410345
cda915f5df21f6806d74904fc5545471,136,91,233639,75413,158226,108,93,207781,70529,137252
ab5d90725e57e9eb308a742aa8f7c01d,82,53,185329,44835,140494,112,71,240505,38654,201851
0046323db5cde76606f61f934b6f2ebe,58,58,105418,36568,68850,75,71,113197,44978,68219
bd006e6c786216309f51ca417f66ac9b,10,7,1424,792,632,8,9,842,1371,-529
5d4e10af988dd926aac226f4ac49afc7,141,113,366902,97577,269325,117,96,326488,86646,239842
a2233298fd9ecd54eb4f446232114b7e,40,34,35852,19076,16776,47,34,42072,18768,23304
27b1519d16e2abb2e02aa68c9af4faca,157,118,565512,175483,390029,172,134,720170,148388,571782
5287825f2f75247e0bc64d6798824caf,49,43,59075,16683,42392,40,35,50279,13152,37127
8b071be597622c8bdcc239d33521ff0d,137,108,351128,149131,201997,176,118,625989,90021,535968
b7b7c8f4278a38e58f8fedf72a58e9a4,31,24,34833,12522,22311,34,20,28142,11740,16402
84dd7e5e86690bcf38aabfb647ff543e,34,23,13775,6014,7761,29,22,21392,5511,15881
5ebf0c05c8f5cfe24b29cad878ed2f88,66,56,106371,22058,84313,67,52,99529,22844,76685
a7af28dbc5eb291bb64ddf9810a4c09c,154,103,315419,63301,252118,138,116,392119,76643,315476
a6edc420e1ccbf59cac6496baab76729,58,50,48194,22925,25269,79,51,67297,21068,46229
80feb82abbd75a35eadc133be9f3ed11,23,17,7174,2786,4388,26,24,11907,3955,7952
e75a521dc5ccba5a4f87ee32c7d2b833,98,78,171145,42263,128882,102,87,142767,57937,84830
dd531ef363b6f35645e3cb125b42ce06,77,65,96571,40440,56131,126,89,187684,36145,151539
4a461876c6c40cc49bf040eba08882d4,89,52,116437,38344,78093,75,62,105213,48184,57029
5b641f0d6d0ef7e13d70f363698e4604,160,128,788758,119587,669171,126,94,441413,170139,271274
b45d01774156edd75fb4f9d95d8bf7f0,67,52,98699,26604,72095,44,33,64616,19954,44662
c90288610665d7baea2e11150b7b1451,64,49,50723,17189,33534,55,46,41924,16368,25556
6ac80bd0fef6d11a33adaab3b1026ca0,42,32,38489,10480,28009,44,29,23434,13349,10085
93e7b356e7ef1732219906b5971be921,19,11,3642,1302,2340,17,16,2562,2085,477
552564ffb6d1d4c63819c34879951e4e,109,95,189264,46152,143112,104,83,174445,42170,132275
0783481cc310e6eb73283556035ae01b,177,123,418381,95272,323109,113,87,273380,85361,188019
ebc7d27bf41400fcee08739210b8c901,112,79,172472,36096,136376,98,74,160735,56084,104651
3ab0c2a830fe2ce51a321a5152ccac92,125,110,385723,104826,280897,181,131,618017,77377,540640
c446c139c3da785e052406890bb5a0dd,29,20,12693,3706,8987,32,24,11580,7031,4549
45caeb96653cff79159940344d4a69bd,87,66,73375,27505,45870,63,49,67108,30234,36874
3ff2838809e1ea1b1d76ebca4eb034ed,35,24,15908,6933,8975,24,23,11200,5345,5855
19020a80c5100c1a4337b1d681edf4d2,93,74,178005,33440,144565,106,79,150155,37971,112184
5552e330ad97a78c9977304543ec45d9,146,109,383089,76306,306783,154,129,490309,87300,403009
3db823a6556d7f2a0a0e368a66b9f03c,86,69,192757,54473,138284,73,57,153135,56140,96995
7fedb3988f16a71ca54b590b1ef69693,93,63,149545,42087,107458,103,72,167609,31168,136441
8ee763c3cc845aef00813934466f64bf,137,100,209629,34475,175154,88,69,120781,36112,84669
fdce9450dff3137b3e8d64fa7c090b19,178,105,535885,92370,443515,153,102,361221,108411,252810
e124c21880c9bbaadc42efee82d27256,64,53,81868,14827,67041,59,43,67497,21518,45979
b166370ed99f7747abfc2b821f2aebf1,80,61,148263,31220,117043,76,57,102143,39135,63008
4b235f63ca5fd8b4c814359abcb31676,28,15,20319,4593,15726,24,21,15192,5102,10090
81a1d4240f7e1ec8ae151985e71661b8,85,73,208727,56096,152631,133,112,296001,62944,233057
464dcb653a79bec1e1fa549a84ab66e2,213,138,663153,135948,527205,141,107,519579,134622,384957
aa54d56e51c02f6e8fcebf398aef6a1d,20,19,4460,3570,890,23,17,8895,2510,6385
2b8a9cbb1c52fa5cf38ded6cf3f0b364,28,34,26186,12773,13413,43,29,27218,10913,16305
3a8e1ba2529d3cf652697d3deba8f37b,102,68,218562,42058,176504,112,93,243120,67896,175224
b52bb4dfe62b3b1b5cac843711174a95,78,54,107074,21261,85813,83,61,92831,22763,70068
0b6fee8001b212ab4e45a2e58fa201fe,115,71,192203,21413,170790,73,65,105150,30781,74369
d75b3eba13e478c672b30044c40545bc,92,80,213641,60464,153177,113,96,197091,69705,127386
820e87ff31e8f4d54244b7d6a16c5d2b,127,103,356014,60751,295263,142,121,406035,72195,333840
515fef02d7391caf598e9d8f4b4d1b13,138,102,257272,46049,211223,95,79,174988,49900,125088
3c08bf7471cbee4c3a8944c792d3c928,98,70,208171,51486,156685,134,123,301372,45898,255474
111229870b9fe4b9b4a26dbd4244a1cc,63,46,98942,24071,74871,54,41,60758,29412,31346
9d35912f0afb2ea03cd87738ccd9c950,89,74,234712,94216,140496,138,90,335649,76285,259364
3f1a6a63414caef01a0cb050412a74ff,60,53,72494,25773,46721,108,74,155001,31799,123202
8e5b32c90ed195081957cf30c5e24d67,68,60,93451,21486,71965,45,40,55070,27120,27950
30288b2d4bd835b038db2920ce98ea05,57,46,106966,36026,70940,76,64,107175,27471,79704
fced174a788fd19f602d1a7b6d01e44c,37,28,37838,11582,26256,52,32,51342,10805,40537
e2aaccb9f6cc7d7847e580c42ca960a1,186,132,711917,89130,622787,136,93,305708,109540,196168
82da4213a2ef7f67effb146ebd864709,23,20,6553,5412,1141,28,20,10157,3478,6679
5b3222b2bdb1e420812846d19f5e6613,134,108,221865,63379,158486,105,90,212766,63667,149099
f8104270a51e402dbc4d1f070171f8ab,42,38,35598,19165,16433,57,38,48489,14930,33559
ccc67bf6dde36608ef20b138d5aefdb0,52,37,64338,17357,46981,55,36,63394,21473,41921
d5c3153975fe5af47e71d8852720acdf,93,74,142711,37954,104757,99,73,114475,34045,80430
e1a28ea982df4c89ec880bc570deee3c,124,96,182636,60414,122222,98,84,191423,62437,128986
ca01d97708196a162615bfebe9e2a9b8,148,107,420251,90580,329671,145,111,362934,72981,289953
96ab4356ec05c695db35c984788755cd,84,64,138027,39405,98622,76,64,133643,32482,101161
1b0df3f519b03e1c739a7f9cdecae740,163,124,423241,118684,304557,134,107,391262,88176,303086
08a31746dd8b99fc6f959de6405e4cc3,147,107,462313,101060,361253,135,116,547674,94285,453389
bd348259a538f9d79720deb5c92f5d71,2,1,576,144,432,0,2,0,576,-576
2c58f7905486789b37c48c6627747490,12,10,2468,863,1605,14,9,1585,1909,-324
ae7a9f672d9fea15be9440c724021cf8,45,29,31884,10934,20950,42,38,26135,10731,15404
1436a405a00b8bcf5b3d0f6992e045a8,152,122,361666,60976,300690,116,97,166007,58202,107805
10612245053b2f861866bdc21f3dd52d,35,24,27134,10345,16789,35,31,24699,10667,14032
1f406fdb3c5b114ea2bd693d2b659253,109,83,251892,66320,185572,105,92,282127,77675,204452
af8ffef6cdede38e73669dea756b6c4e,27,18,14426,6276,8150,24,22,12333,6973,5360
17b2d4f480aa54c14182f67374b1ba60,24,24,17395,5416,11979,23,19,8979,3879,5100
fb309a7b77dc3095cec25fa58291384e,41,41,58892,25052,33840,44,32,60445,19777,40668
ad0bcd7ede36b6d6328d3d66abf8ed98,49,35,38951,12621,26330,46,36,44915,12877,32038
3519d480478a0dac3f6578a00af7ebf5,51,41,80763,41370,39393,68,49,92339,35262,57077
f61ea0db076a88e10088609686bfc5fb,23,12,5708,2556,3152,19,14,5116,2650,2466
212a8e01949647f55a400e85d3da92b0,56,44,70343,33902,36441,77,65,112998,36488,76510
0526ef2ff0f2a685fa0d7f4562901c69,152,112,886039,191105,694934,205,141,916365,176213,740152
6c9296a37b7b5a1f784df79373932c84,129,101,242607,70617,171990,118,82,207697,73956,133741
ae8e9f0cb8886e1b2cd88f08f3adba50,42,34,71340,18899,52441,58,54,75434,29682,45752
c9122ffcae6544f8109420f8f820aa53,152,127,360476,54724,305752,179,143,535833,74887,460946
1c49927ee8dc93986733c806f6fe84bd,174,118,657248,160624,496624,167,124,708557,159491,549066
e727af1186542368455f8a9f14c2b1b3,31,25,43908,16502,27406,25,23,24877,16480,8397
cb30e9067c3d9facd3d3485550406f2b,152,120,494642,95363,399279,159,117,416188,114896,301292
b4844d9b16cb991014ebb22b5cee1ca3,25,18,8714,3068,5646,17,13,5430,3377,2053
acc98b57406fe9e631511cbb97115b36,133,113,242128,33488,208640,79,74,162085,63291,98794
eae29482cf374330ad0c6f72fdded130,61,48,79412,28231,51181,51,39,68773,25054,43719
b69905a3925382aef99f19040337e725,48,32,31864,11671,20193,42,40,21649,11463,10186
526c09eaeacd3292efeb7d3289366038,87,71,143721,41548,102173,77,63,162101,36432,125669
4983f6ce1a64500bf8e766105040c071,77,70,201072,65024,136048,154,132,348820,79760,269060
45f76fa07fe6facfe9f7f9a2369b138c,144,106,516653,108114,408539,142,106,433065,156545,276520
ab5b56b6e1e7e610135bee7ee33c9134,38,34,39054,17260,21794,33,26,34231,12792,21439
ba428c116c5e7af2d4b54cba0d245f8d,106,69,237025,52988,184037,163,129,426460,59290,367170
d07fce5696342cbcbdf39b686270c618,76,55,85866,29225,56641,66,58,129163,28458,100705
d13e3470b5a000443d57bc628d6961bf,174,131,517999,162445,355554,165,130,602867,135609,467258
86eb2ecd5b64a0e8265f0eac6af89a7c,92,64,109148,34058,75090,61,59,78108,38982,39126
272ee6ff4d7de8f6c9b61f3f3d39ae7d,63,57,51923,19461,32462,53,47,65001,15567,49434
1a8502932dd4f2953036cde416b369eb,98,79,251958,54147,197811,90,77,218497,65420,153077
e026939300344a9d416a1f22cdf92d42,153,113,653770,172820,480950,178,133,777283,155481,621802
19e2459f77b81d5dbce7e5b65e5b4f16,133,101,305246,79217,226029,112,86,237205,85071,152134
668b5e1cfaa9ebd4d414a1ecc73a83c8,110,87,238206,34731,203475,115,103,241392,49477,191915
ccddb42cc622fbab604c265233a3b6d7,18,12,4672,1336,3336,15,11,3538,2368,1170
e8ad7502d68d9c296596e3ffddb1fc57,30,21,14416,8262,6154,36,29,22377,7899,14478
cc40a7cb084dd718077b07da9c209019,39,31,28423,9289,19134,39,25,23857,13286,10571
85c6178c70b08b9ec65d5cf2a53bdb33,185,129,889011,192107,696904,216,164,942987,226571,716416
3012b0c5aaf14b98e82452c00aeef098,97,74,161955,37793,124162,86,71,152406,37566,114840
ee535756fee844a9c2841a1047225e5f,40,26,41779,21706,20073,37,29,46118,11429,34689
ff0b4c83919833b8c71ca22169ef5c2b,129,98,270728,89653,181075,74,56,184084,58880,125204
dcc11500802b7744d60da5f0f64e9960,68,59,95910,33225,62685,64,48,77455,30304,47151
b21b88766db12d9fbda69a82f74d25f3,47,42,49403,17563,31840,37,27,28983,10358,18625
e7e76e5c3fb478ef21e0e6608bc703a8,58,40,59427,18453,40974,45,36,38370,12759,25611
37e49014abfa82a803e75282e2084c3d,144,89,452383,100195,352188,170,133,428993,88497,340496
1a67648f08e3e612721168ac8b49101b,134,109,308624,67580,241044,152,116,459916,63965,395951
9290fc993a8185d5225f070892ef7c16,47,27,39806,15725,24081,47,34,41851,14841,27010
47b0a2ca765f78fe8890e05053fd73e4,154,115,495037,117863,377174,181,142,677229,100475,576754
515a165e96e694d96f946f469b451209,29,20,15448,3406,12042,22,19,4427,2681,1746
d33892ac3044e67039ae5c88af18d1d9,28,26,11022,6469,4553,38,33,30803,7809,22994
cfee6c5ee7bcb451beceec8e032f7e60,169,121,438147,97645,340502,161,102,374904,93414,281490
b2a0edb77bfb656bc7d470b0fcc3b7d4,67,59,99378,33150,66228,71,55,122598,32247,90351
3e1315ca00df1d436f3588671071f2de,77,66,128834,35529,93305,102,91,181677,36016,145661
a8304c39b2b1dacdca2406cc4bf25995,3,1,456,358,98,2,2,658,452,206
0bb3b47c899511d2cf38856b26bb8368,122,93,268313,50666,217647,93,73,193148,60852,132296
48a88c73f1f80f357dbeba48ded49cf3,156,114,417898,79964,337934,153,109,505429,67677,437752
1d2b6f328a5abd68e694742a0d07939a,46,41,46646,15239,31407,38,31,35045,14957,20088
7a1a70c7b03d28505e31ea386e476037,84,64,153787,40774,113013,89,68,124473,32969,91504
908ac02fe2f0843055948813b69157a7,152,113,429389,69393,359996,109,89,286790,56401,230389
e2b4f92d2b7328d965871266b079580b,135,95,273585,67947,205638,113,81,250078,75259,174819
45e9c8215f77f8e8f0496d3a2fe6fc01,43,37,40302,14056,26246,36,30,23777,12402,11375
d71995a154a36c5c65c1c2f7c6e1fa65,96,80,213097,51168,161929,128,113,237988,68894,169094
7de47913cedec50354e1415a63f5bba2,163,129,652093,172856,479237,155,122,412012,139929,272083
be9d13fcf3b6ca97755a9afc7270b285,141,115,324990,71415,253575,88,60,205488,44584,160904
acb94088908221fea5e9888eb2a96101,59,51,67442,22163,45279,52,38,73099,16824,56275
810c61b4c8e92f0b7ee30a1d101df2f3,34,21,22345,8954,13391,31,27,18258,11009,7249
908f1938117d36e932ff7406725e47d4,15,18,3433,1756,1677,14,14,1978,2532,-554
9b520235a85669203eb829270a4845de,21,21,12154,4748,7406,25,18,11566,5406,6160
14de17a2d49d6b1d2b6671409640d412,86,77,182343,35184,147159,95,73,117601,37361,80240
9b310a860b5cc062a63a35bd0b11ac15,61,51,81397,22740,58657,43,35,68039,22822,45217
dcb9dbfd517a65a29b460d7740514c6c,42,31,34385,10917,23468,57,48,45803,13442,32361
9a96798b4e7843041096db5620aa9fbc,152,100,432016,94746,337270,94,86,212208,100316,111892
0a9dd473efeca7b779ca8e272b35c32f,165,115,517881,69935,447946,156,115,422685,83532,339153
fd5f973da4ac09106fe68892cae3b01b,35,26,31011,10203,20808,41,26,26103,12272,13831
d59688bcbf5b41e3ef6d62f2549399d3,51,31,88995,14021,74974,72,53,106502,28144,78358
62d873a1e1605facafddb85304d1d3b2,43,37,62545,18137,44408,39,32,58154,17445,40709
6f00cd88dd7abd2da8012e81da0be194,54,36,49579,32174,17405,62,38,104831,18772,86059
b1e1a9f207a3acf30d4746c96cf9fa7f,32,31,21884,10403,11481,37,32,24852,9331,15521
f3a08fcf3da88721ab11cfc2aacf3400,61,44,80250,27127,53123,68,49,89523,30303,59220
ed720ad754f75b1ed40eb66d6a5d6e91,109,90,265421,72029,193392,138,118,341596,92615,248981
ea85960aa5631762a4724c6547fd0fcc,65,57,113826,37364,76462,71,55,111180,30461,80719
763897d9002d3d928af26a60efd2ccad,118,97,245155,70802,174353,123,102,249491,76975,172516
03ab003a30c0aab81c7713d4dddb447f,100,66,170910,36377,134533,98,70,152340,36223,116117
e2327be1f7b6e3274eefba8672a4e5db,146,112,421026,63320,357706,149,135,434436,78602,355834
a379b3224af1754d5da0b4e325fc37f8,108,93,264188,66949,197239,120,95,235598,50791,184807
d74cb477303a68c18ddcbdb3b6d34233,87,70,163440,70876,92564,86,65,165312,48185,117127
a0273b38c8b9615337072f9b5b9cbf8b,37,26,18816,9962,8854,37,32,27701,6718,20983
c63d561d32282ed81df4aa938f756d33,74,48,90175,17158,73017,61,51,110910,25467,85443
ef715d163903400be730f41242657e22,174,151,713306,168073,545233,174,126,772667,147733,624934
dfba4debd39db77ef8a1146b442d3a54,88,65,113868,25415,88453,113,95,147230,39940,107290
15bbc721518b84788f2da0a0acc0f529,152,132,643091,133512,509579,138,111,528748,146084,382664
69f8991d4f45acbb118edf41a877567d,107,85,188596,45689,142907,98,75,167033,64667,102366
3795cd13605e63b2c42f63a81834ae83,54,41,55310,16515,38795,57,48,85397,28289,57108
ac5690a8433a56d6e02ca2b1ffc80b48,67,45,252953,90535,162418,58,37,273125,101295,171830
8a752da60ba906b56fd2ca0fd0109748,35,29,28826,11994,16832,39,22,32098,8915,23183
c1f55e7895a7b00261af32079cebee02,24,17,4876,1386,3490,15,12,2149,2426,-277
fe0f414005e6f3efa3259cab04f8a3d5,17,16,3978,2659,1319,19,14,4307,2537,1770
abd5cf5ad3300811540e7d8b82b6d01a,165,119,457982,108701,349281,163,120,411636,112662,298974
411a9966f790dd7e6605fa1dccbe797d,25,19,9993,4047,5946,24,16,8591,3618,4973
5f4e0aa781d780cda095b7c988f25b98,26,18,13230,6999,6231,23,20,22142,6428,15714
c9eaaa3033e838f3184068250fce4192,62,51,65799,25777,40022,64,48,65594,18848,46746
c97d05ee62b90369c1c16e9a0137a026,126,95,252504,62331,190173,149,103,318610,74721,243889
d49eaa6754c03fa978e792ee7ea9f61b,111,80,218467,36425,182042,91,80,119185,65209,53976
5919b89b414157c0ad30609d8d7cb496,7,7,1365,786,579,8,8,842,1421,-579
be358112bb306b2d597bac01399ee0a5,120,101,257889,54352,203537,152,119,464650,73143,391507
7020509cef0b3652449a9739a1579b6c,157,105,432840,95384,337456,141,124,447722,108299,339423
bf0cf374f95dcf5f90dcbf2131a00e6a,96,69,147330,39673,107657,71,58,104737,44129,60608
df1ac811361d831cffef060580697a97,90,71,175929,29539,146390,82,65,121936,42665,79271
d388a99c9e84f075a061c07963ec9212,3,0,340,0,340,0,3,0,340,-340
83901795ba89afccf47558f7ebb903ec,0,0,0,0,0,0,0,0,0,0
d08c3198a48b6712dca696ca75c4add1,100,79,161621,40054,121567,73,68,102448,49230,53218
7214b60891a5c35a8ad0b9b8e988a5b8,104,84,220150,61290,158860,96,65,187576,49003,138573
6b5ef5e0e9f5436e0a144d58080881c3,35,29,35643,12823,22820,33,22,32183,10463,21720
67045c46fdca9dafb02b81df93cdc559,160,113,363149,96985,266164,111,83,248945,86725,162220
94f596b9c30c4b92af923759b762827a,148,122,328610,68448,260162,122,98,348209,103105,245104
ae7217ab4125593a16dceaf01d3eaf01,109,87,176746,32885,143861,92,87,116792,33229,83563
fdef8c84392d4f53ca7feb7a6ac20994,162,123,461355,105257,356098,181,144,617109,119793,497316
1199b08f0dc5d910b29eda159ecffd80,115,99,281425,61996,219429,134,99,279911,62177,217734
89758f6d1725561a69039ab79a932d53,40,22,45245,14166,31079,38,30,52337,13954,38383
b8cad16df29d5bcb552a20118283dd6f,124,84,318471,55013,263458,95,71,207559,71680,135879
a1a9789941068ecb8b6fd51a6187c30f,93,83,196115,41976,154139,80,60,111627,38244,73383
2ce2640d1e6341a4b6313619420cef71,47,33,70038,24141,45897,57,37,71522,20247,51275
48f95a360df06329de42b3d2deabb596,121,97,288716,63547,225169,117,85,276955,65164,211791
0b4ea410d2b07a97a7f3b962568038d7,165,129,399284,89527,309757,142,124,498844,84928,413916
aaebfe1523de15c6cf8f9c5e9de9af5d,119,74,243423,50529,192894,177,144,465128,108821,356307
65acfe7ce761f8ef49b06653cc2368b2,98,79,161867,50912,110955,96,61,185499,47316,138183
2ee29a5bfcad71beddd4f1de9d56fa74,81,57,104723,34299,70424,86,57,124815,27682,97133
a137bdff4cab76064bde64f72e958be7,116,96,202351,49018,153333,104,87,160467,44477,115990
a28c182bd5bfc13402b7126999f82b83,12,10,2102,785,1317,12,10,1944,591,1353
491fd37076362ca7ceab99181c8b1fe4,74,57,127420,34985,92435,64,48,115578,23445,92133
8ac91d77391763b189891816dd39712d,118,90,380657,106404,274253,156,106,505532,93421,412111
a9f359924a2bbc30e030421e84db9083,48,31,52926,22604,30322,44,28,55560,15607,39953
350458e1d0a48bbe450d2a94e99c3190,27,19,11698,2693,9005,25,19,7320,4230,3090
b95c5cd8e094d9b8d1d989f8960646b7,3,3,364,244,120,4,3,248,364,-116
9e6d6780fda406290c73c3de4d9b8c1e,148,97,361050,83173,277877,150,110,550033,91193,458840
112d27b64e13b42e9771f7ccd7b02c6d,77,63,130742,36002,94740,63,45,116051,29056,86995
409122d865c9de4fcd90081af11b8cd7,111,71,275138,65875,209263,144,110,423825,85963,337862
3a7438f0dae7ef35ccf65cd4ce942390,88,68,305205,86056,219149,163,134,523216,88986,434230
f643416e3e0fb5a1ac327e90749c6046,107,83,263639,49957,213682,117,94,213964,74173,139791
8b8cb9a6ce4c724bfcdd6d3b4e33cd65,54,39,51064,20325,30739,47,37,52827,16285,36542
6ee8500264226c308c2b82acb9cbcde7,133,107,570660,98273,472387,180,159,655637,105295,550342
b2d9db81cf7e72e27d1cd66f53696d16,89,58,116395,32127,84268,93,80,152555,46171,106384
7836f210049fd73e6c415bcd23c3bd7b,41,31,67134,24083,43051,38,22,48687,17724,30963
a5c3fd67b5f881b84b0c4570505db6cc,32,26,9760,7616,2144,28,26,13805,7243,6562
2f2dda4db3e93ed95ad4f2672c088132,45,44,54547,23934,30613,50,28,67976,9747,58229
45319972f90f792de8194922e27521d3,187,148,782547,184132,598415,217,152,772268,188305,583963
42283faaf0fe1ab261815fbdc52b37aa,191,139,594310,126615,467695,160,121,638753,138810,499943
2f5e0999d2b0b270e8ea35def1835f67,21,18,4500,1808,2692,20,16,4284,1689,2595
e552ee9b0feb3c29c85558df2d014328,166,126,557301,114115,443186,184,115,499479,149608,349871
9df6f106d2bcc6b3a858d5c80b568d68,157,128,374901,66104,308797,142,113,345624,69586,276038
d9dfce63f9a23dc5c2e63b54f3263ee4,49,39,47558,19570,27988,46,36,57518,17267,40251
0d11ce89b76005730ce33ed7c8eec20e,47,40,70464,16692,53772,40,27,47714,20710,27004
d4f978f6739cad09f61a7c3a62a52c18,114,82,246289,43381,202908,124,78,163300,45060,118240
85bb8535a3e55b5fc573bc52efbd6f27,57,48,83589,39697,43892,68,57,109320,39075,70245
8d3b26cec8475cc16f83251f7a7bf173,22,18,9310,3987,5323,27,22,11550,3730,7820
981403bc7d41824d8a702860a7d72fbb,201,145,914743,211086,703657,261,157,964911,236162,728749
8483883acaebd8feacacaf2329857007,40,30,38635,11428,27207,32,33,27424,12155,15269
f31e129f7f941b04ae40654e9bb3e7a7,40,31,31687,12350,19337,43,29,42279,11958,30321
6732924248374bed56b05a5fc6b2580a,42,35,31082,16427,14655,40,29,38764,11017,27747
6b3ecbac4f2bf4eeabb7026f79faae6f,6,6,825,448,377,6,3,755,661,94
7478c2a5ca7315eab602ae6f2011f8e4,75,63,111930,39144,72786,80,57,133023,51022,82001
2965aa9ebece0bc8fdeba1c67c31564f,142,91,290662,40661,250001,116,86,212000,48559,163441
bb8b311110c6b5868a70a0320f5f9afd,130,112,271751,59479,212272,106,82,228065,50961,177104
1112b3e36eeabcc6376c182bc6b5b85b,105,78,261459,48263,213196,129,104,320206,87028,233178
390e6825ea19024b0efabd2e76890241,2,4,210,753,-543,4,2,753,210,543
477fac37cdba54743dfa2d7e2b94d147,29,21,23199,12432,10767,31,24,23039,13426,9613
a6f761266b8bfa978037a1f6c43778c2,29,22,17151,8859,8292,27,20,14082,7742,6340
7c5ad33e9f5a759f795e724a9540224a,86,69,154622,28807,125815,84,75,155543,43703,111840
13dc5ed48f463492563b7dda9115e9e2,87,58,112542,51117,61425,131,96,310580,38522,272058
6ccd43693011dd900a54a729047d6a02,158,135,682648,179564,503084,209,158,897681,218475,679206
b4da65dd26940ee1b606fb6d485ed464,149,113,561488,110126,451362,237,154,862146,123613,738533
33a1d7f3ea60447a557db06bdf272934,40,33,19619,12669,6950,39,33,26634,7903,18731
cc4f1268cb551cddc824b6606a6e96a3,46,35,76748,27339,49409,53,42,80547,28223,52324
2fc10730268cc9d0ef5beeb794af92f5,70,42,85754,19910,65844,86,52,135488,22114,113374
0e60ace89981960f707c529205aa0f51,86,58,133848,27488,106360,112,85,119298,32130,87168
b80215643d8b7447f2e9dc6c4a6ccd33,202,133,687220,134226,552994,221,160,781461,130526,650935
5a9b32552ac58c062fc8e175d190d73a,69,59,119592,37273,82319,66,57,111822,37659,74163
324124c573444fe2648221193a8bc9c9,136,97,412048,126780,285268,176,128,539404,121247,418157
28ec5775c4e97c67529219f9574fc2ae,81,69,142439,39215,103224,54,42,91109,19393,71716
1530a3a29aca6194cb29839a5673af4c,207,153,715153,126547,588606,166,144,609472,131083,478389
896d12f7161e5f344596e906550e5ee7,59,45,53075,27425,25650,71,49,105580,18446,87134
82f99aa84b4752a688a890201a2551fa,40,30,39718,18235,21483,55,49,88900,24586,64314
49adf82c135658a5517f847a42403174,23,11,6824,973,5851,13,14,3540,1436,2104
686fe37e853f0ba5d763778c4175d3c7,106,79,292284,64294,227990,139,113,284950,55288,229662
814b6f1165934274b910b330a1113390,64,48,162034,53477,108557,140,114,341455,61491,279964
7587b1c8c8550301e7fb1675a9b5b129,138,104,371367,54853,316514,125,89,331363,67036,264327
cf443396d66871f9f5bcef51d9e845f2,220,124,885624,255335,630289,175,110,855921,162536,693385
6882be11a9074bb78c4ee509db04af92,52,40,80546,17210,63336,59,53,63153,22867,40286
2c9e6aa279e5fd9f5089e7961485d9a7,20,16,4937,1683,3254,19,17,4649,2288,2361
33af45e507b02084b3698f6d314db52c,134,94,351069,58279,292790,119,98,251084,54853,196231
09675133e394bd5804dd0f62b69dc03f,96,89,153916,67118,86798,87,78,172763,42897,129866
a3040680973a44bf258388e4c841af4b,15,19,10858,7552,3306,32,23,28606,6665,21941
11d1cb98873fdf40763856e24bcd421b,72,58,106650,32186,74464,68,48,112660,25909,86751
298ee8d789fd4e06ca4b5301a173828f,46,32,49938,15864,34074,46,37,57975,14974,43001
0dde9be7c701ba8b634dc59dcb7d5bcc,110,97,249861,77533,172328,73,61,166732,52388,114344
b2d4f8010c6ddb184b2512e4cf52045c,145,103,417335,63281,354054,107,85,205235,85319,119916
4dfe5bc608e91a6a0d0cad4be65be65d,158,118,477116,71738,405378,137,116,357293,94244,263049
6d91122e86b029ce1a00a202e2b9e0dd,83,61,210029,54196,155833,90,81,244300,60949,183351
19cd7d84f7cf9d605c8172e12f3f8311,161,137,881561,209291,672270,191,150,610625,201061,409564
b14887e640de377bf1033528df75f6b9,113,70,160679,37850,122829,126,89,148963,39356,109607
84403a3d99844978ccc09c89ebe29b42,136,119,336551,113150,223401,120,106,437563,63931,373632
30e05076c412640583b0f21b1f72c38c,47,34,48823,15066,33757,42,30,45891,16242,29649
3794d999cbe4697edaa8e8daa4c20fcd,21,11,4371,1277,3094,21,12,4906,1108,3798
16e4d90dd6b056cb8dc24972271cef78,45,30,59694,18852,40842,47,40,43415,26592,16823
638775b02788f31380ac1fb142414642,22,18,4595,2831,1764,25,17,5165,2164,3001
fc203035e19e8e7d22fc1008c142ddce,22,20,5806,3659,2147,21,18,5811,3383,2428
04fbcd21cf164ca9c1a5551e45ef07b6,72,65,149038,46132,102906,64,50,120512,54308,66204
e6948b035ad528a2bcd94090b4ec3709,50,36,54531,22849,31682,53,44,60304,16385,43919
7232f852621ac6e51c0c3eb1d18e2e17,19,19,6678,4550,2128,26,22,11955,3981,7974
20c9ad7fb996778dca5ecb54c9e1f7f4,204,152,740187,142133,598054,189,135,674715,178664,496051
61689d7253076b88465c327d26e74cf5,71,56,95775,27579,68196,74,55,101964,22024,79940
f35c0bcde0195f5197492ee40e721183,47,32,60756,17082,43674,50,42,52458,21309,31149
337767013b8cec3fc98af33447706245,64,42,96798,34076,62722,83,57,108093,27567,80526
a81d10dadb8bd4afc5271db4a661a839,100,79,173714,45720,127994,117,83,243595,43654,199941
c8574467838c90fe8e24d0bddc527555,125,81,245293,72888,172405,98,79,163168,77569,85599
a8f0c6e32537082d72d756501c5cf4ed,164,112,445589,84014,361575,166,128,484014,81129,402885
86503a5973ff7c7c9edf9c3184a12b14,230,171,874334,112791,761543,169,108,594049,114485,479564
f70ab9f8d540bf12d1c45f48e68557de,25,20,10508,4759,5749,25,19,7588,4132,3456
d3c37c327744072263c1369ee9e5abb0,3,3,276,770,-494,3,3,770,276,494
1b6e37329fd99f1ad189d3ad8c14951b,59,52,88698,24063,64635,99,91,132698,33897,98801
6b5b1d033cabdb8b6dcee2a03176bd16,52,42,49960,18181,31779,46,45,48976,23116,25860
7bd92fa2919bd89cbd55137f0a70d9a3,95,89,211306,48678,162628,99,83,209670,37288,172382
3065cdad8d94ab21892e9e4532f9701b,15,13,3469,3916,-447,12,8,3973,2183,1790
a9ee8034281145265630bb67e0aa27d3,58,52,73642,21910,51732,85,63,104847,25396,79451
20c43c9484bb5ab2fa0a8e038b0ff613,137,114,289222,69692,219530,129,91,267322,72173,195149
bd55c2902f49bb16bf6451378ba36d12,50,39,73404,14200,59204,59,48,63570,17090,46480
88561342860a377b4a48d19392e73115,97,61,133950,28910,105040,85,63,140225,43892,96333
dd768240e6c845123ac20ffdfa12f355,80,62,129288,43449,85839,111,82,190577,59072,131505
1b8119bc334f2e32983b448e6e8947c5,41,43,31335,14090,17245,33,28,30096,11567,18529
5aa9a80044e16a12f9297a87f3d99086,34,21,17671,10289,7382,39,36,43567,9878,33689
a9bc87318313619f423fc1e392215c27,33,25,26427,8346,18081,52,40,51419,12052,39367
4406fb833f21dce6564f3c2b246a1a90,141,109,410310,89735,320575,144,106,438570,89032,349538
2c755197323d4187332cb39398059b37,58,54,121115,53413,67702,90,75,224695,41748,182947
3975d18ed0411db3c4ff87f35d8e386d,75,58,135542,46504,89038,80,72,129107,40961,88146
625c222d6e12c58dc5bdf8a018abaa1c,155,114,374799,66565,308234,154,119,442692,124282,318410
2a603078c96c5615debfae275dc374ff,125,106,292243,64930,227313,79,64,178486,65488,112998
924be70f27312923c1d9cb8343b4fbbd,1,0,157,0,157,1,1,45,157,-112
5fa2f33cf76f335d0086cbb82c72a655,121,93,268113,87613,180500,151,106,386618,83924,302694
1fa1461127299e108eccfebfc0ef4749,46,29,59086,13075,46011,43,37,41635,22807,18828
f458deeaa08710aaa98e6691568f818d,45,31,42810,13003,29807,33,34,21018,13497,7521
314498ca86b495e6fa3b91e228b1830f,153,126,521578,88964,432614,178,125,542460,115094,427366
7e3cbb7e8b9381c0fecd8b0cd951ff16,178,144,534232,110425,423807,127,98,423884,120657,303227
b44237e1bafa9da2b0584dea78df4527,55,37,98108,29515,68593,59,47,96783,27788,68995
a519feb190101cc24835e7cc784e0358,86,72,152714,35587,117127,105,85,196677,46362,150315
76025094c9096d5ac54a6c91d61d2dcb,106,75,213398,53794,159604,94,76,175575,58421,117154
bf9c643c76975b080142096a77fb58fe,51,38,36419,16197,20222,50,49,66006,11534,54472
a84c37d50c21ab7523f6340d89cdda31,140,119,343211,87552,255659,126,102,309521,112221,197300
8b7aeb216abda586c90f223f2d1586ee,31,22,14243,4680,9563,29,24,13453,5247,8206
0770c5c37cbda6a718f46ab64d7a70a4,209,129,579468,150986,428482,148,101,413075,124342,288733
75e243f1aae4338c9dced74c64de5973,14,14,1841,1497,344,19,13,3592,1383,2209
af473cf15432655a3261bfbcebb49f05,60,43,76685,30085,46600,51,47,99116,24674,74442
10cc1db46e3d8204cb497544568a5740,185,142,888821,178572,710249,180,147,984293,160340,823953
a6a86dd042a9a40f4e4406152b655605,19,20,4585,2421,2164,20,12,3432,2090,1342
9b146c8c2d72bb24e0e849344e04d1b9,141,103,372241,106866,265375,180,136,498358,115612,382746
95586a3fd60f0e5a8716221375f7f789,69,60,88813,34153,54660,81,63,114633,26611,88022
f8b3cf1a4d5ea92891e6fb2ff832ab8a,99,80,238420,46102,192318,120,96,291526,51621,239905
f7c04fa48a666949d8f82226a87ec719,26,21,10637,5188,5449,28,22,18075,5459,12616
6ad84dfe27c62596eaf2364c01da1c35,123,86,218400,52053,166347,92,71,204128,64269,139859
f5a91ef2e96c6bd5d529cab05637229d,66,44,92490,22648,69842,64,41,63974,27662,36312
1bf5a7eef527be8a53f5d93dfb749919,25,18,8731,3865,4866,23,15,8616,3224,5392
1459929c2855343ac36b302281f0c9b4,139,110,399260,76984,322276,149,109,333006,94790,238216
bcfb77c55660fb05feb649ffc1d803e5,99,74,143004,37516,105488,77,63,133196,37246,95950
88fa859d32fc7375da7f128f3a49c30f,77,43,88689,27526,61163,86,71,137095,25456,111639
602ac84b8922ca2c1ce5733b60ef4f70,45,30,37555,12206,25349,38,31,32469,11923,20546
75509a10121b8f8be247a1ce0c1d6115,56,44,80647,22242,58405,49,39,43375,24418,18957
9fab27b54a7ee63983e3602833839460,70,47,103311,43057,60254,72,51,115625,41871,73754
fbc180303bfed3424a861d9dae8efa26,121,89,231836,63697,168139,96,87,215573,72588,142985
899763529c94946b03025d9ada35a2a4,28,22,10956,6612,4344,24,21,14036,5829,8207
a0b2d99fe52e2ef5d75104da40b90d45,163,125,519049,80487,438562,164,139,577529,86248,491281
72cfa9c6b1a61b60844345ff750dc76c,32,25,12110,4029,8081,23,22,6159,5189,970
6fdc0c7aa1dd7eaf3f63a1e979b9d555,114,73,181806,32265,149541,84,78,152285,43478,108807
8f603a23757b4d75fa0c52080fb0e8a1,63,61,80891,30910,49981,62,52,92661,24151,68510
1cf84afb4d619d4f02009e5d6390d7ae,96,75,235694,64798,170896,135,110,310125,73759,236366
97a3123e1d4b5c981a9d47e4e447a2b4,79,67,157831,50885,106946,192,142,358257,43907,314350
4b193794ffd2b720e209bd0e4cebef38,19,17,5431,4000,1431,18,18,5526,3682,1844
a5cb65cc722b22c2296c886ee2759be4,64,48,75187,24038,51149,58,49,61088,22639,38449
db6c160e94d341fb4c5455c48a0031f4,85,72,179606,63976,115630,88,77,198516,57595,140921
e3c0562beb8ff29d31e718229e13b27d,101,68,220766,69416,151350,99,67,206939,65919,141020
331a94cb0767470728582078b518a2a3,74,59,119183,40538,78645,87,57,148765,39585,109180
77099a89828d152a56eee5f0f207ad83,77,59,133937,33313,100624,96,56,108850,29186,79664
061250fa758cb5d26a5a6cbae57a9a21,102,91,263812,62858,200954,161,140,330844,85840,245004
fd550495caf80ff339b8d41e46612714,43,28,29254,8345,20909,33,30,26174,8737,17437
fecc7dd425bed832f92c104f438bd17b,40,28,31696,13948,17748,44,32,32088,12937,19151
5a6bc242fc6fa6c898d993952c1c581b,177,135,599916,147056,452860,179,117,679455,104055,575400
242dcb129c9d85fc86d3c8ecaf9f0081,20,19,6444,2706,3738,25,18,7544,3407,4137
1011d4c0cc65966b3832f05aa08cc701,30,19,13942,4464,9478,25,18,12248,6288,5960
0cb47d0cad362b1ae531e277fe261151,63,38,71621,11735,59886,55,31,53782,10940,42842
dbf7cb523a6126c058b7ebf96e74b406,71,50,102877,23464,79413,78,72,78817,23676,55141
b2ad05f5a0ffe84111e5c12508009201,76,61,220085,57451,162634,127,76,261494,50457,211037
96f47d6b2bbd0e997d0c15092fb3aa7d,140,106,324538,53934,270604,111,85,195155,58793,136362
116083fa0ffcd4496f3d6eba4242e837,135,96,313834,62370,251464,132,105,315320,63457,251863
b3f4ce3e63973c1bfe40b788ed5645ab,56,38,57157,21700,35457,65,39,65325,19769,45556
ca4a848c99a55ce8e8b208213637be2b,1,2,168,221,-53,2,1,221,168,53
9f1ce6735f8f421be4183cf3f553f522,75,56,105784,26337,79447,93,83,135645,37654,97991
443545671739a25286bc7b85772f66ae,66,39,142807,23497,119310,57,37,72228,20585,51643
c7cf53407f547e47ebf14e96490747f4,27,22,25094,7829,17265,25,23,23301,12118,11183
abdb0afa7919876dd2d4e5bc7200cb99,261,196,1545957,376583,1169374,248,189,1908950,294261,1614689
6955804fa2a0920d287f9ddfd895c750,59,54,72081,32381,39700,83,57,101468,27027,74441
e3bc7e1139fcb93a0da613ca05056937,63,48,116245,25232,91013,76,50,131036,21361,109675
982d0c16fdf8483441a29b1f154012cf,24,20,8923,5983,2940,26,18,9308,3017,6291
9ef21f755441459777c6785b0e5e0e49,98,78,198818,41810,157008,97,85,177183,60955,116228
e46e01a405175d0bec8f74160166a10b,75,60,87908,33380,54528,68,47,94193,28820,65373
8346e7ac6b5bcc1cd81aa86009621392,43,27,64733,15541,49192,66,45,65786,16514,49272
fc73c346da41ccd5b0a8b75a9f6aa2a4,8,8,1097,1435,-338,8,8,1435,1097,338
e73b7c4fdd708ec2fb089d792f4e789d,149,102,392536,101051,291485,178,109,362020,76992,285028
a13700125dcfbba722b57bc4ffc3bf43,55,44,32341,15844,16497,73,55,56050,12852,43198
a028787336af78e6e7141daf7c11510e,54,49,52868,24196,28672,65,59,57897,21005,36892
11be8e6abd1ecd46cb69d3d7d4dec120,117,91,169467,34779,134688,86,60,99314,39216,60098
23b5a6c20393c4119e028ccc67857cce,130,110,301699,75603,226096,113,96,243709,50432,193277
225786af01274e798940f3136c037b7b,114,84,200972,48205,152767,117,96,202868,47341,155527
a2b134b16f3b1b1b04e5661fa0fa793e,56,36,54430,14364,40066,51,41,61979,16184,45795
52b41f7b83755b4a822a1f4cb0d7e3a1,72,66,112097,42323,69774,130,85,195474,33382,162092
f49b06f1b59db7fa162d59190df254dc,19,11,4985,1663,3322,16,12,3013,2130,883
b94b8b5b0de88432dd35808e1ec54bb8,40,32,61610,21169,40441,33,28,27772,21099,6673
46c07b2de75fc2b0ef6894034179faee,21,17,5750,2443,3307,15,13,4763,3260,1503
96b14f3eeaa3e2a7110ecfffb33ef949,58,52,79353,34046,45307,75,64,107964,31592,76372
0b9ae00dfd366081fb54aee2be684b4d,170,122,515892,86666,429226,159,132,433956,109783,324173
71a82ea2d24a679a7d3607cb61ba9d1e,96,72,181218,33912,147306,98,64,203858,31174,172684
bdca7778ffe863659c96f0dcb523ab83,81,72,129159,40015,89144,98,83,174287,44977,129310
1e3f63f4b3fceac2b49967b318f6bd87,79,80,141443,48021,93422,85,62,186006,37796,148210
da2213d765e15b136e0bd369ab66039b,86,54,168794,24534,144260,71,75,147596,44742,102854
edf5f1835c04854f5a8d45bf5218e247,187,135,472191,107325,364866,127,93,341672,112520,229152
95355b62f459a9c8490492b14bdd108f,95,75,180003,54482,125521,100,82,180588,81024,99564
26e9113522abd1ba7cc2746ff071da8a,92,66,133108,25120,107988,80,58,118901,27198,91703
42ec7635b52cd39f17035176a1b64027,16,17,6061,3371,2690,19,14,5313,2954,2359
3b024e0e802c0ff85d8a6610d5790c36,147,119,411585,73563,338022,166,148,546437,89212,457225
cd7b30713349cff71240f5e23e23d540,113,90,330382,57285,273097,118,101,335322,66825,268497
80191e4e586629a1dc9709e0fed43174,0,0,0,0,0,0,0,0,0,0
e7fc4ad079ef4521d55cf11439a8a913,141,118,412706,75155,337551,149,122,502065,79622,422443
aece379f0824fc95edd79eb41bdd2e8d,83,56,125262,39063,86199,89,70,131232,37872,93360
3769af729f03199a2c91bba0f98bba1d,167,121,369239,64287,304952,119,97,308389,66803,241586
1dde2caafd431bab7a27b9004b3d54a4,47,34,54877,15560,39317,48,34,58884,14054,44830
3cff87ef2265fd5bbc1bdc524924f077,170,138,516773,102618,414155,156,110,441502,93808,347694
5a2646482b61f903db62704c9b369cd7,157,104,481453,138110,343343,98,62,347913,110501,237412
82909418e2befcb7e050a930dcfd4822,77,51,99197,16167,83030,89,67,117008,25898,91110
d5afafb3a4caa9102d2dc555747d299d,63,39,46406,10535,35871,45,43,30661,14538,16123
2311fe722d73bac7a35a5f9d3fc0c735,74,62,102117,43410,58707,91,56,166421,17532,148889
81b4f95b5cc7a9257ecc48ee9389420b,122,98,254249,56928,197321,113,87,198076,64249,133827
956039d77307ffe5dc6ea366fd6d2653,90,73,103428,47365,56063,66,59,77178,41162,36016
743a48f4714939ca477803c1ce8fbe3c,34,26,31460,6967,24493,28,21,13794,10076,3718
cde092779df513618225bb892f2e6b28,83,71,142059,42233,99826,110,80,165435,52469,112966
bdcab69c4a18a88e26c317e239e058ac,111,90,260463,76832,183631,112,91,277603,61752,215851
a904fde7e422b5d8beebe68d2b058cef,94,71,171366,54377,116989,96,78,225183,54736,170447
ada38c8cb9b655d24d83fdfd156cfa9b,90,69,164247,36521,127726,75,62,101274,41965,59309
1525df91f00b76c2f2ce15e06e873442,60,44,85638,16397,69241,56,44,75707,16969,58738
076fee04dc6098a3e9631783eb198882,37,35,27389,10215,17174,28,27,16464,7553,8911
c12ab4846ba029f020fc5e706c4a1068,98,80,141208,49557,91651,86,62,119716,29058,90658
db0ee7a04b719bcc9c8494a9919b190f,3,1,272,47,225,3,2,130,120,10
b582dc1a9b9260834575822f04e410ce,42,32,43971,17243,26728,37,27,36521,15105,21416
4bf7cc81c627d73f9c8637679d27ac5a,39,26,36564,10900,25664,42,41,24682,10203,14479
e2d2b0f07dcd1ac3fdfbcc34e0ea0466,104,77,172939,49924,123015,89,72,160006,40618,119388
706003fdb58b00a2192104838b05a098,202,134,597261,75330,521931,159,130,606878,89305,517573
6537ecd855f07308451ff0c4233fe578,38,24,22382,11611,10771,38,31,40500,11499,29001
8151c1ec3d48b1f5e3a65eae8ad3bf72,119,87,345434,100396,245038,105,94,273896,72998,200898
2b32e19ad2968ac3a53f674e8da3f6a2,67,53,85938,41080,44858,52,44,91298,31161,60137
5b3d02387054f0648f7349e230d56d48,220,127,550756,135559,415197,154,116,555070,136639,418431
6286942474327ea6d87abc258607c243,128,94,302510,89405,213105,159,126,389512,81184,308328
6796ad6545b0e3cfd8920648b5d933d2,73,54,102751,16522,86229,64,47,80065,25530,54535
5fe2728e37384c0966ec54a117a0c339,111,97,234544,51543,183001,82,53,156976,44782,112194
55a30526a6ffc6b66333cdc3a8dd4aa8,38,36,39705,17288,22417,40,31,41565,9304,32261
d28c88f19223156eac5fb9a914d62bbc,11,9,1542,1398,144,16,7,2622,476,2146
5c0df40342c466343f2990d8ec5737b7,88,79,167170,42050,125120,104,74,150517,37512,113005
126bc5a8d17c5edec9756dc0973cd87b,43,32,40037,11620,28417,30,28,21161,14755,6406
7f5fd64df5d6702b32e7acec88992ebe,143,109,513724,95353,418371,174,120,542124,84231,457893
047fa130ddbc4abd779bf43984f15a91,50,37,63471,21700,41771,62,35,72470,27821,44649
cad517965d0d10bab0a247a98e3b4094,20,17,8952,3741,5211,19,17,6560,5364,1196
57eb0762af0102c598f25b4d6c2cb1fc,119,89,272828,58860,213968,93,75,184807,81576,103231
56ce96c2b9427c946d6d0e692f3e5f44,69,50,93584,19157,74427,69,55,67408,27545,39863
8ba876d5137f1988af10f847c7799626,39,29,31565,10480,21085,46,35,48745,15371,33374
a5f9b83a4b2b1c3b302c59f4e03e38a0,79,66,160234,54469,105765,70,52,180744,50513,130231
ba5a18a1d2bf82b4ffccd7b01fe39646,213,122,546762,129937,416825,180,133,549223,103315,445908
01acb95833e43c4b215e88a306533e92,134,81,322237,61149,261088,145,117,314446,86278,228168
211b7b44d4d501f375c644e2e7f3f7c7,21,14,7857,1286,6571,20,16,7338,3430,3908
198c2f882dadc854e3ef163dea2b8e1e,21,15,6742,3792,2950,19,21,6837,3484,3353
f3d679b5483ea54a8097475908a85b58,44,49,67582,14984,52598,42,30,43488,14784,28704
d4b0df7f7c22369471c58c5cc0921c02,76,68,133407,46194,87213,110,103,212393,69771,142622
2b73c42695f5e40fb871d5a52e26ea0a,95,73,197855,39236,158619,79,62,108864,39814,69050
fd5de6a2f6494dccfa8bac1debb9b58e,0,0,0,0,0,0,0,0,0,0
d201d1bd1903deba250aba50b8d4737c,122,72,253060,54332,198728,162,97,289048,56831,232217
fab6a4653003fa7d9040bc9e61b91642,53,40,54905,21458,33447,50,37,72219,15186,57033
8f3d4391ec330d808ecc2e7f6ebb9412,33,25,15848,4489,11359,45,20,14514,2893,11621
957625b3923aa158619cfa5a35187513,67,51,54674,19002,35672,48,39,58761,16166,42595
79e2f16e31811ba57770a56d30504d9b,91,58,148961,37429,111532,76,68,128123,46024,82099
7d0bafd913f844fcb77b394e67d442f3,18,18,3034,2666,368,20,13,4823,1367,3456
f5da1736819f450a7a60b506c6ef19b8,115,73,284008,68902,215106,139,106,343328,128791,214537
ed5171e4c8471f07bf9cf269d325dccf,140,121,297853,43928,253925,110,103,241824,62511,179313
988baf7ffd617636cc5d140a846b6f63,53,46,92000,23377,68623,63,52,71018,27867,43151
1920d16799bc03c3c4553dd4f9a58914,132,109,355741,109273,246468,147,93,433339,72365,360974
ec176c2910473138731e97ee48165472,144,101,567337,141659,425678,180,102,596803,117126,479677
95eba8ba92e273729eb4ca581d694634,131,114,424287,93655,330632,155,129,463584,74593,388991
c95699ef089ffc67a75dab934280ff69,40,39,28097,20614,7483,55,37,45882,11926,33956
6f9015d3a34072a13fd0699a5349b51a,59,59,101339,47057,54282,106,60,146375,24028,122347
f7a6fbb2a24d37680a408f39fdea8b04,129,99,348977,76790,272187,148,101,410277,65130,345147
bc287d18d9fd57db39e644ebea60d975,34,26,29036,14630,14406,40,31,31607,17778,13829
fdbc89b7d99d901a429a3f3c0f9d22af,170,104,683090,127893,555197,153,135,620652,163703,456949
96fa19e420d2a6cef4d8a1ba7bf8add3,186,115,523421,82054,441367,126,102,302563,110572,191991
d6018b3f27bd3521050c24e0c4b68a85,44,38,43943,19037,24906,38,30,41591,14701,26890
d8fc13e3a276282e825e2067fe7ced6b,42,36,49050,14437,34613,43,38,35447,15170,20277
7b6e88ff072196b207979741e4f7426c,144,121,446451,143881,302570,140,123,605307,162191,443116
b3a45a54fe75ff47e4e2b68e36574c99,150,124,742881,187018,555863,172,132,659900,157731,502169
a18ba121916dbe98e2c51b501ae0a812,124,88,245540,63093,182447,107,81,217237,70749,146488
4f351762f91bfce6dd72bd874715fde4,47,40,50040,13484,36556,57,45,51085,15753,35332
15de13fdfc8f0c97213f051674080da5,116,104,201535,60721,140814,80,61,136543,36929,99614
f9d5307962bd0bbb4d77ffe519945862,22,19,9077,2831,6246,23,15,5680,2232,3448
cbc28b5abb6a2e4804e85af0cd916935,72,51,76033,22153,53880,55,38,67093,20797,46296
87d19dd2b0c8e659e77f420ef3a8b0dc,110,94,212870,55531,157339,134,106,198199,55637,142562
d9bf77510dc927b502e84967ea8f14cd,169,120,712066,127657,584409,175,139,544673,130534,414139
5d1dd6200b321ccfd7921c1333585875,114,102,261309,58245,203064,100,86,239730,61573,178157
2413c78ed4c54b30ca5f75b047d8ecde,124,114,303852,93176,210676,97,66,213511,63763,149748
9bfd54645a67387c6e7bb4a48f1047e3,32,22,23491,10246,13245,41,38,51294,12143,39151
b8521176a1e7fe22c14ea3e2613a1ba2,113,73,197349,51381,145968,138,118,401303,54657,346646
78fbfb3f7a13caba7ef7e76f6c8968d1,14,7,2467,905,1562,15,9,2416,1527,889
c0368a8860477fc86487114486be0c28,34,28,20161,10253,9908,33,32,26776,9277,17499
fafa9cc8f3df6a60735e039716c3a3d4,150,122,420576,139523,281053,200,161,660654,174835,485819
905f9b31a58d0eebe8a09b488381d8f4,56,53,88152,25747,62405,56,42,57597,24233,33364
124da6fa30d5c09e29ffc7fba2694a1c,119,98,246269,48635,197634,148,112,316342,67532,248810
ac44fa86ae0b6ede686baceb296e40a6,110,73,249405,68244,181161,150,126,507925,85125,422800
a1871c656187f299cef28aed702c1f3e,179,126,693265,107525,585740,162,96,463344,101880,361464
f9c9a35180b436346c781696d8250fdd,142,97,340100,87639,252461,194,139,510963,84336,426627
c40c27d665237325878a499bde36f778,100,81,272391,66922,205469,80,64,217475,72588,144887
05d62484f605865559ff0778cf9fe00d,121,95,202376,45160,157216,133,96,240417,31477,208940
326a867d748f64bdff5b5d74e42834db,104,83,194560,86111,108449,147,128,363110,67817,295293
b5ca4e6b9db7cec580e47bfa7347749c,128,97,241272,60606,180666,99,77,202094,42519,159575
ca5598bb3d9ac6b436e316bdfcbde0cd,119,92,285646,92652,192994,117,100,483349,81414,401935
18e66246f75c2cd8d65eaf795f6e74c8,183,142,635463,205033,430430,195,164,776835,166837,609998
68dcb38dff89355865db485e3e3160e9,25,22,17935,5049,12886,27,28,14069,5125,8944
77a1f8ed8c85c0447bd232688b6f05a0,83,50,123974,27206,96768,105,73,126906,33554,93352
8347118cc24b13dbeaa6ec8169e8144e,93,70,109436,37589,71847,91,77,148081,41527,106554
f89b51daccd4991edf178d45e808651e,119,107,340043,62351,277692,123,83,273482,66259,207223
7db19bd791eb8fe5c22be1232e3e8468,99,69,172196,48908,123288,114,89,234566,44224,190342
304ab9881e34574dc53e2baa2508734b,50,41,82505,23639,58866,66,49,83071,27146,55925
25bfe51f6c6f572f191b0419d99d5313,172,129,372365,90636,281729,123,96,267466,83247,184219
5be826b8f274d7f556f1653d27ac4f2f,51,38,66333,28653,37680,95,80,143711,31092,112619
0fbcd839c815a067c16dc33e301c945e,38,30,26586,6744,19842,33,25,26740,5559,21181
0181db113cf36a95c4c63e9c23ee7c45,145,113,300154,52564,247590,161,108,328930,58834,270096
f5d552b231ac0e41ae5178be26194dc7,40,31,60842,16363,44479,42,42,29664,10381,19283
4e8567053119e297e8515e8d77378a7b,156,110,413925,109696,304229,179,144,470588,93953,376635
6abababf2815f906e24ecf34c962c209,13,12,1997,1922,75,12,7,2907,789,2118
9b35acfff900534c301f7461fb0b995d,83,71,114273,24167,90106,58,44,86234,32256,53978
e4741d463e5c61d0618912d266978919,189,117,557344,128760,428584,158,103,517348,125645,391703
a730626c127e2e1feeda571908324601,22,19,7184,2611,4573,20,15,4570,1202,3368
0c1ad48c37d1f218f03e22d85447afd4,213,136,766180,103833,662347,169,142,575473,195045,380428
f0598f1be25c539199229f780469df05,108,94,181572,49291,132281,79,52,119552,30009,89543
183132dd35e6982324d6f0663423aa03,15,11,3041,1337,1704,14,12,1958,1185,773
628e11b264b157dddd9ac9a64c441df0,130,97,464692,114882,349810,153,125,561763,158433,403330
a014734d965b0348b41af9a1c1da29ef,35,28,25205,6937,18268,47,30,49142,9853,39289
372c9cae383fd8449dac4e461d4be8b3,30,22,19365,13001,6364,22,22,19349,11370,7979
93f942005874bccf5f494c997af20098,45,28,44762,15778,28984,47,39,51003,17130,33873
001f558f9710427883dbd060f6ed1039,149,114,431698,86498,345200,120,93,306981,81236,225745
0c8d1b9a911fa1977d9d5309370244bd,129,100,366238,83513,282725,123,85,266000,63545,202455
3398782bb8125483250740c785644af3,185,124,537746,79546,458200,110,87,269275,110977,158298
3ee535935b5afae7f2ef0509e53f04c1,65,49,83167,23898,59269,82,74,105240,31915,73325
c59aa2d7efb53bf8149b788ccada7a12,150,114,398331,65541,332790,132,88,387962,62166,325796
09d4d5d79b657ccefba5363856eef9f0,173,132,519732,79373,440359,126,94,352601,84235,268366
eb28092cac4877656b7a651e22909a5f,34,28,23182,8351,14831,29,26,20577,8370,12207
6a9ae49d6217fb21c8626aad40a73ffd,71,51,66753,16442,50311,48,40,54312,18202,36110
7d2cfbcddc05350f670d333be7c7533d,113,85,208903,34882,174021,119,97,210844,50452,160392
05e13fcbf626926c4c0ad46de3b2e6a3,94,71,145394,45951,99443,100,75,158810,33104,125706
2e30e91e5c673bf3917e9401e9ffa2c9,72,53,138379,27742,110637,69,62,126679,40480,86199
106bf6e1c0474b68b27c42c8dc7b3681,35,38,22742,18344,4398,41,25,31936,9320,22616
3878f1ba3fb86b5fcca11802ab5a4a0f,53,36,44250,17999,26251,48,40,55191,20786,34405
caa82a5f6f476aaf98079a4c5bb3627c,27,18,6822,2786,4036,18,16,3323,3362,-39
89c01ac4e33dd8a1acd3f9b261a5a124,66,54,109672,33971,75701,74,51,86625,36197,50428
12a02adb055d06148009538ff5fcb727,88,63,147113,39591,107522,108,78,183265,33950,149315
e344199656eeb62067f1b1d6b1ca0b0c,128,91,302378,76449,225929,133,105,371793,82066,289727
6caf5b1532ff21f0df384329d051dbb8,168,145,736967,146486,590481,184,133,783610,96582,687028
402d96c7bf94edb2ef2847fd4da873d3,29,17,10942,4223,6719,25,20,15923,4076,11847
23afcf95b98843dad1cb3e241c063837,39,31,43270,12614,30656,50,37,59646,14777,44869
b7d7944cca083bc8315399041927e0b3,121,114,281616,70088,211528,110,89,258056,89478,168578
74935b1ea5095f2646d74d0bffd65a58,162,132,520610,128542,392068,184,127,565412,135875,429537
cfcdaf273625e97d62aa19ec7ecdcc5b,68,59,126154,38642,87512,59,50,61242,46552,14690
12e8b1a85ed1858c2f08461245b70ccb,174,125,418205,75103,343102,85,76,230795,58907,171888
64edc23d783745afe2793e7bbb04620c,18,12,2754,1479,1275,17,18,2455,2145,310
3cc04520ae2bc70040439061ae09759e,23,16,9195,3393,5802,30,18,9112,4611,4501
d87b31554dfb5b16d7701798c8690d73,128,98,416782,89346,327436,142,105,400983,83523,317460
bea2b991be4d468987bf362b2d1a0ed8,75,66,125425,43509,81916,107,76,162674,37024,125650
581ec3212b29d386e0b95f89e18ae850,25,22,11878,6125,5753,28,28,25198,6735,18463
284dc448c0b6dea5a1b5794cb9693e99,34,29,24692,7647,17045,36,26,19068,9456,9612
fb0a0a5daa355880a3eaa659b8f8ac5e,40,28,25555,9085,16470,31,31,20542,10634,9908
f66122babfdad50be864d519fa20e154,148,118,570149,104853,465296,143,127,445993,164914,281079
964357b2bffe4a9917311dab99908c49,121,89,264177,55016,209161,75,54,137791,52671,85120
b8ff39e201f94bbfb98e0ff5e021793f,111,77,207931,50015,157916,108,90,237389,74247,163142
070225d5273a6adbeaab34e2d3304755,139,96,315455,108904,206551,152,139,365992,103852,262140
1fd409bda8d548f95ae9a7444f8bcd65,26,19,17663,6725,10938,37,31,27143,10554,16589
a1952ee6fe86a792ec04b4dbdc04f0bd,62,54,109662,29641,80021,64,58,100952,31690,69262
899b09134cc6ec601f923e3c5ecd64b4,130,108,264812,51273,213539,145,109,309708,63257,246451
70b0ecddddda8bc3f9a4c6a4f500081a,63,48,70834,23232,47602,61,51,74807,25304,49503
51d959e7de94647dbf57a05046705687,40,30,32454,11729,20725,42,31,35607,12812,22795
cc02d4999af3ebcf0ce5b71254560ff0,181,148,514745,135358,379387,133,101,375422,84662,290760
b408c2705df8f3130465a9ab67fc571b,73,59,127739,41394,86345,67,51,111609,41675,69934
a2416b746d822fea52c5512c9d94cf55,94,70,156509,40163,116346,89,72,198208,30307,167901
5f8076d2bf63d757029ea57baac1a4b9,154,127,566872,117570,449302,183,161,630927,172207,458720
1ec68ffb50152623b91b87c33d42e12f,66,48,77973,21083,56890,56,41,65162,22451,42711
483197f653671b29d4f48ac53029f4f8,143,81,370549,96213,274336,139,116,331665,105596,226069
636232554868f3f8e77a527d9fdb74dd,66,52,65871,18956,46915,46,44,35798,23496,12302
a6b83ec26d18d44e4110397f013db039,50,48,69160,20233,48927,42,35,42903,25801,17102
c35a9d6d1780bf37723bf32833b69d1a,11,9,1981,1085,896,17,15,3009,1427,1582
7317603878e88bd5fdee71a644bab046,145,126,418442,126204,292238,155,117,430044,82534,347510
f52eec0c9db27690e096ee727304dbc6,80,66,157202,35974,121228,94,70,158230,40048,118182
ebf24f499cf71c17df71233b57efe9d4,133,100,344117,65230,278887,141,106,424583,66051,358532
b24c98a3106501b7da89df9710117aef,0,1,0,39,-39,1,0,39,0,39
a745501aca60445204652986e1e2f9af,193,128,782494,215689,566805,244,176,1282213,177773,1104440
157419c21f7622ccbbd58ed3de98e6ab,83,56,217790,51899,165891,92,69,240711,53390,187321
8aebd68cc2a0a2b2a0437f39c0780b46,31,29,30163,13495,16668,34,24,35755,14096,21659
f1b1ad1f3ca0342e0e2d3b38394550ec,47,41,103661,29418,74243,71,55,108485,30015,78470
21e0218e0295242b396527e98a2a3490,116,76,159889,44708,115181,108,73,147921,39345,108576
bbbbd5118eefaf022a3bfde10e43ccba,134,119,381060,79872,301188,153,124,373304,65850,307454
8aa9cbceb509257e163b8f1608ebd9f4,88,54,142880,29256,113624,82,64,108527,28825,79702
1187e41d87333bd00c3a7123edbe6cd8,125,100,353337,117568,235769,168,112,397781,90286,307495
a84b36c3ed5240a4540c9c37be0ca423,141,113,386701,103871,282830,109,77,313936,82706,231230
c3680e45b76a88103cfdd68d027155c6,59,48,77978,17795,60183,36,28,45041,13846,31195
f2c56e5050b9085be821a279442e2db2,106,88,366005,84785,281220,169,138,486975,84957,402018
509cea00f600ed4f8c69e0f7de0ba168,41,28,36971,15531,21440,43,26,35276,14107,21169
d2535e1cf231a0609a868cda20e65645,11,10,1762,1593,169,10,10,1663,1702,-39
0b2f5a9660fac8da36af76ccd94f000d,15,14,3667,1334,2333,17,11,2850,1089,1761
72b3ed89092085648a7e945bd31dd517,103,88,199264,51222,148042,129,77,234005,35837,198168
e8d8618f316719468fd7429e6536d983,100,64,185916,50251,135665,90,74,196279,64160,132119
d64380aa181cded6eaaefe003bf4ea4d,65,41,137741,41082,96659,77,67,127235,43613,83622
7b1f196ee6d5837f77e43cd19a453056,137,113,434881,152924,281957,182,146,620485,114377,506108
1f29b81e72b76564b551cb96a68a7bff,30,23,28660,8997,19663,37,30,30881,10283,20598
ce05ab91da42196d448b09293ac4a60f,122,82,300642,41353,259289,128,94,291776,63288,228488
b600f6a1e27a0707e9864c0b446609e6,17,5,4190,615,3575,10,18,1901,2104,-203
e4e556116f4026c6ecc7c53e6dc3bb5b,93,75,121529,47479,74050,118,97,186452,29466,156986
932286e7ba76b1aa4deb8d1b190b099f,131,94,315444,69538,245906,108,76,243721,84850,158871
7d252abf34b4b1dde171819b60a5ebc7,67,55,78859,27306,51553,60,47,79154,24475,54679
3ae0cada34082907a0dd607209720631,141,93,275481,50045,225436,115,74,195983,63603,132380
a40311b3585f0e453520dcec1ffb19c1,101,80,179167,49633,129534,84,68,186743,37504,149239
01796fd8c763fed6ca70673bd7e2b88e,116,78,279418,68089,211329,147,88,335461,68395,267066
cc98f747cb84a7803d9153a872a6a509,108,86,231771,48431,183340,116,98,298989,57841,241148
ee10df229b745c6a362d0ba5a53fe143,137,108,333895,72764,261131,128,114,354434,66181,288253
6dc72a255872697031633d39286b8117,140,96,313213,66839,246374,130,95,259867,63050,196817
2156419e45ef2d55682c7dae51c04209,76,64,164308,40935,123373,58,48,90394,42774,47620
4e447787a8632b1b4486961a92ab6623,26,16,9780,4671,5109,23,21,9999,4691,5308
96f8078ad6e09e1fc979abdce8240e19,31,26,28411,9137,19274,30,27,20231,9885,10346
4ed3c1c3de3589a7f9d254a2ff468ee5,74,58,124402,29565,94837,73,63,95647,32279,63368
3d53cfa26fa7118e57ac5cb7a209966f,112,80,214794,48568,166226,102,88,241137,64096,177041
91152648fc0cac20d1cf3ce5f84b80de,100,75,209840,67904,141936,180,135,503205,68751,434454
8f9c0fd9345a4344a2a98f1c3dfdfe56,108,92,302177,88972,213205,121,104,338551,91808,246743
d6fe83c1e733d94aee3f91ea1d7ebe45,166,123,984177,161408,822769,201,173,1016464,161650,854814
299f5f5551ea7bd3db79709488eef149,101,84,176857,45611,131246,95,82,148106,50362,97744
1e988066b28755e7fab7418d34899840,66,50,61205,22497,38708,53,48,61500,19245,42255
547bdc0dbae5f8efae44828fdbabef5f,231,162,934753,137165,797588,177,147,561703,165821,395882
e8e2b2936afaaf06c20d7d7a59dcbdba,96,78,271830,63628,208202,125,102,346820,81197,265623
51e55cd5779b7ef49f33e2f47473d070,58,44,41755,12420,29335,38,39,26691,12159,14532
8d067e4f61d30218e0d59cb614553ac9,160,132,673255,117758,555497,211,149,742981,131269,611712
e06727c34c30c4ee6df3482dc2aedb87,40,32,46481,14241,32240,36,27,33044,9470,23574
39023743073b7814ffc25e6825e1f97f,40,35,27815,16574,11241,45,36,42447,12700,29747
0227204ce79704386bfebfccf6526b13,64,47,99900,21189,78711,63,53,119965,20433,99532
eacd9ff14231114eccb5e86aac9e3b71,38,31,32298,14413,17885,57,42,94497,15880,78617
6b37c499fddf336b9e280d00047f7f28,156,116,461860,90354,371506,152,106,492603,122419,370184
5bbed53bddbbbbf521852c92b14f782b,101,79,140840,39328,101512,83,64,143637,43182,100455
dd9fd2187d90c9dbffbe0e09cd02f2cb,55,45,60410,15369,45041,64,57,58617,26568,32049
b9e85bc56fa013c88fa730f8c71ad18e,36,31,21726,11587,10139,41,29,23118,11329,11789
fb437d43d6e2ccdc7687e05b86bec018,42,31,58244,17725,40519,44,39,64484,18388,46096
2bfc9d911c5ea1999fb8116a1c8754be,180,109,622843,104393,518450,176,126,495903,95032,400871
1e6d790b3ee1eaf14790046448008805,72,59,131255,41754,89501,46,37,74790,29645,45145
e373e2b18ac49473d913445e9e10e25c,40,31,41781,17740,24041,35,32,40453,17069,23384
a84c662a6bdfa888b88cdff49db28652,11,7,1921,431,1490,7,7,483,1531,-1048
029eec3a734e71c7c3bf95186aee7625,104,88,233704,64474,169230,108,90,214156,70992,143164
b413cf4544102fe70bfc075db0ec99e5,173,116,591257,134594,456663,183,131,665179,97350,567829
a9623f71bbc55a65204ed1848f251d6e,38,27,34732,18181,16551,39,33,47338,18606,28732
f8288203531d1102d94d1dea1071551e,49,40,55511,12285,43226,36,30,39005,14631,24374
963564258d78ac50306744c7df06c767,20,21,10939,8081,2858,27,21,18362,4805,13557
3766dd41f8cb109885d9444af3ecb358,90,59,136231,43383,92848,108,91,269143,54013,215130
61a44001432fee242a695977bdb45869,133,88,404906,104246,300660,147,116,512428,125742,386686
c88c068edf6f6c62056a261bdad88978,103,78,246296,44536,201760,106,90,230854,53782,177072
bf09737a73ffb0ec5b53715ae274ad9d,165,123,344973,88289,256684,124,74,208981,99940,109041
05c3d45088e291cfb7db6b49d438ad70,43,34,26487,13878,12609,40,34,35951,13598,22353
bfdb96ef32bdacaf7bc9c5cbf4aa44f5,59,47,64933,36124,28809,99,66,141454,21095,120359
87723df6f4a3386b678100639872600d,14,8,1986,640,1346,10,7,1158,943,215
c19851868a29d2d1d8376f0c42bf78a7,162,106,372457,126479,245978,111,90,269951,140894,129057
194d1a0be4706071023af603d12d14b9,19,17,9702,2709,6993,19,15,10099,3488,6611
ad36fd85beecf1281ccedb4a1f91bcf0,99,80,189450,63122,126328,148,128,308136,59049,249087
7e73bbbdbbf2cf68a242f0e87aa68ae7,132,110,339779,61145,278634,132,94,280544,66784,213760
859ae64564693b51066dfeb19fb64ec3,68,43,88244,27250,60994,59,48,77913,25159,52754
20ee4530656b939b49312b37a514f781,51,31,69891,12364,57527,53,43,47610,21475,26135
318bea5f26fc8dcffd62271033ca4ea5,100,87,211524,58932,152592,80,66,126899,71779,55120
890ba152050efab08f0ce073da4b8643,48,36,56455,22797,33658,43,36,51195,20687,30508
b19579fdc9e8f6440008ea05320aebb9,5,2,256,28,228,2,6,98,141,-43
3287d600e8ddfb2158270baf5ff6ac6c,96,73,206041,50403,155638,99,77,174787,64647,110140
5d63108b7ddeb0477ac2e5d4c2924ca5,21,19,17854,5078,12776,24,19,14189,8069,6120
6655fbdf3e1046327b1933180e667d6c,39,28,41836,8544,33292,36,26,37407,10027,27380
b8139e3dff813e5fa0be16894e62bca1,52,40,76102,26569,49533,47,44,52744,32500,20244
fac461126f7b2c4a0492dd3862a04ff8,54,38,66005,18043,47962,35,29,43455,13975,29480
a6dbc0e524fef31ca36d13e8ad4b70ce,32,24,15543,8242,7301,27,25,20555,6166,14389
a6212b10c154305c82efc1a676f68a3e,70,61,105839,29138,76701,77,52,81935,27624,54311
3875a87897dc73b181b6668a98e3dd3d,172,110,699100,118572,580528,234,170,828799,243859,584940
1e4b2cf14ac8ef83adb2ecff5b8117fc,36,25,26119,6551,19568,26,23,17065,8190,8875
ff97d145c9e13395e029c666a489416b,26,26,10536,8012,2524,31,24,15114,4529,10585
7062294041ce5f1d94d97b7d3d857730,148,130,405784,102898,302886,172,127,481614,85381,396233
c74223a7c90ef87c08144adf6c177d9e,122,83,211638,38132,173506,112,76,160902,50660,110242
f8696a580a253ec616f02f4482473459,83,70,186194,52229,133965,103,74,191981,57880,134101
3e9ee19c34ae98c85b986903c485a8a7,55,39,36205,11540,24665,34,36,29156,9587,19569
efaf73eb41b12dd067b2aff3863d448e,68,55,72904,17957,54947,82,73,101115,28171,72944
18bc635a25747e35d464b6c346d2cfcd,133,99,276043,43626,232417,129,115,261947,69789,192158
4915ff640d5db60adb2c3bb9a024c0a7,23,27,7108,4609,2499,28,20,9574,3932,5642
368f9d8403a18d5cca679735e8ca0034,173,128,515880,65163,450717,140,118,367181,55083,312098
ea9ea4ab9352ad1aa529a40503f0aade,24,23,15541,7555,7986,29,20,17976,8108,9868
727d0f8566064c5282d15844ed05a733,65,53,90569,28338,62231,47,42,65477,29708,35769
114807f32762a81e0744e8fbf4ee9d54,92,59,142521,32040,110481,71,63,94379,43800,50579
f496c1df80dff518d4e20d1fcf142ac9,94,75,113403,31780,81623,91,72,127280,26817,100463
ee596155d49f2abbf237fd3633e0e5bb,59,34,79877,20494,59383,51,38,66092,21961,44131
14ec1cd5b18d9d7ab0ef0c65b2454cd8,118,95,189806,39234,150572,111,91,162670,55417,107253
516469f61f2a206c920e3a93a3e0c415,36,22,30930,10590,20340,50,40,52325,14388,37937
a6128d067d18ee413d0b62bb6df9a6fa,63,41,59406,15215,44191,75,60,55776,23155,32621
5ea96efb751e9172d744849c2ad91f24,50,39,63634,22303,41331,75,54,92644,24836,67808
c2ee26286eea642f50f249ea5eea5448,53,43,81407,27124,54283,51,42,64207,26393,37814
985e6c49ca8819584b89b19abe76105f,54,50,73824,19463,54361,68,46,79689,17647,62042
1aef5fd2713b4970611eb731f7ba3159,98,84,167416,46663,120753,83,69,203928,29600,174328
d2b7fd76d2ffcfe5dd8604f8f5ded510,115,94,219333,47503,171830,100,82,185315,50344,134971
7b631644cf1d63121133524d851ac789,151,125,557264,91329,465935,134,101,345891,69740,276151
013e4559b68d5061b3f2346a8ab62640,136,113,342995,78755,264240,100,79,240179,73457,166722
65466d8d41b751452cbe08376da27548,79,54,167484,34193,133291,106,89,195444,46427,149017
59741931a5acd0769c036d5af79b28e8,75,67,94680,48644,46036,95,73,198567,42184,156383
ceffeb9c0e14478eb6779d9a1ca6877b,130,105,252012,54802,197210,98,80,134152,50404,83748
860b1ee708bdaf4b5311ee086c225e89,118,104,287250,94037,193213,151,130,447572,80754,366818
d2847cdf50e352794e41e53b2fffb681,6,4,1019,1275,-256,4,6,1275,1019,256
05c0be739176983f604c3873cc322209,15,7,2000,669,1331,9,8,2015,493,1522
8ffe8838efda68900c9b89c78a1370b1,118,77,472229,108417,363812,174,151,653463,118779,534684
91985fbd4b2734642c9049e1ae94508f,141,110,418348,108634,309714,210,158,690503,87097,603406
fafc88af5ab1bcedc1bf58bb7c06b518,86,76,85046,30185,54861,67,53,85963,24123,61840
799e3823ddfe7f05c8a296ecf5d6701c,154,108,486930,152783,334147,155,104,468607,146672,321935
88d19dedea82eb1db2edc1b0dbcd243b,97,70,220128,49946,170182,102,68,186022,45326,140696
bd03c39d1d3d6cf1f613e5f273794722,255,180,1032179,142141,890038,216,162,1009300,142267,867033
60016d2f89f394c8d978a849a0e7b244,121,101,407464,88272,319192,185,148,596279,68344,527935
998dd58183a4b81783f37647458c37dc,74,50,66951,18925,48026,56,40,54920,15443,39477
589cf5ee0d1c1242babab8b665c3e69a,134,126,418565,87624,330941,149,126,505297,103204,402093
2f57a7ca1c1fdcbc39c8c094d5766052,128,108,255455,92148,163307,118,88,313922,79295,234627
51d4f97af118376db53423b8e1d7d2bf,109,91,190472,57096,133376,110,99,192104,67376,124728
bceb47e2d7ec90a8f61967d9e1e2b2e2,62,56,108291,40894,67397,104,82,200411,50183,150228
eb452c8cd2b5af879fa8645b5f9e49d6,20,11,6740,2836,3904,16,14,4962,2511,2451
46a3b58ac4e1e25c32e645e46324c487,189,120,502504,66051,436453,127,105,234482,81558,152924
a9f7631d6e1f3d20f6c0b3e55bbc64f6,104,75,202558,46235,156323,131,88,302688,49547,253141
463e35b13b0e514a4e96111a87083e24,94,67,185092,62628,122464,126,92,409826,48991,360835
aaa53242a4d387316c3a09518ad1f834,160,128,433834,79333,354501,162,122,469361,58669,410692
e11f086f7cbd239f99e07c4359054574,130,90,420706,84558,336148,126,83,350298,79535,270763
7ae78efa67e2bc0abe020b885fa82555,92,74,192343,65046,127297,96,81,257716,69339,188377
aea7e5d6120d94b430487b149c6448a0,134,106,364135,53002,311133,128,103,323760,52385,271375
3b57d041a2d5b617417c1cb74211b697,81,72,107778,30547,77231,52,43,64768,23687,41081
987a7cff90edb899a102a9608bf15eda,26,22,14278,4362,9916,26,22,6853,5360,1493
b210e66e0aa9daf6286137041ca8a9fd,134,98,490701,91941,398760,127,103,469316,106117,363199
abbc1cf9c3792ef1aa98cdd65dc18943,60,56,72318,35737,36581,51,42,84951,28734,56217
3f5fb366329c02b33b999a3c8e39f3e7,40,32,38744,11028,27716,46,38,40230,11789,28441
bdd23b15568a44b1d5fc99cf7e5e736e,154,104,640386,171009,469377,162,138,766614,169170,597444
6a32d7806c68f56372a996c0fd6a1251,98,74,190512,42259,148253,105,75,195151,51440,143711
04f27b37dd373a19c9c6a8c324ad43db,88,77,188699,56122,132577,79,69,152194,54007,98187
b21e768adea97f8174c09bad2724c64c,58,43,39106,11125,27981,46,40,40275,15618,24657
14987c1558a11ae18eddbf3d08f932bc,55,41,68839,16451,52388,47,39,64540,21919,42621
8f813255680cd2564ffd8e2d94292a92,85,67,133660,32341,101319,84,69,136105,42385,93720
1a3cd4f8ff084db27e54b40498ba5fe9,131,103,410377,110588,299789,184,158,693802,103203,590599
ae72a8354d436c00328f199acd162667,173,99,836745,187308,649437,167,144,810283,170254,640029
08498c768ffd47cecd85d509e5d86722,161,106,349247,57871,291376,149,123,258786,63907,194879
f2b4cd72707e44d235c3caefdba75bfc,120,101,236293,86265,150028,144,94,362392,57747,304645
8510e4a3798cf075a66d50aaec70efd3,91,75,208386,58061,150325,92,69,171569,60250,111319
b4e21c4ed9d5c2ae655b9d654f24baf7,45,30,31003,15793,15210,48,38,53157,12773,40384
830055477dac7c2a30563e34d552039e,109,84,182791,38303,144488,113,87,193226,48701,144525
d07caeefc27e7207a6bc51e713695154,84,71,122844,25424,97420,92,63,101756,18270,83486
b0ed9c987fba2d18163d7fa52ba9abd8,40,31,29862,12538,17324,46,33,28890,10932,17958
21432cee022a275a24f03404190b245e,38,30,28311,10219,18092,38,26,26477,10504,15973
ef61ebe362d2ce9b5d7cc3eba1eb08b3,84,64,145485,35482,110003,93,80,153355,47284,106071
c4b72bb4cf64bfe0979abfbcb1b5bb04,54,43,41755,23038,18717,62,57,66466,16665,49801
c796dff8861ec0b0992f6d287639cda0,17,16,5425,3334,2091,26,15,9279,3001,6278
c6b2ed126b97454c6ee8649937df6fbc,40,28,45836,19656,26180,47,29,54762,16789,37973
255017d3e783473f214e0e62aeed9fad,59,50,43282,15064,28218,47,39,47983,12073,35910
0061adca0e8f7c19750d1b5b53131d93,66,49,79479,32015,47464,85,69,106544,30114,76430
17c269aeeaf63d4d4b8888e6179b65f1,137,98,313622,87422,226200,199,120,389052,93823,295229
5b31c627ed72325dae3742ed8ab40c5a,20,17,12739,3902,8837,19,16,8563,4001,4562
0deed55413108cfd735b66b58dfb7d04,37,33,43102,15853,27249,45,28,47857,13718,34139
400e00ed1d46949649806eaf15d710ed,165,133,336830,80736,256094,120,89,250286,78429,171857
7464c6be1e812663217831004294059e,62,45,61866,14424,47442,60,36,41024,19119,21905
4248094aa30bd6d0b3d4b6b124ac025c,65,54,103018,43801,59217,96,76,167782,34755,133027
204e9974e913d94159e0e61b21eb64c5,95,71,177312,34606,142706,74,62,126426,36999,89427
7cbd413691e0034366a051944ce0b3b1,22,16,8587,4220,4367,27,16,7427,3715,3712
e6e05091ce84bd7277b3f440a5256592,101,74,94496,44612,49884,101,73,164493,39634,124859
58aab1c66e6c1341509f1305bb812ccf,105,81,165211,43414,121797,114,86,189266,42426,146840
5ccf38bd3dd2d6ead9ba1e6e1e201a9c,89,63,173215,50395,122820,137,120,298927,55239,243688
ce34a34ba11edad39fff9c12d3e0ca79,26,21,13840,7971,5869,27,22,15628,6886,8742
a9a2693cdfc0b2aa4b4c94abb4079c4f,131,93,255925,50202,205723,157,114,321437,48784,272653
98e379827522c2e2e31166a39f80aec6,151,115,301650,94971,206679,149,109,260581,89567,171014
547df4e535fd3cc93279676496680ffc,54,42,53405,20226,33179,36,33,31836,16653,15183
977fcb7c68fd22f4914802b71b601893,106,93,228614,55016,173598,94,83,175720,46397,129323
760ae0f8e100370ded09114efb36c553,170,140,661772,71255,590517,164,142,590647,86348,504299
7f1328dcd0265f585821c3f760b81d56,28,22,13712,6810,6902,31,20,15099,6063,9036
64f90db58989cf389d635d5015700994,113,90,305252,63402,241850,127,96,291717,52077,239640
f5c8150458f78abf8c9922ead6fac586,115,91,240378,77164,163214,113,85,289012,56228,232784
fd638b76cd28fdb396ef40ec8a24eb77,53,37,40047,31846,8201,78,65,105712,22923,82789
ead66120fd415550d6e8729ead078964,34,26,37416,9948,27468,44,40,32641,14237,18404
0a6b10c26e1c6b9a5276dfda268114c5,71,55,126112,26068,100044,37,26,43930,17157,26773
790775e1360b96930b67af288ae98b4b,91,63,152836,44220,108616,103,82,220675,46093,174582
5c6e90ae64feae24cae15914dc9f4c4c,4,6,265,664,-399,6,4,664,265,399
e252bcbdb5d3663051c7fb581e106311,48,34,30350,12857,17493,53,50,71884,16239,55645
a31c173899cc981a415f687d2fddeef4,48,35,38415,8456,29959,57,35,63675,11021,52654
ee66d99420e7943046104158d5cca4b1,148,113,386109,88145,297964,141,106,369992,66931,303061
e7bac5a36a0e16a3ccd5d31995f37018,126,103,327582,55983,271599,132,97,312613,54681,257932
b13c172c62f7413f99732258486fe882,185,133,675467,111528,563939,152,115,512948,132920,380028
9c85f76ee4d8408a95e0769600201efa,40,24,26879,12105,14774,35,27,32082,9417,22665
35bf3d9ca99185424cc7c5ee09074bb4,68,63,84866,26113,58753,68,53,114593,21795,92798
d8f6c46861e2e18f1eddf75efbb0e822,106,88,347067,65945,281122,111,94,271555,80229,191326
31f86e6e75dea36945be234f6be9068f,115,73,274841,126044,148797,163,124,382547,109198,273349
d0f81683288440006cea7365fbe85b11,158,94,707168,94479,612689,186,150,1077569,143227,934342
d8c24cea5d206a57ffb3b4c3863df309,125,93,277593,82825,194768,129,92,315618,64037,251581
85ed0f1e9adf08f9493506923fe8e8e3,58,44,77713,16738,60975,42,31,50846,19280,31566
406d5e06a5f63ba8d6d4024302899a72,153,106,354692,70747,283945,114,81,243368,65750,177618
7fdc5e092873475d2e9b5ce392265638,109,88,245505,44808,200697,110,96,213501,47484,166017
d2f0f54e9497de2b080c141dbdee2264,159,123,414405,95168,319237,140,119,379462,92146,287316
ee4d31c6fc8447c1428d746bbacffde2,167,123,619362,154162,465200,190,160,753490,252790,500700
4b4b7345fdc4264f0fbbd4b7892ab61a,146,98,293372,71515,221857,114,98,255739,58260,197479
bce182e582dfc38ed2c280928258586d,65,44,96385,45965,50420,69,53,110853,42635,68218
4c6be78fc827c7982ce424b5136d0667,39,34,38791,9006,29785,28,24,15562,11408,4154
b15c399e1cf0067d624f28e5b8dddd4b,160,115,542562,91840,450722,217,152,667023,105863,561160
ab49b1f1ce9ecfbe78da27b662c0367d,214,140,850506,191119,659387,172,126,825501,134292,691209
85da0ff4f22f41e2fd481efa14f33d5d,73,54,106413,27751,78662,82,74,126762,35878,90884
eb838120c95d4b055bb7cb89ad5b331f,67,58,94698,29738,64960,42,37,81333,26104,55229
b4d389821e15c802713f895ddafd92d1,142,106,290747,54375,236372,114,90,242249,61974,180275
d4c5f64a8cb16fc7282999d8cb7135a3,19,13,4587,938,3649,12,18,2014,2489,-475
8f55c8de5298d91a3effe96b05092124,30,27,25318,8502,16816,36,26,14334,6299,8035
0ee544d90bd4637190cd13e29cf31695,84,66,173302,47562,125740,97,64,186827,48484,138343
befbf24055124a17c5e4c7d08dc2b403,27,18,18221,5517,12704,19,21,12690,6745,5945
dab133b919e760919e1778cdf58a7ab2,142,119,375971,58684,317287,138,99,251497,69204,182293
445a6e0d94049fd1e7a0ed5ef63595c5,104,88,177106,39660,137446,119,98,240630,49798,190832
9afdd91bbc987630f6ade4eafa35a130,56,41,70806,23905,46901,50,40,68400,16757,51643
658f952c540b8967861751268b8a3945,47,42,62117,26559,35558,49,38,77991,23026,54965
47ecc5618bbf7cd42dc2f79ec0732dbc,20,15,8245,1561,6684,19,14,5795,2683,3112
fdb8aba35d73652dfde555467e4cec38,41,37,29346,8612,20734,39,29,24236,6379,17857
b758753517b481d8fe24c22617d5ef06,15,16,1877,3364,-1487,17,13,4736,1001,3735
a257752a779731f06bdbe3d5175f5b0a,23,19,7719,3936,3783,18,14,6372,3204,3168
2ed5ed8e7331acfd1beef5499123f8df,124,93,324923,81118,243805,121,98,347523,55059,292464
4a9d3dfb4e3c0c39bbbf43f37fb3a010,51,39,67785,23077,44708,48,39,51188,22939,28249
f7549a97f113c97c0b4f62a4e661268b,23,21,11524,4601,6923,17,18,10236,6199,4037
422503432b50a7211b21da78460a8408,210,153,1184828,197638,987190,246,156,1075532,194377,881155
0f8d9c585d984232d98e5046fbaea320,29,25,18270,3729,14541,25,24,16493,6711,9782
1cbe59479da5c33a8c3c4ceff28149fa,43,44,37217,19905,17312,43,33,30035,17865,12170
37b88731e2ad0781c4e55d4ddc66cdae,99,49,168005,47454,120551,120,89,230341,57681,172660
24f6497a46c96a1426a9c4c34e8dde2a,86,67,136512,38309,98203,75,61,115924,51932,63992
3a5554b7172757c14066c0ce044006d0,58,51,63447,30601,32846,47,45,67690,23622,44068
6ba888660f26bb2c22aea002fff2d332,96,80,196842,46095,150747,128,99,239721,51330,188391
4bf3c30a969a5f81f9d740749afe59ba,70,37,90330,21289,69041,70,46,79404,22424,56980
fa4c7508c90b389e37531a628e4fe70a,152,105,445561,91177,354384,174,131,546887,104733,442154
36cd6ed02012475051aaae270c32f21a,120,85,296081,46681,249400,163,145,386261,78580,307681
87466a53be10e085d6bd6c56ad779ce3,100,70,167153,54212,112941,84,74,179350,50429,128921
9427cb8ba77e0060a3f95beb7f409d49,27,20,12052,4968,7084,30,21,22121,4234,17887
4bad1732414f915d506438a9d477b5ea,102,82,173888,52075,121813,87,71,176341,60716,115625
005d6bc14e9f08290650abc778ff8c08,98,71,157509,26985,130524,75,61,125782,41204,84578
c9081f1d5996b8fcc94c8684df6f3725,46,27,53403,18736,34667,42,33,46745,21517,25228
0e88547597cf25667ce59f66da334222,20,15,4231,1717,2514,16,13,2808,2665,143
942d51fb102916f986bb398e8a1530d1,64,41,71425,17062,54363,47,33,59224,18461,40763
7a2f32b5623192fd05150da7165ac9b0,132,103,294751,74931,219820,148,113,344707,63134,281573
c7617fdbfe4cc9e7a295b73eae5efddb,114,89,220523,36296,184227,85,59,119506,50219,69287
0c1fd7b955e91ab5df56e5c569cd4bd0,169,119,541215,104502,436713,180,122,678498,98317,580181
d39dc2459798659ebc1cb4e062b39152,26,28,9364,4748,4616,29,24,11665,3310,8355
b1678bddc7cecdd1d4ca690693ad93ba,113,81,237236,42134,195102,61,48,89418,40669,48749
eba2267a2816c16923a4ba2ee5d67ed8,110,87,178035,59504,118531,139,99,256805,48746,208059
659b5d305a80375986e03e2beae1567c,70,52,139134,40708,98426,48,38,68930,48130,20800
8673d4e792b5c9559a1bccbbec2b640c,146,127,502882,113955,388927,166,127,612121,80433,531688
ff20f8ed35b0c0f5813f8eb8afdd9101,53,43,89455,22906,66549,66,61,93349,32893,60456
4e95cf82c4f47427314f1ab1bde035a5,181,109,614217,88896,525321,224,177,814645,135403,679242
c39d4f1af41bb98fc13203f36eea2769,24,23,21723,6797,14926,28,19,18169,7663,10506
5d758211a99941f490541bc1dedf2e5f,39,25,36502,20846,15656,39,31,52886,16963,35923
f7a5ecc92cbb587be5f19b834775afd4,94,68,138827,33090,105737,80,65,104606,28691,75915
fd95ecfea93d91234733da633c522dca,129,103,269393,43463,225930,109,97,327164,63989,263175
f1ad7fc1a349f2fd629bbc633b595735,36,25,20702,6121,14581,26,23,18753,8496,10257
50cf0b90f1f5907f24cb3e32c0477042,18,15,5035,2937,2098,16,10,5933,1027,4906
f9f6a29b20286d3478d5897f11708375,51,40,72913,38650,34263,79,78,136531,47992,88539
d314042eb320917816af38dd8f2b65a1,2,0,150,0,150,0,2,0,150,-150
fd4921b77a7ac1204db602faf211fd2d,3,4,478,791,-313,3,3,674,478,196
4db2e7fa0df610ba1e5a2f85c9138de7,124,95,368837,70118,298719,138,115,350260,90834,259426
f2e68adc91f4f6feda91520fabd07658,86,55,133289,21735,111554,86,59,108731,29366,79365
b314aa84747e9b2ea526b0aba76288f4,66,57,157279,41237,116042,62,46,127106,31826,95280
f4c33bd5a12912d60ef756dd9c217383,133,101,346479,106099,240380,155,143,418362,120004,298358
960f617228ff584e7fa6e61425fb6d28,18,10,2808,664,2144,18,10,2284,1354,930
f6ddb09672a2cf681f8e43a8bf151a83,85,68,210424,62492,147932,115,96,291161,57390,233771
0d9991a9ea42fc22bc3072bc849a1cc6,80,67,89746,36800,52946,93,82,136977,30015,106962
e594c2c31b5c4164d4a65a74f9f34e9e,166,91,367631,68821,298810,111,79,258725,73791,184934
7b4b65aa0954c63d289499cbebff2912,97,65,134976,30419,104557,91,71,138580,40941,97639
fb11005b752e5961242d5af08c4e5f24,27,21,10863,3196,7667,31,26,24070,4694,19376
b61b7f389de1a5889f74814f521c7590,74,50,116642,23140,93502,73,61,89275,31348,57927
d57c08bea77d9c069d59bd883c3c9f17,1,1,45,141,-96,1,1,141,45,96
5337fb399fd624d15ed1d470708ca04e,42,35,34091,7372,26719,26,16,22711,4914,17797
e91d8261faf807cda536616d22967148,228,138,1011693,164677,847016,230,155,1428504,160454,1268050
77266be1911ea4b7b5bc2d76f0d37547,56,50,90294,13219,77075,59,53,56767,27918,28849
2336abae7b9a64b615fbfc69e05fe34a,111,93,182649,54275,128374,78,58,155028,47731,107297
27d383b2c0d87f34015f47bd04fb64fa,168,129,413714,80082,333632,167,133,421639,128571,293068
0d299a5554139c3cd8ab5f542424f1ca,54,40,60943,22546,38397,49,41,60661,19955,40706
8c57f780f4e5a6e5d6f7991aee116c99,62,48,76281,17309,58972,42,28,41263,14571,26692
c5098e46ce5e16204c2983ed17af8eac,200,107,597269,143949,453320,154,97,651236,88331,562905
782a1fcc360770f6bed859f984316d86,32,21,20782,7175,13607,40,31,30379,9817,20562
da2fdc30bd0b03bf96c7399d6446d324,186,116,438606,58281,380325,133,99,276395,67243,209152
3d9ace55fc07f9a37940a6514ff2fb1d,112,90,212753,26430,186323,110,88,195069,49629,145440
d11e8141c9f6e2f9b57916bbf3f74b66,106,81,289780,59585,230195,105,90,270890,74137,196753
5d1346cd7dc2a675b3c9523e1a6e0cfa,104,74,228621,49973,178648,93,82,219327,64573,154754
bc820940daff6fd7b1ef8126c29863a1,28,24,19461,6335,13126,35,18,28124,4859,23265
39543673532b73153c4de0c3680c73a7,152,115,449913,102131,347782,149,90,382838,88506,294332
f947a36f7f8d2830d6dbdc8f053f1064,152,116,532628,119501,413127,129,116,380801,106784,274017
4823c2efb952692ab4ce4d5595f00ac8,205,149,971133,187807,783326,226,163,1128031,154840,973191
1741779bb4e997020bc20b156404ee9c,144,101,409956,66358,343598,170,133,448492,87406,361086
2be7300628301ae3a5133191da25eaec,165,126,451448,76692,374756,134,107,329651,66368,263283
9cfae502996765007ecf0ab9afdc3478,72,60,103981,25733,78248,66,34,65007,16775,48232
4d117fa72ad7a3044c4b513d153c5dc6,118,91,309450,57242,252208,97,80,147302,69668,77634
d3e53f0a9f42b71da721bb489aeb4869,50,42,60732,19156,41576,43,28,39420,16935,22485
dd1c65d694febd3a78b1250b1d3ce50d,59,58,87931,26957,60974,74,54,101102,29989,71113
81a3c4cccf7372fbbaa85da351f68579,34,19,22396,7604,14792,32,29,22982,7204,15778
7edc27c68638eaf8d53a90974aadf7d9,41,24,40629,21906,18723,46,38,55225,14332,40893
0129d5f149d89dedf528f3129809dd44,162,112,254443,31468,222975,95,56,140684,18450,122234
6709a054f751e24f679687829f11183f,72,50,84663,18703,65960,70,44,72070,15481,56589
c6f2f91334c35580274362f752fefb23,104,89,259940,55443,204497,142,98,345610,44127,301483
5c20ffadf71aa94378c7997f3b551bf7,102,78,205986,38141,167845,91,66,162293,55648,106645
b5730fe27c3cc229b1e893e62805cedf,42,32,38253,14122,24131,50,37,42620,16186,26434
87b29a3be66b8a0d97a1d7f362d2da03,15,15,5495,3566,1929,17,12,6033,2626,3407
c876c2b9c6458ca0264fbc11cfa8ed62,172,143,795578,110776,684802,182,151,860981,118594,742387
f9faf0626d6c20e99967102f16e39003,57,46,70941,18031,52910,53,43,47390,20392,26998
485169ab7fe81d7ac6c41cb22fdefed7,107,91,159548,29349,130199,108,89,147803,33472,114331
4ca8aeeed3701c6ee3f9da9b1b5d9a93,160,118,489598,127432,362166,146,117,457008,101889,355119
028413054649da3d49a1e7bb7cc744df,107,80,325163,61874,263289,109,82,286037,54185,231852
124c26259bbc083a44b5878cc0db5067,195,157,624425,141018,483407,150,94,483428,108977,374451
a9ec9e6fe420f1355b1a5f2035a0c434,100,86,205010,50762,154248,114,88,214564,60221,154343
d608e1e64a75bcc77e926f1c80d27e79,89,67,179315,53946,125369,107,84,225449,52719,172730
115f24fd68965240c76f11769b2ccaba,146,106,419064,75290,343774,111,79,304254,81571,222683
b431b7bcdeeaaf9edc762a768c99b7d8,104,68,220439,63587,156852,143,102,273263,53706,219557
3e4620361232802f974d8a57092a8f5c,81,66,162230,47492,114738,94,86,185370,65810,119560
4856355881962571dc7f33588468ff1d,44,36,34697,9960,24737,32,29,20809,11336,9473
efc28e3d1625231d64ac8270fd2507a6,116,88,268344,45133,223211,136,93,272228,40468,231760
10a324623ca1db2500bd137810cd4ebf,39,33,35472,10202,25270,35,29,30499,9434,21065
402f294d683e408c744fe374046ac856,29,27,13823,5481,8342,24,22,9317,5406,3911
39b1793e4ada960796d3c3bba91980a7,26,21,13517,4377,9140,28,24,14673,7893,6780
9f8046da0b6a28d9124db1fb1a017905,20,18,8113,4860,3253,22,18,9233,3961,5272
668e6d36fef4b9c01911eeed5e5dbfb0,68,49,108089,26146,81943,105,66,124571,32864,91707
f7526a510d49014c68af3a68fac38c04,92,86,202731,73424,129307,109,105,262877,81461,181416
907f6a5aebb441c13c127e5ba9f87add,159,125,531071,89969,441102,147,111,524753,116923,407830
db4358c8015a05570062111d652d148a,38,33,25803,7823,17980,38,31,22532,8625,13907
d12226e8daa55b8f376aee52e4cb2e90,91,64,144089,41291,102798,88,77,143126,47906,95220
317e5619b9f4af096a4ea5c28caeb77f,10,8,1241,652,589,11,10,986,644,342
e067848174f4d1bc9ab07e925e3c40a5,91,71,165816,41402,124414,99,79,144404,53594,90810
29d0bc4f76927925c07b37b557e734ad,137,108,313840,63825,250015,115,97,244881,64046,180835
6f8cf915ed117808aace069f7e0b81b2,38,23,41547,9133,32414,30,23,23362,12495,10867
f2263486bc8dd374b4d0bfb95a1e2555,41,34,42936,18389,24547,54,37,65878,13180,52698
257424d0f4b92e529ad895f9fbffbfb6,26,16,10570,2367,8203,25,20,9130,4800,4330
ec731dd9603c181e14fac4eaa473b760,41,31,34580,11190,23390,29,23,19437,8780,10657
a9010a8ef561af56f1b2fb24daa867d7,36,23,26387,9023,17364,33,27,27316,12016,15300
98f305a6ad96db81bfe9f9dde2d0411b,104,79,214670,53315,161355,103,81,206402,53507,152895
8ba5989d9a3234893730101cb7a99de9,104,87,193701,52637,141064,140,115,345012,63712,281300
087783c09100bd152e723797a7c37d81,78,64,114208,37328,76880,86,62,128746,32927,95819
9427ba3b32996308b55deeb312cce171,32,23,28203,8730,19473,32,23,16734,8064,8670
d03bdf4f4c28f7070c713f5b7b4a1ac1,147,129,479820,155832,323988,162,127,513022,142917,370105
19657f4899a77410ab074bc9b6565668,97,81,173597,50425,123172,89,62,167953,33162,134791
d8f75e587fde610478fa9740ae38ca65,137,95,337159,89034,248125,97,65,251580,58277,193303
8106a285fdaa8aea259a70d263f812f9,47,37,80066,34958,45108,57,42,112794,23970,88824
37c8f76780fb2f9eb706e805aba89de0,26,18,4218,2031,2187,19,18,4117,2018,2099
86da07ebae0c3dc53b1a0803c01328dc,108,73,208014,58015,149999,121,77,216449,60238,156211
1c0bb74faa8b718840923ca90e1a6a48,18,11,5634,898,4736,17,11,5675,1655,4020
0b7f63feed75c6413af3dc86be8a617a,3,9,765,765,0,7,3,615,497,118
02ca2eb71382b1505146fde29f5ed305,117,97,222230,55443,166787,109,89,200553,48129,152424
74790d75e80f12f7776ebe3476098376,131,93,360774,87025,273749,131,101,332019,86457,245562
22a443e5a4d08765784ef0e848dd35ab,34,24,20887,5562,15325,37,27,25721,6982,18739
84bc33989da06fcdc19d23f171131bc3,217,158,557082,101794,455288,166,128,599142,94147,504995
f1be28e6dfbb58c278125425a679784e,131,96,190717,48539,142178,150,94,190468,43276,147192
e7500a9749b3fba23ca3c6585a647a7e,130,102,300025,107772,192253,127,99,339048,87267,251781
1d42a089c1360bdd1a08646e6f5b707f,26,17,9914,2745,7169,23,19,8318,4470,3848
2bd3933fb05b52a2b937bf8347d47cd6,118,99,258899,53793,205106,133,107,211692,40832,170860
dbce46ac883265c6d230a15ee81dc6b6,103,65,156859,31366,125493,115,80,192241,37308,154933
a19698ad5f7600a29aaa524b4a68c61c,153,122,431888,79417,352471,148,105,355568,70483,285085
fb03c4c89c5cd164ef91021dbce3772e,93,70,295216,89365,205851,179,125,656706,138748,517958
662dcdf9784a7aa59932c6b07a68e98f,90,61,138088,70148,67940,97,79,270859,62394,208465
d59593cebca23f06c6daaf63c73903fb,55,37,67596,21164,46432,48,39,79263,21707,57556
288e58942420327c958b30c0cd87a668,51,36,51260,27213,24047,41,37,59569,23746,35823
07fca82d6b29b3559a9658a1cac122c3,74,57,146223,45421,100802,71,62,195765,52541,143224
ce18a47ad5c64aed9daba9a79f4549f9,35,30,28792,10073,18719,36,24,26342,11091,15251
9cf18df5ce99fda177b241f66c3dc6b3,33,24,23170,10011,13159,31,28,21877,11302,10575
7d007ad7bc41ae6a4c0a3af1c007dd87,30,29,22526,11631,10895,37,26,22393,11195,11198
6570b228a1fdc8c12dd7433320fe7df0,94,55,180806,31922,148884,58,52,92364,53164,39200
cbeeadd0f4c2f5ceaf459af921f8d61a,23,15,7138,2854,4284,16,17,5046,3661,1385
6af230e59bb6311337774209328ff979,52,43,55224,30760,24464,53,38,76142,22033,54109
a70106e4f4994ee338f5d5cc9741f412,144,94,410635,79440,331195,171,116,579013,90603,488410
5c21bb27b5b3acf2246e4c9d9544199c,137,98,272908,40839,232069,72,62,138516,52313,86203
ed1ef4f7607cc23a73fa5b01c64ad934,46,38,32156,17164,14992,45,34,50265,15818,34447
4dce359387c891d475f9eb7f17991282,160,118,352985,71005,281980,188,105,442683,64542,378141
b356a28ba61c7d6ee5cbb325839c4329,132,99,301441,62907,238534,104,79,193774,90621,103153
b8150de55018f40f895374c4d203a09b,11,6,1473,278,1195,10,5,1272,474,798
2d69300e1616bec564fa5741990e28f4,21,19,8525,5650,2875,21,14,8863,3248,5615
6c370d964d0af1dde980d8475b4f1354,18,16,5248,1740,3508,26,13,4666,1510,3156
bfd8c09ee11750b3041eea05a4563755,103,87,189061,62171,126890,112,93,203899,39259,164640
2134c81bbf26abc0aaf5162fb47d7660,161,139,709948,175507,534441,187,150,692258,158323,533935
276a4de5dbf71d328f9ff8459fc077be,47,37,47851,15951,31900,41,31,28037,11653,16384
d1170bdefab76bb8ef2a8e90c8e4b9ee,82,52,113928,21743,92185,94,71,129457,29599,99858
77783651fc075aafa7cb842173f78af0,109,90,156078,37964,118114,76,61,123409,31222,92187
d2d71cf87bddec2fa54b8e766a1b353c,101,63,116348,18983,97365,83,80,118733,46925,71808
6af076234e5a57e125191dd0203264ac,22,24,12473,5700,6773,24,18,9981,4752,5229
4368533512e8da919cb8ab17cfe39ffe,76,55,117750,30346,87404,87,57,147706,32378,115328
47d535bff366a6399058447746d6eb8f,86,77,124729,62235,62494,151,118,289889,52455,237434
9ebf566b8d9accc7d88721bf8285f04e,125,105,498966,84599,414367,127,109,406513,100714,305799
9fdd9aed6de23f57059e7327c4772e82,37,31,34042,7981,26061,29,18,20588,5091,15497
72f0a6e0bf46d6c01321980e9c3d2906,26,22,15874,6186,9688,29,18,15651,2772,12879
84aaf228a0f109f34fdea8913acef952,131,86,318983,63522,255461,131,100,292652,110969,181683
5708f302a396e22d9154099a9176c95a,107,78,212851,47268,165583,112,76,190228,39369,150859
b441790f45051ca28c9447b89284af06,25,20,9139,4522,4617,24,20,9648,4520,5128
0c162c57a4333b65c362b7aec3695c29,32,24,27504,10824,16680,33,27,30574,13019,17555
9ef2f287b1343045c1ad5cced63b4b29,173,135,538402,80069,458333,126,102,388508,115362,273146
e61ec502f6e8cf8b14ffdedd9be7b86a,46,38,44133,16567,27566,45,47,57452,18081,39371
07f1732152919fec035b2f03d1ed0a9a,76,69,119452,30750,88702,118,91,174844,30513,144331
5533597d1738aca741495bcafb46935f,156,113,588754,99756,488998,136,116,571631,117559,454072
195958f531ea4c348cec79b3047c03bc,127,94,285643,54718,230925,121,104,276138,77594,198544
377115bfe297b319ed75dc0b26b58dba,35,28,42552,14458,28094,52,34,38353,18312,20041
fd25ca053002e376bf899f5928fece3c,28,25,13791,8246,5545,37,26,13594,8049,5545
2159837dc52ab6a7cc0030d6a3c4f780,18,17,5222,1712,3510,20,15,3905,3019,886
d7362e54a67344d7bd72f8c30e0503a9,71,50,124457,23561,100896,71,56,106485,32824,73661
23fd5e5408bffeaae606fe31da1ea8d2,28,19,16071,2455,13616,24,14,8678,2741,5937
3575b837d3f024d173735a107308a8a1,72,70,265555,104858,160697,140,111,375199,72453,302746
eaf03a28edac86bda12c143fb96b3032,125,107,233236,51869,181367,125,105,238527,55014,183513
336ac96aa25443bbc825bcf6568055d6,88,80,165470,41630,123840,67,47,96544,42620,53924
326dc1e05406929f2020e602d85e655f,78,57,92376,37819,54557,79,58,87245,26883,60362
25d2ae536f042de7c01c0827e2572d2e,83,59,162413,51547,110866,103,84,191739,50404,141335
654b66846b09b19f4ec09e4c63385d77,51,36,47025,19905,27120,59,44,52075,23938,28137
4010b4b0b492758320d68ae3c428006a,109,81,321423,75845,245578,150,108,356770,69415,287355
5e5eb49e011c7f3a17f8f2207c72d74f,212,139,910053,176351,733702,225,159,836609,160136,676473
5c123ebd4e75ab55f3216d586e365a3f,184,143,535299,97142,438157,161,127,482187,95976,386211
cb6cae015b6a101d0cd62c07385a077c,151,116,597975,128930,469045,146,111,493120,135303,357817
4abbf444d449a84583fadd8fb9c5f722,133,98,240605,68283,172322,107,73,140842,66306,74536
47019b6d053e4f2edbde3cba788aa650,46,35,75540,18612,56928,45,38,63539,26583,36956
91a6b08fd64d2e3cc38d0d7e1eceadae,35,22,29096,7406,21690,46,35,32496,9890,22606
7a6ef34ba0e1dc9163dadbd97b21207e,75,50,127586,26301,101285,89,76,143855,29062,114793
29181c213a41cb1e0a726398179fe961,140,110,324312,44224,280088,107,61,258491,55526,202965
326f5d2b6d46a7695ce4a340b6da0e41,10,12,1360,1095,265,11,11,1490,1085,405
85309de64560c0d61b46475cbdb3e160,43,31,45968,11492,34476,50,41,60283,13046,47237
058c4c9ca98ea00ce08ae468f9659957,60,51,96996,31041,65955,63,46,73539,31672,41867
33f4a69885c64a43741870bf20bcd4f2,36,24,32206,11734,20472,32,28,27376,11968,15408
db0211951d14537df415a61d991a041b,146,114,493135,68583,424552,129,94,379045,64224,314821
63734bc98ad58317074832a5e0e2c172,152,125,372836,92705,280131,118,96,307276,86505,220771
a8d12dd956bed460cf8f1ef9534d8988,30,27,18266,9509,8757,26,19,18044,7904,10140
e19713eab7a542a696784155585e09a5,176,114,433441,81446,351995,176,142,544462,103314,441148
c0985ac83d9372efd8a0cc56b0e30fc8,173,140,494774,92314,402460,141,102,361742,96851,264891
a63dabeb4834b3ebce1f537c8b769567,33,23,33021,13191,19830,39,33,40888,13870,27018
4e9c58f2b1308d46fa50c15f5d6c3ca9,26,15,7613,5183,2430,22,19,8801,5867,2934
4bae11b5511e04a5bb79fc69e9b0f47a,94,73,162938,38818,124120,147,99,215999,56448,159551
3bb7c57ca6ed0b62ef58a47a7dbfc858,28,23,24217,7234,16983,42,33,24734,8772,15962
8c026bf2dfb772683dedccda80514cef,146,119,314413,52720,261693,109,85,211771,53023,158748
999ae4ab4d97dc5cef1bd2d619167b2b,90,75,138859,30781,108078,46,43,66330,30142,36188
3bf84e6dad2ba4d293f30a0d7bbc5d9f,102,89,249427,75567,173860,99,77,251444,53255,198189
feaff3efa84f9193763a5d2704281a70,160,117,483970,71829,412141,169,118,429345,64411,364934
3de5f96ea3fc0bc380480f6c0b2ed75d,93,65,201299,60739,140560,108,76,275684,74678,201006
c1dfff20059fbd56dbd183e398a36c71,9,7,938,937,1,9,7,1269,385,884
43f30997cef452a4901c8862f78461e9,39,36,39837,15452,24385,36,23,25335,10692,14643
2023f1cfa7ce9a1a6ddca32622d21370,44,27,44835,11880,32955,36,28,33896,22715,11181
b4b1a15bfae86466fffb0d07b072ea94,102,72,202093,57923,144170,93,61,149060,65837,83223
6db388ce8e45985fd5c766269317ca3b,43,41,57994,22780,35214,49,32,43062,20324,22738
b6e596ac33b137db4a672e9c967dc795,22,20,10041,5246,4795,23,17,8457,3891,4566
3fc84a8ad31c11352843554a12055ce0,16,15,3752,2700,1052,21,17,5008,2354,2654
1ddef35729f9f953c785177647d9a41f,142,99,537685,149040,388645,199,154,578827,156641,422186
b6e0cee8bfd1bf98b56ecdec0424153e,108,84,183700,38961,144739,129,108,262427,40693,221734
7e611e94fb7ca1c6232120198c8e24f5,35,22,29797,9660,20137,39,34,35846,11734,24112
e9d6ad7019e545c292c4da62a61dc1ea,30,25,13218,4964,8254,29,25,12616,3779,8837
382066fc2f49bbc4f142d6388d15dfb0,30,19,18044,6420,11624,28,25,22631,9119,13512
1a7bc58444f539d2b4e6549c65951fe4,123,90,248446,57270,191176,124,102,290282,71793,218489
7e60137a4b85035dc7ffb59c1bae10f6,28,23,12211,5574,6637,26,21,10096,5808,4288
a52421390a3f133ad9203b1d7e18a66e,157,111,395413,83322,312091,132,103,348425,74565,273860
6bbe839369aa5ecc11190e7d4a15ebbf,156,119,448044,110750,337294,157,110,396947,126464,270483
74fd1fff77184092acf49f3ee0b9bb37,26,24,20841,10474,10367,34,21,25121,7887,17234
d24e8fe3dff40a2b9ffec13ab001eda3,176,127,677581,206256,471325,196,147,639604,138412,501192
ade24f567d40808f381650d7d8fd2367,151,122,405606,114829,290777,167,134,604458,94468,509990
a7b3a7b8ed45966e8b7c8999b836e2fe,60,49,94287,29029,65258,40,32,59933,19555,40378
eac2904a83a168d0ed380bacd3dcda28,21,21,11901,7047,4854,34,28,22370,5929,16441
7813f4436dcc8277ef526a2a6ad3e3da,21,17,5321,3140,2181,20,18,4604,3313,1291
551838708320b3e7049f4ec2c8493c5a,87,70,134448,29960,104488,87,64,132077,28961,103116
5a441df3be2af03384e760496c2ab603,72,59,149667,45075,104592,63,51,122910,34693,88217
39dc36ff66cc95d68ba23cd5aec4edf0,227,133,744857,162086,582771,206,124,570655,161588,409067
86105a1daeeb784b57f6d5aed09d1716,133,111,311178,87315,223863,152,121,362884,49076,313808
3180d7e4940f9bd62b85bfd5019618c4,1,1,15,73,-58,1,1,73,15,58
dca8ebaf9cf9a4e537f947c8b19760e1,126,90,321379,72731,248648,167,127,454278,88898,365380
38e3a753705803d1b6f7b020fbb688a2,118,80,227161,66367,160794,126,83,239893,50933,188960
cbfde1501e93acb5a67f2c043c9cba4c,96,66,200828,37166,163662,88,61,132849,61554,71295
4408677681ddcb8aa337be4ff465ff80,47,37,46080,11849,34231,29,25,19910,10287,9623
742691950fe90a1a3aaaa303641aaa8f,37,30,33813,7795,26018,33,24,21372,8198,13174
d3df53a736979f0a86333e6e08c7f18f,26,23,14554,4547,10007,24,22,9945,5007,4938
5fc422e6b1ee0f2caaa1d21d65db9573,101,79,189098,48838,140260,106,99,226338,64137,162201
bda8c24e44ec7dd8dc0a29661888ffe3,66,57,95516,23859,71657,79,62,101436,25376,76060
ef0a48b3f4d11951cc3d47f6e1c8b2d3,130,89,219553,46414,173139,152,99,282346,45190,237156
234c9e808e90d005b8532fc66752adf7,189,126,659566,150501,509065,219,147,787346,173529,613817
7c31e3887a68efaa41856fa8ff64e5f8,10,11,2735,1682,1053,13,8,2123,2002,121
1b1e1da722df7002bbddbdcf50f2d8e5,208,164,790439,165406,625033,202,135,691549,111674,579875
4d16d0cedc5be2c1706ac2c1539c3da2,148,96,400153,53579,346574,162,94,287959,80337,207622
f5c406c9b69629e83186072142123fa4,75,57,112862,32037,80825,64,54,124084,27372,96712
18dc603b889a8fd8a2f6ff5d5d929161,67,51,74962,20536,54426,59,46,67613,20563,47050
f2d592e183d2a7a854900bb77a7a1887,158,130,447029,84945,362084,148,125,395979,91568,304411
c9b548cbb640d6931018d551340c6f93,33,30,33307,13683,19624,38,32,31703,15454,16249
38ed4333bf5a2dad41c3edb5458f256b,42,32,31173,16906,14267,34,31,31933,16491,15442
57cc623e2d9a1ae2667c281bfaa2ebcf,17,16,5215,2992,2223,23,14,5232,1744,3488
c190a628e296de85d136f54eb261e769,51,38,73971,22486,51485,68,61,64405,32581,31824
ab367bf8841285aac2d51c4c2d44ff72,190,137,678156,124073,554083,213,145,632659,143749,488910
1bb5350db3189f848a358be5c7c6ed53,82,65,154572,28410,126162,110,87,165689,33077,132612
892b24e6d92d86deb9189c0b41857f2e,25,17,14422,5676,8746,26,21,12364,7204,5160
72152b8b49764ea51c99a1bbe31c9d00,45,39,35328,12743,22585,35,30,22053,9789,12264
785a13be1c5ef2c5686baf94deacc1a9,130,111,225431,66693,158738,136,109,342378,62219,280159
de5c888e361c6c4d5bc1876031988fbc,27,20,12141,4911,7230,24,20,7276,5653,1623
f59669e95e4f09066e481a8a5e91cb91,41,35,44258,15337,28921,34,29,26976,20095,6881
754f2c1c0925fa28415ad0ca0fe080af,48,47,58867,31144,27723,53,39,69113,27546,41567
5e79d73a10b80471bc5ac99dbabee16d,92,78,156835,38704,118131,99,78,189921,36915,153006
076f1cd9352449dcfdb5b459b9bb4059,136,103,544749,110280,434469,161,106,569289,95331,473958
07c8d2463b520ad97ee92d91ba91c2ad,137,92,300141,81631,218510,138,89,304248,57336,246912
97ab7206d166ef03ecb85b07488e43ee,35,27,42657,12957,29700,48,38,49028,16532,32496
54bf76081da9e4289b9acc3aef12eff6,78,54,131694,50813,80881,100,82,213029,64309,148720
4c84e54252c6d837d908d9e7c2090f30,172,135,686523,111112,575411,169,135,781618,134441,647177
d4d272018558943c87e51601b7f9693a,113,107,232280,66820,165460,111,82,237056,73622,163434
cec9f6d753d6f0ecff643cdb826ff460,28,21,15128,5818,9310,25,22,21003,5563,15440
6212ab249da45133c7c45290ad1e9b09,12,14,3793,1198,2595,16,12,2589,1278,1311
fdd33c95503a15a263bab7a90192e76b,87,72,210325,58823,151502,168,130,424526,75041,349485
2ed21ce1c499090c893c9f2715888a49,163,119,528789,197052,331737,151,134,644754,174990,469764
256f33733ea6ed235886b28aca7a9e36,8,2,1266,460,806,4,5,736,746,-10
e4720d24d2a54c6d68d55fb215ab8bfd,114,81,240177,47331,192846,121,102,293881,64292,229589
1759b17887e7b33cc0ebde89b8ab0ebc,30,26,27593,8703,18890,34,27,25718,18620,7098
36159309ef68c3a4fc8ddbc2340654b4,186,136,554450,86656,467794,170,146,500134,113572,386562
2d39c1189ba20541d131ba137d51c79b,182,140,1742905,304170,1438735,244,198,1605359,266255,1339104
b27054e98f8ed174fcb8cc8ab6d5c871,57,33,63121,14203,48918,58,49,104405,20265,84140
1b7ffcc2577297297bd331fa18cb3a40,70,55,177782,18523,159259,85,52,125427,24987,100440
46f5ecff65881e27701edf240cbddeb7,27,21,11656,3865,7791,25,20,14695,4490,10205
03694750975803562daef84ccbf6d9cd,72,55,62185,25736,36449,63,49,71068,15182,55886
3954f14ce2bcc98a6c8e088e9e4fb751,68,48,84703,23478,61225,49,41,63051,25816,37235
578730b56dc91f56cfc16987fcc71e13,118,95,302536,74220,228316,141,120,341680,74362,267318
a8cd01fb44b437562551a9508f857e32,53,42,39372,20095,19277,55,39,50926,18355,32571
7629dec2a50866cbd11ee2744daa6e13,178,113,314404,86849,227555,148,133,381712,133854,247858
e30f39569e942947c3a629835013d495,184,152,406638,77204,329434,105,86,250575,58566,192009
2d6b4a3b893c8545c676129895af116d,165,124,770172,153511,616661,225,177,1108040,164050,943990
2b95bd85534f7809f5e7c3c321d7bf64,92,78,197994,42772,155222,91,85,192165,57869,134296
5795f9f8f02fdb78c31b95691ba406d8,77,63,87544,28665,58879,76,53,130310,22777,107533
7ba037b30facffc76b605d46198b8f8f,91,71,161562,39587,121975,127,108,252535,63025,189510
eb6bb1bd08b3336c78421ba9400d902d,107,85,183168,56922,126246,97,88,239826,49700,190126
ec495ba4b3004a020a1c015445d68251,33,26,22506,11720,10786,40,30,30367,11460,18907
bf1077452bba256c3a8215a78acdf777,196,156,1316722,163493,1153229,178,151,962695,276181,686514
051e6d2f9ba6c7545e8f13c55433bc13,31,26,29409,7510,21899,27,21,20765,7363,13402
564311c3e9f942c01ae23e2ee986b216,157,117,620043,122607,497436,161,121,711846,119507,592339
03272deeca5240a02078938b6c75e6cb,151,95,398407,67227,331180,107,75,260577,77662,182915
86c821808fb5b7722b4eea13adc5b256,186,133,907374,190822,716552,218,155,800046,224433,575613
3017f5ebab7d24ff982765e4beb58b9b,26,20,20885,6110,14775,29,20,16403,8312,8091
cadcf882d7020d2142521faa06cb0981,168,138,688244,184468,503776,128,99,553533,133442,420091
f891ec3ffa18449eecf9489cf16d3930,121,91,314368,74898,239470,145,128,446093,109442,336651
bb4c4d240ee2be3af058a6e1cc8e9106,138,111,330131,69054,261077,142,110,311001,81934,229067
093b098ee1ca9bb82d1c237dae819e33,19,20,12231,3476,8755,21,15,8081,3845,4236
74244d50ef6241900f74947acdf7aefb,89,70,167444,47052,120392,103,89,192859,52073,140786
fe8078c5bb9163db40e2691a6e9506b0,122,101,300682,75316,225366,182,145,544919,89329,455590
c10d120a5a078321d48c02ff58a0ace9,37,33,27692,10729,16963,33,30,23721,10026,13695
354531d084ff5730cb48b2feb84eba91,182,127,578847,114796,464051,204,129,713185,130296,582889
ed86622e68ae49850175cff5e8da7b03,48,40,49657,26829,22828,56,53,66503,27951,38552
68c7602d00d3805e48dc39a2fff03c2f,15,16,3318,1945,1373,21,11,4805,1711,3094
bfc4ca2d66798245d2f8c684db00c2e0,148,121,451082,80272,370810,124,92,384922,74186,310736
b4bb9454b1d4f7d6ad513b7d1576c433,105,98,267120,123095,144025,97,74,230715,65840,164875
04a2e67395b422f3c1ee619c26548fd6,77,34,108016,19036,88980,50,43,73325,33738,39587
6b70405ed855ffc524b026b63f0c6b9b,198,154,729774,169664,560110,172,143,733470,173863,559607
0073eaa0a66ec205f8a22c0550454085,9,3,2107,431,1676,4,10,455,2131,-1676
f76db401c2a73514dac9dd50493bc383,110,82,242450,79965,162485,99,79,211893,88141,123752
5c25b3fdb7bdc78d348c429b6d85182d,4,4,573,389,184,4,4,389,573,-184
95c26d569b3c5cdfe1f9d4f8323c37d9,195,143,647233,123740,523493,180,133,746490,111737,634753
60519300a8076c656b50a5ce9f532866,176,87,334758,51204,283554,89,70,181933,69666,112267
b74f74e844678beb72d64d30b4afc7aa,27,23,11095,5423,5672,22,21,9321,5331,3990
df9a930bc4dfef4e8b623830f6ca9da4,98,64,185726,47329,138397,114,87,200842,46543,154299
c94d9e0d49b25b1c04668b3befd82156,41,35,40382,9363,31019,39,33,30855,9019,21836
ea5e08c4526b821feb84bb076dc16783,24,19,10694,4836,5858,21,18,8936,5410,3526
20e53fc664452cbbe15791d9ca1114ac,5,3,268,147,121,2,6,197,233,-36
306e8b03e495dc8deaa235c9d9b8a6ab,99,75,297379,80849,216530,111,96,221182,84825,136357
a1425e9d288d1117aa17b6df21c68519,137,102,418318,123503,294815,189,124,624484,129533,494951
43b920b41dbe198ff9dd78995c8d1991,141,107,368711,52918,315793,173,146,416870,89945,326925
b19ba391280ba3da2d22f4dbd06dc743,32,33,30626,10198,20428,29,22,29486,8466,21020
fd2016bd1b582049e1aeae1579f3c656,156,104,396573,86614,309959,126,82,309251,86205,223046
8421c6f4e1246d8232e134af42c201f0,129,87,253893,49670,204223,105,78,212132,65618,146514
f91aef1f4d733148bc1de61d87f22c54,89,66,112928,48402,64526,78,67,139363,45012,94351
59a7407cf1888225fa2b8fd98ece7e23,32,29,27957,12910,15047,32,29,24686,12763,11923
a68a0adc5eace78e9234630c1e6e2e78,113,76,194792,28792,166000,92,77,148371,33584,114787
27eca56732a0c433b04d3e937b6974af,79,63,124833,29502,95331,99,80,137680,31735,105945
9755defb8402283dcad07ff1f695c7fe,99,80,190768,58666,132102,121,102,267952,68917,199035
e037b6479b309aa4f251a89de0a793c7,73,49,120048,28717,91331,68,46,95835,25425,70410
fcbde1d7c01d461d39f88b7fb1392477,37,27,28084,19628,8456,54,42,67438,14586,52852
016c4ae3628539f49a897e74a189cfc8,111,90,172459,49634,122825,96,72,151155,41157,109998
32e9bc09bbac606c04b7fea4cf8338fb,177,123,462247,51967,410280,96,81,260053,57111,202942
a7cadebe2fe52c0a817d5706a09dab87,207,149,521528,108228,413300,159,117,492987,134822,358165
5915edb5c194fc5c553421e341bfcf2b,92,55,179530,33183,146347,62,47,96108,63499,32609
7f7b65867da1b24aa533eadd2fd8033a,118,78,211853,46567,165286,135,111,250433,44035,206398
a5aa76bb955c71935e0c42a2519bfab3,15,13,5234,2383,2851,18,17,6530,2068,4462
1ae97bbb8cf41de3f7bf378c0d5bd02f,83,60,148292,56383,91909,109,75,185480,42519,142961
384dd228aa3434abb64e3bf413340df9,109,75,214918,52213,162705,141,98,258850,52392,206458
707d55d0bd98fe13dcb4dd3ff266f4cc,27,22,12130,7379,4751,27,24,13247,8577,4670
31f1469eed51c28b884e549753a60f66,133,115,489121,116358,372763,148,112,400874,87471,313403
11899e18f96ccd99ffff7de3e23a70c9,121,102,279919,77185,202734,93,75,204010,52916,151094
898c54d9bc50cd3f81551fef60171fa7,71,58,113774,32821,80953,81,67,121427,36053,85374
07bb5eeb02286a016def978aba456284,34,30,30230,9368,20862,42,31,36409,9825,26584
128bd3f408015e91658c75f97849e3f8,130,97,258963,43243,215720,99,80,204720,36158,168562
63dc3aec3bf3dd2781c209f7a4a4f9fc,153,101,437686,81370,356316,146,96,325996,84911,241085
15824f2c1142f19d55f17f875f3c2684,149,115,362709,165584,197125,109,74,330341,90077,240264
94b365a04bd7db59990d43ef73b0de23,109,80,166253,55370,110883,116,94,248600,57072,191528
41553e64a97b52fb07aea0ab8563e661,95,62,181324,57289,124035,131,90,248915,42492,206423
402da01ef52840a3832550b384ed6cfe,84,69,115985,28319,87666,109,95,209088,36664,172424
f27099270ce23fef28d5364517dff6c4,94,58,158352,45639,112713,73,51,121583,45220,76363
5531f8a4f47e0f601e66bca14b32408c,81,59,100953,26041,74912,91,68,119658,24147,95511
d759853b464062bcfa408c54a7fbdb40,174,115,547811,110726,437085,175,142,756981,119953,637028
e06b214fefa4706da2e6276607014499,174,131,774704,135944,638760,197,146,1245076,189222,1055854
0a8fc5a1eab555a33a9756516af4fc3a,146,116,551388,144934,406454,175,112,548159,161553,386606
aa8adc7b8674b02a181c705461255d69,166,121,372598,76247,296351,174,153,429228,100539,328689
013f8b6b84e7f44d8b3fdf5d19661f59,80,59,111770,36872,74898,101,65,211932,34289,177643
4560123d937d82437fc5099d74a0f3da,5,4,620,625,-5,3,3,488,390,98
c5ca1b71c7775a7395bbc62a1fa056ff,27,23,18496,6232,12264,20,20,13423,6214,7209
32df5577cdbabd6b39053275d044ca8d,63,59,85304,32333,52971,108,88,171186,31244,139942
bbde22c00ca59867ab950c04e0ddf276,51,38,67492,20167,47325,66,48,91370,17695,73675
6c01c8ec02ab6e8a861d5604252584ed,119,101,527894,122881,405013,158,101,447086,111983,335103
cc3e66760096a73b75cbfe9200f528c7,135,98,265628,40086,225542,103,86,229241,42466,186775
7729a1b5bab2387b85e95174ee4402d5,5,5,367,270,97,8,5,678,256,422
3fe2de5b95e5743444f6a6aab9802394,30,18,8832,3137,5695,23,19,7956,3767,4189
57c06980c6bf42b1ea814bb46e741db2,92,76,125520,42476,83044,89,74,140514,41123,99391
d57c1f8a93fcfe16e605e8a464588f1c,0,4,0,415,-415,4,0,415,0,415
708e9b6d608a828d41f43316af67ace7,28,20,18085,7572,10513,29,27,25886,8932,16954
282998b6278999fc00badddfa57fd69a,170,137,734681,141435,593246,200,151,727618,208715,518903
54d837d78ebca374dfcaa4f8b694e202,92,68,151728,35192,116536,94,69,156079,39342,116737
5ca76f27d237e5f492c2c152a82ff539,101,79,207240,46643,160597,96,70,204441,46562,157879
867e8489f80d343c98a4b35c0e6344ff,130,92,400367,72615,327752,163,119,365395,88875,276520
da17dd14c3f1eb5a9b7354913439a1a2,153,109,416298,98240,318058,168,137,482312,103984,378328
59255a281593f61af037fa026856f59b,101,67,159141,50063,109078,123,91,208668,41546,167122
4311e37ace0695a5c2e4830d6c504907,22,21,8994,5388,3606,23,18,9868,4601,5267
7c377384c7e63b9e71f20784e8840374,120,72,404226,85364,318862,146,116,500360,105055,395305
04d841f2ab4b28641e5f9d574447d80b,93,80,151994,28387,123607,113,91,176580,38116,138464
3b004c8eac358b506d592756ba301f5e,92,69,220834,71708,149126,134,104,279474,62779,216695
72df49d181c99d12eb40f9790366efa8,81,57,111320,28241,83079,75,53,97980,29767,68213
190e2773ca402f7dbbd9ec85fe5161cd,30,24,9976,5389,4587,31,26,15134,4854,10280
4bcfebee49d2df0f713a83e7fd4ebc7c,207,141,708264,145049,563215,210,140,562407,166536,395871
5142a49fe6942925b4d4251bbd705c95,69,46,81363,22501,58862,52,42,63288,31869,31419
dab6b4871f1af65c65c031e4b5222c9c,150,118,515182,99691,415491,147,89,443253,66734,376519
f56f93a150df4510cdab734bbd2134e9,144,106,357546,115143,242403,153,126,370684,128476,242208
8142ec25ebda47c868f47f7d4ed8b9d3,135,106,339789,86317,253472,116,77,282131,90239,191892
b8946c8ff3b98a52e53d0ea91c14ecaf,27,19,19348,6503,12845,37,27,24247,6209,18038
0cbdd6c35047fd33b6321d61b735a4d1,56,57,81764,34502,47262,59,37,62003,17080,44923
2d16f4913c715edcb2cfb3755c38e84e,162,130,449598,90171,359427,109,91,315303,105437,209866
b6a93d5e5c4e7d80738a7282208f170c,156,123,312832,102813,210019,170,99,461954,73561,388393
3d7cf4b809b3c3e89d1741b36b711f23,196,169,759140,151631,607509,151,118,915494,112358,803136
fbe35e712050ed91f0b179ee51877f46,158,111,774867,74576,700291,182,139,607360,93342,514018
c0a4a56e976f4be0e0124411a3135c77,42,33,56244,26402,29842,67,60,115301,23935,91366
4ec48e1c2081f0f9aa7fa82305899def,122,98,305627,103375,202252,142,114,364920,102903,262017
c93403b1f9015b5ec081577c01777617,99,77,198197,40582,157615,97,75,171964,52835,119129
d59a217b35b0d861eef1d7468c8f7d07,101,89,265680,43646,222034,79,73,135652,58709,76943
386136f2d9b8be3bc5e2a6fa76d1d1bf,28,19,12690,8036,4654,25,27,19093,7845,11248
c77760c3222bc8c051bd2142e8c484cf,48,36,32692,10975,21717,36,26,21256,7443,13813
6d4f566381a73af50cefc74bbb22b195,147,108,466943,76128,390815,154,128,478689,81706,396983
fe30933e1a059c8fbf1a76c5fc6238b9,44,32,40232,27841,12391,75,55,104892,27201,77691
c668f9e4d2d4214bfd0d680c7ede69b6,23,22,15935,6743,9192,32,22,22414,5007,17407
f210cb030301a24493df7e8604fd6eef,47,37,88781,21977,66804,38,30,51052,24054,26998
9e520f7b5684daf5c1fce27e6e10ac72,131,107,322355,69364,252991,119,104,314346,61072,253274
bea2e477ee840cd87c92928529badcdb,50,42,42805,14893,27912,40,30,42176,12105,30071
637415ec8feae895fa2eb34c039706a3,23,19,6928,3977,2951,22,18,7906,4402,3504
b5a6da5a9dbc74893b48220bf2b81928,86,73,207014,54503,152511,84,72,224097,65790,158307
ca05a68e1ecce2e7c338d59a6d517def,207,143,918112,250117,667995,211,144,1103922,183294,920628
3ca7e1c9ebb008dc98e9632df967505f,69,52,84469,17105,67364,59,38,56390,15777,40613
8034fdb6f687e9c253d9b59d516f2f3d,127,81,290713,45752,244961,104,73,212797,68339,144458
810ea675499ef9a01bf535fbb6255112,57,52,116063,46783,69280,94,69,181671,48832,132839
3b8c98c2189330860e832ea14ab8737f,157,119,368464,92661,275803,123,88,320578,76739,243839
f9e774279cb810e0b59577f74e946e9f,39,33,55950,20981,34969,49,37,51379,22702,28677
47e2ff9ad4e3768703b1192daa2eea53,158,111,481871,165349,316522,205,135,595380,129163,466217
c225e2b9a167cb3600f02dffa5f701e0,179,125,572392,86186,486206,150,104,428055,99390,328665
3cdd6e5c7a6e5228ebf43ca6bfa2e980,82,70,179857,51067,128790,76,46,139449,36626,102823
1ad3dc64180ad40f7ee895b1d772e1af,127,89,182474,28181,154293,114,83,174742,33167,141575
b957dec50c2f64691b1760c42802da53,28,20,13955,5201,8754,24,18,17076,4792,12284
8ecefbecfed3ecc7e8f620f91bb3fe5c,133,102,509271,147299,361972,190,160,786324,142265,644059
9d4b0a036a4a1eca27c2d5bcc22cd5f7,132,107,393986,83528,310458,178,135,445008,122888,322120
756f30cf9b93209dcdcd7ac06342df24,158,99,638690,111619,527071,143,82,503388,111817,391571
0000cbef31e13f297dbbe47d84a08169,87,63,154591,37340,117251,73,56,154120,37138,116982
d839688e4a02918a0b6ca7cb1007850b,131,111,301786,83475,218311,136,109,338909,83987,254922
c0a738269a50de5c5db9b24ba0ce2f70,55,45,83835,17765,66070,39,27,40521,20222,20299
7dfb05f6c99ed2ea722957b68ca0f7f6,28,26,13932,6003,7929,36,23,10623,5126,5497
cd254f840c149b88840293c02c0b3639,93,81,225025,67291,157734,120,93,202862,57555,145307
beb5ccd1914623e436a2d3886e1cf24f,14,9,2450,867,1583,11,12,1070,1672,-602
4a627a2d49ccfad75b819e8c6fe1ff19,2,0,377,0,377,0,1,0,56,-56
75f1851a71ac4bd18fdb9914a7b5c323,181,115,411497,57069,354428,149,102,363597,64691,298906
bdc6c3e64014fb3daae421445ef48e1b,49,39,75548,22601,52947,54,34,72567,20903,51664
779563b8c50fb987d7920712db9f02ea,76,57,145892,27867,118025,59,56,65179,43603,21576
44919823518d2d08065222c2872f36c4,73,58,99451,30422,69029,79,56,95136,38236,56900
7b9cbf6e6be53ee493e0bf172f16104a,58,33,67705,13761,53944,47,33,42744,15580,27164
6f9b7d49865ab5a95b86ef272e67fd61,83,58,114766,40178,74588,100,86,173806,49600,124206
1076151891db2962b9e86ec7a94edb15,25,18,5980,1738,4242,21,14,6018,2774,3244
1d3815c8cf53d9b9448d727c4f59e50e,87,64,164845,36013,128832,65,46,107568,41953,65615
5a32835bc6a180c2ce02e3b336e03e61,8,3,1921,551,1370,2,6,199,1510,-1311
7fcf885d139705f4cce36e31c981dc79,74,59,101403,27484,73919,51,45,63097,27795,35302
f00ca96285c64aae3549fb7cb7afcd07,146,105,692453,135379,557074,190,150,793486,196937,596549
82838db322240c75d02b03794d258d6d,83,63,151189,35675,115514,82,66,116483,44614,71869
9d8a1d2677e20e6ee567edc7163eb620,201,129,594028,100514,493514,194,125,579225,101877,477348
c52a1d8a02b3cfbc342c047953805884,22,14,3956,1976,1980,24,15,7045,2123,4922
cc5f25d4e5b403958bfded3678732430,31,25,26291,13998,12293,31,23,28333,13020,15313
7b503afa57b3951fc82b3aacccccde65,31,25,25324,8859,16465,46,41,39547,11013,28534
557b9e06d86cf5e6a553c6153efd51cf,90,57,149884,22164,127720,92,87,221015,49818,171197
799b9bcbce5e21e9c6ac2ae1237946d3,37,33,58307,20767,37540,41,26,41795,23035,18760
d31b52db8406f6c18091e40451b8485b,77,60,120155,30129,90026,72,56,108201,27032,81169
9c2d63ba3f7b72b31292a4237691b755,95,76,190340,48098,142242,93,70,199411,50887,148524
985a584b0a4c55d5f39e420a0361067a,20,17,4726,1565,3161,22,21,5544,3169,2375
467fcf75b594e62f4a83f8313a8a7199,48,37,55116,20520,34596,68,50,65474,22721,42753
6ce062879f4eee9d8c89abecd998b3fd,170,130,411641,101099,310542,227,162,716968,93651,623317
ebaf1df6435123fb14560984a820912f,111,86,283529,52491,231038,129,106,300220,47937,252283
0729f42b519c2ce23262c636ce21a062,56,48,87697,35555,52142,53,41,92322,39654,52668
275f1460642095e9602ff05a369082b4,25,20,13966,6565,7401,27,22,14487,6919,7568
db0e12247e63057a8f634b98383e2731,20,18,5552,1959,3593,19,11,4035,2270,1765
67ea451590983d024ee982613df49d78,129,104,228667,81724,146943,86,74,170741,50222,120519
102d0969e91467a9319d830d2ea2d96b,153,113,452420,121381,331039,148,108,423503,110206,313297
ec0b53d40216057029b893efef7a0077,17,14,3677,1284,2393,18,14,3688,1453,2235
1dd0e391fe2438644aaf9c0041c52ab7,128,104,344319,100681,243638,123,92,407735,79283,328452
32c7ce9950e2b78b426ef24dc87000ac,132,106,322748,87838,234910,76,64,199481,96796,102685
47ed7f22152a6b38cd12a5115cdac80a,115,83,238841,48217,190624,123,68,186942,53361,133581
7167d300e746626c89cdf8ef885da494,36,24,22596,10608,11988,31,30,27878,10009,17869
41bf71f4455afbb3cf58fc1c9e5915be,58,50,93444,29421,64023,65,56,87659,27218,60441
4ba9ae65cfa54efd63817c1a4217364b,49,41,47564,12297,35267,40,27,32557,13130,19427
a78d2621764a2184776da06409f3fca9,3,3,125,128,-3,3,4,215,90,125
00bf511011701848266f9486c6302b37,33,24,23707,6876,16831,29,20,18413,6055,12358
0b79f89cf703da6586440f15753a073c,49,39,82751,23833,58918,72,64,176764,34991,141773
5f393edefc7d4b1f72b3477db39fb631,81,56,169070,40096,128974,91,65,182280,37125,145155
03f814ff6f96cb6c0a0f416b6e341cb2,28,18,9265,3327,5938,24,18,9211,2730,6481
066c94bd163ad5d0928599c4707d6f19,122,97,355179,108030,247149,129,99,295566,79177,216389
696d9cf6218a56406b7b3ff4c8691a22,47,47,73266,22859,50407,48,33,53071,13793,39278
3857257f8a6ee7f6cabc1e10dd23358f,44,31,44493,20229,24264,51,45,61852,21272,40580
476d0f177b89d766f8599a4f1cd19b01,90,64,128222,47324,80898,124,86,179303,35127,144176
0ed36af7d5774823190b0a1439f3ff69,47,31,55925,27177,28748,36,38,68144,21951,46193
a8dcf7c30751dccd37654d6c2637efa1,79,64,141178,33855,107323,81,66,147993,50546,97447
866eeff8ad620a8b2030aa91dabc82eb,28,20,18567,2849,15718,28,23,8291,4134,4157
9a22537654aafe29a02d208170646aba,122,98,312871,64628,248243,106,86,191753,61366,130387
1f895b798459aa98516d87bedeea3781,50,37,49577,10825,38752,49,43,37942,13756,24186
4ad3eb7fa0be7e2524eb3f95129c9532,70,48,119552,41692,77860,119,103,200152,63163,136989
fda8018b6a280968a26e22c55c53503e,57,45,72814,21423,51391,74,51,105519,20703,84816
19a7a67fc6ce93cb7a932ed9002f7cce,23,18,8769,3038,5731,25,15,8858,3536,5322
33e2aa01c34db73339f92e88f43e9b3f,119,82,213911,61402,152509,135,96,276834,53527,223307
c42c061e0b0238be1afdc32ec54954a6,14,11,1655,1753,-98,9,9,1924,1066,858
2432355229615356052eec79475f7210,157,115,594934,130263,464671,150,117,660315,162945,497370
f2dc18533cd0ef0b9d2b4795920f1e79,126,96,314834,70277,244557,77,58,186383,65888,120495
14aa6626a7311ba15a4373c72cd58288,21,19,9935,3631,6304,22,19,8509,4908,3601
205ec1275139171a978f9ac427bb8c87,118,95,316322,69163,247159,156,130,533294,73198,460096
279694334bc04895e669388d59495102,190,138,734271,171696,562575,154,118,621066,210244,410822
9367560165d2c50dff7c582596a5b07b,42,33,93044,17991,75053,46,38,68071,25964,42107
51d3d11d291c76f548b2c5b92d564fc3,110,86,230026,65398,164628,161,118,318945,65673,253272
042fc4004c6d466b0c7b97d0d529f31f,78,59,87536,32407,55129,77,54,129748,28595,101153
5766d67927586937f1ada0ff8e33f025,100,83,179101,46012,133089,104,79,196763,39785,156978
5c0f559f7761c4db5623929aff4ab52c,61,48,112524,33429,79095,91,62,136026,48591,87435
58c5457d5fb9c52065301a21455f350d,232,144,811441,190339,621102,187,142,675294,151827,523467
ea39f19c01bbdb13a37fb175203406e8,144,94,482005,164854,317151,188,142,595158,180300,414858
a599f798b5d972596248274a75556432,92,61,93815,23642,70173,105,81,115475,22625,92850
c65897cc0aa4a0a76e2cdaeecd145781,51,37,83375,17715,65660,65,58,99278,29081,70197
564e9ef5e348a3d52da046c003e6d53c,79,67,197727,51377,146350,93,78,149181,50130,99051
f0c920885e9e964785e3e6dd48e414ce,92,66,178424,48430,129994,97,78,186248,55057,131191
d03280ff88e7fafe27ba096c0d596a04,65,52,96121,39996,56125,83,55,105018,38342,66676
829600fc2bb4e983489d40dd3d1957da,56,34,59346,10029,49317,38,25,36424,10741,25683
8c5b4a89b503c4e19aa52e00a766370b,168,111,643854,121639,522215,182,135,566650,158638,408012
bacce2b5a31f7dcfc094c0f4c6ce91fc,104,89,254584,63648,190936,128,83,282056,67067,214989
9af809ac1249234c49c6a5607298b937,164,106,351017,60941,290076,141,107,310379,77760,232619
eff48e9d57ac70364b8f0e5cf179e38e,17,15,3653,2945,708,17,13,6052,2500,3552
08ad584c86f96d9261f3f477036224e7,152,126,498656,104287,394369,124,87,391072,67151,323921
f8bb98de2b71627f6b3e201c08b2f99c,117,102,245613,41481,204132,107,81,211473,52423,159050
b1da6f2fe03a7217129b6a6c11036bb3,43,36,64165,21719,42446,38,35,62285,23149,39136
e7b05226cf7b53762d491b0b0662ef6b,101,70,132972,41725,91247,136,117,211483,46953,164530
68009c6dbcea9bcd639ab78f282ec158,31,25,25696,9459,16237,41,31,31869,10362,21507
3bf3209526917076af7dea20220a326a,212,165,1293422,228331,1065091,210,132,869644,192172,677472
8d38f94b77688d0f37ea605c1cf41b4b,105,83,264847,61895,202952,115,86,211693,81377,130316
749a95f305187f42adc422e7c3943736,124,95,422573,118698,303875,199,155,543205,94511,448694
08accca681bf58692488c602c838bb3a,115,73,146438,44579,101859,106,82,195275,36911,158364
08fec2eed2a147f1d85d66e3fa49abaf,124,110,601827,140790,461037,177,147,819991,148426,671565
d8e0e2769f124726b9f9705bd275867d,53,42,77328,22942,54386,62,43,107916,27325,80591
0c6413f143d2c9f54ef5b11e9de4a4f6,76,55,108504,55941,52563,125,108,267409,75206,192203
750b1611dc82fd0b3035ede789eea7f3,172,138,733272,208208,525064,176,134,690913,128678,562235
bdb808ebe2751355a6849ff9803035aa,42,42,55245,17339,37906,45,29,33742,9765,23977
8a27d28bea0d11e31cd7868593d9b377,42,25,43066,8985,34081,33,31,27096,12819,14277
28add548da1307d65c8de4187d6c9535,117,82,179156,26567,152589,91,60,121913,22409,99504
b0b1c9bc44ba10dcf6fa2dc92258ee36,151,119,399190,62369,336821,143,125,517607,80144,437463
1225a4a55a1cb415d6612c10e0b3dc0a,103,83,188819,81836,106983,135,87,201836,60986,140850
6fd08a9bb8db8dce9de9967239c66677,127,99,236899,51043,185856,119,101,253244,50703,202541
937ec12f44d13351a0fb534acc43c01e,175,120,650805,169332,481473,180,122,721710,172234,549476
3748f5b17a2c7fa8ebf77d7f51012a49,140,129,518123,110267,407856,171,124,489469,82211,407258
cefd256122503b678e2eb64e788c364a,179,119,1174676,196262,978414,240,175,1482565,273025,1209540
9b63e51d3d2af6bd56416b6a59d32937,43,36,50416,18979,31437,53,43,59107,22305,36802
31cd354719d9a92b98c960173e10e274,99,74,177831,32279,145552,95,73,166414,27946,138468
b45491c15f70e31d7d8868ac09ae38a6,21,14,5916,2182,3734,21,19,4769,2760,2009
bcd6e1bf46c22689610fb23b3bdb30bc,21,11,6134,1549,4585,21,16,3481,2222,1259
3b26c92ed1b63f9de9c8b5567c4f2adc,21,19,8651,5303,3348,22,20,9857,4976,4881
038893b4ecd7dd9da0ec8f52a72e65ad,59,47,144840,73309,71531,80,70,170261,54014,116247
07987db802ce1a8115d553ee83be6cf5,93,79,195444,42238,153206,83,74,152844,40016,112828
1ba86b2d5fc8cb319d713f21c014cf79,58,47,108239,47509,60730,55,48,86135,43059,43076
3a55c907eea52c0ad78303cd17d66e3c,123,88,305916,53549,252367,116,85,278770,61222,217548
ec3e58ee25fe539731219e59e59e7503,30,23,23659,5654,18005,29,20,18028,6877,11151
ce0cb2eeaca53aad80f22a89a3f1c393,114,80,186629,29479,157150,104,76,174466,29763,144703
6c5b225171848f1ebb092ca20e5baf10,152,102,456167,77531,378636,160,115,465475,68913,396562
7d94077e706880709a3007753611b483,65,42,78985,25539,53446,57,41,62737,22820,39917
26b5bee0049e7a0f37b4c0e22509e597,143,107,459499,133206,326293,130,94,458169,107120,351049
95dc8db6b36e0144d006ec4eb6cac987,17,16,2542,1289,1253,14,8,2672,1181,1491
0a5f2ef60f887c4479d0926b3f1cd3ac,73,55,95424,27887,67537,59,48,76226,22021,54205
478037b2cc3cfdeecde3f743e78430fa,42,29,19424,8831,10593,32,26,27426,5568,21858
9836730c292743a14f11e179a95bf450,172,129,548187,97578,450609,130,92,471320,123611,347709
bb76f89216c5d4a9845fa8ee0c9bb656,84,69,98091,31980,66111,63,53,84842,26193,58649
5807a2adaabad2ecd16d0e8b631c1532,57,52,96490,17997,78493,66,52,73687,26227,47460
9a7d284b4e3caac96d2f3b87405a279d,88,72,182525,47862,134663,112,88,215384,54130,161254
a43476ce9630177096ff4915aa638527,57,45,87730,31283,56447,78,60,121529,32873,88656
542be8023dd8452370ff2b993cf81b6d,247,169,1213692,154131,1059561,195,167,1228916,214607,1014309
c4f4108bfb36c79c4af2635b9368a1e0,146,100,311528,93750,217778,98,86,251086,102113,148973
912d616a8126707a6e5a27aad32b73eb,161,111,587763,96573,491190,160,119,436908,109394,327514
9636e96dbbaf6347777f5372c7fee89a,89,71,127034,37392,89642,71,50,93860,31477,62383
beac4d1e1b25e9647596d5c6fe6f5da2,83,64,169373,58154,111219,88,73,249040,46627,202413
9fbd3c1fe17ea5a799c6ccafa08a0503,57,52,64839,27478,37361,75,62,84383,27076,57307
a4e1423e795522be96944eff26da08a6,105,90,205341,24502,180839,87,68,145838,38656,107182
58f995f831f3d49ad0a670fc7d472c6b,63,43,91440,25202,66238,59,49,86470,36112,50358
3be51b928016528378d98409309f17b3,66,46,96847,19907,76940,51,41,61807,17693,44114
69bae77f4ac910b61404b42e58424202,53,46,79606,21593,58013,60,47,60506,32491,28015
d0d167dffba7cc3de386acbe4397ab36,28,23,19436,7177,12259,33,27,19731,8049,11682
fb087e8077e4ef1d2021405929205e39,127,86,292762,82687,210075,120,96,259254,105386,153868
2050cece7fc6381693439fe34c59f9d2,56,42,50555,20093,30462,59,57,63821,19864,43957
e26d306c747277688d9bf16a6bf3b05e,120,93,231707,44374,187333,80,61,132632,42031,90601
d950e3b5475cca6d99fb85f1383bd465,49,34,69690,25058,44632,44,36,67465,30927,36538
27a6d9416246ee8abe725084272e77af,50,36,45472,16627,28845,48,40,50401,17885,32516
34c01f8911f0b2199d4d3ab269fdb685,135,104,391123,63392,327731,152,128,399802,83060,316742
ce9cf1a5a633b3b0be4d66c86abe2e06,18,18,9203,2450,6753,21,15,7899,4292,3607
610d3d196b4404a56bd6b9db681f5d82,39,31,35778,21858,13920,42,36,48047,16953,31094
fe5a24371919681acbe077ea870f5c72,59,39,59106,19292,39814,52,41,68632,21065,47567
550adf530ba61a66cc53c26f5bdeece5,124,107,241169,57988,183181,111,80,183099,49991,133108
95b73c760d94e6780fe09f2908a8614b,73,65,85419,29503,55916,71,55,103366,21595,81771
e826d90a663b0f10b0c3f2184a5eab02,95,71,157915,57814,100101,106,81,185571,46088,139483
f5194d7a3bc08083f9a7a3a91b47ed2a,44,33,45105,12247,32858,35,35,34796,14881,19915
5470717687ffadb9408eb6e50518fb56,160,134,390059,83065,306994,117,82,275336,65313,210023
42202099a5acc78143b1bff7a5b1d1fa,62,60,115735,34917,80818,68,52,81070,25138,55932
5e4dbc5d622fc19ecfa59aebaec7867b,114,77,188297,43229,145068,108,85,238324,35255,203069
7fc400d3142c02d9cc8ded3850e29cff,189,127,418661,103921,314740,114,81,311068,72563,238505
c343b5559cbe53153cad93dec46f29c6,42,32,49387,20786,28601,48,41,47082,17495,29587
6f566b102d13ab608a65f66e9bb13812,188,132,653316,127229,526087,185,116,770818,138537,632281
b7f1edddf8ffad52e4e191e379d46f70,52,47,60429,23429,37000,60,50,87615,21164,66451
0ae9336ccb0ceb5c2daa2f7adce0de74,72,53,95128,31395,63733,83,63,167997,41026,126971
1b061c289dbd29a8a25aaf7801a9d2c1,23,22,20674,7483,13191,24,18,26210,7655,18555
d69db2969698e324b04eab18de9b7cf4,105,67,186773,63529,123244,124,85,222974,63989,158985
0576d3216a0b4409ab7f01e718485356,62,59,81100,37021,44079,52,39,72924,24402,48522
796d79dc4bfff6c8cc003fcdb5abbc71,25,15,6533,1255,5278,18,13,3305,2679,626
b690de86fe20cc45b8ce8da4c67765f5,34,23,27681,10531,17150,38,28,30957,10983,19974
058a40264b731f97e3110df853127fd5,149,95,418547,74789,343758,145,105,491370,95643,395727
39533a39311fd7a3d6a6b5a70fccd97e,172,125,721204,135193,586011,204,156,695289,122984,572305
d007ae31fbec427f497877791e75d058,170,129,483124,100656,382468,139,114,471381,105184,366197
b72f2df88edf330eaeaa59c63f7c67df,39,27,30595,9348,21247,45,33,29460,9607,19853
f803f0b1cbf911493e3788cbe9b1ea7a,153,124,435819,109659,326160,169,135,547475,98937,448538
0d6e068630c40ac52b0485eaa4c5ade3,95,73,150572,58352,92220,107,97,259240,63752,195488
ace9ef5368b630391eed0acc6aa1e05f,126,85,308777,89061,219716,133,114,388336,128385,259951
d87f0e66b8a2bbdf2264017931d8f01c,166,123,517409,72372,445037,167,125,454007,110633,343374
513926f6147189a1f8dd3fb009f0a0d8,86,71,191735,49692,142043,130,97,243763,47049,196714
db9dca33e4f2db0c84b158c1c46d3f74,22,19,16655,5464,11191,25,20,12766,5944,6822
fec8997154733f2c9e10e43bf72f0f76,163,117,654379,81635,572744,219,171,548867,120943,427924
8b27f9d731f75d26945bd2c7a6ee1758,93,70,181815,48761,133054,82,70,156656,42830,113826
a465ddb6d2855a4710f6ab5d6a3fc6cf,104,86,216255,96873,119382,124,111,357849,104577,253272
3cbec618e66f472494aee4986ed56c43,144,111,454307,144432,309875,196,118,522884,105091,417793
f8b0702ad6f608c643043b275c9b87ad,150,126,655900,152917,502983,176,132,853982,144623,709359
2a0b5e25b6106a04b1868661fbc44d78,141,108,277456,83749,193707,149,99,327735,56714,271021
4a2c3d661ff970713b6121e0a6df3cf1,151,121,373599,120584,253015,162,105,376178,73755,302423
369eccd2e397044f2b169406a998b6b6,123,86,333970,76777,257193,102,83,344268,96164,248104
5ffc223326a8300d106898798377a6f1,52,44,59348,24027,35321,51,40,74145,23203,50942
f826b7637be5b3803afa8016cbed4b6b,93,65,190681,72656,118025,172,141,394813,77936,316877
b62459d2eb642e9d14590ffd00a5902e,191,136,638356,97320,541036,199,166,807894,131608,676286
6dae31b4477d6d824d9d2b58d36e2d83,37,25,36031,10370,25661,34,25,32773,10566,22207
a9c09e72d72e689ce2673cf4a44b4b38,74,63,152841,66648,86193,115,76,247802,64910,182892
71e6cceaf0ab4d358307ef9392265783,100,86,253521,95387,158134,118,89,287643,66930,220713
d6a870f34b3bb77e9b1b1cea7b00d793,118,103,344569,83505,261064,198,166,622720,70342,552378
367b2eb7a4674071b35d7877c2532899,134,102,303320,63987,239333,120,103,280574,60616,219958
6f6b911c3f37390231dff80a95b77113,71,62,99362,43757,55605,79,60,122173,28576,93597
9ebfc805b759693b4e1aff7f3e178c81,125,104,213071,62511,150560,160,123,323937,59244,264693
4d65650e8e593e9c686e0facc53209cb,53,42,69484,21983,47501,65,46,90962,26894,64068
23de015f9967385987f10d6205e0f821,73,55,92274,39434,52840,105,74,172669,32990,139679
a21a34fdd8e8f348f27f84030cf0a048,44,36,43945,17052,26893,54,45,66763,19209,47554
8d234879b581dc660963002134c77d55,126,73,349535,78482,271053,187,148,520594,114628,405966
a8195dfa1c70ffde5db7b9accd65a6c4,26,24,23672,8869,14803,28,23,16601,10432,6169
f4d273cc0cc5830c47a2911e2953bbb9,25,23,11522,4827,6695,27,16,10397,1821,8576
52533bd2fdbfb220678729abcd36e956,88,81,180658,32583,148075,94,81,124904,41473,83431
bde1adbd2ca4cc9495980f84fdb3a7be,28,20,12503,5260,7243,33,28,15048,6116,8932
df63e16d72aae2e65a5e2b11166ee7e4,34,25,22477,11548,10929,30,19,22230,8542,13688
25d49b3c440002a425df92a55c366d8b,95,80,205415,47367,158048,126,95,278940,54230,224710
61549ec036c55cdcaff8e4ee5e99934b,63,52,107520,17840,89680,45,36,30653,20137,10516
5f5cb874e62812b1df17bd5bfc4082de,85,69,173706,60750,112956,112,91,223285,66075,157210
3d76b0caeca06539efeba4ab8b2bab54,20,13,3908,1921,1987,19,12,5099,2320,2779
1eeaff1ae4652a67559476eb332d86bd,116,88,263802,81025,182777,167,110,312839,103823,209016
fcc1c440ba93f304db982a04483e0c47,59,46,77291,21074,56217,55,41,63337,21137,42200
9e1f35ea1be53df75d0e77bfeeafdb9b,123,101,347310,77055,270255,167,134,475834,75006,400828
244239be48a1cdf1d3451e5424a10d26,178,128,744353,159613,584740,162,124,832037,162453,669584
6aaa5eacfa0fc4f500aeda47903a8592,71,51,101480,28977,72503,80,52,107550,25188,82362
b7265ab48638cd273603052a02b78b85,90,64,114177,27341,86836,79,68,116888,36069,80819
a48efaeb74e4ba4ed82fd75ece0ce536,118,99,388204,71201,317003,155,123,357472,69783,287689
501bc1b426046a0d0617971b39945671,84,78,191889,86970,104919,105,76,287247,69685,217562
a5f50a810986620e5349fb51bb8ec403,133,101,282137,74939,207198,123,95,278852,53646,225206
d2284bd43e3b2f85157b4466d8aa1eb0,98,67,189404,66612,122792,156,103,237994,72880,165114
81ef24fd20134a65108c7def232fcae8,118,77,248319,60034,188285,139,92,263909,63516,200393
7ba76327838992aba11436bfb7e86e5a,145,124,638166,166882,471284,158,111,646258,194979,451279
99a070bfb744e69578d05ac92db06230,18,13,2885,1803,1082,17,11,2863,1870,993
213011cf7596e725eae96507593a7598,12,12,2723,1685,1038,13,9,3344,489,2855
a6bae5856032f95837d7e1e9d793f02b,159,100,581357,162489,418868,165,119,531375,124085,407290
600386aff68916c58b52a4f293ba0a82,151,107,528507,99167,429340,171,130,588209,100609,487600
a520da1789b7aabb0024d6c1f3110e06,32,23,22982,7438,15544,41,29,23518,12489,11029
a0d7da277278b4947dc7063c4c1ea1a6,193,141,676802,164924,511878,170,141,727639,156458,571181
c93623d5426755a609c3a1fa5ee8756c,97,69,226066,50189,175877,107,98,233116,63944,169172
e72ef14e6f8d533f74e0ac58dd8d3f60,158,88,314482,56888,257594,131,101,261325,92890,168435
1c9adc860a58d36fc9f0df82035179fd,164,119,383620,77591,306029,163,129,424704,58704,366000
d7b820b2c70d868f3f45acf0898f818a,40,32,45142,12526,32616,40,32,39260,15342,23918
7b3ff58d56484db3c42ae38153aa9318,95,61,179126,37045,142081,63,57,84147,46072,38075
80f6b4fdf5de7474bf1114c2c95b14c8,65,45,52857,15230,37627,54,42,42469,14957,27512
d5d2e3dcca8db1b6aa2666a20e40509e,80,60,154211,44766,109445,73,56,147155,32577,114578
a27614e8215f1f8b9bc762fe712dec12,48,36,52878,17814,35064,67,43,66438,19459,46979
aaee459034f17886f0dca6de00692873,133,116,371132,70722,300410,177,123,385037,103655,281382
68bc3081c6708b34ac09b491f99e435c,126,98,290634,73003,217631,133,104,307588,92388,215200
5a7dcb9b70066f4742328e7acd6e9da4,0,0,0,0,0,0,0,0,0,0
c3428b4d7f83526133ee01b65253a16e,204,151,1249308,155040,1094268,180,163,952180,174425,777755
087cf0c3f2dcc669072c2f126512a8b1,86,69,128725,27767,100958,86,51,155187,29010,126177
167c12e551bebb3734fcd8bd99f3a742,184,146,761779,171761,590018,194,122,855063,123299,731764
3a0ccdd009288ae87f85a4b3263040a7,178,135,557459,108934,448525,188,125,536100,126430,409670
8ba371da85c88fd0ced84f71c9cb327a,21,16,4838,1449,3389,21,15,4467,1039,3428
2e9747cc9612292fb6eae83ef543d590,118,80,218983,43118,175865,154,123,324936,58857,266079
8e3a10f687bba7e8429ad50dd7e034ba,70,54,119431,27579,91852,51,35,72319,31488,40831
6b2e5729f33c7b5382bfe65bc87e8948,26,20,13607,2454,11153,25,19,4644,4140,504
cc8a00b609292a73187e45a3380d20f3,71,56,124848,33075,91773,88,78,159814,42851,116963
c7b0eece794dc669c9b9493c848ad7af,219,131,509240,68857,440383,166,109,433223,91173,342050
4d81d99be52d5823cd1f6d2cd2f24c24,36,31,37847,13822,24025,47,36,33178,14252,18926
152b15c14fa27165fc39682145422bec,30,25,13166,7586,5580,30,28,13214,6928,6286
8db996d64f0dae465e8678c45c640b47,107,87,184667,35805,148862,102,94,205540,35703,169837
50248e605e27e3adb6e555567fa3d807,102,80,167697,45275,122422,84,58,106360,40550,65810
d252176d05260124f7626cf448626152,165,108,524326,113278,411048,147,113,467816,77001,390815
a5b616b9b973b893c4f28b8bb9fe1d38,61,42,102308,30407,71901,102,86,151382,36831,114551
ff632f2edca83feb2ebed611641dfff0,208,133,886693,141139,745554,235,151,1001815,182581,819234
44564b4528c520b4d50b513f9ff600e8,115,92,240983,74939,166044,122,99,260603,64181,196422
4861bc9e66cee98d874417607a6d5eb3,154,129,435560,96445,339115,174,132,583580,73868,509712
c4c23f414fe5af28637aac04036b2f14,42,32,32644,12575,20069,42,38,42755,15732,27023
e5cddb3abb70d9df1978fe51f964c5ef,131,91,279824,64359,215465,139,124,313379,90017,223362
d6d7d449bc317dc232232ade665e853f,35,33,27761,12105,15656,32,22,24541,8005,16536
69980d9d950167c8f65434ba14ae2c14,3,2,201,146,55,2,3,146,201,-55
ae0462c7d305053ff2403c5b9d21d049,108,74,198315,59356,138959,126,95,207374,52605,154769
abb7cf576e4f192a7eceffe33afb9970,182,99,479112,108918,370194,138,92,515313,123375,391938
d5e11a0d50d946fa9faa349c1f5b171b,122,99,280686,69325,211361,107,93,202122,63513,138609
0f70e56fd39db51cf14d5bc3692a3fc1,146,105,514176,131761,382415,203,136,897857,158107,739750
efa9f1ea26ff27646f58cc72b213a185,103,75,166578,49761,116817,87,69,164348,47149,117199
970a7575e7f82faa87a799b04c91584d,41,35,39188,11451,27737,35,29,23092,13429,9663
2c53594bf20c2b53f85a6ea90b4dafbd,12,7,2185,918,1267,9,8,1691,637,1054
b8e385aa29ab046ac9d7b8793a66615d,60,38,70778,21620,49158,65,56,79384,30526,48858
146fbbc508df63367d08576d7214be28,81,61,152776,53964,98812,97,77,246386,62450,183936
f3354f8e60b438bea38360ec85ec3eca,67,50,108239,30276,77963,74,55,124831,24848,99983
c5fd790433a2a26699919f69d406ac01,125,107,334517,72890,261627,138,129,483495,85738,397757
7e60aaa2f4c19d059289afee0273729a,33,26,37581,11157,26424,37,24,31117,13058,18059
f8d3a30a2c4bd536a03f5062adabb50b,105,90,213455,65531,147924,114,63,189589,38474,151115
a88d2cb8512df53846290aa52ec1c6a9,48,41,57957,26235,31722,60,49,67764,24446,43318
295bac1b4e26fb615116939dd8409bfc,124,106,364160,119836,244324,132,86,353539,94574,258965
71fda82717e4ae36913e208c31ba1a87,13,13,2805,1492,1313,13,10,2398,1444,954
d1f4cc291f06986e23ab68076e1efdef,76,64,143915,34000,109915,84,53,119087,32152,86935
bca01c7e0bf75065fddce3d7a540a4e4,170,120,350709,72567,278142,155,124,396095,90610,305485
c13d756990b09e4acf9e685b790b4b26,58,49,62695,35465,27230,86,62,108026,31721,76305
9f0750b72c4c6d1c7c3831113c1c349a,106,85,190895,76988,113907,98,86,216417,68387,148030
c5a9a04c0d6e46ef8cf7ae3d8af9cf7c,49,35,72549,27061,45488,65,53,107407,33397,74010
e0a089132f346dfe43e597798d9cad8b,84,71,208126,109374,98752,117,99,279135,78183,200952
bc2d57b099c0bf652600769e10099592,89,62,177664,52209,125455,128,93,264044,54844,209200
c33bf7de67f08591b6bc978896da8a16,70,50,95176,25779,69397,63,54,78045,25410,52635
c42271129bab0bab154910fd93c42e50,90,62,187470,70131,117339,127,111,268873,55605,213268
b15b0ab12da667d075dcfbd18ac6920d,56,46,70273,29778,40495,60,48,86299,23618,62681
b9fc02be02762e77ddd1ea47003230a8,45,31,48275,10132,38143,46,33,47217,15494,31723
0bd25933247dd73d5838ea69ac603f2f,134,91,235183,50895,184288,144,115,283657,59443,224214
d00f72add3e4d4799100168f4d864403,74,66,145332,52381,92951,115,92,281977,60560,221417
1fb5bfda1c497a165470e5da68559457,140,99,409798,82057,327741,155,100,327653,79897,247756
eb02afcf4d0a27b43611ef1a173ad2ac,159,129,497998,74170,423828,159,129,479931,71754,408177
b32162ccca49a794fa1bee66f9015fbc,40,29,37296,15023,22273,46,31,46192,12067,34125
364665875283efc0f0bbda3091859023,152,112,389738,90231,299507,116,93,333554,107368,226186
d98aaa73b9f35af367803b2f87161d7f,102,82,223027,87840,135187,131,101,302077,84005,218072
32e47e0b4a655b6a43ba4885b5a99e5c,151,115,478340,87507,390833,196,156,703016,117761,585255
1ded4049d93105a3aadd09255e8afb9e,88,67,155389,26324,129065,99,76,109500,34480,75020
abb23784a33a24b07d65969a86c4020d,58,37,98562,38238,60324,54,51,107810,39918,67892
2cab84c560bfc7c6053f016139cca909,190,145,525979,132507,393472,134,95,359796,78700,281096
08300420465c19f4daf2026d55bbac09,98,80,236751,55532,181219,98,88,289155,73594,215561
3136f8de1fb6e37c388a6a173341cfc2,74,52,129480,52986,76494,47,35,81165,31612,49553
17509970526b0df019cb9219b17ab875,99,75,216042,39045,176997,99,82,178527,44440,134087
d58828d6c1aa195ddff8bcb3e72e5da1,115,109,283931,80155,203776,103,71,200463,64020,136443
ef8a330689b7d5b956f78a03e1afd52f,42,26,33942,11827,22115,41,30,37621,15084,22537
bb12b1e1e1bd7349cbb8af535f463816,74,53,132308,35591,96717,76,66,148609,48396,100213
576aa3689cc5964d06a8c68954ddd640,41,35,60210,19936,40274,37,38,49122,26679,22443
767da6ebb923f56ab618ab3c1c1c32f6,54,43,76921,36452,40469,57,46,77089,28392,48697
38e68de85d760c8687bb75e00e11e6a6,108,82,197895,83586,114309,87,66,191859,57061,134798
4111315adf34866f0c1e74d28bdecafb,78,59,125832,32629,93203,90,72,141929,35385,106544
562a3e586867ac0143e1e8e0ee071ce3,168,131,577770,102027,475743,170,133,488841,155598,333243
3c4a35a734302ff45a3068c478bf87aa,16,13,6917,1288,5629,16,10,7306,2908,4398
b5cbf77e99ad9315d05021860f9b73d4,34,27,17244,6111,11133,35,28,13101,7937,5164
d3189686440cc3d92d857cdbbc2571aa,146,125,440612,116140,324472,145,126,475841,106778,369063
33f8c6d560b3a42e5367d0484ce5be81,62,53,74416,31828,42588,63,42,70015,28212,41803
09cd89c52a5d34dbb0ba6f8cf1a1d2d6,143,118,385302,73042,312260,134,102,297910,62897,235013
a75e9128278c24b89d36955796638b5f,58,52,110871,26941,83930,51,37,69486,34140,35346
18bf36d5f8cbc807959bdbb30ab2c2c8,21,18,3739,2984,755,25,18,4893,2455,2438
fdc40fe164537a750f140ff2ee9f1591,38,25,34577,9239,25338,27,27,16924,10784,6140
f33958add56242a81cb3560344aa1d21,51,41,75017,22616,52401,46,35,58332,24680,33652
4a8ebea0be9ac0286fa8cd6a8cbca585,46,27,39813,15081,24732,48,25,39795,12476,27319
2e87a6a24a0425547184de59d1718b44,83,63,121483,40356,81127,106,86,170981,34600,136381
617bc8244febf899feaa35bb9d7bbc63,85,57,116391,18225,98166,48,42,43574,21345,22229
a2bf0b8da7baabad23b62189fc948cab,192,135,928921,260648,668273,231,167,990254,245951,744303
df747186618e51a967084c30b4fb1999,83,69,268257,84938,183319,100,85,266548,79491,187057
647300e6fb9dad29988a7ddb332e6b58,163,136,615363,108951,506412,175,135,448834,107024,341810
be6131da39c3f47758ca7a8c1baa6871,35,25,32304,13457,18847,37,27,35748,10295,25453
50a20c650e4b366b5d0d5191ae7a1ba3,96,79,267048,62833,204215,122,87,247684,76955,170729
d0897078fc16e29b49b22cd24e5c331b,123,101,331529,85055,246474,131,87,256587,93164,163423
0bc4b35c685b2fba500497e5c8b2e563,143,95,349727,76986,272741,140,103,480837,100749,380088
4ae4ecd0acc02ecf8757bfd006992d5c,84,58,126622,25319,101303,91,70,106203,35861,70342
5297e99cbd5a5d2940434223ce2c2b19,28,21,18407,5739,12668,32,26,18385,6258,12127
d1da3720b5b2199b3964aa9e42916c42,60,36,69121,16917,52204,45,31,47758,20967,26791
31afb9017cf7da30edf867945b91aade,141,115,325902,95925,229977,125,73,255373,79088,176285
1b6e8f33623638d065bca4128f7b509a,148,104,236566,50968,185598,103,85,184412,59286,125126
66b767ee13b2c291474147e021d62a94,78,59,101128,43007,58121,101,79,190539,50288,140251
1063658c5b3b33d9fb33c08408dc3555,108,83,222589,47934,174655,97,85,216487,53999,162488
178087d513575c0b3f9265941d50f670,90,78,152442,59291,93151,74,64,155505,43807,111698
8987dabec0f92a992c4ef1333ee3769a,151,112,373503,69696,303807,112,89,240041,74615,165426
15d80ce443320ceece3f67e451759ab1,125,99,264289,72359,191930,108,76,230512,65044,165468
860fc5026b6a739ff94ec8dbbb640af2,136,99,278587,60872,217715,122,75,238451,57297,181154
886ff02edb9dfaef51ac512cedc65adc,40,31,35397,13260,22137,56,46,50492,15958,34534
93365c5f1d90b9ba808a1d046efc8bc6,41,29,22653,7429,15224,34,26,18794,7807,10987
4061da4691176259f269e18b7ebb2960,128,103,279002,73226,205776,122,87,234010,52694,181316
00cd7fc2ccf97750ea93ac085230d08d,67,51,140380,38277,102103,63,53,102994,35927,67067
062c3357d48c2f4bcb47c5a47fb4ae49,28,26,18534,7119,11415,25,19,14038,4011,10027
93ce9555e74e1cac7572a7b84620f505,108,83,298379,133098,165281,148,114,354690,107836,246854
b7d258406a17fc523f5fbe120ffea51f,107,88,204104,53606,150498,91,78,178120,54335,123785
851c99d8fdde51286f97fdfd4727fd21,170,145,519358,109553,409805,184,126,566138,114086,452052
285163961a47020b7f47755c03657e78,76,49,61661,20766,40895,69,53,71909,24713,47196
bb55a6a66001f81eb5af692a318246f5,81,61,193885,29627,164258,87,46,195815,27720,168095
7717f41c13a8e5cee12e457b3a9e411f,33,25,14488,4992,9496,28,25,13850,5104,8746
42c939bee3dfdf99dbbea0da58ae9c87,168,106,414949,84800,330149,151,119,464893,109849,355044
5652943619090b6309188750d04ce233,70,48,79045,17267,61778,72,60,92160,29414,62746
dc98838fbe0968897b2c633dd4555539,20,14,2741,2833,-92,15,15,3390,1849,1541
6b62aea59c3d069c1318e82beb375fb9,108,65,156966,43776,113190,57,45,77088,51905,25183
a24559f9f00ed177febcf9d393611745,126,105,240264,38536,201728,139,120,292825,58150,234675
c4224c9aa166ef984b83ecd73ab79c5e,24,18,6593,4295,2298,29,15,7768,1928,5840
4e0430a825e058e6b361c00adfeae52d,58,40,53006,13742,39264,42,27,40786,11887,28899
140f554d6d0bacb4703974bbc22c699f,154,130,478608,82203,396405,148,96,348205,92997,255208
489f527c08c27e4207f7d289e3a34497,57,49,86099,33478,52621,58,40,95768,28428,67340
f7a98e5c38cf1b54111f92483f28066c,110,85,209285,48176,161109,89,50,140003,44643,95360
084129f83133fa71b7748db7800410da,133,95,277967,56163,221804,152,126,414346,67052,347294
5f13b5cd4880340705922eb325ff7454,140,95,341327,86334,254993,162,129,373313,81469,291844
fdeb0b1b8fa6ccd99c3e7d9859b74260,34,24,28577,9326,19251,39,30,34409,9995,24414
53d1a56e370a69fd01a2715271409a4f,22,18,4594,3068,1526,24,17,6110,2578,3532
66be5a215a9c722a3bfba10b4dbaf93d,98,73,223052,71089,151963,123,93,252716,63670,189046
13be9cb6e02114bde54a9adaa44fecee,105,79,308687,64091,244596,123,111,291192,89944,201248
75586eb31a5b171763f3eac887c0d6da,54,46,69939,22814,47125,45,34,49987,17250,32737
4a0f748aa446e28d4a80350158518f7f,149,92,309396,60726,248670,156,112,341846,71732,270114
7ffc6ab82f828576bf7e2a0ff3bd4f93,21,18,4044,4123,-79,32,20,20922,4253,16669
aa597397dc204acc3a488b30e82c1108,85,64,117489,25425,92064,64,62,90653,26605,64048
1ccc3a0f83cf62ab96639050e9a1dc41,138,119,365601,57261,308340,141,103,350438,51430,299008
2313a8d5b8423cec92d2166a4af1497e,142,98,585281,74246,511035,195,142,607155,135950,471205
da407c19944b0fe9dff1db3d1c25f04e,94,61,157285,46282,111003,121,80,201380,55221,146159
bba804820eaeb9b7433a0af8946bacd4,45,31,32556,14549,18007,42,31,34116,11878,22238
f0657af7c437b09108ad00db7cdf6e67,49,33,58868,18308,40560,45,37,63704,19615,44089
239c6a3b0e170b480d1ff3ad6290f500,150,98,395634,108211,287423,153,120,412494,111744,300750
4d527a181e91a34f2abc8335c174027e,79,66,134471,46325,88146,96,82,165474,48159,117315
7033ebcfcfd8463a5dedbdbfaf00b5d4,127,113,365205,74802,290403,116,100,324451,64846,259605
e17ca580873f34417b91baa5ae4762b7,136,105,393963,71306,322657,135,116,321019,84167,236852
fb902ee12f9adfc6e61cb9afd506184f,106,88,264915,49555,215360,118,98,268441,33863,234578
25dd39544d09c308a9b68fd9810b0f38,26,19,17554,7112,10442,27,23,16736,7295,9441
c2f04a5280e663caf05e8959353a13fb,47,33,97987,23255,74732,47,44,59449,26651,32798
5b080e28ded01965d926151e8d34ffa4,25,19,9006,4982,4024,26,19,12143,4380,7763
b8b2a44389490950ff66cf5e11c323ec,60,49,95392,21005,74387,50,42,60353,23158,37195
2002206296870240addf0ae7b0a4fc89,199,143,544627,148863,395764,163,127,652926,165935,486991
73744a92ce8e3ccdc1be37436344b60a,31,28,17712,6296,11416,33,21,14624,5129,9495
485aa9af53f556d7c3767692c924d7b1,130,120,350378,68193,282185,100,78,225471,38179,187292
0244540ec4117d94c37b5ed83a079c5b,98,79,188610,82441,106169,128,121,312087,65470,246617
9c3ac63b829b4c53441c40b16ec34d25,54,39,51788,19517,32271,65,58,84124,20868,63256
222d11868325d95460898b3707ec66d0,38,30,24210,11037,13173,43,24,24720,9837,14883
0fd48f008e60486a9f668a21745edbb9,185,111,461971,62674,399297,151,90,443710,57840,385870
41673aefb645dc07a4f05aa10c8262ba,117,74,198309,41565,156744,118,90,213489,52053,161436
ff2954b411db4cec90647c3b886f6cd7,165,130,578910,146959,431951,156,126,704019,204367,499652
e359fd63729a5dbf861b45acf4d439e0,190,129,784501,207128,577373,177,150,767721,216764,550957
8d79d48f2c970bd11812b72cbdf93c57,184,137,683060,113843,569217,141,105,479528,95551,383977
113e38cd3924cf12348bac89babd0a75,35,31,30125,12785,17340,44,40,27099,15695,11404
eee2ee73ecbfa673bde50f974cccc8d3,42,27,50908,14532,36376,49,32,48077,14391,33686
c57b7d430daf15890b61219022febdc2,53,44,88423,25443,62980,61,54,103927,26790,77137
f83be7d4f3e8bb0d6cefc2ecd6bdbf91,169,114,553519,88917,464602,207,151,659616,77641,581975
064c377db41005965910e91793ad55b1,222,156,1323865,167334,1156531,248,134,815026,172554,642472
de2be0b25d2d0377730962f50e20cef6,108,90,231947,53523,178424,77,54,150361,40758,109603
d74769972c8a9ef6595dd76ab0a6998c,174,133,624693,117512,507181,192,148,813847,174901,638946
56f79d5d6273081f21a6717a7ade0ba5,41,30,43078,13953,29125,33,30,32217,17574,14643
7dd7c48b444c5940d7480715a5b3d2c2,80,60,132987,37367,95620,71,69,121002,37421,83581
a920fc91a6fe49332731bcce1b00b126,169,141,572734,142591,430143,193,110,558882,95517,463365
bf09de8e89f206bae6638b6d14071a5d,55,46,111568,35636,75932,68,54,136325,54106,82219
fde1e8264afa4e18f3d6d2d3109decaa,25,21,17941,5326,12615,30,23,10118,8245,1873
5cd2aa62c8ef8c9b11b0c060561365ab,101,83,193170,32255,160915,90,78,123725,27234,96491
348060d673adc5ed793556ed2e3aca80,25,16,12910,5451,7459,24,19,12122,5248,6874
a17b0504b8cbca77f552e1264bc1e171,86,68,128680,34711,93969,86,62,138356,38935,99421
357ab8e06b3a4273f582db251d35efe0,115,97,246248,56793,189455,85,67,190577,55990,134587
abe74f947f67b2756b85dcb894aa30e0,100,70,184203,32674,151529,114,90,189004,47025,141979
37301fc16be58103056893aab982c277,8,7,1374,1366,8,10,5,2262,1041,1221
4a5bf8cc397a623800342feefaaa2a31,162,125,386975,65109,321866,119,100,234807,77495,157312
9bb0e6459e43437da80fa4b8d75a8b44,35,36,32520,17271,15249,68,52,71674,13423,58251
77425f552fe227639f1e6a21cdb3cd30,59,42,74076,13756,60320,59,41,64566,13224,51342
4b0c3e0e2d1e000b49762e8533215ace,90,59,135837,30090,105747,78,52,104865,31460,73405
6242955b3ebd735f911d7b5facfd16b3,44,40,41799,15332,26467,44,31,46308,12828,33480
7181c40faf3ded7dc3e375e19e04c88d,92,65,212721,43422,169299,113,83,191762,43949,147813
06327288c4bf217f88dc2995347f4601,95,59,153085,35841,117244,83,63,140824,39883,100941
02c01ff3214c4a4366c0bf25efa76f22,79,57,170675,52634,118041,92,78,199856,60776,139080
e0323738f08dc7b66a89ebd13573938f,48,45,44608,14919,29689,48,24,45794,10894,34900
e5d8cd642742a9db60e3016e781fddd6,18,13,9658,2389,7269,28,22,13770,3361,10409
395618a3a8c44e028355dd7587e8f0d4,10,8,2259,2410,-151,14,9,4014,1734,2280
9b086e024b3409c80581f5d7a4627c5a,58,36,44123,17223,26900,47,32,63679,16336,47343
f99cf8e7d76ee571eb7998e0481c0681,27,18,5566,2234,3332,20,14,4773,2785,1988
54c87756c3578a8e37d0b647c47f450e,140,97,367775,56298,311477,127,91,289939,72710,217229
2ae5c934ba8eb5dd02e893c10c59871c,35,29,28088,12136,15952,35,33,27144,11750,15394
3e04dc43d39e69afb57f4cf2dcd3e3a0,78,71,142047,30982,111065,103,81,136390,21837,114553
c483faeb0a2d7635351c3f8f48dafb4f,69,47,100291,29900,70391,64,52,112348,32306,80042
f2f09d4f082334b0fdce0de13c0c4c5a,105,88,255756,86983,168773,97,87,265393,64918,200475
5c04642e12e3b843d45cdb64bd24e819,88,75,129447,32073,97374,63,53,86973,30039,56934
6dfc1b919131b77517f99cd7eae4d07b,105,81,212742,49225,163517,98,73,177700,60278,117422
5bf482fdfbb3a1de7718e29f265bd953,186,138,523110,106385,416725,183,122,467753,81382,386371
8181501b02769e9e6506ec4a933c23ff,30,23,28343,11039,17304,31,25,26802,12756,14046
48549ef494ac6d8c01a7c59de617993e,81,59,147830,79706,68124,120,94,284234,67753,216481
664f72c328c2e2e179373132ab82b98a,53,40,62765,24882,37883,49,45,75443,26138,49305
d0603add62e5ac225b30648562825367,88,69,152701,47478,105223,56,51,85364,38302,47062
2afb6cb8ed3ae37967abcad55f6a4768,77,58,108200,41489,66711,115,101,256427,43575,212852
3942aaf60d122fb81c6d6de9268b1508,40,28,53075,14863,38212,61,34,71421,14530,56891
352ebd2dfe101374b05a3ee693a1f0a2,79,60,137083,28545,108538,85,62,156135,24109,132026
b19c3ca490e1b44b665629be02609a9d,31,18,27914,7296,20618,22,22,17005,9457,7548
975637def01405de7e11812efa79aa4e,190,144,947700,223948,723752,204,137,771079,182671,588408
6afdffb09f70e0be262b45f40e38938e,89,75,119924,33262,86662,58,49,96954,28598,68356
a865b8457c3470f783483a9787d104a8,91,62,152782,54765,98017,107,67,156146,42982,113164
4c8dd7b73691970bb140195d5a21d5b4,135,107,266358,32238,234120,115,94,206734,40632,166102
57a57b1199e7fa7f97eb574cf47566b3,45,34,40203,13341,26862,43,36,30524,12989,17535
6e8882831f94bed2c123a0b58596a03e,55,39,61815,20338,41477,53,48,51110,22226,28884
f0e6c9f6302db5700ae156ec3b7737ef,64,51,89649,30583,59066,55,45,93768,29512,64256
2eb1dad77974f3ca9710e15e1a71c475,74,60,93174,32030,61144,74,53,90024,30914,59110
993f0c1eda92e6f0cbe219eb000ca635,110,86,210288,27267,183021,102,84,166873,38864,128009
1a57db338b8364c81f4b41877beb1ab3,17,13,3189,891,2298,16,14,5369,1495,3874
1be048f8facdd34f381c93c4bd5bd29e,49,38,52223,19594,32629,49,36,46304,24645,21659
b4a1be523b0573020026c01a4c05b2a4,46,43,51432,25156,26276,93,69,128189,26277,101912
7781bf816b3123445bea5398651b68e3,134,85,264643,62389,202254,120,79,289092,59870,229222
0359323dbac06253ce13cb9bdb71f2fe,109,79,199321,57047,142274,124,80,211776,52249,159527
2c013e48f18149768793c9c01868659e,94,67,204756,70205,134551,117,78,243994,76744,167250
ea75cec991288a24882fead0d3f8cc8e,128,93,334679,101220,233459,172,136,404554,126499,278055
90018ff40fda931eb395ac2512e7f21b,61,46,98251,31795,66456,59,61,90981,31326,59655
590b2dd65e40502899c87be6d70d8b30,34,23,19666,6623,13043,36,30,22404,6767,15637
f318323b794dec1f9897f2deb14a101d,94,74,199525,55968,143557,141,119,231031,76699,154332
b1747c5bcf0f51f2a6b28ffe7d0b840d,31,22,33102,6167,26935,28,19,30562,7771,22791
1d44de8b37c3059e114179b9b6c2bc0c,173,152,535401,153792,381609,169,136,569194,129832,439362
28823f038b785b9e839e88f335af69b1,166,125,709668,120300,589368,175,139,762606,126764,635842
c1163d173bf327895a9c9037a1ec60de,39,34,27245,9275,17970,49,44,33375,12481,20894
c5e4f6d888687e7e58c648a887201885,65,44,67443,26075,41368,70,60,85095,30689,54406
8be1ae5537808881448b0194b686bd6c,122,94,398797,85329,313468,147,117,559280,99665,459615
c745fe6ce4cfd99f851508444a6274ad,165,105,582263,154650,427613,184,135,737527,195347,542180
93d67508d6d57660d5e437f53cc32a27,183,134,692604,143626,548978,215,138,898274,153560,744714
5c1429b0d7c4e579bb84e6cf034be395,101,76,160686,27077,133609,96,75,151966,40649,111317
ab78331a51cc25b9edfc3ca294cb77c2,20,17,4948,1903,3045,19,17,4877,2749,2128
359c81424f45dfcc6f08b9d58646074f,123,96,318726,63753,254973,89,77,227429,77757,149672
6524d04c761bb094421f584ac614cdcf,173,138,609907,125219,484688,164,127,471334,125478,345856
c80be47291fef4e3dd769bdd22d785b0,67,52,97694,28056,69638,58,42,64369,14964,49405
278fafc9311608dd1fdab8ecabbee4f4,19,19,8421,3368,5053,19,11,4519,3461,1058
edd340dc461671bf93f057d2db57a135,29,16,10240,2289,7951,25,19,9135,3686,5449
34a305ccb544d68103f6ab7c3ebf3b63,49,39,80158,32016,48142,63,47,83239,37411,45828
9e1e37cc7e27abf5515fd1b6f6a7ec3a,38,30,32363,16029,16334,31,25,26981,6123,20858
ecc481a1018f3633925e94bce8c141b0,90,68,168088,48150,119938,116,92,274091,46471,227620
e68808ec64289ac383320c5b9c0757b3,30,23,16837,8561,8276,29,20,18604,5529,13075
085aad5d41ed5fb0c37812b19fcde60a,45,39,54731,19812,34919,55,33,64974,17770,47204
f8b6ba2af55e0579df0aa2fdf4fe7823,70,57,122965,37011,85954,123,97,212061,59078,152983
e815327ca904ac9fb860accc1818ac36,23,20,9870,4360,5510,26,21,11831,5032,6799
2133831a6e7919ecd338e7bbc7c27294,73,42,78169,29621,48548,79,61,129076,30619,98457
9b3a002fc42d7243e2964f8e4a72ef4f,154,124,501681,142341,359340,171,133,669383,87614,581769
b4c849cfaca183a039cb86c6b7fa8562,65,60,82329,27430,54899,73,59,104556,29379,75177
a4a2c37a6d21f5bcc6a1e57f12c90862,93,68,138190,68852,69338,99,67,226325,39379,186946
2887ca275cc589fd426f234449198912,62,58,89623,22727,66896,62,53,94226,23660,70566
0f83c7d4b29e2477accaeba4ce77d2ac,30,27,18769,10460,8309,26,26,23266,6765,16501
aedcf74b7260e60a2cbb2194ce2a6971,47,37,51132,23556,27576,66,55,99544,25657,73887
c57607fa809b2c85e6b7b0a775a45135,115,69,219240,27323,191917,109,76,129871,49714,80157
b55ccd5467cef31b3fc343f8c6bc72a7,180,153,680792,92383,588409,224,161,722950,121412,601538
cbde90f11d30246a91f89bf006e3b505,65,50,85537,19788,65749,77,37,98598,16600,81998
63657ea74e6ef74c12d42cd2e617cdfb,85,87,131400,66278,65122,83,53,146848,42159,104689
06fffd8bc9aff2621a05621f93049d7d,148,114,608032,89194,518838,166,127,599442,112477,486965
ca86a9b0bb26f060a5924b29217355e3,107,73,158557,41656,116901,108,85,154140,54526,99614
eddb7a93e6e5745af5250e3f08aa54ff,135,101,600059,138873,461186,198,157,792651,153318,639333
230c85432329c48fd7f5f36684286c0e,63,59,62107,35664,26443,67,64,128343,33978,94365
5c6cd2bfa7ce398ec9d1bdd526d48088,120,65,208858,65658,143200,131,101,243770,71026,172744
96d6c4f20dd97431c217f000cebc569a,87,74,150780,43022,107758,116,90,214950,45058,169892
ca5d1b76bf4e4732039329ab1014ecb1,93,80,218487,45443,173044,74,65,167197,62042,105155
fa218312ed595a3cc462bf6afa05240a,53,49,87751,23581,64170,88,77,128885,37386,91499
a6c54ea48952aa7202fa832547505817,75,54,84151,36378,47773,99,65,130899,22344,108555
76a05fc9ed7c3d98a116def9e3a6866a,19,13,4780,1676,3104,14,11,4748,2142,2606
691abfec5fd96ceeef5b3b1c8aa8b1d9,66,48,65901,21474,44427,61,56,63881,23943,39938
1a37cf454c70af5d2add43d71a526b94,134,107,345496,120995,224501,123,98,261072,98445,162627
ffd7d7e30ddd74a208c0d640bb579541,97,72,219480,80428,139052,171,114,396883,87869,309014
1aaba706b7071a6ad476bb00358e397f,63,57,84773,27553,57220,61,43,72868,23738,49130
c7e3cd7525f4492a6dccd42b154ce9d8,165,145,479184,74616,404568,144,117,375923,78081,297842
d0e39bde879f5238076f96d52afb8778,81,64,139620,42544,97076,120,90,269856,64775,205081
2fc4c9a966448ac63f20f2eafcadf5f2,18,11,5197,2026,3171,14,15,4871,3111,1760
4cf501dc372fe6614b2977a9f6bbe69f,87,56,201002,18725,182277,86,75,113618,35866,77752
ee417485d47415e07d14b8a3ce482f24,53,32,56295,12715,43580,71,51,62942,17852,45090
83fb467f3b3128559e7277f4abdd70d4,27,20,9366,3374,5992,29,28,8928,3660,5268
7ef467b1f708ef7bbce153d7c988a231,86,65,173099,44455,128644,108,84,198039,45590,152449
4faf8691343804e14ed71fed10ee2f21,40,23,45334,14557,30777,57,53,48918,16822,32096
3e7b22db8d7cc0b2576450d67ec8c7e3,228,157,1290001,239212,1050789,216,161,1059832,192820,867012
4e8a13ea495e888a15a4e55340d54e20,60,44,99173,28872,70301,54,46,79772,29979,49793
cf180be76ccec8da3ff8f93d9ad80d0c,57,48,71109,23130,47979,65,46,70223,26042,44181
d6c063fa84f9bdc2a380813ae077ba89,88,60,148845,41378,107467,101,71,150834,38010,112824
819f9ba6832460cdc0d4ac389b0d8556,60,47,69775,28702,41073,54,42,96914,25190,71724
7a659dca589f9993e190b27491cceaac,8,6,1103,696,407,6,10,1274,1157,117
70b11aa640d2788f6efdef52ae11f116,142,96,515909,115408,400501,180,138,651442,128500,522942
a7abb01f5912d48fd7d7f5fa44c64705,101,61,231318,41912,189406,114,91,213273,68114,145159
e8d537bd963c3e58399689c0af8674f4,174,130,491393,136671,354722,129,96,435398,96489,338909
413bbeb69826d72eca6685d729654218,42,26,30677,8459,22218,36,27,29337,12145,17192
2a353eb474a6460c8da4ed051c57139d,89,72,120505,34807,85698,77,61,87271,30792,56479
6c954a0c38bb1cbfdaf3effbe1bba01a,36,38,22716,11204,11512,38,33,30580,12053,18527
89b454ff5ab04171d2925e4145c36d02,16,10,4916,1987,2929,13,15,5938,1626,4312
7c791fe17b46e5a7839f6ada3bde562a,140,108,307307,68913,238394,185,136,481301,67756,413545
a9cc6a7d3a9c922acfeba349dec79274,77,56,81569,25697,55872,64,46,68439,27689,40750
7cffc72516c9c5b1ea8832c6d22abf54,172,135,751202,222481,528721,194,143,717287,175743,541544
b268be48228bd501246921accde40a95,89,71,195073,52214,142859,132,102,264117,62817,201300
7426af9c0a452d95e2cd431bb16548a7,43,37,59133,16399,42734,41,31,39785,14816,24969
bbbba7cf099a7abcc1d428d34adc27f9,29,23,17130,4993,12137,30,24,9764,6956,2808
f9f907085c8b8071c46e5cb953fa8e1b,29,23,12530,5552,6978,29,25,17572,6726,10846
3215a5aba03402cd0e05166ab1c1f521,24,22,20225,7892,12333,20,19,14173,6015,8158
4c99dd865f97b69096ae423502553792,29,20,17223,5814,11409,28,22,15026,6375,8651
f737a4f6a0b147d4fbfb6eb20a831060,17,14,3319,869,2450,12,14,2384,1768,616
a10811a59c58ff8dac5b7426d11d3640,81,63,113531,29516,84015,79,61,77616,27815,49801
782da767721744a755983dd170671c18,51,40,34435,19317,15118,53,33,48853,11297,37556
d691a3d59326953347165cffdd571d1f,43,32,77278,13244,64034,47,41,64371,26998,37373
bfeedbd432ab7cb3043774ca6d0e2ce6,49,42,96135,33645,62490,74,62,124234,41372,82862
57f76fae30ca455bbc1bd7d5a32df7ae,65,62,125098,49039,76059,84,69,153194,48595,104599
68aa7970e0ae623e2afee4c23fb77ce9,103,89,225576,44996,180580,90,79,245681,46742,198939
7a3dc82b02ee248ca7176305fe22aec8,20,17,5904,1714,4190,23,13,6718,1344,5374
6c0237feb025404b018e91df6d650198,141,99,521503,125424,396079,142,120,559850,155119,404731
cfcc35922dcc3adeef9aacdfbd7ecce8,96,63,160373,38601,121772,111,81,232840,38111,194729
c4714aab9ed90b0367ae84f0a03e6ca4,113,92,204928,40056,164872,60,40,87313,46837,40476
85e93be456df1963c8c05ffec59e5fab,118,103,234017,63717,170300,119,90,303407,44913,258494
24d8049e81a5bcba4b5de45da2a91d94,114,87,224427,43538,180889,125,108,254442,55489,198953
1108e0076c40634b74b6ac1103a9da0b,9,6,970,210,760,6,7,653,782,-129
d51e3e687ae1b64b373bfae689e56f03,170,148,550864,129669,421195,161,116,476784,82720,394064
3bf473e818aca3507933609fa2b4bca4,53,44,46672,24385,22287,52,37,50258,16029,34229
a3585b530d8b3b8c2d181e3fbbc36267,36,30,35301,15672,19629,51,35,58980,16249,42731
24d368abbc93bf108e4ac44ebb910842,104,68,262073,60483,201590,144,112,458007,75676,382331
b50402987558aa05ebbbdb845b2ff3af,92,77,183315,43887,139428,95,72,211047,45871,165176
16d9db588cf4593221f7fd480e0fe8a7,217,139,625635,101728,523907,176,125,489785,101021,388764
75b1e64ad1f62d387b5c2b61b7e30526,131,105,525608,128760,396848,178,109,373033,74027,299006
782eb208472a49c425d4c9a06ff7aec7,153,121,368860,79659,289201,117,104,323843,59924,263919
c9bd6136c69e739f7849890b8bc3ed88,191,130,733604,136253,597351,222,157,978137,153160,824977
07c2416be06c465059de0877daa2aa0f,73,58,94379,27205,67174,56,49,95810,30894,64916
3c030bac33ebea7a70c19cd0b1cc1ce5,24,18,8631,3493,5138,18,18,8897,2948,5949
ac448d865a62786f8732582dde32835a,15,7,2660,633,2027,8,11,1973,923,1050
68aa5469cbe5b38622ba753a5b3bd458,129,89,285125,96390,188735,123,85,304582,92089,212493
be4f4b08419629593219cd9358749cd5,43,34,42801,21976,20825,43,34,52464,20375,32089
1bd4321f9cf6362117fed59b4d231c8a,107,82,259658,77079,182579,123,104,319759,63593,256166
f567bcb690ec93182eb416275810033b,206,149,698248,172248,526000,201,164,793674,235970,557704
2138ba9daed511c8ed5db016ef3e3f68,115,96,220599,57677,162922,112,101,220647,58322,162325
b7f9e73386aab610f4166da5a56e939b,45,35,57380,16739,40641,54,49,43066,21690,21376
8391d13641e58e69302955de0dfd41f7,98,82,193631,58936,134695,116,96,244985,41044,203941
72a27e2a6bf94188eddbe08f1fafcf65,20,20,4175,2991,1184,27,20,7198,2470,4728
98195a4d7b7f189ebe60b054ae8e2f6d,157,122,423143,86377,336766,135,92,369844,93448,276396
1fd509813317195bb7242feca898b6b2,51,38,75160,19515,55645,60,39,66459,21968,44491
4629c41bda456ed0d5fc05952561369d,20,29,12479,11463,1016,29,20,12867,5409,7458
b5ef3cb3f15e552f3ff1681ac003b6e3,133,86,486493,135798,350695,179,124,534572,128552,406020
6381ef19f1b413446838ea5e6506a414,112,96,289658,104265,185393,188,168,557627,99375,458252
c8b09202af932b40bcd4586c06f19d33,141,122,255045,48283,206762,74,62,120719,43661,77058
68b40eec3c8b922732a3723cf3beccb3,22,30,13996,10370,3626,34,19,14049,6248,7801
28c2e9b7201c51f5d2b38bd17c6d3a0b,193,161,789861,135724,654137,188,153,745273,138907,606366
c8b174a337c95ecfd7301f5ca891fe43,151,125,381836,77863,303973,118,95,372374,81793,290581
8bdc35f61365d23616208ec31b5c84ad,63,47,96157,20551,75606,54,48,74024,27087,46937
8e94b3b4b31cd2c9ba937fac5508fcda,30,27,26493,9110,17383,28,24,21189,8578,12611
ee7b957c49af971e9a736c91204c5c43,115,96,256760,58240,198520,116,94,309743,71389,238354
635487eb9ef413286bb65c7f58ff1ca1,7,6,1220,1048,172,6,7,1048,1220,-172
610877aca4a69566392f791400700ad0,153,104,534507,150176,384331,159,136,590334,134096,456238
add65bfd6e269685eafe9bcad4e632e0,171,129,720217,101469,618748,142,110,403111,121276,281835
9c68f5b7666a2c18b9d9f44c62f5e1d2,164,107,442969,61477,381492,164,129,444463,77163,367300
6301cfa7efa64a5a4cfda35afa9e7e42,125,104,406701,111377,295324,159,115,430270,96116,334154
e44d651118ed9d2e5cc71dda8e6bd4e5,122,93,303721,56739,246982,95,86,237292,63162,174130
9cc2bb2f7dc685da8ce237c35f61092f,28,21,13620,5001,8619,29,28,16813,4678,12135
e3d3d84bd8317d65642153fa8c94915e,17,13,2864,1187,1677,16,14,3212,2552,660
336256c9d055011ea6ff88c880230722,138,112,349899,83844,266055,151,129,374606,72438,302168
8795bfe7e1b4770658bbd70609391b51,70,64,119292,38002,81290,48,34,77770,16629,61141
79c077e776cd9a0f3e415c36f702e554,65,51,104615,35906,68709,87,81,172476,42468,130008
2ad4ec3d6ee913b58e8c593e4a9a5adc,166,116,443745,65809,377936,151,93,348890,86103,262787
27dc4b124b31b77e53b4191a125d30c3,73,49,118182,43380,74802,74,67,121648,41564,80084
a894602fcda02b5832b97333b0633f8a,110,91,208803,35805,172998,111,95,190858,51360,139498
23b5267b363a3ccecccf6fa226b5100b,35,24,20080,12205,7875,35,25,36289,8579,27710
a2407329eefd70d0853ad319e7cbd965,108,92,311535,91457,220078,158,97,385292,69665,315627
a317bf4817d8c73fac657fed0c770b07,119,90,268000,83239,184761,146,106,330801,60918,269883
02f47482527ee25c87721c053a5d0017,101,76,196669,64621,132048,118,87,238947,67561,171386
07dd0fc0f5f4bc424a37a012a1739ae6,107,87,154661,39237,115424,110,84,212326,29632,182694
3c2e12182da4a81146b7e5d8d8fa9aa8,69,56,82816,30795,52021,46,32,48846,20480,28366
6d535b1cf47f68aaa4a3f9ef984d6381,105,97,216422,93945,122477,145,104,317664,76549,241115
15636cfea8eae9ec0e54bb13cd6ede13,23,20,18360,7559,10801,29,22,18692,6039,12653
c899296f4c6ded992aa08f596b62daf7,180,110,771131,221707,549424,222,139,929159,151657,777502
0192c5967de2c4ae1e749631011a2d53,127,94,400988,81773,319215,168,143,451022,82124,368898
65bbf92f0f892b2b529e7c69d0cbad3e,106,78,209460,32494,176966,109,100,201294,51737,149557
6c9b0d2d14a20ea4f645ce30eead50a4,108,96,216339,41129,175210,94,67,136685,33952,102733
0bb55b832bb39938cb0d11a9b458b485,131,100,330741,62099,268642,91,75,241751,72456,169295
eb201a0d5f7d73fce9b6a0f918021575,77,52,146808,47253,99555,82,60,108861,55929,52932
911e5adf39763b76bbea049dfdd62425,89,67,138597,27019,111578,68,63,82308,25711,56597
41fd319482c162cb5138e63b3fb18e31,63,56,95651,50608,45043,74,55,140803,37490,103313
b41ff6ef82f804ffc61ca07c96e3d236,64,52,118932,29500,89432,95,59,130236,30940,99296
ccbfa80ec4eb22151bc55ee5f663a314,56,50,58622,21316,37306,64,58,66910,19247,47663
ce73c99275a24580addec06121552711,144,109,442096,120265,321831,174,151,545957,114104,431853
c69f116b22cceb2b76d3bf3ef0fef8b1,118,84,274446,72852,201594,160,136,434024,101135,332889
257573f1da2a6f77edf64afb09001f92,135,97,357574,85666,271908,92,69,239148,60714,178434
94eac4597cc61a792595682f93c1fe7b,84,70,166728,67721,99007,138,95,244265,68017,176248
60be5f312c84e4dea3c4947f387390dd,42,32,32871,12194,20677,39,31,27702,11979,15723
cec3238013cb23a550450991cf4ba8ab,29,22,15101,5937,9164,23,17,12582,2496,10086
e835438f47e35d5fec66ae11b601e904,56,54,51420,16411,35009,45,27,42732,10070,32662
510b2d7c2c75afecce2a91a088608596,8,6,971,825,146,8,6,1401,862,539
a3fd075919c519d39e7d86e13f27def8,87,73,170760,61616,109144,103,103,158557,67703,90854
f538a00b524a46015ad1243c5b9f4ec9,104,109,260005,113241,146764,116,85,233425,49055,184370
5ba6f72b57fc0144bc9556c9ba1385f8,38,30,33211,10845,22366,36,31,31842,13175,18667
110d4aa5ac49a74cf082d5c573b8bf52,94,75,161033,45903,115130,81,60,130673,45865,84808
be8e6bdb8639a77399249d1719e3cf8c,124,115,411124,111261,299863,148,126,457824,110694,347130
7032ff691a5104ab0448290c5e1faca6,50,44,77070,21404,55666,66,49,69257,26815,42442
69a4e780e30c948cbf84a1f846339fdc,92,67,140903,38018,102885,76,60,128079,27797,100282
dda57f42370fc3c79f506d4ce816d583,27,25,18740,9497,9243,28,24,14651,6783,7868
b07121ef7da201f86ed7026aaa278090,74,51,123779,35545,88234,105,85,151556,31299,120257
a629839770ed2c15883d42856a9704f3,110,81,238735,48691,190044,135,98,250695,58578,192117
4cb856178c1fe9e605d33271822b21dc,152,122,447682,89629,358053,150,99,424125,72646,351479
7e24410bcf4da3ace4ae0814c5cec94f,135,91,349138,81477,267661,131,102,338268,68023,270245
bc824fae957d74a8ee6c770ed9c7549a,24,22,9907,6169,3738,40,20,22484,4889,17595
a3ccc47dd56e21fb7582abfb607c0aae,142,97,294128,38755,255373,122,99,223262,56754,166508
4eafc2b18cf21601d4afa4dfc5af29e1,46,27,46493,21034,25459,52,47,75835,22934,52901
ce362682dbaf3e3f1fa7acb86ccd2d3b,28,24,19404,7272,12132,31,24,18005,6028,11977
6cf357dc11307980d6e5c02d629bcec0,116,96,258995,61285,197710,121,92,241299,58066,183233
6c59fb805e6e9cf64d02c1cdffa1bf9d,94,62,151093,49860,101233,118,101,199412,49952,149460
3dfe546fa2cfb2eb5ecfe3e86387b669,135,109,328392,63486,264906,144,119,405764,82393,323371
200ff1c99d2bc627c0d24dad0fa816ee,20,19,6056,3198,2858,26,18,6680,2771,3909
84fbffa038a50a56d2a7de957696a027,69,59,85938,44438,41500,89,65,124184,34515,89669
744d16ea9cb5f2f0c9c044beaad29638,73,67,59823,23795,36028,73,53,74185,20278,53907
fbfd1860229dca0789b76345a2e6a7f6,62,45,65167,20486,44681,49,36,52162,18179,33983
c213ac60309b9b9d2829c9c468eda6ab,182,114,944191,165551,778640,205,153,1150437,148679,1001758
2e20749da7744db1011e852a87241261,137,106,432592,95231,337361,146,124,369490,79586,289904
c44d53a49f08e9c2ce92b7dfe5f319fe,34,32,24853,11889,12964,34,26,26071,10085,15986
81e7d363bd0aae2eb7adcb87993540fb,109,94,245949,45234,200715,83,73,165068,53412,111656
d2534e5a7af74b354c905918f8982ade,59,52,107540,29510,78030,56,48,78669,33430,45239
61f8d0da221771579d4f74f1827172c7,79,60,109422,50239,59183,70,55,129621,27505,102116
190edc25d163bb6d709564363f8a44ce,4,3,203,116,87,3,3,149,175,-26
6d560ff42f3d088207175e01fe8e9c3a,113,100,220775,50256,170519,109,83,174370,49571,124799
c978a251588239e8227c3c5dd9db20e9,66,51,114968,42277,72691,56,45,118680,37090,81590
13088228348ecbf4a9ca87408814ab31,64,48,83707,32109,51598,104,83,197092,39195,157897
92659949b4d2297600dddc7fbe1d3ac2,51,37,104484,31077,73407,55,32,82630,33771,48859
841735e443de42b65d88a00ae55c6cd1,35,23,29349,10733,18616,38,27,39803,11853,27950
eb3cc0f439229e7cb3a1cc05cc94e107,24,22,39328,9801,29527,29,26,33071,15541,17530
187a573887fcce3308270d5474c9e780,106,76,229870,69326,160544,140,120,285397,67791,217606
8c8a4935824ff2556e2305d85e9facd6,156,108,574075,80967,493108,144,114,465665,97728,367937
8d68eba25bc1e8df26ae2b75c08bc954,149,121,442331,101243,341088,173,129,421392,124989,296403
1608e3d171f2388db01c67bd795df49c,17,18,5972,2613,3359,20,17,6226,2922,3304
11919d85c142564d0a31a83d6e14ada9,183,125,631549,137582,493967,187,130,775719,124701,651018
cea31d875932172c52f0870bcf0fe2cb,71,58,131265,29814,101451,67,54,78548,22790,55758
aaf7bf4721d0cbfb3973d691d30cf15f,42,36,38607,12331,26276,60,44,47799,9827,37972
7c1c5d0588621deed22eb4d6b14f712c,27,33,20312,13073,7239,41,30,26681,10457,16224
8e2c51122846b01e836bd4df1fef5917,26,20,14324,5475,8849,28,21,13309,7206,6103
319d83dcba853f0d88f6b00e5aeff39b,87,72,125393,39024,86369,69,52,120119,30236,89883
fe6488981592d31fb56061a1cf1aed10,33,32,14935,9409,5526,34,23,27859,7812,20047
b26dfb6e9885f795812a1f020010a688,129,103,341935,67610,274325,166,114,380602,53584,327018
71dfece61c9a4732dea48485f0246c32,183,122,260551,56603,203948,147,126,312958,68790,244168
c6d01fd9e79b73c71dd1bc121ee4c5cf,45,31,63675,21418,42257,42,34,58736,23097,35639
5ec4319d3def53ef39ea45e1be73c815,59,39,70122,28790,41332,62,51,117014,26030,90984
429dd5eb4ada1594cf7d87d11895a954,149,119,404390,111198,293192,146,111,458186,105145,353041
b4d49c478a901a5d605dd2327caccbbb,88,60,187552,45588,141964,79,65,127147,64969,62178
ca207a77000a892e6171fe4790b9ea18,49,49,88140,25303,62837,56,43,79128,19153,59975
b8b01165a1821ca565c780cf9de9daa3,126,97,288728,53513,235215,117,68,232061,57255,174806
e3032b645d7780c87e9c60ef9aedb370,78,63,123256,39524,83732,108,92,203987,43718,160269
d6264d2985fc7ec1223b9d1f1affe002,90,84,119960,51387,68573,93,87,210441,39598,170843
40bdd74098374865fc1bb9996f96d377,56,42,75337,21339,53998,52,40,56941,21282,35659
11a8d787bb66f45fc1e137344a63082b,65,57,88918,44495,44423,139,83,216684,44607,172077
69b2b3a58c8cb7d7064949da5db88dda,145,123,413651,90077,323574,132,118,383817,72299,311518
7d1585306d93401df48dfd6a58d273df,150,122,488278,69127,419151,157,137,497233,90819,406414
8532cb538505cfe4dde13b14a0fdbfc8,168,140,613244,140156,473088,169,133,696848,117772,579076
fc2eec27ec8641d2629ca090f953abf8,202,118,835206,160401,674805,202,131,765033,151786,613247
15ef49575176207ca1952d1f798de1fc,107,82,212378,50424,161954,104,87,222067,48279,173788
7e98d30edfddfa1bf97515dcccd12aa4,151,113,654527,93815,560712,194,127,606052,97387,508665
e21ff7a1de787c8f44cd5855bc3b4c97,69,52,82961,28477,54484,66,67,80837,35693,45144
fbdf0d672f8d9b468eb538d179991bca,155,117,486113,86461,399652,181,137,623414,90960,532454
720e52d0d2a3d4bbe3f62172e66f011f,46,37,48398,14402,33996,29,25,19426,12284,7142
afe63090a13458f43344838b24194bec,29,17,15711,3657,12054,24,17,8422,4695,3727
741a461e0312aac62627ae27bae0e7e1,18,18,3719,2590,1129,31,18,10095,2095,8000
c63f53216938710fbc56b8cdab4b6012,93,69,171200,35448,135752,111,89,245960,49235,196725
f2b91112ae92985c7ec37d0e1f4b12bc,71,65,167480,50361,117119,82,64,214368,73747,140621
118eef2a8492ac455757644843b0f7b4,189,139,392900,93953,298947,129,94,320604,105224,215380
2341cdb6be1a508e4fa24306be436b5a,18,16,8837,2939,5898,23,18,7592,4060,3532
4ab9f18c5a5c145724c354d47a744ece,71,61,97390,28986,68404,69,55,87595,21662,65933
fa2381a61964abd4ff3acd80a9b4e9d9,38,30,34201,12542,21659,38,30,36069,16985,19084
278e5589d2017c8ae6129ed2c56e77db,94,61,142041,38627,103414,107,87,173342,43385,129957
2d84bc7f980e089b9b35fe754ed7cff7,85,80,98242,34712,63530,66,57,79360,19773,59587
7e15ab6eb0f25be97320c410a8ef960d,89,65,155459,36332,119127,75,67,127884,47709,80175
b98db6b21c70c267de111c36d096dd34,57,56,54017,30849,23168,75,58,102153,24136,78017
b60e55a05a357243971dc9e76e31fab4,140,103,337008,103996,233012,172,130,527326,84170,443156
037a4cf28be8737bb223d881226cf053,54,44,110648,34642,76006,74,61,92698,41666,51032
2c674f7f26e2f290ebb98f2fc395b6fa,153,111,434130,92658,341472,182,129,453449,89866,363583
cd2a91e2c73f37f043afb81c822028f3,153,126,370192,66557,303635,140,103,250238,62117,188121
ef24af025dbaa484b1906de355288e0f,113,89,224133,53311,170822,85,66,167679,54293,113386
d64ad0bcccddbf5f457e150001fdceb5,216,131,850582,144727,705855,235,178,860514,139446,721068
9718a5eb46555f344003c5afa4beac40,71,46,103696,21902,81794,52,44,72581,19338,53243
79505c5a3a978b70cb28a9e35cb7cbd4,49,40,52138,18564,33574,44,36,57084,17611,39473
90f67876eeeceaa577e1696ebbbcd2fb,144,113,380276,94202,286074,175,115,525095,65886,459209
99ec27ab8cec2bdb36f301e88b0a438b,25,18,16184,5451,10733,28,19,19992,4955,15037
10163211277c582fd64d9ce5f07933c6,35,24,28032,9349,18683,38,24,23588,11556,12032
c35bbca17eedb95f2bc476ce8d88dcbb,125,103,401242,79623,321619,163,131,416254,104735,311519
a806fac2619c9e5f60309d0bbb75c70a,145,130,412023,109642,302381,129,104,333013,93438,239575
ad7aba9f4c54f17696fe3f35256a37eb,116,89,223530,67608,155922,135,110,301973,46298,255675
992731a155e9667e5daf2044f3f8b70d,181,110,543107,75158,467949,133,92,301667,68542,233125
b0aa815373273ec6c052f87b500399c0,122,80,214414,72602,141812,113,94,299111,64838,234273
816997057d184ecf02b919bef58cd8ff,103,77,210988,44677,166311,92,77,166381,37062,129319
e43bacaf006f160fe1f9979bf3598bac,81,58,185767,70649,115118,91,77,248960,70039,178921
7af9d15edbbd4918dadd39f0c5a252d3,140,100,360089,72338,287751,147,86,355694,75385,280309
4c14366f9f954ecb89ef6f9a648522fb,142,101,468264,91673,376591,138,104,422533,88756,333777
42f8815c7bc5e680562e80b598ed555b,141,122,273947,80127,193820,168,128,407072,53803,353269
02cea9bf6db843eda22ffabf1d62818b,186,152,672812,104878,567934,149,122,521012,97135,423877
9b786424ff5cb7ec648d0f45abedb4d5,13,13,2830,1506,1324,17,10,2276,1473,803
6efcb5496a7bc8ee715ca181d740e8fd,44,42,53604,31234,22370,68,47,80968,19639,61329
73e5dd79d636d4b71c53773f5aff88b4,115,95,270170,75282,194888,81,68,182760,85570,97190
bb2881ea741d8e816c8175e7c8661e4d,23,20,12556,6846,5710,31,24,30313,4758,25555
4b1958f3c2b08266d750cfe00a8fda22,175,126,427444,117833,309611,129,108,373829,99540,274289
236b15660eb652773552954611cdfa54,123,87,218865,88866,129999,149,111,357177,110637,246540
3d9a64b754c29b8d5aa85a026d1efce3,28,17,9771,3902,5869,27,24,8300,4645,3655
f113813b1ab4b8f4ac4d96752e137cf7,27,22,19608,4770,14838,33,25,18049,8030,10019
c289a72697baf1ed81ff0e24cd8cc046,126,89,289215,44765,244450,94,80,191099,72230,118869
2654354f3ccab1d2f59e52efb54cd064,49,36,50543,17879,32664,44,38,41242,17668,23574
1da469747b5a9eddee72c905e2d8af9b,7,6,671,350,321,7,2,520,230,290
3eed9b06f0a390f52d2d6db0fb240f00,66,64,117259,44839,72420,93,74,182173,48610,133563
64097b0899c03f1d6b4947a8782d920f,43,31,36833,7220,29613,35,29,23650,8931,14719
a606aea4f8d9b1901527d1197207d142,168,114,589580,156670,432910,188,146,662279,142881,519398
346c802e93210848e3c51c55433f555c,27,23,11712,6990,4722,24,20,11166,5459,5707
62d24f39f95bb5fe2bbfbafb3e45b2ac,137,101,437440,92949,344491,184,118,527290,86965,440325
f42abd63e3db7f115b40ec2bd92584a2,128,89,281037,76211,204826,144,122,356268,103023,253245
80c4e76e8fdd353fbe725095745676b4,99,76,183952,46898,137054,102,81,202250,42235,160015
f69834d2c0608790d047b1e41bf03d18,118,91,278895,63259,215636,111,80,266355,72656,193699
1d84cf0768adce380bc116184b15d153,115,82,211295,58870,152425,90,76,222812,57077,165735
bae2d386a1f8aefd575931377dbb2afc,90,63,107542,24965,82577,87,80,102195,33929,68266
d140e1a440b23c8e1dd1beff29553079,56,41,82539,21751,60788,106,67,105874,24665,81209
40691b0e5ad1d99f613861be60756629,50,38,65211,21050,44161,47,37,57958,15899,42059
bc335c7bbdc6f9c43cc58fbccfdb47eb,144,101,395200,73024,322176,142,124,376393,92193,284200
c1a0da4ffb3d9acd33e9f2c1e3da5ed6,44,42,100007,38259,61748,100,70,215851,55714,160137
547ec1042de54606efddafd673ece714,92,73,162201,35277,126924,90,79,151606,46279,105327
fc4c6b8c68585494b4071c3e55eff4e9,126,98,320166,93408,226758,93,76,172502,55143,117359
677844b52affea0bf105f391123cfea6,176,120,824658,184683,639975,142,118,956362,148406,807956
59d23115bcb07a0cf052fd668ecf6725,34,23,29842,10115,19727,34,23,24333,9076,15257
dc9e3160d24b13990667e1b68c8973cc,53,45,95909,25790,70119,57,49,103372,27347,76025
09a9fbc1e0d7523b45b6d533c51c925e,28,22,20868,8266,12602,29,24,22088,9743,12345
c1a5ab31858777f7c334a7d0e4044954,86,72,158949,40425,118524,81,60,140759,39448,101311
7df353f79d53d4bf7e8cc0a7149d2693,27,22,14516,4117,10399,31,27,18677,5188,13489
2c3b7c9a362e02c76944f60de467b35c,17,19,4140,2860,1280,20,13,4592,2458,2134
d0dda6d77efb3366b502864d32ebf878,20,15,6083,2198,3885,19,17,5268,2143,3125
c0d7e9ff6dadd63616a2368807d40d19,23,17,15401,3253,12148,24,17,10507,3400,7107
789ce55ef3170a5af3e8e02080c8be54,23,22,7826,5048,2778,28,26,15885,5299,10586
d68e5450802b71087018360a601a7841,89,67,118414,26891,91523,118,79,145204,32637,112567
79bc3bc6265cba5ee32e8fc058ec19b1,204,167,1050290,150872,899418,193,148,776855,151172,625683
68d790b460a1d5febebc5442e302bf43,69,65,139462,54006,85456,87,65,199556,43132,156424
6bf222790645762300ff06f671c8c325,120,103,354091,107745,246346,156,124,377255,104535,272720
71aa8d41696d198f4f6b3dc5ba74c4bc,153,106,389980,101349,288631,163,122,455230,107454,347776
f7bd7f93590a170455671c594294a98a,108,100,237496,54686,182810,82,68,168525,38214,130311
4a34c6d41d68e98948ed45c213882c61,99,71,164614,45759,118855,93,56,139051,47280,91771
4e22fecbd590a8117bc0febc2ca600a9,155,119,464900,164053,300847,128,101,391830,95478,296352
139e3de585de4c0626acaca89742e776,124,89,320910,84674,236236,132,102,331109,67829,263280
f1ea81a9ea3cdc933501c6ddde390ed6,133,105,405961,82896,323065,164,125,393656,83277,310379
ba9663b32407c52eea95c13149b3d09d,122,105,321306,80441,240865,130,103,306101,78039,228062
12c26b31aa5f320122438ea08b79cbc5,41,32,48438,21629,26809,64,58,95947,30640,65307
524dd4255e6e82ced5c8a66794cadb0b,69,51,110217,37702,72515,112,87,169328,50163,119165
8ebe8fb7022b6423a7e0b114702541fa,23,16,8378,3789,4589,22,17,6647,2700,3947
4db9ef6b3ecdf8ec13b97091a05f501c,246,162,691064,199400,491664,192,140,826068,206816,619252
fe5f0350234c1ec02d84266e9d503ed1,19,17,5319,2809,2510,15,18,4758,2530,2228
3efd8e985a2de5afdee0bd2ac2040d5b,117,89,208374,60295,148079,147,119,320639,68906,251733
3214fb9a915a1e873a98efdd25f0071f,66,54,85246,27262,57984,43,37,42605,27011,15594
684b0d6f1ee5ff88612e7ef0276c7bb7,43,34,40752,15467,25285,57,44,69970,16026,53944
d756c381f4dcc8bb099fd0e37d9704f4,91,72,155526,36448,119078,97,79,123956,42858,81098
709fc6c17f0ee52eb1fb7f2c7ad9be3e,100,69,224515,62127,162388,151,112,320888,67531,253357
4ce4175d049e695224fb2ad2cd4530de,116,75,151821,40484,111337,75,52,162643,38835,123808
2708a2512fbe6e62a2463765f2fdd61f,125,83,255291,74287,181004,157,92,374634,59470,315164
6e22612917cbf6f39fdcaf38105bf0c9,80,72,181946,64305,117641,99,74,171705,51104,120601
4264dbebe12fe1c24dac0ccbf8aef368,22,18,8073,2662,5411,23,19,5355,4247,1108
a0bd219aafd1d2a1f477da309a38d7fb,64,63,104132,49197,54935,103,82,163949,37549,126400
e17dfc8337454964337a81943694146f,45,31,34193,8543,25650,46,26,45307,10098,35209
266220ce8a33584745851ed14b441a8c,132,112,371418,94342,277076,126,106,341758,92674,249084
e6c5f1a600b09ad298d078a9a4e2f164,127,71,155199,22858,132341,99,70,128807,32476,96331
f356262bfe58f75a70f8d2f9cfdbca21,154,105,488224,96395,391829,211,121,547758,76225,471533
7f5d3fb73453c93b85fe9e163bd20ea1,165,146,572621,109333,463288,144,112,400729,118425,282304
96bff037ba9868b7b3b7d9b2e4d5f80c,13,10,1708,874,834,17,11,2654,1178,1476
a2826ca7bbefaae068ab4154d9965a76,166,118,415044,57187,357857,106,80,194347,46611,147736
2b94b3582f9b96d50730a13a3290de62,52,41,88841,20493,68348,89,51,112122,21545,90577
25bcd517fc2017ddc9eb3ec000ebb9bc,105,92,174881,46308,128573,88,70,152220,33815,118405
0c5fab672b420e9928c2b4865881b997,150,126,495434,142397,353037,133,117,513010,134417,378593
e5303763103259f17d57c4d689bcaa91,109,91,208318,97090,111228,134,85,306175,62604,243571
91a09703ce042f6c54feaa80f3d60d18,10,6,1720,1546,174,5,6,1532,1089,443
b0420b91874f68a94afa9dd3d38fa6e7,207,147,837360,208322,629038,190,125,1020380,162832,857548
b651608f5b7a98266777d34455bc6283,86,63,189218,45232,143986,77,69,131801,48769,83032
8c367c933b9450d63450e8eec2bfbc17,123,71,200080,33525,166555,107,74,224841,41057,183784
84b2c09b21112abc9b2c4d3e920b5039,199,143,729145,140647,588498,207,170,783045,134075,648970
2546e0cf9072acec43f29d6c8104e366,15,13,3839,3344,495,19,15,5712,3046,2666
90aeba62df799d987596a44bd860a2fd,179,92,316152,41792,274360,126,88,205018,50209,154809
8a8ea982c756c1fe32e475987fa0a2d4,69,56,105522,34915,70607,75,59,149183,28969,120214
b878c2896470f9d0cea6e6059bf14992,38,30,38344,17757,20587,38,31,47843,17248,30595
92786414ffc09f7c0704aa78f8020511,133,106,370908,78555,292353,174,129,484274,95226,389048
2681d3b2afc3b689779bef2a65285a92,48,29,66647,9382,57265,48,47,55707,18223,37484
b68367f5ba174f2053dcd1f127c3062f,91,69,159925,51420,108505,94,70,197851,50009,147842
09735af297f60be9b8cc07019704094c,108,80,202205,44964,157241,92,84,170536,55170,115366
ca2e3b6d9ce001376150ab55dc4fe590,149,118,351785,73517,278268,115,94,270999,53850,217149
bc53c56b5ab73d92f9637aff0af261e6,3,4,614,181,433,3,3,169,614,-445
d2feee9f5603d2a47c928539743267e4,11,6,1337,523,814,9,9,1777,1023,754
3ce52538b84c6755e8650b531d3989d5,39,31,30409,11900,18509,29,23,31267,8605,22662
e88b4d6affc146f3b2348c2a82dfb8ad,117,90,268007,61870,206137,131,102,330902,66012,264890
ed73d21d9d08e67ac54ddb4471426a89,60,49,97751,33559,64192,67,55,93449,24311,69138
01d95b7350838bab33e92587d85bf0bb,33,24,33298,13766,19532,46,34,39192,15382,23810
270f57448a36d6401e2caf268459f3aa,157,128,570224,130507,439717,166,129,492918,96012,396906
fda05bf4704604842bd04ed024816103,182,123,599237,121974,477263,175,152,647613,149143,498470
825710af9dc2eb63bd97533fdd2d8fc5,85,50,143567,20004,123563,78,64,114784,29722,85062
688e58c4df0c9fcc3f2c91ff3f070514,58,39,66550,27424,39126,60,50,76350,22560,53790
f866d91e604dd8317955f812e3f77606,147,126,324468,82120,242348,128,108,281696,94605,187091
48215e08048e977fc61ca4ccfadfa5b1,41,29,51043,21333,29710,62,53,102572,26358,76214
f9af2a9b48bd234a368d450937bd6294,130,111,325335,100078,225257,167,113,367027,72450,294577
dc205f019d957cb02b051af77f2ea232,35,32,27706,11799,15907,42,33,32607,11617,20990
e01f0cac3ad75139cd5bfb653a7fdce4,93,65,121148,30998,90150,75,59,103596,38817,64779
932064a79f601aec4a0735e7428a6e50,74,69,87186,20959,66227,66,47,79776,14683,65093
9656e6fcc5158e60d5b621fe2ee2d008,85,56,120330,39808,80522,99,88,127879,40160,87719
50b6ca484c9c0629042c2696831d2dc1,78,70,153816,45986,107830,106,93,210198,54231,155967
8694f98747bbb276c5703726dd50b16b,148,105,257850,52124,205726,140,100,297443,40731,256712
0f5d4f423822a079d4056a8129b5946a,43,23,39917,6809,33108,40,27,38428,6784,31644
028bbaba421e1430f73cb1494f30f034,37,26,30307,15895,14412,47,30,51544,14917,36627
b90b2445624cd2f34a324d416f36a39d,168,146,721639,171785,549854,207,149,748995,139116,609879
8cae94905094443cdff1184c3b139790,74,51,99204,21637,77567,70,62,84907,29129,55778
669f2f3a6222067dac9f30cae0381fb6,25,19,9895,5495,4400,26,16,14405,4043,10362
c3a01ed28d47b23546280d4ca92ea8c6,157,110,440236,76394,363842,152,113,491775,100099,391676
043c34ccd144fabd862d785ff867a4c9,30,24,20669,8071,12598,35,24,18758,6144,12614
181cb6b679cbff8d8564f4bc1a48c1cc,35,33,31106,10941,20165,42,32,31435,14269,17166
f5c43363aa0c1b2fca5c2b34391981db,40,30,28240,14720,13520,47,39,31660,12256,19404
33f109a0ee92da6ad2452d0eaa3dce91,84,65,103411,42990,60421,85,59,107429,25270,82159
a2ebef0eedc9e9433cf79b3e10024eec,138,82,267036,48791,218245,112,97,208475,74084,134391
271b99d71baec40a82ec8f8d46e5f62a,59,47,79599,16253,63346,59,44,59055,20614,38441
ece12c4a7cdffda36ec46174415ed7f7,42,33,44174,24286,19888,53,41,75622,24292,51330
e0305b4eef68315ac5d7aba92dde998e,97,75,182070,52979,129091,107,75,194981,44820,150161
68f3db7c6957528a4ae34608e00e238f,47,41,50847,17471,33376,45,39,42468,18991,23477
02d71dca58b762e0e5c093658914c466,43,36,46329,10907,35422,52,35,45782,13164,32618
5ed2eca486c9b3a1bdc22a0c58cb2a43,151,108,321509,63798,257711,132,100,268613,58122,210491
68b17c9856b59640a1d2e4d337b9b1da,56,39,38448,23906,14542,51,43,78497,22506,55991
6a076254e98d1e439743c82fe3576402,137,103,479581,96510,383071,172,139,553957,101356,452601
d509b851df427dce09cbe09a564dc7f0,58,46,114392,38070,76322,74,58,110269,39017,71252
2ac024f147296ff25d7757da058804e2,128,93,289158,70122,219036,124,91,210210,86334,123876
4fcddde33c60411a74f15b678c5736b7,64,48,141066,54860,86206,85,66,158132,68919,89213
64adb669bdeb1f42b0909e560bd74cf1,6,5,409,275,134,8,2,651,60,591
2c11017f1ed7f03494229bf0fa30b86d,117,94,261573,51249,210324,136,121,263363,85069,178294
2a87f013ed2f5c9c700bbcdd1bd6edbd,87,71,164409,36745,127664,74,59,98594,45707,52887
5dd2c1ca3417c59465bce15ae8732492,53,47,90396,28090,62306,80,53,108319,24163,84156
f5478298168f5ffb2c82db5d0b63b163,93,56,137062,34213,102849,118,68,164767,38362,126405
20200447be1ad6fb9aeea90d40bb9eac,4,1,368,37,331,1,4,37,368,-331
2dc474e3cf485068bf30cfdf2e0ffceb,25,19,14657,4717,9940,35,20,20063,5850,14213
9eea99bcfbcf7dc8737c04fac799d105,44,33,38116,16252,21864,45,36,40249,15755,24494
33253b9ece4a4d9cd9c75bd6c4d754e2,135,110,442623,90552,352071,173,126,629049,88779,540270
39673eae6771c3a7f237d7cc36dc8456,139,108,345045,63018,282027,115,100,249801,94433,155368
e851559be2c9ee25c542843394071179,125,90,259410,97551,161859,130,93,359067,69360,289707
74c1c8fedfa3d23024f0456c0098371b,100,81,218452,61089,157363,114,83,193244,69776,123468
b364cbc61410490f9e29f022e6b4bc11,3,3,257,45,212,4,4,108,270,-162
243b0d2b2d166c73ff09fe6a099fab05,142,99,270210,57383,212827,100,74,194380,50656,143724
b06e5d7e4ee6337aa556e651854e1eec,156,119,533416,114247,419169,190,126,466605,138868,327737
2a5509da8395aedbbccca15c5700cdbf,146,115,370175,104939,265236,132,96,330419,94884,235535
8f8cf34f2d92f35727b43d47920d05ef,113,89,182842,39835,143007,98,80,155310,39921,115389
970a7af9f42f62f84774fdd452350563,126,110,423504,102461,321043,130,108,470661,110469,360192
1d22fc97d385c71ad9ec3687d7c6f798,153,140,534246,99261,434985,159,128,432052,103365,328687
056c3c50e386e1a7e0666146deb26db1,174,160,717900,100688,617212,156,130,498797,93517,405280
1ad8f4237576ed0ce553f326aaad9273,168,131,591466,107558,483908,140,115,467175,150099,317076
a2daef9babe88620bbf7bdb4eb0f75f2,11,8,1680,637,1043,13,10,1369,858,511
2a567b96302ce257b52fe447bee904d2,51,38,89311,25572,63739,55,50,105438,29061,76377
0eb372ade57b59e3e0c095189c3cb3bc,39,34,23138,9593,13545,52,40,49587,13187,36400
fb10acf08961d0a27424faad67716edb,124,90,214741,63895,150846,126,84,246404,61220,185184
f0bf2eb9129cec2215b7657b674d206b,51,43,31426,14740,16686,39,31,25336,14399,10937
be46174d2a754a0051dd76ec4799630d,73,58,114771,25929,88842,70,57,86833,26269,60564
63e732537dfc3b046b0b2d83bf771309,43,34,41935,20202,21733,52,36,57951,19094,38857
69c695c87ab1acee05af81b4a6f32d6a,16,11,3884,1642,2242,18,13,4087,1723,2364
69e5f427ae84e49e6923a8b9f72cc8d1,146,118,411804,73062,338742,161,117,450903,102836,348067
387ba2b5038c4832315424f487b820ff,203,116,418137,77621,340516,109,104,268273,119418,148855
793137aebf55376847efd3c026d35a46,20,14,5513,2744,2769,24,21,11047,3761,7286
351f54685d5504762f6ad7a908cc0e5f,116,88,274704,48142,226562,104,79,245967,66196,179771
353f01c5947a50401616b116aaaf79bc,30,24,13166,4877,8289,35,25,18774,7232,11542
a38d77fe548533ff37661c49a30a6dc2,51,33,42608,13493,29115,47,37,36885,17385,19500
6ea81d00ba4e13a3c1b7a43dbeb9e681,46,33,54150,12229,41921,44,37,54992,14315,40677
8e881a9352a81f5aa13b3d168f43a2da,124,94,368555,75447,293108,162,147,407299,99019,308280
c54b2905f97797e7cdbf8d2961d55b0e,140,102,331375,65271,266104,143,118,338676,78019,260657
f3a3d23d8c66ae63f3a4391aa455dde7,163,120,382529,58816,323713,141,98,306087,55536,250551
50afa110eb8423d49fb6bfde8b656aaa,185,139,635344,147153,488191,200,123,577480,145881,431599
349496dcd44b9fa414f2725334c0893b,21,15,7423,2524,4899,17,21,7128,3188,3940
3865b8d4e67ab400b8fe008dcb10c8d1,100,68,178642,64579,114063,101,68,179783,64061,115722
8c0f0c917173bc7b0173b88b42e9a452,63,49,108180,27046,81134,43,35,56786,25899,30887
9cc38f283671d6dbeaa095ccab8d8a3e,49,38,55333,18284,37049,73,59,74838,23988,50850
ef6ba20eeb99e73b088157e87f36968d,38,33,39895,14604,25291,65,51,55568,17690,37878
cd8b998bc5a3c5e54b38efcf148e210d,109,90,236379,53702,182677,114,79,286397,39700,246697
e688a922986daa797f405b8848e592cf,117,92,271605,64114,207491,118,100,242266,74562,167704
d8f9664bd1691d5201671b9af87984c5,93,73,219219,45502,173717,87,74,196790,63838,132952
09d8d691998b5b5394b7427c8a4a9fc6,39,30,22833,8665,14168,40,36,25495,9599,15896
f4dc1fa314877871620a17d3d165d520,114,76,227758,30249,197509,95,81,152218,50099,102119
536479da43265a5284eff065734d507b,117,83,369294,79068,290226,162,145,524496,107917,416579
41a761ce5c6c6af3b14e4cf96e10f9c1,128,100,276703,65184,211519,122,102,289004,90618,198386
e280814cee2d9c79856f4d83542efecf,27,23,13943,7152,6791,23,21,12448,5415,7033
b784d4b1cb4654bb4d99680c55a144ae,49,52,52589,21383,31206,47,46,43223,21229,21994
392a99ab84df25d9454f1217e995e0f4,186,140,927124,141291,785833,188,148,908296,132242,776054
7138079e1cc641e1c40d54cef00b06dd,42,39,70756,21221,49535,48,36,54209,28803,25406
3fc1697c157df89751e522093a140014,41,27,25719,8096,17623,25,21,19507,7066,12441
06c0230cfd5cc24f874f8f2d0fae9702,50,40,88155,23391,64764,60,53,88024,26613,61411
f72ac71dfd99246fe2d5c71342083057,24,20,14401,5749,8652,21,18,12425,5502,6923
7a275745580d900ebcf2e764ff09cb18,43,33,71767,29095,42672,94,74,166120,38187,127933
ad44b3c77eef5112c17d29ba5a1d7072,32,24,17277,6262,11015,27,21,17802,6201,11601
0818d9f1ad289d02f5b3ec708fd43202,128,99,290456,66708,223748,122,107,308578,61661,246917
7a0eb817cb29fef42065db779184a0aa,14,11,2425,1900,525,16,13,3807,1648,2159
9349134399be709fd75a0100d2227633,195,134,559583,147910,411673,178,120,656904,114813,542091
0c26bb0aa6491ecd863e7d3156645bf8,63,38,53492,16668,36824,46,38,38072,20587,17485
d99bf777a951e76ee9346fd4ea8eb899,49,42,50182,21937,28245,53,48,58664,21775,36889
25a9006eb4d702b2bab0ab467460bd1b,88,64,138161,30681,107480,83,64,103222,35096,68126
c137306d5446c43a68327caa840ce7af,96,66,224211,49268,174943,123,100,238979,55108,183871
bdfac3a9fb3f6f01eb92de59d2a93d4c,51,33,50480,10829,39651,51,31,46574,13320,33254
6aa82be997ab37b81015adab22674b35,162,108,310015,66938,243077,114,86,222736,57659,165077
7bb0ddac9f0bd8ab6a0b4c857671ae73,65,47,76539,24956,51583,57,32,63320,18881,44439
4197d9920e9c22049a0ea38a7f0b1d47,117,96,275546,74149,201397,110,84,235058,47953,187105
1e1dbd84e436e4de4c412ba21bec7ebb,37,24,23903,8097,15806,37,25,21419,8680,12739
de91a458745b3b423687628542910b70,69,48,127126,47977,79149,87,62,170544,50055,120489
57ff4c221fe832e0d34c25fd8198e716,63,50,83724,32216,51508,70,55,82906,28952,53954
dc7be52492c01a92f01d35fbb573fd8e,98,71,155385,44333,111052,62,50,90007,45718,44289
929f65ae7091f3565aed9651f66ae9c6,114,74,128301,34289,94012,94,80,150703,43483,107220
cdf1297eb0a9ff0786ea10e439225286,86,76,182030,45402,136628,101,84,153683,54085,99598
7b45be89587e504b431dbd79402bda14,61,49,68294,21916,46378,48,35,55451,12621,42830
1ab1cd409684e64b364c9707cda7a14a,75,56,85547,38407,47140,86,68,113733,27707,86026
844bdb5a6063de2c95596491d820f2c2,112,100,251472,87672,163800,169,136,460250,85631,374619
0d94e1115734a1172de677ba694e511e,79,59,137098,42177,94921,89,76,160895,67003,93892
1bbc4a5af0a5f91ddbd667886bd1e07a,56,40,71536,25117,46419,48,31,61456,19774,41682
608f8191660185252def250ae3b84c94,117,74,349142,71974,277168,168,123,520869,90424,430445
098bb59985fcf7f731836d7b3bf40c67,237,170,1087746,154016,933730,197,151,1095651,147448,948203
d077e3a3f8773c9f2815aeb45cd1e660,109,78,215311,60182,155129,88,76,155513,58552,96961
8b7d0a8cf2ce5132993b7054a876fec3,116,90,188950,53092,135858,113,86,206471,62882,143589
10e419e49d6dbf86e3bd97de30063799,157,106,516014,129247,386767,132,102,423034,163937,259097
ac2731338cd0e5fe03a2c996e7179921,161,107,462136,65818,396318,117,79,246067,66113,179954
dbf34133bb2475327ddc914a023d54b9,52,39,61073,19610,41463,51,36,49586,18323,31263
a896843017c3d96b6be362f0f59e2a19,81,79,164020,58243,105777,72,58,139139,42038,97101
7ef2e4ed903b3855270733532ec79ef7,81,78,162877,48619,114258,66,60,131460,42442,89018
444a0fb7ae0430b6477dd43a413ac941,119,91,277976,41496,236480,133,108,309867,54951,254916
65aa29ca38f92e1674caace52a0a67a8,127,111,315935,91295,224640,169,135,447882,89418,358464
a805d311facd305134f5f77b27c666b4,80,64,144262,51363,92899,96,89,192766,44544,148222
d3b6b410ed98b52003bf5d4da451b31d,26,23,18782,8609,10173,31,21,16375,9694,6681
faa2a50ec37111a9aecb2c5bf9622991,104,86,173574,54811,118763,122,105,199418,41176,158242
a7cb0b1ef0195be682a86102de2463ba,43,39,27717,20883,6834,56,41,73433,13628,59805
83a086acea7da50b1814ce435ff1b112,64,53,83798,48016,35782,70,48,94250,32215,62035
16fda87c5abe17d5ac06653a1363329f,174,115,467364,99847,367517,116,108,316659,96357,220302
8dc30309563945993a3effc5b5c9e0be,69,42,157106,17933,139173,72,52,103858,29720,74138
6571ffc9b0ecaf2ace73c77ab6ade512,136,98,328033,110792,217241,151,118,430496,96702,333794
1bb8b1855a76bb0ff0dadc1b7424a1cd,96,76,249613,84635,164978,121,101,310803,86926,223877
1effcad1e924b0d054377803fc3711ac,99,81,137483,37088,100395,118,97,209387,30128,179259
af1258d12364da8960ccdb11a7a641fa,119,90,275316,60609,214707,110,89,232534,30646,201888
4d8b5304ba1ccecccae0b4b3156b4bc8,115,78,127417,32382,95035,93,68,105710,36028,69682
96457aff863ea12cb682f9843446210a,168,105,318493,50304,268189,129,93,294558,63395,231163
b33957d6a02d16325f402102a7c4bc92,21,19,4669,5435,-766,20,14,9966,3640,6326
b580561a9c590ee87ecb5c49b39b8a00,196,164,720138,147719,572419,180,151,668842,132463,536379
608d7c2b658709df4a34f1d5fbf2ec72,83,64,97667,39709,57958,63,51,90786,25939,64847
d101a05cc94e1ed913b18a93ef89cd81,80,67,101628,32711,68917,99,75,127475,31377,96098
779720c2a639695dd4d746d1e4cd5e5f,20,14,4970,2350,2620,19,13,4729,1935,2794
f80fb9d1332459647d13354e4b8d27a4,38,31,24910,12090,12820,38,36,31843,12119,19724
c6295d23494892cb87511d3b15c1271d,39,36,23820,9617,14203,45,32,22737,12204,10533
6b55c73d2482a125865733d03c5050a5,127,94,341960,80396,261564,118,93,301086,95954,205132
0eb2e69365cdbbeb7091cba8eabe24f4,150,127,491337,97874,393463,150,115,365657,113591,252066
2d1aa8c66fb8cd3e30b455b9dae97e68,194,123,522152,148750,373402,173,98,475086,93208,381878
5c257c318aac085d719d7ded236c51f6,54,44,78727,21113,57614,45,34,52635,23766,28869
4d3cd5a383e1178c43d1a85f46649614,108,81,226817,39849,186968,96,62,174285,42428,131857
0b3f0b423150ad1706bcb180558709c3,163,118,660456,179306,481150,204,159,828682,123921,704761
c3ed9ea8fcf14ffd1d1a0257fae1a35d,19,21,9624,6185,3439,20,22,12852,5268,7584
79c47423b3f9d8d7272166934ae3bd06,97,60,228415,45792,182623,110,86,234682,79150,155532
f3a041eb323c1df3e5b956d9c82532aa,162,121,910812,137986,772826,135,96,437869,145052,292817
7161c97233821e40e74b69decd0ba5a6,143,120,368301,51654,316647,143,117,371336,54308,317028
6905cc13e560dcc5bc3ed121131ab430,107,76,233291,47172,186119,148,134,360590,118997,241593
b689a92f6fef671c542bd8f60e7832f4,73,61,125099,36130,88969,90,81,176969,58250,118719
c4fff46755a072e02cbd22ea5ecd554c,163,112,377219,76333,300886,150,108,357485,105310,252175
7d8f7b5f3660323f1ec93e32175fde36,173,127,555774,122784,432990,170,150,669132,124464,544668
eee63bdc640b642267a6497f8ba8236c,24,18,13087,2281,10806,27,21,6496,3082,3414
63097d50b508c0fe568918f96ba17ce1,33,24,35160,19062,16098,38,26,50099,15917,34182
5eb04d271f7eccefa964a6ff172fcd4c,62,39,57075,13793,43282,43,41,30770,19849,10921
6046f024ab1abbbaaa8690dfecab6764,135,107,257448,44087,213361,107,85,223473,56720,166753
65661196b6e8b4a3552b1ac53faa786c,66,44,71565,18718,52847,70,64,96979,30644,66335
c2b91dc2439e382a55309287e98f80e1,149,103,462480,111980,350500,152,118,401860,118236,283624
b029ab1d745d80be5f953ef8f6b2754e,99,79,266941,70881,196060,79,62,161909,78658,83251
1b9008b03cf77e55850d3cea24cb46df,90,67,128319,46063,82256,149,114,281538,42959,238579
dfecd2eca3a4a42542ef48a76f99aec9,64,53,122561,30206,92355,90,70,139924,30914,109010
261b7eaec45365c269ce8533dc0dd149,165,133,494606,105809,388797,133,113,356207,134321,221886
8a8cf8c9dc996391b76acb152b953161,151,131,393609,83180,310429,123,90,356653,73039,283614
0e75e66e71642422a2a80cd979245af3,62,55,65634,35452,30182,98,74,143564,23569,119995
d05404057c8d0e9898c90cda99f89879,94,62,154225,38642,115583,52,50,54488,41277,13211
551780a662315c000f31a27d8378dca2,142,120,337888,57198,280690,129,110,314687,58374,256313
6a1591fa273a2224997bcfcc32502a34,67,55,74833,24502,50331,67,60,99110,25079,74031
6479ac7f9659e4db1ebca91a2644726f,76,58,181341,64575,116766,84,79,186294,68279,118015
1565a5a291a92a7f3e2a3c534a387375,31,24,10197,4367,5830,26,21,7678,5472,2206
c69d362f190eb68e5e4a29dcda330e46,35,25,41401,12183,29218,35,32,29453,12601,16852
cebc7c90a1bdaf50d219f89a62c98abb,6,5,1918,518,1400,3,3,484,721,-237
d4423bcaff1e892ee892ff8fabde704b,67,54,105119,34304,70815,81,60,117350,27716,89634
3aac91dfbe7d395dc3540ece5b6b2b27,124,90,260129,79038,181091,147,115,295281,92855,202426
4419e2ee3cc6916a09b146c7f7522a1a,92,69,173327,65695,107632,111,84,222584,61203,161381
4647d0615b110c46480dc0c78f84c8bd,175,99,396018,107103,288915,120,108,398691,116207,282484
4baccc3f8776dfc9b978e231ea2d28f0,47,41,49032,17465,31567,44,37,38804,27213,11591
9a32e14b134259117ffa2a4807a6bab1,45,36,63431,15567,47864,55,32,60804,12916,47888
b8605ea48f703429f31a02a75613c16c,23,12,5967,2256,3711,21,16,5460,1720,3740
0420564dec4b5a2cf85bdcce7e696646,110,85,169821,36770,133051,102,83,158265,32244,126021
cacf73fb7c712bdcca61e968c4d3939d,51,41,55438,15895,39543,65,55,62230,20057,42173
190836ab650c64f682f3542619e10231,103,68,175707,48147,127560,79,64,142590,36003,106587
e56202f5fdaa277c26aa55e6c1bc4de9,51,36,43451,8652,34799,49,42,30864,13217,17647
955e10e695ff919d54fd9fbd16c6bda4,123,103,251119,47632,203487,129,105,257958,53506,204452
edeacddf9e1f87834f7a490648686997,31,21,26548,9202,17346,43,32,44600,8138,36462
cbd5dc69c6d86e85eb29592d1b78efe0,103,76,173512,46354,127158,104,58,139958,51454,88504
784341c4d0baa4903a6848ea33540221,76,60,234711,74815,159896,116,91,269344,77303,192041
5b4939491edeb3b713d6f1c9b44be8a0,34,31,38071,9088,28983,49,29,44187,12710,31477
95b40b6ab14c9ed79c059ec0c1d29850,87,76,255008,93858,161150,158,96,429238,68320,360918
d1c0759d8627889f8cb6c7e86e39e659,104,68,186280,40050,146230,82,60,144804,40242,104562
5eaa1abfd1c12b8d74662a9a4a7f06e9,136,94,298291,32545,265746,111,84,199311,62580,136731
ac9ca45475d3e66e2b08f7f35104738e,87,68,187534,50624,136910,105,89,255893,41657,214236
dd9665575d3c92fbc223ae4720f7ff7a,31,26,22333,9775,12558,33,29,16578,10113,6465
872df4c3a017d183fa30653db7ae6360,128,109,301627,63068,238559,123,83,310975,60651,250324
0eefd8a11d360616b9e791c656ca08d4,33,25,27624,15622,12002,45,31,48761,12232,36529
eb15171f91ceb5c799af967a9032f8f8,81,63,91909,26688,65221,64,52,69175,24337,44838
a29ed05d303c3a0d9ef7304ffd7b6d28,144,115,272192,61906,210286,116,96,205272,65243,140029
b55bc04456ec78fecc7851a61140d066,103,86,176871,45479,131392,80,51,126204,34980,91224
f698deb49a16648e65f84078db28a7d7,154,117,378111,63923,314188,146,110,433898,75998,357900
9eda7b00be08146fc486439051543e4f,56,44,71468,23206,48262,69,47,85352,25218,60134
f4f05f3d566fee5bd0503ba6663140a3,59,49,61361,19699,41662,46,37,48263,19147,29116
be5ec00b134b7a7b7c058dd5081c7528,202,156,933398,191704,741694,195,139,854843,173641,681202
2fa5f01d552efe5e0917d61d91e313a9,46,38,70058,21700,48358,52,45,63337,23438,39899
48493cd238c5fa6782a857023c608090,85,69,134689,24686,110003,73,63,112005,25416,86589
235a6796c79d951a1e6211d81d6c7f63,56,41,64253,25269,38984,60,41,67281,22732,44549
a5275362ba761c2abde9849826e55d4b,37,30,39543,18541,21002,53,35,67477,17792,49685
61118acf83edb54376acf76d6557a12a,35,25,41842,11686,30156,53,31,54621,14464,40157
d2d0a198f7632586c6807d3300e7c865,168,124,398582,113803,284779,198,128,414327,82028,332299
c5f396dbd10044019c9951b8b5a171fb,55,50,33858,21614,12244,38,29,44918,12814,32104
b31abfe10b530dc0698f206266288aeb,63,50,97147,27839,69308,57,46,67106,20161,46945
405046a3829a2561bb666ad2f1613d55,232,158,1368567,347080,1021487,204,142,905305,336665,568640
e6dd5de7e00c1dfbc75e4c66b1ecee0a,56,47,53010,20818,32192,47,33,72969,11410,61559
3d51755b587d8fea9df1ddf6f8c527f2,82,54,85906,29039,56867,76,57,107971,25117,82854
9bf20b4f8fd3da2c1b4d47f5bd1736e6,173,140,768392,179901,588491,182,147,704968,240314,464654
614b4bf86546ae62b4b4c0c0e03a9e5c,208,157,750653,181596,569057,158,124,678698,123617,555081
76935aa52e70ab112890a4d5446ea5b5,99,71,209554,40571,168983,91,77,177669,58739,118930
ff19b1588a19bf776f7f89fea2edaed2,85,60,174544,61590,112954,99,61,182092,45751,136341
13f84f1f291675f9c49fc7a168451bb1,237,169,1399114,153478,1245636,215,152,1147499,327441,820058
14e0d8fa9fe50a9bcad7e386589eeb39,49,39,56141,20631,35510,56,50,62706,27066,35640
26a3ebc44ff88d8e89240ded211c5897,133,98,277678,85336,192342,144,121,348058,82923,265135
34faabeca2c9a3abd45c171202b5046c,126,96,372906,114559,258347,112,93,414403,119061,295342
9ce79420cc38325f569a907ea3be54ec,176,150,763760,198011,565749,206,137,1025625,144520,881105
4df79549a5fc83fb25ca33e273a7cf62,130,110,305601,60562,245039,112,86,256187,67764,188423
c82c379f37d333a1f062a512be94fbc7,123,97,199044,43527,155517,105,91,167754,45036,122718
d054dc25a14e3981f2e64cb3acfe50a0,103,81,175608,43874,131734,89,71,187012,50787,136225
7a3009168ceaf8687ac5322d4cb544ea,13,9,2546,1610,936,13,12,2551,723,1828
a81b70ccf4e2635c7b5745b4fb3402cb,48,30,37255,11734,25521,41,39,24471,16730,7741
55b6fde76c6a6d0412ff77485eb39856,26,19,22101,5782,16319,32,30,26227,9648,16579
a805b7e2b7a4e09b796432149f2c8fbd,174,129,727872,169982,557890,179,125,668624,155259,513365
99d5c24c69d329ee24d2263899837285,121,78,273206,90246,182960,126,99,372101,111031,261070
7615e0d790aecdae29b19817915b3a92,91,58,107452,35667,71785,80,63,103274,32300,70974
a7fc6a8df5707ca10b6b4d65615b549c,50,47,46188,16516,29672,47,36,37305,16700,20605
e386c1e318fb093c7b3da28a4b2e4e93,106,71,159534,22882,136652,64,51,90887,25853,65034
952098f73278cc075a6b47381e25aa35,214,148,652193,104972,547221,160,122,641185,145851,495334
15bb8fe042e5644b8c5753c238070da0,32,21,31512,10869,20643,41,30,33693,10016,23677
8e9ea1dcbe2a20851e6c4aba454855a6,29,19,15387,7483,7904,24,27,20523,8756,11767
040a014931639875420eb070711e709e,77,51,73313,20403,52910,63,57,86167,24938,61229
c2252265b71d8841f130f4ec7bdb538b,27,23,16592,6549,10043,22,19,8082,7043,1039
a087cf4982f8881d3b3d85378b841e7e,191,132,672342,202298,470044,190,166,888129,156464,731665
98da621c568a344047de5f1e80396bd7,68,58,147103,52672,94431,118,102,241499,66144,175355
d12ddf26647bbb877270f7cbbdcd0b70,132,111,265960,53711,212249,111,89,182497,49507,132990
c790a8bf620411b1808d169c92e66676,164,116,358444,106770,251674,167,132,445457,109134,336323
d71ff0cbb70a604f3cf3fba2aac4fe91,40,37,44470,11326,33144,40,39,34504,13288,21216
fa7d902b638eedce09e1656dba212cdb,96,70,200469,36775,163694,82,67,97591,42286,55305
1673712a4097a45ed43a780a6361fa91,62,55,80373,23359,57014,62,45,69543,28392,41151
05bdebf7063f5abf4d7f0ae09a05e583,63,53,116011,39604,76407,68,55,141419,34513,106906
82f32d68c25fb2ce5e0590abd2e1aa33,95,64,190347,37420,152927,77,68,144096,41916,102180
526bc29bcead2cfede1c0ea6a874d22d,119,82,184211,42579,141632,81,68,142128,45085,97043
9b24936c120b0e12b2ad731895e8a2c7,156,120,535268,101775,433493,108,92,278051,109912,168139
4756e7dbebadf93e97eeeaec621c5333,52,45,57876,14639,43237,61,46,66903,16452,50451
47ca506feba4488a4d0f2185c8fb8e16,173,124,631138,100996,530142,155,129,593409,168499,424910
dc9e4f511c1ca895b5a970e5921ad2ba,126,97,281826,76176,205650,144,120,256583,73254,183329
be02285012f95bdecff544be8bab1c59,163,107,638310,141521,496789,142,110,511007,143591,367416
9ad5742675c2fa6c096ea1fdc2839249,113,79,253901,60457,193444,112,99,233682,73552,160130
7291456d55d1d1c33c0607546f95253f,19,16,4650,2167,2483,16,8,3704,1747,1957
5d195e567f27b3644ed53bff70d456c5,27,22,20103,8994,11109,32,27,24942,6983,17959
3737e7d186b5be83c110a2c62b3fb786,48,32,41905,20232,21673,65,58,99650,19811,79839
5b96d1a301d366a03375bfd77b27a92a,123,96,334188,90488,243700,142,115,440652,104511,336141
60c05ce81fdeb1e8bc5bfd751ec60a9c,111,92,234796,34171,200625,101,76,224732,45540,179192
08b0a32a19c5178979dd7f416cf33487,20,18,9105,3838,5267,22,17,9035,3611,5424
545fd2c7932807c313aacd4e1f4d49a9,72,60,129809,29506,100303,76,70,165141,46946,118195
13a1baefd32bb924b5008a57fe06f4fc,48,51,75884,34607,41277,94,71,121002,32805,88197
c58fd6584b337c6694df7d10583893dc,51,37,77771,29597,48174,58,57,87479,32782,54697
89fe5f5218e9eaf0201702e1f478db98,156,103,432335,85185,347150,133,79,369300,73095,296205
096eee23a2acf243cc0533455ee4b68c,13,12,2312,983,1329,16,9,2727,716,2011
cc1dc2339c0d1b17cf6fb2615d54e343,56,54,71591,29855,41736,73,49,116549,28256,88293
61aa760df7a4aa8e96a014f1968f0271,148,119,309946,78553,231393,167,140,438691,111040,327651
cf58b32e3fb212fbb8bd542a586bcc28,79,60,130697,34538,96159,69,64,114469,54439,60030
5093f28021b0da678cc7e6c68d62567a,48,39,54439,16251,38188,38,29,33993,13609,20384
7ca68df981f161c1bbab63269bbe90f5,163,103,383417,63587,319830,133,90,390022,73645,316377
1a794750542bb7db9145bac9fc2423b7,69,45,91389,26192,65197,56,46,55539,28273,27266
198e70e49743431d3e682f90ba24d11d,27,16,16098,5570,10528,28,27,27754,7935,19819
301ce337305af00bd185076a5215f742,221,136,793495,216588,576907,159,124,911607,177107,734500
5ea1b5842f704ea37c3b60eb620987da,101,92,157471,32232,125239,103,79,124587,33456,91131
e0805b524744c77560a61d44b106ba8c,44,37,69799,24100,45699,49,34,49048,23274,25774
99b8ad72e7e661cc3c8d75515f69ebae,22,20,14521,8864,5657,27,15,26900,5884,21016
3d315d63c45a2a83206d4c7de249600a,140,111,421085,80218,340867,121,93,340746,97920,242826
3fdb1ec327de0e3ecef04def7e8b6678,100,72,227636,36777,190859,88,66,171079,40123,130956
51180733e13b42738e99b362ba292241,155,119,561229,128464,432765,189,115,648203,85008,563195
cdc7e680a28df9d04d561e99ae8ae1e3,26,23,12359,3497,8862,30,21,7743,3350,4393
ef89f7aacd78d39d3d13229f328915f0,140,121,476488,121393,355095,202,128,557110,118602,438508
5ac23695984318e950643b4f294637e8,115,88,237139,62770,174369,151,104,345070,62732,282338
c6ddcb83155d03d9e21a2a3e6571d4b6,52,44,55602,17863,37739,45,32,35300,13627,21673
46f5fcc4dc1dc941cb58c49bb77bfad7,109,61,163481,48400,115081,88,73,179384,57293,122091
1c9275a75749d09e38e3d872c773040f,43,32,44868,14438,30430,49,34,87781,9383,78398
07c8b14d70ad223a4628566221d6eadc,23,19,7235,6356,879,24,24,15259,3730,11529
9f371a17cd0483a2e548eaf07f14fd85,79,55,92997,18500,74497,66,53,64908,21822,43086
4d742333925ad09c9cc923ec79f12d84,92,80,185978,70400,115578,108,78,281346,71103,210243
04041be1f7a2248a124d1378f6ae14dc,178,120,579282,148086,431196,174,118,545725,116024,429701
25ceb76ac14817031121f75ade0108ba,80,65,89891,24268,65623,82,65,99803,26756,73047
80f79664f97ccfc65a1fd8a188b6785b,37,26,46455,10653,35802,29,21,23506,7135,16371
5f6761aae600e7d39a7158ebe08d2f15,147,104,383795,79993,303802,104,90,251280,111205,140075
914044da224f2ec91206b7967302c0a8,131,97,310120,113653,196467,112,77,269508,88389,181119
863010a1c163e70f41fb499753816009,50,34,59962,20672,39290,62,52,96785,25698,71087
7af8f7198f2adf7edf927cb1634ae03a,161,111,318389,80803,237586,149,109,393440,87775,305665
62e334d8433b4038c54c995f855386c4,113,87,346057,104668,241389,118,95,269976,89872,180104
d60cbd58ac017bf810773dd6e3f93090,26,21,13779,6201,7578,24,19,10449,4362,6087
43ee4a1410a65de6aeed6b1901e652a9,76,64,102741,33769,68972,66,47,125939,26438,99501
028ef3ae9fbec029ef5c5c04b310689c,53,38,77685,27056,50629,42,29,53720,29424,24296
362e2a35673cde70d29caeb526e4a616,78,52,95150,18808,76342,61,57,79509,13017,66492
97ba44d8f0fc8ae792364b66ef2088e7,66,57,133299,48637,84662,98,71,217615,43857,173758
c64bd7f2b432a12ea5de3dba7af18054,126,73,217773,62555,155218,114,100,219133,66907,152226
5912352709672b609f8ddaeabb241e53,131,102,379559,86963,292596,140,121,419235,115742,303493
f71f1330028774ea984420d9fa24ebd8,112,92,288453,81798,206655,129,97,313404,60315,253089
cf3a59769553da4a4a3af6d2d77b612a,126,96,263632,64786,198846,111,97,226299,59444,166855
fcdcad318732c942236ad41516002869,117,84,196039,44516,151523,135,90,185193,40611,144582
b28df2501e188288b5f8bc89213edaa7,62,39,93209,25495,67714,44,40,75363,31647,43716
c4e272a10e397c052d286056ff742d7a,93,71,161075,40032,121043,86,62,134481,48558,85923
99b11d33557eff02e3001092dd62dbb3,115,103,272953,70460,202493,140,109,363474,90597,272877
ab9dff86d95924468d7bb53bc6016be2,55,45,41702,13042,28660,53,43,48945,15244,33701
23089c0f9762de4483fb007abe09cd1c,23,14,4617,1747,2870,16,15,6097,1875,4222
0090e8d9186aaac43b59ab9030c379d6,47,27,50067,20674,29393,43,36,42615,18575,24040
422992e318fb972d4fcd5a68b656adcd,37,31,38638,13759,24879,46,39,28946,15208,13738
4dc7a3830985e9a779387b7a85664733,45,35,40263,10932,29331,42,33,44851,11824,33027
7f04399c90847fa16f259820f3faa18d,188,149,821124,191479,629645,189,145,782707,141550,641157
edf7d91c9b87e16853066b76171ece41,156,114,466189,102409,363780,195,140,621519,106076,515443
f41abde31922fb8029016221a81a9a9f,150,133,349825,87490,262335,128,106,290183,87971,202212
053d5a9220b952fdf24d825ce485a603,72,54,110132,35222,74910,61,46,92816,27563,65253
d8f559b0d02b1f3f745a2d21d50dfeaf,106,80,228229,45866,182363,104,87,168433,38642,129791
3711155112e3bb648e6abf0e61438c82,52,46,56456,14422,42034,40,34,34809,12875,21934
a475210798d5370215ce49bd06b333dc,108,88,251299,42683,208616,146,109,233041,48055,184986
1bbf1baab77f577960063e3c9c6eae85,188,142,821201,119708,701493,174,124,602871,155446,447425
b7f5776a2b08e02f7359adee5916e3c0,94,79,176083,56526,119557,110,79,181542,47736,133806
92efb9ac2a79f4994151378ad0cfec1f,106,80,213126,55488,157638,129,96,208019,59528,148491
8bad1e84c9eaae335b218013fe97466b,186,158,550846,107810,443036,154,117,447694,118319,329375
5b58bdbc760547acd53c565b526ea453,53,44,73265,23937,49328,65,46,73619,26020,47599
66e20829f9da4151a0e6b3e535ec7a2e,97,86,200384,48402,151982,89,78,158946,45808,113138
056d0b155c94acae54ca9c751a6c7b3c,125,94,302103,79515,222588,113,87,243385,63297,180088
2fa40bc08020e17f9ead1482fa2ed1e1,94,82,162793,45776,117017,115,93,160291,31968,128323
2ce8aa91c57eadbbf19cee9183334bf8,121,95,258201,51472,206729,136,111,283089,47824,235265
473ff66f1c8de460bd51180a00d018eb,25,24,14967,9751,5216,30,23,21089,9249,11840
93e3f7db4b9af526c68896a1f92bc715,200,120,675469,85906,589563,178,129,447367,143156,304211
6d2e06c1ad27b846bf36fa0ecdf08c67,69,56,91442,40796,50646,123,77,189735,36958,152777
c0a71f781bd8321a88880329dcdc98ed,68,57,89189,28205,60984,54,45,68688,30189,38499
148cc40804f42d27d5085fb9007a3c5b,126,95,319638,51782,267856,160,123,325113,57233,267880
6f81bb453ca57211a01e52c67e506e9f,34,34,19318,6461,12857,25,28,13594,6309,7285
aaa0303ec2fa45f43b90dabd86cf8388,88,79,174831,53258,121573,125,87,212774,54608,158166
08f4453f8f5c1d72c5f00cc3cb9163ea,163,135,560143,93487,466656,159,133,549980,128703,421277
97857bbab7ce6e14c1a550b790958095,117,90,204363,41901,162462,102,87,217565,55736,161829
696e2b3990b76f2ecdaffe62f79f4873,115,82,206037,38990,167047,70,66,116900,43202,73698
7fd3a2fa733405f8b31aa19356e01ebf,23,12,4453,1159,3294,13,17,2981,2243,738
93eba08fa7c9d969573e3eb5291448e8,158,96,561767,81399,480368,171,122,669416,111684,557732
ac831d981032ed9e63c2e9dc824d9d65,152,108,467922,138841,329081,116,92,345851,90070,255781
730820a46c48bc6f6e2004450a08d5d2,54,41,64957,24633,40324,45,36,79727,21633,58094
e3365899dd22feecc08dc181064331cd,39,32,30366,9527,20839,39,28,31552,8094,23458
0853fe19a1caf1ce775463a7f0852606,167,114,730682,146038,584644,159,132,904451,194383,710068
d67725c7eab21e6fa810ad490fc16f52,4,4,749,616,133,5,5,772,905,-133
2d0942fc8c3e7a5686a05b8ec4113897,138,96,382354,56124,326230,94,76,195237,50694,144543
249f5bca7496ebfe81bffbd7fee283af,120,100,270451,68837,201614,145,118,389224,57083,332141
4e37d9da7d6f3bf8957a8acfafef5dab,60,51,103653,20588,83065,64,52,94315,23972,70343
511c0a699deffa26cea340378041eae1,146,121,358377,84966,273411,154,104,399974,86658,313316
80eb150811c2d56dc096621835d8eafa,18,16,4557,2433,2124,26,18,4924,2658,2266
a2d5877266b8bfa9c8676adbe2a877a1,48,38,50270,13307,36963,48,36,42194,15863,26331
5838c7fdb8922ae9ebccdbf4f614f0f0,97,74,149884,46691,103193,110,96,199309,50253,149056
9e218dee3df7d701ea3f9a3f449368a0,62,44,67182,16710,50472,57,47,37074,16949,20125
261136a2d7cef258bc66f39085e663f1,23,19,6464,2086,4378,22,15,6554,2155,4399
255e0ae421682afa17a08160046a8e90,39,32,43443,22555,20888,45,34,57381,16351,41030
57e05598667742e850386a1ea45f37fd,39,31,46964,24303,22661,47,32,55470,17450,38020
6d55888cff3000ea127955c782c4698b,98,81,290739,76119,214620,134,107,308424,88770,219654
5b70ca2d33a33f4496ba88dd27c4d0a7,80,60,126271,39695,86576,85,70,143422,37363,106059
d8e7d67f43572254e12faa3fc3084009,89,83,183388,58561,124827,85,78,184913,65626,119287
fa9f4764b2a7d41b649eeebcc0e61a8b,103,62,149016,25658,123358,97,84,163183,33716,129467
93e7a789befb289724b76f2319bab482,39,32,37108,12019,25089,40,35,34124,12761,21363
d0c4968e1da5c0bcae85dfbc840c7395,103,82,179477,50181,129296,101,75,205966,72535,133431
fec973be1f82f3fafd102b3ff81866cd,72,62,89731,15233,74498,65,60,67230,22330,44900
0bce3ad42f7da40828996928ed323969,227,103,545587,79641,465946,171,102,411224,89112,322112
09e59f3225a9e7ff31a354179f36d3c2,131,94,321899,91573,230326,194,127,423094,90442,332652
e50bcc0e5765b5b3c69d3f55e4e09f6b,172,112,681496,127291,554205,174,134,776763,156477,620286
e9550dc4058db38171028327b29f410f,149,117,424648,76144,348504,128,119,395154,65900,329254
f2ceeb457f232ac4b06584bd191f61ce,97,78,172763,55218,117545,108,85,235485,43895,191590
2af7bd31f8a3d55aff22ad2879fc66de,54,48,73032,26622,46410,89,77,116379,30964,85415
1ca94d46a8b4159515abdb8df78f1cd0,210,138,921800,156412,765388,164,131,816499,206030,610469
c69ab032806a64203bf501431c1cc027,133,91,298799,79925,218874,117,81,218158,103416,114742
95a78ffbea94b14ba50f75d6714c3a1f,47,33,33594,11849,21745,42,32,36418,9640,26778
a65c4dcfc62a809952c97c7db65e46b8,91,81,276198,110085,166113,132,115,388910,93504,295406
751e993eeae07933e365078a6ac665c7,185,131,965330,200156,765174,203,132,834806,136166,698640
cf64ecf38f1362c17e59975f11c010bd,89,69,102970,44946,58024,92,78,146417,34545,111872
fe069dd665ec3b052abace815d5a59f1,25,23,14324,7027,7297,24,17,15380,6603,8777
b59af74239be3d8bedb9ebbace5a8a2e,108,81,167714,51017,116697,101,79,177245,51124,126121
039d37f99fbaacc47468929b36479bf3,27,22,18404,12986,5418,31,22,34875,6618,28257
cd7cbc7a020ffdfc19c1893338265697,39,34,31239,13787,17452,40,30,31577,12770,18807
234718eda04d85eb7e3c6a7f30f6e5d4,37,26,39018,20862,18156,49,38,71993,19996,51997
cfba5bc69195a25fb69aa5f07ce26a96,27,20,18446,8058,10388,31,28,23795,11498,12297
9f1e8a95325de0549cfd4d99d5a8a3fe,122,85,297150,73060,224090,75,67,184653,67119,117534
a8704a7c45b4ee7314bc0271f8ca3b09,106,79,195856,29468,166388,103,85,170330,29533,140797
f7a3a3f7f5d789e32507a728164f3e4c,91,58,157848,37721,120127,125,77,205653,49095,156558
e93c017339c7688e4a829e3d64b24c0d,140,101,334698,64984,269714,146,116,285763,63700,222063
abff2b5adc27a09252a31ce773bec0ed,45,35,69656,22494,47162,56,53,82506,21963,60543
5ea9f5196a95b07e7256117ecc2a284c,40,25,38901,12514,26387,35,24,21522,13781,7741
2bea2c9d990dc741d5bde6d2badcfce2,30,28,27700,8511,19189,21,24,27737,7887,19850
38d6a4a571b419c87028577ec8cf48bb,30,22,12505,5632,6873,32,27,24475,5957,18518
7b18cc07559baeb7f59bac47e7f6183f,54,40,79789,20958,58831,57,50,96582,30808,65774
adae92341375222ebd8060ab7d8e4ba3,134,99,329261,80237,249024,172,128,416248,76524,339724
1f63160f23c17e5a4b3edca94b9e1935,178,128,438238,73288,364950,131,96,320517,62464,258053
c73379c4ba024febd144b9a5737c1562,86,62,159404,42932,116472,85,70,173245,43668,129577
279899d504b8a19b10c9a994e3efcd91,5,5,651,189,462,2,1,121,59,62
0b52d90694fd6cacf0177b595c7821c4,194,134,553258,86923,466335,152,112,597974,118195,479779
67dc42ffba06b9e5e02ef21136bd9387,48,46,40159,12589,27570,40,30,39810,10614,29196
0a646d98f73a38818741711821c32c9b,23,21,6486,3567,2919,27,20,10647,2629,8018
865b6f5ea1f1384fc42ed0db8c0f5bab,69,52,134422,55869,78553,82,63,181561,55690,125871
156eb407eb74375ad14233b6f680631b,88,69,159519,26037,133482,108,97,176794,42603,134191
623a3bb65aebadc96a760d51f01576d4,34,23,26301,10743,15558,38,29,24001,14269,9732
4de07bc90ad6f30c27bf53810c76e3f9,214,141,618765,92016,526749,174,143,568155,128558,439597
76dc6b3c6c60c4fce30b1aee2a217426,51,46,86912,47030,39882,69,49,126367,38663,87704
7b15d51269bc6d226b50ef02d933d439,105,80,228260,60217,168043,103,79,258434,60913,197521
b11481be4298a477a814944caa704606,151,99,457033,74913,382120,115,90,382136,92093,290043
737c891dca328a8cc92e2c87b32c32df,134,96,262804,51282,211522,105,74,134477,52598,81879
eab2d5962514dad332325add6f5b1d5c,38,31,50039,15556,34483,45,35,56286,19577,36709
41b62cbbfb3618bb834fe33a4486eb50,51,42,66846,24614,42232,50,46,66611,21343,45268
a51a61e3a0d750ae69fe187a189c8a70,16,13,3260,1385,1875,13,10,2841,1470,1371
7a21f7fd553dfa81c8f4adf55ef8c81d,180,142,720264,168977,551287,164,139,773729,139147,634582
481435a90bb9b99cfb5117440342907e,30,27,24614,10080,14534,37,32,18281,9015,9266
017f9c31f7796967852ab3d4644acbc5,228,141,1008730,126443,882287,220,176,1011961,193813,818148
b9e29e99a2309991941c7739b510dd39,175,131,500733,178672,322061,152,111,500913,120261,380652
7e2bc3a3c1d6f40e9ca03610d074e92c,115,89,213678,48372,165306,106,80,165141,61574,103567
be9f67a7662988b2368388aa807f06a6,39,30,28993,15677,13316,38,32,34737,12656,22081
3e3601239d8249cb461d16f76a40aa69,169,133,835463,144168,691295,208,136,1039462,131426,908036
a2cf3c288fd289e9fd9259b0672f8119,210,149,781596,140831,640765,181,144,545409,126053,419356
355fcef1b1283973dff75fad090831e6,143,114,468341,111799,356542,130,119,452334,129444,322890
dfc0dce6a382e311a784bf73132c8698,104,74,193587,60266,133321,85,76,151464,51262,100202
1daa398867215c9aff01f1fd9314aba8,0,0,0,0,0,0,0,0,0,0
88fd81a40a7c0a5ed11ca515946edf4c,67,54,119315,66250,53065,79,74,232508,48493,184015
b45b8db880e590e347355f9fd1928a1d,28,21,14922,8000,6922,26,19,14624,8051,6573
da5fbd565756d929447079aff0436fdd,93,74,128282,38300,89982,100,77,147866,37484,110382
a7d85afc1cd94c796777596fe9bcbb38,102,80,133653,38929,94724,101,82,166675,41894,124781
d4d64a4f701b9e8913d7786ed819add6,41,29,36214,7437,28777,32,21,16504,9104,7400
f999dfab5d159239a80b4cb53cd746da,86,61,202043,57399,144644,108,78,239221,59989,179232
7b71eeb56dc1a2a4132cd837b2764772,83,66,83988,34249,49739,67,50,88883,22776,66107
d9c3766f4f1364d9c14296f74e0cec61,63,45,59220,14077,45143,40,21,31273,10961,20312
706f64f9473a58d9b2e735aebf1cc1bf,46,34,31381,12125,19256,41,33,32365,10892,21473
fe204233e48f22478946b9079f647947,53,34,51120,23536,27584,49,35,60395,19828,40567
116391938cd4cbe613ddf4a6daf35d68,49,44,58022,25514,32508,74,57,107390,27744,79646
66d27414270eb8788bb583dfe48959c7,173,134,464780,113991,350789,133,101,552847,85830,467017
a048b6594e2a5483f87b570c52358dbc,48,40,40337,13044,27293,39,42,41509,16478,25031
0ee545ff7295c29264a51ec1346d9bb2,63,53,69966,28034,41932,46,37,53699,18817,34882
dd14db4cc5b0e281d266772162f90a7f,215,143,1208009,152630,1055379,239,159,935240,243744,691496
dd40395580b202e40c093f748eaa67d3,52,31,31918,14938,16980,57,36,51681,16599,35082
9342f0b515b15cff1d1dbcd49119dca1,191,143,561076,182843,378233,216,168,777557,152139,625418
9a10f686b961c9b88c235f43cf59e8c1,128,111,263964,81527,182437,127,105,339377,80390,258987
232858becb2b6aa49191e4f07fed76c2,49,37,62992,27047,35945,36,32,58085,27908,30177
7b20682d800874f98165d0168bb4f301,50,41,54476,9864,44612,49,36,42239,11547,30692
c7b20d83a27b61eb628bb90bd9cc77bd,51,39,53463,12724,40739,37,34,20419,11498,8921
9067f53d2cbeeb2222d14bb47ca928b1,117,108,306963,59526,247437,143,131,363350,56890,306460
2a98cbd2ec9de1d6273b0e8f13d7cd4a,164,140,667523,140676,526847,205,163,1096359,118884,977475
61cf7aa6d30b3e8da781fd3f224d050f,172,120,481101,163564,317537,175,125,606852,114613,492239
e41d0e434f2845ca78b90e73aa6275de,102,77,250038,63945,186093,90,75,196866,79327,117539
065671f6b2865bda8e76bdea3fedbf2d,89,60,162616,48099,114517,109,85,230573,44220,186353
1d850c3b4fa6647667c710fe4d7a7b06,45,33,79041,35813,43228,111,80,179455,31672,147783
bdcf25c4ca853c5c79fd8ad486a0ac34,137,97,472712,94513,378199,165,135,498452,138401,360051
48429c293bec19153f7486c32a1a1bef,162,113,381040,114165,266875,117,99,333224,134829,198395
43324b8717952a09bf0d55acd589eec6,9,4,1316,545,771,7,7,907,890,17
3d568b614ac2ea57a59a71ca08fa662d,137,94,472380,125262,347118,156,103,539865,97127,442738
4436503818e095bb5355a0307df7b3bf,75,59,109432,28555,80877,79,78,121369,31336,90033
242eee27693742814a57fb6cfe8bdff7,74,67,132390,28952,103438,69,56,81296,32235,49061
70defb6bb05af59d557551281682b7c1,138,100,293754,91596,202158,79,70,194011,73279,120732
5139cc1ee71e65c092b3ef0827b22d86,32,25,19403,6662,12741,27,20,16274,7154,9120
3cb4538be09c0df235f2dd3bb0ea5e3d,15,15,4688,1254,3434,15,19,2675,3011,-336
dc824dcaffd2526c9e05f5417234dc8d,53,42,80985,17592,63393,40,32,37534,18134,19400
53954755cce0051271a47d0d50c0d197,40,28,40247,19739,20508,53,43,78738,26829,51909
da72fd6f209a5deb7621f57f1d550b6d,138,100,411410,114778,296632,145,105,358303,124843,233460
d463a82677fdb8fa4517438daf1149fa,176,137,481091,71668,409423,158,125,470661,123784,346877
42df9ed0f4394d11c4445742cefb49c6,177,111,577533,107098,470435,147,114,406399,97963,308436
b2ee406598fb559a16570bbf3e95d5d0,107,97,246602,46144,200458,121,107,271704,40563,231141
6172038845b3b14766ba400f003ec5ef,22,16,6592,2076,4516,14,14,3675,1106,2569
f55e87e16f2fb484f5d28a19b09215ff,121,94,317716,67955,249761,128,109,423946,72904,351042
f3b11079d9cbbf6feb68b8ff5ff91a96,36,23,28396,11789,16607,56,42,52809,11569,41240
98f9ee33f67e4de99f6dcddbd7d75446,116,100,296881,94291,202590,119,103,281460,82109,199351
1697244425ca0b3d9117dcbe2ff26852,78,58,103560,30143,73417,76,58,94713,31955,62758
b054ed26315d6c9324ca92c66f66e9f5,84,62,144252,41818,102434,106,80,147234,46312,100922
f7019cf5d3f7b7c6c31d07c02e267c8d,108,82,286764,72060,214704,143,124,350550,67862,282688
141330561948e68e8d51807aab6c41ce,82,66,211793,81650,130143,101,87,260411,87448,172963
40d00c9482c66e15b0e6f2626ac8388a,138,79,362033,89581,272452,137,117,330182,114797,215385
88245fa7b44647d810a0bc7d522429fe,219,153,723587,121239,602348,126,108,590471,140966,449505
59352f7a1d24fae292f0d60de65a386d,112,82,395067,85701,309366,133,113,432838,85984,346854
884c85bc8715704aaa85eb13a4f1e1e6,125,94,217858,71035,146823,130,114,274336,52984,221352
382ce6c37a02e477fafd020edfe2209d,58,43,100313,21406,78907,51,44,63334,26145,37189
f3d8dce756b576024cb152490c3a4874,146,125,600423,113425,486998,165,125,502486,122507,379979
65726b3b8446ed6a062554c324602bca,85,55,139025,27874,111151,92,76,149153,28537,120616
c3d77054216e41062e672ec342845f0b,103,79,329308,62282,267026,80,73,184595,52245,132350
a485b1b9cc487b6c33e5006186e15784,127,94,214143,56911,157232,132,85,176280,54739,121541
781d370b273e6b67d97f3429832cbab2,171,140,467033,50657,416376,141,88,376466,53781,322685
9ade31794c539743e042a98b67277369,26,20,15948,7989,7959,21,24,17347,10896,6451
90d356726b6664a2d9e851af7c6a7e91,49,42,96824,30914,65910,59,46,74100,41106,32994
8eff44455b30c042e6ebb03a9253c5f7,79,72,135711,43928,91783,58,48,129888,36432,93456
700019f3fd21439634bcb4aae6ad19a0,37,24,34914,9191,25723,32,25,25240,11383,13857
41c4b638b43e6dbff0c90e9302cfe498,82,66,142355,29476,112879,66,60,95751,41011,54740
08158cc56d38583deb908a81564b45f4,140,105,470098,109858,360240,156,119,514940,124676,390264
b0763a5f67a879890f9f7f95970e6f96,24,21,10962,4894,6068,27,20,11821,3057,8764
df29ae25ba264fb00276fcb741ceba55,36,29,65470,17811,47659,40,42,48125,32026,16099
f8500c6dd37464e91a70583093ade3f1,40,27,34666,7004,27662,27,21,17635,6633,11002
1e6f93cd6d89920e5b26bd0ed4e73f19,64,49,164400,28539,135861,71,56,103743,23761,79982
a6c747b601c7b5937ad35d7326bba937,28,23,23355,7319,16036,33,21,18957,7862,11095
cc0228f71c82d64643ecbdf809754951,75,46,184531,78326,106205,118,96,292669,104119,188550
eeaacbfd1ef17719948c27c9c7ad24ed,26,24,10107,7052,3055,29,22,17452,4685,12767
db0206ba0accc417ef87c5b02dbfb066,57,48,110491,25654,84837,45,36,63313,26118,37195
4a166ddfb220ae61be57c127b62f5370,153,114,575647,114959,460688,146,104,417275,93342,323933
aae6f6976fafc280043fbf315a11aa8a,24,19,6876,2553,4323,21,16,5533,2902,2631
503b71ae07147a4c3bdbc6b55b6c99d0,119,82,363322,69103,294219,177,139,534146,90131,444015
252dd1ad4a58d9e4aa75eeec6a6470a5,87,63,167672,33749,133923,98,71,168012,41225,126787
8e13d36f986a438982b430c741b2aa16,7,4,1241,652,589,6,5,913,787,126
e3f56ff9f8f60a12a034d9043d2a6ecf,104,86,215117,45208,169909,93,80,192142,37880,154262
f7bea3f00a3ed4ac554ba9395fb8786c,45,29,47405,17222,30183,62,50,78459,21889,56570
f9f5e44a01019e849471136785376021,53,34,46309,15079,31230,62,55,68599,17369,51230
283d0aab8af943f4984e5d14f5b6301a,125,90,281750,60692,221058,113,73,266096,46284,219812
9a330dfc98431c11781d841750bebf7a,28,21,15820,4496,11324,27,21,9661,5486,4175
d9958599371e6da506bec76998db5a6f,51,37,52304,13829,38475,44,37,37351,15349,22002
b61941b1d5619dd8ae3e704d414af488,124,103,306772,69433,237339,90,82,248161,79158,169003
5232cf453c7a31442722d425cf6d0810,98,67,129800,38443,91357,78,66,117332,32313,85019
f8ac4dae90c488da6b7bc19b5fc79dc0,169,113,602956,116665,486291,162,144,621903,127173,494730
9d8e1ad2e7d2e078ed19128c2f4331e3,46,44,59327,27817,31510,63,56,83051,22363,60688
6f92d083e25417d35d8bce2bacbff919,27,16,12773,4992,7781,26,25,19988,6620,13368
56ece986fce08b736d54446bd561dbeb,95,73,185984,48914,137070,126,108,244286,53572,190714
713736da19be545e400e5f252427af3c,95,72,255865,75539,180326,89,68,204609,70609,134000
382c08862273cb2c0592b753dc77c490,142,114,404531,70394,334137,117,90,252683,67127,185556
3071c232135b8b8ae408b3b7d77e1b6f,120,93,258260,87830,170430,140,111,355172,96178,258994
87754eac3bcd2e924e08e5356cf111f6,77,61,188686,30041,158645,89,63,138222,31163,107059
8721fd0e71d98f6eb96e3b3d2fc39aef,78,51,96298,24850,71448,87,69,153697,35126,118571
e5e605d23365923c95664abf27b66d85,54,53,77749,22827,54922,53,34,64223,9716,54507
292d4e8b72ca9f63da7229108f389d1c,60,33,85798,14781,71017,43,23,54758,12274,42484
b9067d966e2eb134fc7d35513d865e29,94,70,165841,67575,98266,145,69,263979,40548,223431
8ac4d918b11a49e0b7bb8debe72128ff,20,18,6834,3976,2858,23,16,5197,3727,1470
7c9af0f59f676f4fccc4c152a0fb35fd,92,70,185831,79087,106744,128,103,281286,61379,219907
ef7cb98a79f402e8cc145a440f8f7856,114,89,234801,74771,160030,96,63,186891,52206,134685
3bd1761f5c705827812d2f1d46bfa78a,157,112,528128,100447,427681,160,128,517123,114482,402641
e510cd9fb48defc48430179feed409c5,191,110,482660,83811,398849,160,124,375233,115295,259938
fa629654d0f42c0ff30083c0ae07311c,172,134,469051,122483,346568,174,133,517938,128692,389246
3d1f28b1386cbcfd45ec829ad1420f08,45,38,37185,18950,18235,52,45,65959,16746,49213
cf179d04c814a6af2d830fcdccc15365,137,108,397334,67225,330109,112,91,308174,55036,253138
e5b3467820cd8dd781481a7f26c67c12,66,55,81272,28268,53004,77,52,84855,16688,68167
b9bce1c19664740bb7b29fe5898fd2fd,143,103,385906,85329,300577,152,124,428897,97628,331269
2bf611a9e015684b13d378e2311870a7,56,42,70124,19146,50978,38,30,39799,14269,25530
9a710528138d7fcdfd739b732881f7de,61,33,77281,14483,62798,64,45,55212,22113,33099
57fb781c4c16ba3241919540ca7723cd,63,58,97257,23641,73616,68,60,88189,26343,61846
488015f4a4476d9c186ba19e07c75768,125,82,252255,74486,177769,87,62,177280,57075,120205
82d024a8d9a9f81ccebc88a56f413cee,44,29,30743,9214,21529,39,32,27872,10545,17327
ac12df8b0059e64d033cc6351ce7bf6d,164,126,588518,132776,455742,194,126,658198,102270,555928
0a82a8c6df28a876e5da17ee00e74b85,139,108,395180,128112,267068,195,162,674507,133420,541087
5fa50481101d8743b8ef98cc884ae1ab,70,46,68208,19855,48353,54,37,56112,16244,39868
9a851018300ef530858647b4980e34f3,56,49,82322,29313,53009,78,46,92379,20216,72163
f6fb21da8113b307b4691a304513f64f,49,36,57133,35121,22012,85,60,122760,33669,89091
6c924a72cc713b1380245e9020cf6b4b,37,23,33442,8537,24905,29,17,22555,8410,14145
fd69a769026a97d08b532e6309b942c4,26,25,9957,5469,4488,29,22,10212,4097,6115
d889429d3405ec15fdfbf815bb689543,103,74,217027,53348,163679,101,76,193227,74005,119222
4cf8e53ed9ec0f0ee49e7a6d0f4357a2,65,62,83861,19166,64695,36,28,32766,19544,13222
98992cafe24eebb276972ddda05c357c,40,32,25614,12267,13347,39,29,30290,9597,20693
e3ee04292f142ed05b919927daf8b4d2,58,53,45086,17332,27754,57,42,69827,17376,52451
351576e9b300763e2a594c6b387f2c02,41,35,29242,12097,17145,54,42,36038,10509,25529
db19a8d01fe9514e9d3596bdd4af4760,132,94,334037,82956,251081,144,119,427843,91319,336524
4edcf6f807409522776788be3d6de883,152,118,448961,96069,352892,159,133,596230,87839,508391
ae5ad1f4a9c80826481b9fe40bff32f2,37,28,17197,7862,9335,34,30,18290,8557,9733
6e726395e239ac1596c4862d2e62895c,94,73,189094,63117,125977,121,75,235070,51602,183468
e8ad6dcb22b138c5d389ea8ba92ed483,19,14,7525,3406,4119,22,16,5346,2881,2465
b4c31dcfa25e57852e43e5baf904bc70,37,27,46334,13385,32949,44,28,58405,12878,45527
dd3ae4751ed65d29f1c840df8687bdea,162,158,796271,309822,486449,189,160,763698,177547,586151
7647209b99d0d026d87467bd453eff62,39,27,46399,13314,33085,49,34,49061,15058,34003
6cdd63b510ea3d1fbd4f1b9c6097e01f,52,47,53710,23089,30621,66,48,82137,12463,69674
eb4172dde200cc132a181c8dd47aa78b,47,37,76008,16084,59924,42,35,32794,17277,15517
cc63c9bc7449a1c1a593c164fccfaebd,24,20,12030,4955,7075,29,24,14801,6037,8764
013e26bb0e3d501ce93e057fdbabb834,34,29,25464,16248,9216,35,29,34314,11661,22653
c3de75a7f19e833d24bd0195f5cb4ab8,48,31,24013,7599,16414,46,31,23967,8320,15647
544d94ddcff187ab9b89ab50a544e99e,162,117,451372,82580,368792,171,134,498538,89872,408666
d9866a120856bdf1b4ebad0d9b17af04,24,19,8040,4450,3590,25,21,13585,4501,9084
1cd0e9feddf40c884cef7abacb15d2a9,143,106,379319,96657,282662,148,119,388452,106588,281864
35fb181fe20487a935445974398ca24b,161,104,402867,70002,332865,142,79,276756,63342,213414
cdbb4a280434f7b2f9cb40098d338a88,128,99,422306,105249,317057,141,105,404573,77852,326721
d82e93961bc6504aa874e5f0ec369d8d,22,14,7362,2524,4838,19,21,7670,3070,4600
6eb1bae653b99baef840db0882a30e76,26,19,10378,5934,4444,29,25,15791,6107,9684
0b35b6d1de33deef2e85de6682e92e8c,82,70,119766,46510,73256,100,85,145779,35114,110665
7360296aaa1474b798d4d04c0fe3c019,36,29,36069,12269,23800,59,48,78675,15078,63597
14c48b4f2cc7d5fbdf1f285da409ef17,109,83,270815,69388,201427,159,121,325830,86214,239616
3269ee802114c40e2ad82ac3cb90f840,125,99,303428,51478,251950,78,68,154273,36367,117906
db2674625d442fcc26ba8bc042feaaa2,144,105,361719,53593,308126,132,115,282540,82374,200166
5b20bd82849a68a29b29d691bbf7f8ad,32,29,29668,7173,22495,27,20,15480,4754,10726
64502dbd6fc14adb58081944269ed13f,120,86,331458,83849,247609,182,128,419253,90443,328810
924d463dbe5721428eced2afc722881b,52,44,72763,23489,49274,42,40,48627,19110,29517
bc2dfb30fc97b1910b8bfc7a3615c880,150,117,492902,113952,378950,156,136,586760,106490,480270
8d8482c43d9dd8c12c0a5a7d174bed14,178,128,1015171,167830,847341,195,155,1017680,185160,832520
fef01c158948121c959e22b000f370d6,27,21,14659,5126,9533,24,21,13464,7239,6225
338e718f2e48d86dc1c1b59979b8fe16,80,61,119028,31369,87659,87,73,120638,33257,87381
9f81b6e24b37d12f3e7462ea0a269733,218,154,1340176,214866,1125310,221,146,1391475,200032,1191443
d4ea4365e224667786eab11d5cb6bbee,84,71,139474,81024,58450,102,81,261300,61421,199879
1415530a062511d6c56c766203eb1f8c,80,59,146968,25463,121505,68,49,81505,22292,59213
c908f544c74fc23c77a555f1b8bc45ca,30,30,19544,10884,8660,34,30,27052,13080,13972
b8957ecee17fbbb9b7cee8dfa32264e4,126,99,282034,70467,211567,141,103,332135,53933,278202
3d3a6a63b24d0a4843152f2c4f890479,139,114,526749,172645,354104,196,106,545873,175920,369953
5a877c69e05a1018f4b293185038f80f,42,23,40280,9213,31067,27,18,25499,7959,17540
8432870841fd4fa9bf794d49eed7ecb3,133,105,279913,69408,210505,129,102,299723,64910,234813
2e5870a97df45a107d651edf298601ac,36,26,28571,7894,20677,32,25,21884,9427,12457
ec54126d6615beca4375686ef8cac94c,159,123,877140,141545,735595,181,144,869905,184405,685500
52adeac66e12cee13f891ee180ad5c49,146,108,457116,106428,350688,156,116,470426,122380,348046
6d07627f63933acc1b64fcf998dc1348,119,100,393074,67980,325094,146,126,455082,95645,359437
edf8cb2149a2f4c79cc9d2dccf0a2901,74,50,141496,55779,85717,111,99,229702,58360,171342
81fbd1c6a47f835f819c15b16d05993f,186,111,445842,83503,362339,160,124,510180,88776,421404
2f4f3c348cb2ada999b5bdbc15b6d23a,34,25,24185,5223,18962,31,24,15415,8788,6627
84a8cd9e979092763666cf66dfcdf9f8,146,116,449698,132784,316914,118,105,412055,179820,232235
44ebd20478c70acd5fda830fa7ee1774,104,70,336539,79899,256640,148,119,458711,84604,374107
bd3567efdec6f486267afb0e31924b5a,2,3,351,136,215,3,2,136,351,-215
c78225a9ecdbafeb2cf2de968de8bc89,73,58,161555,36137,125418,109,67,153509,39014,114495
8dfc3abc8e4b979c2500b47046bdc255,13,11,3803,1264,2539,18,14,3880,1203,2677
4baea882f60837b72950f5bb41c97660,136,93,311897,54887,257010,149,108,246979,59133,187846
0c63424c9c28e3527ba0b21a603ccbe1,83,56,123297,34142,89155,112,89,185949,36401,149548
6db5cb7aa4452adbaff06ea0f4acff70,1,3,379,323,56,5,4,529,554,-25
5d292ee9afdccd96caa9f9194c50a3fc,51,38,73869,25180,48689,70,55,91592,25070,66522
2843d7d6c6a3a587aa4f40c146f5f9fd,41,33,39280,17397,21883,43,36,43430,23499,19931
a7aaaf061342459975ee70e90b1f7c16,60,49,100096,26246,73850,76,47,94498,35191,59307
434f4610033fe4d11ddad5782c8ccb0b,155,107,381843,103793,278050,125,99,280936,91480,189456
2240e56e108fed6a4c70484cb5e67500,30,23,23868,7894,15974,37,24,25725,9379,16346
1efbc61374b189790020f6028372f808,44,44,75569,37300,38269,64,42,102810,25516,77294
910c019a169dee7ddabcc79f0caf79ef,107,85,178418,39691,138727,105,76,221140,42089,179051
97300382247b0d124e4edd16866e23f2,49,29,46639,15137,31502,33,34,33733,18576,15157
b225aa739e319646dafeb0fa2c11a60b,139,104,235656,33469,202187,60,46,108924,40058,68866
6821d7ba02cd243322e249ad4804c49e,35,22,24511,4591,19920,29,25,17644,7152,10492
26b4a615c7965140331e3d0d2ad2fd93,26,20,17779,6295,11484,37,30,24352,8161,16191
799d00636dbe47826477542a5289e4d1,93,69,152084,71656,80428,146,104,281873,62270,219603
044ef1c102af25fc40de6bce867ea851,91,64,288871,51172,237699,109,88,281212,75153,206059
f31c7d9e421a3ce1b5c5a1185da47fad,42,32,35811,12253,23558,36,28,33422,10348,23074
f0708f680271590fba363a366d3bb63f,101,92,181738,31323,150415,73,62,124686,35141,89545
18100c71aa10b72901c88d946647ff8b,130,89,408419,80627,327792,163,126,445221,85973,359248
4a1c1d8316d180cc9267f7e8ae4ecc0a,76,57,114069,36280,77789,63,36,65115,19290,45825
07acc82ff53cab6b7634fefc18bfc8db,67,51,98462,25199,73263,56,43,70855,27875,42980
76a01681c37bcffaf75e217e48ef1e15,113,82,230723,66479,164244,101,84,194935,51492,143443
2291a92bf4b00061810e71fa2bfa7089,121,103,344691,84938,259753,117,99,299909,58343,241566
f7d761bbd127870819f890f3cd076f2f,34,28,32121,11790,20331,34,27,21585,13821,7764
2c227bee6d92962b525345ce64e4b721,25,24,8867,8536,331,34,26,35160,5712,29448
11e694373e1441310350981650138778,133,106,313465,52205,261260,114,84,225488,56940,168548
bd9426b989c32700c78d3f10015962d3,168,138,425683,80149,345534,96,79,236515,79492,157023
fdb7c384a25d2b12b0ffb00346a1dfd1,108,76,254743,66248,188495,86,74,197609,79636,117973
70280e9540ac3e59d677a580403abd54,73,64,111544,46219,65325,68,63,142413,33028,109385
9d5bb64e7aa8178e3df3b1abcc4f8913,136,109,319293,74237,245056,124,98,271360,97753,173607
b1652e11f7c7ec28434441c56c9b03e5,194,134,700616,138822,561794,213,139,794787,157029,637758
3cf7f106a596575ce08e7b41712b4585,109,90,238140,54300,183840,148,113,283644,62678,220966
d33140a8766d580cb243e7f350950e20,50,44,66334,16508,49826,42,35,28893,11620,17273
a14675bb199dffc8683079cb4e7f7fc0,133,83,275913,62427,213486,93,72,179826,76870,102956
6375aff8b6804ca94f03c9bcdd893ec8,137,96,295474,46450,249024,105,80,287683,52548,235135
79655ee3f43f093c9eb091f2cab21ab8,139,120,296806,85674,211132,150,113,424254,63745,360509
2c3eb10f890bcef5dec3871efa1e4421,95,85,223802,52395,171407,78,67,139501,60951,78550
908ddda3ee09d3bac375186b366ec88b,127,110,356257,74680,281577,158,122,433991,105230,328761
999cf727104f832c9edf9e5790ef7c05,100,80,178154,44629,133525,99,83,155839,47872,107967
8d70a2bf31b640f19aaa04feb5519c5e,60,49,106006,35061,70945,74,61,114747,39032,75715
96b30c10ff708ad26ff62c44f64591b2,106,83,158807,37070,121737,96,68,125601,31197,94404
609f675d7c799d18d51ada4cccd80b24,4,6,731,1162,-431,5,3,1149,678,471
b678962e40184a8f0e717950060de40c,39,28,33548,14229,19319,47,37,32321,11365,20956
5d0fd8bcfb89211d7a99ccba0940fb34,178,128,685588,77849,607739,200,150,911219,134059,777160
4742f59dc54de9dfdf6f6220985a71d8,215,165,920928,142690,778238,211,133,759297,130336,628961
bfa1e90a1f809d1cb9cdb25d18e536fa,61,44,71896,35095,36801,83,65,124821,31760,93061
75b085e8273984a9cfda1b6cd9e4521e,121,100,342428,74646,267782,149,115,425118,94426,330692
a76168fa8c159e00fdc8d6b46054adb4,32,30,21919,9458,12461,29,24,23234,9673,13561
0de9b8bfc255a80a1464b9561a700369,150,108,428353,127140,301213,144,94,368484,94051,274433
96f25f8ddbd224a5dbc03d5654e9f955,38,32,25955,9141,16814,33,22,25292,5621,19671
49be23655c82fbdbe3198aad697bb91b,136,105,513680,103840,409840,128,114,398354,114614,283740
9308a5423845f43baa86f245ace30b79,41,30,33731,16097,17634,45,36,57889,13745,44144
ddeed878ed3bb16b8b48cf42158ffbf9,101,82,195539,60255,135284,78,63,159766,57151,102615
3d704b2768f6b0aed40eafb04ddc4292,66,54,84222,24853,59369,83,69,102911,33126,69785
04c5773d735bec43cb0ab5a7bdbc9365,27,19,14404,6495,7909,29,24,14402,8145,6257
a3f6c43e2c4d5645131817e3ad408539,48,32,51949,19715,32234,43,29,50536,15225,35311
ccc31aa8fa5281fef334d06805191dfd,59,47,79411,33634,45777,46,55,90471,39962,50509
c494bda0275b73adee6b0332bcc98d18,115,91,228306,44352,183954,100,77,202417,44745,157672
9ab3ca063f6b9c0884c16d2f062f6da6,21,13,4136,2167,1969,18,11,5266,1501,3765
37f4561b25b99f09d9e586c0ef9cd267,158,125,446928,131844,315084,129,84,394992,135620,259372
d37aa645d11513db9fa5b15026124c04,170,133,602759,166901,435858,135,84,393506,130213,263293
2ce32294cdda5337887ea6280156c4a4,40,26,32907,9328,23579,37,25,27546,8656,18890
e957531083f000dbf7bc38bcdfd80a35,33,24,36116,9564,26552,30,27,27288,16375,10913
f227b73efc8a7e1bfdf2aa7cbf2cbaab,86,71,135705,23638,112067,69,58,66274,22873,43401
6b4533b6aca596af82e5b7e492ce4a46,11,12,1448,1258,190,13,8,1858,687,1171
261dcf00b2342e40484542e5d4973905,82,66,125003,33463,91540,74,50,105882,30690,75192
8b8d44cd398d5ae6d4394922625c7896,134,116,341631,83194,258437,151,123,395873,87118,308755
0a04e39ea126f49f57cf65bbc57c179b,32,28,14941,8034,6907,32,32,25238,8987,16251
d414485cd8b9a66870096d511956a73c,123,100,322420,60725,261695,118,104,292343,71091,221252
98d6b0575e348dac5ff499dcb515facc,55,40,63960,31940,32020,80,64,158295,35057,123238
e4c82d0e59a12c33a9dfaca744609305,130,93,258303,53220,205083,135,114,347762,62302,285460
089ad35eb52ca31c3ff1bc8d754e77eb,222,147,822426,252513,569913,146,80,616686,169515,447171
aeaf265e2bc81c735142a7c9454dd17d,95,76,200504,65492,135012,125,107,309057,52292,256765
d6d900f724af9408b5ac4770a8e276e4,61,53,79595,17693,61902,81,57,133524,23341,110183
4971586ac16c0a78b45f5ffd83db8a98,174,127,459058,73334,385724,116,86,330927,87708,243219
9cdd8d18fe1b71300cf5f39daa4b4d37,129,94,245916,54005,191911,143,114,253887,55016,198871
58584e90d4c17869e024fb4c6dfed98f,124,97,344359,88582,255777,141,128,428546,81693,346853
a4c53efb2ef317790cb61ffcb6d35936,90,73,147809,37964,109845,100,67,168614,45129,123485
9b9ae25b280ba78e8ac4200c3c33f382,147,100,384182,42378,341804,167,127,505831,42968,462863
8fd425c0da1ae9241d3677184b91f5da,58,47,103937,35551,68386,55,44,91696,33286,58410
7d1f9bcf3ada8025b6275a11c90e12c3,135,102,732687,90388,642299,195,142,673105,86113,586992
5e9f2b2bb6d33184a0318689f52a1c53,154,117,514014,86482,427532,172,124,598353,93562,504791
4c42d2a920e85ae99766c61ad82b70e8,131,84,311615,61086,250529,164,104,390274,84209,306065
dfd20f613ff88829b792e3694554ffa8,64,52,78774,29954,48820,94,65,150983,29267,121716
f9d44a8e31aa7f4fc67abb7a306a5e9f,152,111,312462,75911,236551,111,86,280063,63686,216377
21b81a10cabbd8f19fb6111b8c360cbf,51,36,66774,15235,51539,42,41,39804,20796,19008
c7e3c4461529af2aeb3844298a7a6d45,179,139,822091,185198,636893,191,142,850214,205956,644258
025e10a8c04c444c4d9cc0fbf209d2b2,20,17,4232,2398,1834,23,13,7077,1998,5079
94ea6405af8b16c2ca5b2e4fe5cfcfbb,55,39,77111,28981,48130,62,44,68401,28098,40303
917697d26bda2799b1d6f3db0f03d8f0,260,196,1425652,271473,1154179,238,152,1811309,268664,1542645
706e376baf196600ead01a5127a3e032,41,33,38390,17129,21261,43,30,49687,17807,31880
63d6f0e69f068fcb797f6682dce76ced,168,113,625858,129397,496461,198,149,517245,177881,339364
46cd2daf09a8f60c6c7701dd2b46603a,52,37,69135,21558,47577,41,34,45887,26218,19669
d7f04b448da42d13a660000b8eff01a5,44,34,54421,23372,31049,58,48,95114,29805,65309
4a4a3558555dcb59aad111895da1077d,103,76,165120,59895,105225,94,70,154083,40103,113980
0e6b06c3f2c71de478fdb07a7aaf2a08,54,50,45734,16436,29298,58,32,44020,15918,28102
730132f2f2a854f4dab478b7fe035777,22,19,7465,3957,3508,25,16,10768,3591,7177
1c593e15a4607a1933ccf0c500208a4a,70,69,92214,41129,51085,126,115,214263,30185,184078
e40c2a20ed1ea077a12ed8f2be1244f3,85,72,168522,41297,127225,70,51,107545,48383,59162
998a80bfc97284b0228a0990fea260dc,65,53,94355,36746,57609,56,39,85746,32172,53574
bc55715971607fcdba0126483308642e,65,54,137933,43175,94758,105,87,239971,40019,199952
33d88b1645d554dbec3fda7bb7909de1,86,72,202561,50403,152158,99,83,239009,45763,193246
e37cd1cac466f805f48a7c8a7264c5d9,133,110,365030,78963,286067,159,114,327728,73265,254463
52a91d02630b53f7f97cb05c7fbd698b,97,71,170719,45883,124836,121,101,321450,71207,250243
36180e8b260ff23d6419c965c214bb47,129,88,321242,100778,220464,120,101,345536,89785,255751
95eb72b82aee1d0d8b6f2b2dc11e9d0d,121,100,268350,55946,212404,69,56,114020,60686,53334
9a68d751e1eba3fd454af81700fea7c1,48,27,47114,17042,30072,64,47,88515,18995,69520
128306c83cb51d987731f75e2410e053,190,152,779921,139470,640451,183,146,809989,107158,702831
4254816548bab509a8657c90993b01ab,191,93,460990,158680,302310,202,97,526391,124138,402253
14a93a75e69dde312370d748af9def25,68,58,92550,53292,39258,93,75,199693,47221,152472
e09d73de728c777eb524581b8784cfc4,79,65,149223,38200,111023,68,55,112759,37176,75583
f13400df3bd1a5ef64471bf058b671e7,28,23,21799,5780,16019,39,34,29101,6666,22435
7decd3f495fa18a09764386282bdaed5,4,4,901,585,316,3,3,405,721,-316
a380749ffacae10335acbcd528fa61dd,155,111,523045,121093,401952,173,118,678172,123535,554637
db8ec3d03a10201a9958b3c3d4f54841,51,44,61020,28763,32257,59,44,71614,20554,51060
9e14a4cd54efb410886d1adc93e0bbe2,146,103,373614,113608,260006,161,127,489513,91733,397780
6974e354d910a6759e1059eea7a5b0d2,72,67,146745,63660,83085,85,67,158663,31260,127403
4d24e7aca08e1a1b79f4999160826537,66,56,94627,36602,58025,68,46,95641,40030,55611
5a8617987e23d0cbc1d03b82591e8c6d,143,119,301405,65089,236316,135,111,339853,67895,271958
032560ff719383dd3318037a6e1b2ef3,97,72,146973,48355,98618,89,69,182650,28086,154564
2353d1bf1d5e7d39829b2ec95464f7d2,71,54,131669,58478,73191,80,65,197744,51791,145953
5ad9058310afa3532025d6c905effb1e,156,123,427449,91412,336037,154,93,290450,76743,213707
49489f5d1e18ed3490dcbf13cdcd92fc,26,12,11067,1567,9500,23,21,3971,3437,534
b8ef42bb21eb1bf8ecf23a9f9c616ab5,37,22,26787,11656,15131,40,35,38084,9640,28444
54de4236b14f42c78e92ae5790fa2427,141,120,478320,86928,391392,118,100,336236,100486,235750
4697f101d124115a38b6781491621cc0,194,158,621589,103991,517598,188,137,550158,113955,436203
84757fba1b18e8db5502016e0583ed58,21,16,6168,3722,2446,26,16,7679,2717,4962
f372d3d8bfa36a506621ffb44cfc580d,87,74,189634,79811,109823,119,86,245773,69945,175828
b08cac5f1b131ab6bfa497655ff77655,111,86,198484,62481,136003,140,97,267853,35608,232245
0ecec9744f85c12da85963eda2e67247,110,89,208461,83574,124887,134,108,357644,70030,287614
3eac3b4a55a2656d02bcb83c0034cb78,144,99,734720,172987,561733,172,145,749393,207210,542183
a3457958d96bedf18abd7fffcd362d0c,53,34,65793,21664,44129,42,29,46227,19574,26653
2910e545f4f4b686f27a3067fb542123,88,67,191666,59161,132505,91,80,151434,51922,99512
0fdc93c125dfaa33ec9517d7f3fd223e,96,81,189507,58244,131263,128,89,258320,38498,219822
85509d0f42a497a2d962de2f5e6b12a0,90,72,157403,33067,124336,96,76,163811,35713,128098
3eec350cd35550e51debb3a1c247eca2,165,131,459461,60055,399406,151,113,363106,60202,302904
ad7eb784afa3a11d7870717c67d80de8,44,28,58410,23401,35009,57,30,79812,20853,58959
60c0a52565a0a65b94c661052efb4e5b,97,73,184044,59209,124835,94,72,181110,63634,117476
d692487746590eb4e104f071743afa9e,38,20,45217,11196,34021,42,24,47114,10557,36557
7f4717d0e231fdf28785a66b3f181c2f,16,14,4377,1945,2432,18,16,5215,1905,3310
3634891c29b30a7daa013ada2fcaa709,78,59,93773,24800,68973,60,48,91513,27521,63992
104d935e7af0afa41d5afdd38b6def38,120,81,374083,107142,266941,200,140,601283,99727,501556
3166318c4d39ea16670e3b7b1a084284,116,92,275761,55078,220683,110,70,230467,44383,186084
6ff769eb95c4123f72e4fa70992133b8,105,89,216811,69082,147729,121,82,321185,65754,255431
76c20838da2f362b5662e1060dab6b20,28,21,14193,4672,9521,26,23,14519,6071,8448
d92dbfcd9cee093c3d1fb2b348780f11,1,2,77,94,-17,2,1,94,77,17
cf91af9e7fc221833560a6518a52fbab,134,98,303713,62844,240869,109,92,229656,73686,155970
eaecea4e59dcda0fdd541b68d2fcb4fa,98,86,279821,57872,221949,110,91,305815,85975,219840
e4e013ce3f55e0298bbbbac32c4b956c,134,97,403976,152435,251541,132,105,359303,123067,236236
8f735f13d35460868bd901647046b50d,88,75,125479,30449,95030,82,69,170496,22062,148434
30f45fbb90bf6f83ee39e00aeb4cf099,31,32,18259,9842,8417,33,26,15717,7663,8054
bb15937320559d40bc20bedc9b05f6c0,22,14,3970,1771,2199,19,16,5300,2212,3088
c3bef51bc609fd65b3b4ce134d326bb9,29,22,15509,6404,9105,25,23,13359,5588,7771
8b63cea8b749924fe1824850b29a4aab,148,113,435957,51475,384482,149,104,364463,54626,309837
cfb6b4053a093789fdcaede47b3bbc18,128,95,300394,55403,244991,161,127,401048,68337,332711
fbdc41a9e64a3089d3c95542513961bc,67,61,80169,29542,50627,80,75,91035,29049,61986
43ef976b248bf6ecca8530c4dc1b36a7,102,78,294253,59300,234953,86,65,203382,65820,137562
b37a6d63a8bd9f047a8d63dce11173b5,29,25,22362,9341,13021,28,20,15086,6539,8547
9ea9bf3f2f189471d2f84b631c5260fc,109,86,198177,50629,147548,113,103,195031,54147,140884
cba6bbaae2c568a1982ec69abf768f1e,103,77,183524,36593,146931,86,72,146984,45672,101312
420c1d52b6a90c54d826a94e1ffeccf3,124,95,278296,60381,217915,118,102,228077,69360,158717
e57d4398a48986b7ad899978d5ea3935,55,47,63380,22319,41061,63,43,88884,19633,69251
4c8e967849723dacb46a65a1b3c6ea34,174,129,411024,71877,339147,110,84,362363,74847,287516
3f89d2596455b248b53dc4eb1cda971d,109,74,219271,42277,176994,96,75,194693,30842,163851
255cab902766a2448d9dd234f2021c4d,154,98,492941,99715,393226,165,116,602499,106933,495566
480b718c1c0ba0e3cbb6ae731ade1b4b,183,140,468523,92345,376178,125,96,373884,115924,257960
8bfc178333b4ae2be6111b93195cb7ad,66,48,95293,30753,64540,81,74,126500,34083,92417
8432fa2fcd80b26f03c665aef8185003,95,86,170625,69064,101561,131,99,260461,55392,205069
a5537a1db2e645ea0cb7be78cd54d014,13,10,2855,805,2050,17,8,4088,1041,3047
4a90f8d95179f9d46f9a48d806b48ad0,144,117,532268,122111,410157,175,153,511437,138190,373247
53f45cf33b853fb1fec6f7a3cf877002,136,105,423070,82898,340172,164,124,489763,89645,400118
01427f85c28de2c22d7a1c69bc23acdd,164,135,652264,119744,532520,164,131,570123,97332,472791
d8fc32572b77a35079eae427b6a2f627,36,29,38496,13399,25097,37,31,33111,20467,12644
3ed2ab3921e9ed8f9f27c26be90cdee5,69,52,116213,30856,85357,74,56,89695,28820,60875
576de50cf04e4b3b604018b06fe51ebc,116,89,304539,66102,238437,87,63,210731,40967,169764
916b7002f2d7deeb2aa49e2db2ab4ddb,154,124,781404,103364,678040,158,136,511900,129662,382238
b929ecde5ac32c7fad0a7e4ccdc45526,119,100,242268,58799,183469,135,105,217460,38519,178941
09b06773d4ba11e858e1042194985488,170,105,222443,57353,165090,137,66,198060,48033,150027
a9b6b79417126f1321807f86a22c3e29,20,17,5783,2675,3108,14,13,3616,1855,1761
7bcb715baa0547ca6fa8e15f69a17196,78,65,99847,24389,75458,66,60,66473,21936,44537
7a74625b6b53a7540619c2f18974806d,38,36,32720,14979,17741,38,29,36562,9708,26854
26ad781d3483cd0af0565b80b0befa48,81,48,96938,19241,77697,87,85,126078,37515,88563
8a2bdab4a785a00df8380761eefd74c2,62,44,59955,18441,41514,58,46,60094,17456,42638
4fa72f8258b73cb8359fbd8712aa1f2f,65,57,94855,31929,62926,71,63,102847,37448,65399
83e7eba591a39f65a170d13ff5bc51e3,38,31,33639,8550,25089,39,36,23592,12550,11042
695bc335f1ee46aef3c164c5a5d28aa1,97,66,212746,40409,172337,116,80,270159,56143,214016
4590db1da2427f6a60f0e8925d7b52b5,91,72,206048,43218,162830,122,95,211359,49818,161541
53e53d4f5634e0b366f06148f30e48ae,177,117,482144,118599,363545,170,129,576410,125960,450450
f7e9225dfc9e5afd8fab92a8d2acfdbb,170,133,702960,180814,522146,152,113,556564,148503,408061
75334bb308543c69e6aedcd8146999a9,44,34,48568,15143,33425,66,49,84814,21445,63369
8c763b862942a6396a939bc3f1f0ce4a,66,41,58880,17934,40946,78,59,78064,29722,48342
543888dd9f757c58ec20acc0bcc303d9,186,129,497753,77838,419915,128,122,302947,90270,212677
3f64cdaf48714dfe894515ef497b2364,39,37,25923,13904,12019,49,33,45468,12359,33109
ab72ab466a06f4e626137b50bb77f2c0,84,71,191396,49091,142305,128,113,234632,63195,171437
e48c573658c237896c9b58e30dbf60c6,85,50,128346,26000,102346,79,53,98598,35076,63522
4aa6cf43813d2b351a458c87bad32ac2,163,129,571937,121077,450860,162,108,584748,92021,492727
86d69c0f3f9a118a7826dfb9c3675518,173,124,576338,99788,476550,198,112,642663,106168,536495
b2ace0db6370ddc89827f9ebe34fc1f3,214,131,1098736,208198,890538,236,153,1229443,188096,1041347
bfb2ec4201767b8ef22e667e5dc32c2b,41,35,36814,14405,22409,54,35,33157,14805,18352
1fafa9650b31d39b8658c7d2ed41c5a0,23,22,6974,4805,2169,17,17,7485,3746,3739
478a4646b575cf19f507c46a7ade93b8,40,32,39906,16221,23685,45,36,36670,16640,20030
9767c97507ba2a60965cecfbb4db3faa,111,86,162361,36343,126018,104,63,133251,31108,102143
80fda5fc01fedd7894a28fbbe01aae5b,101,78,174088,51530,122558,92,72,168204,47969,120235
adf5b866665e70694e7e340398c95c9b,31,24,12926,5306,7620,25,22,12395,4940,7455
66e7738b8a4460e9a5b579b463e98a19,170,115,603888,149643,454245,196,150,806556,168312,638244
c6a271adf62b430a348eb15ea884721f,17,12,4766,2693,2073,13,15,4623,2067,2556
1451b2301a7ab591c80b40c609f5258b,45,39,46392,16996,29396,50,42,41673,15744,25929
b6b589612efde9ffdac06fc3597026c0,24,14,14831,2943,11888,22,16,10185,4022,6163
c7efbcd42a7f247ad9ef7da0e11e171c,151,113,421254,79091,342163,115,92,307464,95948,211516
9efeca7fd788161a75a1a6c6c5d3cc33,126,100,310446,94236,216210,150,115,469050,91886,377164
519c3490da245c9e08c0f7e6a05d0505,30,25,33426,13506,19920,41,32,56876,12693,44183
882100172c46c99cf5840b338e19b5c1,124,99,236324,59576,176748,99,80,206534,63950,142584
ac92f34c19c068773fcf27ea6ba514dc,141,86,241001,64411,176590,121,81,187216,63986,123230
4f72b76661befe213852f8f7b1e981a9,91,76,206076,75088,130988,136,91,277255,57244,220011
869e3694525c62e2973138e391ebaa89,44,39,58216,15947,42269,47,30,41226,20363,20863
732803d96c9d7349f82658ac84ba6f9a,39,30,24694,11533,13161,44,35,33621,13970,19651
81f912f919916f22db572a068f4fe57b,52,44,49880,21183,28697,48,35,53065,19414,33651
196fe256921147aa3573a2ca73271d08,95,82,130167,50392,79775,95,75,148922,40362,108560
bebd3bf26682ae67d3a0899bb1a7e59e,3,4,688,1000,-312,4,3,1000,688,312
fbfbe667c9d09814d63c167ae1ddec08,102,86,240274,51387,188887,140,123,359351,73278,286073
d1a121b96567dd7778d2214a94837cb7,32,24,22116,6788,15328,38,29,24409,7532,16877
0209ff9d896f0a51911fbba02f1d1944,60,36,64842,14859,49983,42,35,35688,17344,18344
5abd30a83f9e58a4db55bbd38726fd73,174,91,343666,78654,265012,135,91,395379,57833,337546
d0f60cc49dff7eda9a4db7220c951423,141,112,581283,173645,407638,147,104,526867,177208,349659
1f1a45aa5a1819cb61052ff479592815,134,75,204617,51970,152647,118,84,273501,57852,215649
2a7bf54e55be61f9d184d8e2ada38d7b,78,58,163704,68196,95508,126,103,327592,59245,268347
5f7ed73672d168e3342f165de418b7a1,154,94,497173,109906,387267,163,142,560432,129281,431151
a1a6ddb2261743ec26088e28a4f94216,103,87,242462,44922,197540,136,102,326200,50133,276067
cbb7b9e90a6df46c0179cb020227a320,40,30,27461,8620,18841,37,21,22936,10357,12579
37164f76aad8e36271fcdd88ea29a315,73,56,137706,36456,101250,69,47,89533,33236,56297
46b24eed1126362fc78c0023bfa78252,167,119,485991,107688,378303,145,124,507317,125437,381880
6937015e664a64c2cb0e6b9e04d324f6,169,131,570102,94784,475318,172,141,447914,152889,295025
efd04b8427ed10fadb8f2f73476b17e3,64,39,75965,24863,51102,75,54,64721,25514,39207
f226773ed987d7a5839c9c500b6c6cbc,56,46,105406,37255,68151,127,91,263321,45643,217678
4f66b49da275b3c912710c610695b1bc,76,68,114711,31668,83043,96,68,180223,27930,152293
9ea2906524247acd27ca9f4c50c656b8,203,121,480983,139971,341012,181,131,670553,133893,536660
1b2409fe132e9da8d5cc2015e86964ff,70,59,96831,28346,68485,50,42,75196,24300,50896
1e8469b6a86e1781f0a5ef9dc0b760af,131,81,320886,82926,237960,163,111,445897,76723,369174
c0abd6fe4755d8e93617341c9a741426,106,79,207363,80117,127246,191,113,397482,57192,340290
7d44a34bb052bf8a65e7fc691c373b09,57,37,103409,21561,81848,74,66,108605,38209,70396
f9a0740bc4136f801cb8c2e7e72cc667,17,12,3352,1958,1394,9,12,3326,1305,2021
b5d87897afd8d8dfbfc6b67e6163ee47,127,106,337835,60328,277507,110,88,226911,45169,181742
f8aaa1051b649160beaf11ddc16294a9,36,34,30181,10885,19296,39,25,31036,8809,22227
11c6bcf92eeea334e555bc71306f0747,51,28,54709,13880,40829,59,41,60731,20221,40510
8d7b16150bdc2c36e8291aa62d7b7c1f,133,104,255453,72982,182471,122,99,323334,83586,239748
1785bc11dee3d9c0a80b37296f6aea55,16,13,3930,1230,2700,15,12,3219,1203,2016
e7608a2f0a94b4b123e859c6bb01e4b8,26,23,15144,7403,7741,37,27,28436,10719,17717
94d370c37c2c3555dbc7644bcf1b56fc,41,34,39783,11004,28779,36,30,30455,12684,17771
308c30eb6ad76445660902fa636042e9,109,85,208643,41228,167415,148,116,284753,49867,234886
0f6da1d8c58d295b57daec984c717678,84,75,191230,48402,142828,130,108,315177,57450,257727
32b9208e2df0ee6fd7f200bbde74157c,37,24,49698,9538,40160,31,25,25501,17431,8070
2ee962ed1cbb495d21ec8fc1e8bde8a4,161,112,600964,96531,504433,144,117,385437,106379,279058
6bffbb3f7fdab0f3c19cbe43d246b269,44,33,39701,7582,32119,34,21,21886,8242,13644
21b6a7f0de242eee55eb4ac8110f8075,45,32,34698,10067,24631,55,46,48699,15287,33412
158483f4d664c4050d3d274b62237090,42,33,78025,23087,54938,52,41,87684,23699,63985
4b8e7df480736a193465af822fa6da15,24,20,9458,3733,5725,26,19,12878,3776,9102
9e56dd223c635a906a6c65e4b37b8afb,55,41,62157,21572,40585,54,37,71271,18724,52547
3c299372ce846d3326a78c10ac4e48e8,87,64,174494,29591,144903,91,79,170346,39381,130965
03efe7d4fee3d05952b618605b69f78a,42,26,46615,18929,27686,39,33,62761,13181,49580
e37601849c16e69e9b2c82cf63b39318,122,97,337466,87294,250172,170,132,417436,91736,325700
24c2c1b569cbfb5e383d9ecf94d86325,72,50,132056,40328,91728,80,48,121974,32954,89020
ac363b497dc2f66016228196c7fdfd28,94,68,183695,44647,139048,136,115,371361,78123,293238
99fc9cdc0631b3451817ad529185a45f,119,89,274337,99556,174781,136,107,327446,88144,239302
c6ab3422538ff4ac659165e37c921182,173,129,494011,111456,382555,132,118,348324,84130,264194
2aa9cc0ad765fffc94da7bf9b456c153,170,130,876912,172183,704729,190,134,676345,171360,504985
1c78f8759bb6eaf13be03db9eec1e326,16,16,5011,5691,-680,18,16,11637,3545,8092
e4cad9e60a227b9a3d1155bc5863f672,51,36,63790,15645,48145,61,49,59105,22846,36259
d2ba418b92d0582ce43a429b6db835fa,18,19,3855,3060,795,22,19,6895,2773,4122
1179873c3d0e3755332eaf69d2724b70,96,74,194120,38368,155752,104,79,202131,44508,157623
366ae01df5f33915c3ef049f6716df39,84,69,149581,40900,108681,85,71,140546,29656,110890
f826145d042cd41c994151bd8cc746a2,30,21,19794,7756,12038,39,36,51021,9415,41606
766a04dd5a2082125249bdbb870feb63,77,51,132116,27863,104253,85,77,126800,38385,88415
b6f65179147ce860d47ef8cc56d94410,40,36,46019,14103,31916,44,33,33512,15550,17962
2619fcaf862f8a9fb81a0fea6f175fab,36,28,29648,11035,18613,36,28,33656,9612,24044
d7eaaaa44debc437e604879e327dcaff,0,0,0,0,0,0,0,0,0,0
9050b58dc2ea951923d336e3b4cca295,4,2,437,163,274,2,4,163,437,-274
7b1d6e65570fe4fc850da2d8a084dc19,79,54,165220,51435,113785,106,80,222558,58784,163774
21a504f87966e8a0e537dff4ad5c9bde,194,141,842633,186796,655837,220,152,790232,118764,671468
a3af67109fc3924d5936855d96b59339,9,11,1452,2017,-565,11,10,5011,1727,3284
90bc9895a5a622a9bb32e484ec2e9e1e,170,131,583286,120882,462404,210,130,809067,78070,730997
f0fddc56556c9ccdba384596fd59e7b8,225,158,931909,171892,760017,211,150,915595,203800,711795
d518d27f06f720a0f0213078546439ec,81,66,147210,54069,93141,147,108,287097,51863,235234
aa45a8f8bb397159c4d7095cdb278f05,30,24,20969,7738,13231,32,25,16732,8952,7780
75fd97fb332c92dc872dc21ddc04d3ee,29,21,9460,4690,4770,25,20,10359,3672,6687
6fb68c6a8c3a4ff3845fdfcea7cb885e,138,100,343448,89600,253848,197,157,658507,83588,574919
db553eb7e080c2780d77120eac68e9f9,118,90,239390,54671,184719,118,89,218844,44397,174447
43e37a9a91b656590d81702b044d45b5,60,45,131707,35220,96487,64,50,122040,40509,81531
86bdd2755629283bf491b9bda1c09ced,211,160,883684,156184,727500,208,160,873006,182465,690541
ecaef7747d790c462c6d589fd41aa62a,83,64,100622,26524,74098,77,71,118157,38060,80097
39848cb4ca858a7ef6241a8bf84d2ff1,62,49,84328,21044,63284,66,45,82168,26282,55886
709f8c49cf80e8632202f1a550d1b3ba,90,68,153340,56469,96871,131,88,227791,46192,181599
14e7ea0aad8b9fb0e7da67142b2fccca,171,110,473556,114378,359178,169,131,463219,153116,310103
28a0a03479e8a90629241723cff03bee,68,50,78045,18010,60035,69,57,66225,24860,41365
4430a221a6d405d6e1a6ec8bd7b64cdf,97,71,220542,55268,165274,80,72,164108,72009,92099
461ad72d4b38d24f2136a0a58b28e1a5,70,55,99361,34498,64863,91,65,129527,38309,91218
bcce53836f2b2582b4261777dfaaeaec,82,71,101837,37178,64659,62,56,114426,26314,88112
759d07be2215bf236a3e763b9320ecf7,17,12,2127,1130,997,17,16,6449,870,5579
90c553fb1a7f4d72caab331076259775,196,157,608393,144331,464062,182,111,530017,94041,435976
38cd0c75e280abc0bac1e4425b6ccdf2,74,56,100832,28568,72264,65,47,77696,25966,51730
ec3aeefbd4dfa6cda24a70d58afa2ef0,152,124,688814,160605,528209,213,158,901105,143330,757775
d997b7b0d2ebfd59d4fca42e6a2a2e4a,32,24,16307,7014,9293,35,26,19224,7079,12145
f93a20f05b9e1a03d8febd3b3ac9d8dd,64,54,82635,32491,50144,72,62,71914,34748,37166
aa5851a360e7139b13432e01b8e98c44,114,85,188581,47346,141235,101,92,189717,37400,152317
d8f749f62681c73e61d6832304a25b7f,52,43,63233,23186,40047,49,42,68864,21662,47202
9ae861d37cb6cc88c699e5e544605884,74,68,101038,26618,74420,44,38,48077,19550,28527
c79e6cae0020dfb1952a3f5c590d4ac8,65,55,123603,28829,94774,102,81,195391,33082,162309
a5fbf2922b21ee487490a09ce37d66df,19,12,4477,1714,2763,15,14,2650,1417,1233
039ef31482ac9f1a044219e7a87d1b28,37,26,33978,14789,19189,45,36,47637,14545,33092
9c04f10767cbd8b0e609d5f2f430bfe1,64,55,79535,23972,55563,75,52,93904,18573,75331
c6132e55eca437caf7ce2980c8b1ff7a,168,123,434255,49271,384984,133,105,434921,62950,371971
e639a0b6d32cc2c2b681a680547e65b8,87,63,103849,25181,78668,84,73,123115,25096,98019
60a5d27dc48baed151025265d9112eeb,149,114,294214,63713,230501,141,122,276842,58924,217918
d453f8edb029557d0561fffe19838a64,111,78,198000,26703,171297,95,75,160741,31096,129645
ad567376f6cee6faacd1fff7351a8f43,88,65,150356,37281,113075,69,59,122979,29009,93970
1d22dd663d211eaa9b6c38abd59b3c31,18,17,6748,2467,4281,22,18,6535,2783,3752
19341885acf66dfc1b0387f6ff5cc425,30,25,23898,8325,15573,40,21,35012,4245,30767
8d7c9cafe465a9741de8da4950513c41,81,62,199229,50249,148980,121,94,245787,65400,180387
a8ba8f5594c15f5296a3161f95ed9d8e,47,35,47573,21134,26439,44,33,51880,17167,34713
944cc658d5bf59770d0def83fac7c559,151,110,406793,64631,342162,151,113,329122,80127,248995
62cdd6d2c44018905bf0f2b4d1d2ca86,112,89,278919,79989,198930,128,89,377309,68098,309211
155cf2ab983fb3b9e2a52aab3a55ace7,32,27,47494,18255,29239,33,26,38063,16720,21343
47b4349079822a10dd90582f58018e19,193,138,598302,115858,482444,152,109,595129,78917,516212
812150a6f76e09996dd970c876d8ea10,12,7,907,765,142,8,9,960,479,481
1199e6b820e5ec6b741195638d27594e,110,85,397307,106865,290442,95,78,331984,130108,201876
1dc37257074a55d72c47b3dd68cf87e4,169,143,871173,171812,699361,200,156,829394,216157,613237
3cc05e4e64b7040fffbc34777bb2c2c6,46,32,75416,20715,54701,47,37,80770,30770,50000
043a2a522a1c2fac6183c9be5f7606cb,130,99,351917,58020,293897,131,102,301459,78124,223335
732298009591c38d2de7307872830765,51,47,58500,22854,35646,65,51,73552,25009,48543
c3c50a5765e42cb0fea59bbeacc83bb9,37,28,28916,10875,18041,31,21,29564,6723,22841
306796c8f8209176734893ea7b81b3a8,82,71,140648,43816,96832,111,87,145515,37971,107544
d5d5a30ebfc972a1403a8ad5596414f8,91,63,143337,32878,110459,78,44,110329,27528,82801
e69ec37a7ff5405feafc2a16d55e1de9,120,98,315627,75658,239969,115,80,230360,75254,155106
92d92152cf90ea14e6f7f1b6e5c8f5fe,152,144,364792,94611,270181,125,89,259778,109330,150448
42cc9a8ef5477417b12d15d2ea65b557,142,102,323217,93065,230152,118,110,320093,83355,236738
c717aead0490173acac64daf038544e4,48,41,54677,26096,28581,54,42,57327,18281,39046
38729b23cdffa574bbbe69856ead14d9,157,105,375333,102477,272856,194,112,439339,83261,356078
4e61b047a59849098b16d63ad35778a9,142,88,311906,59551,252355,105,82,230192,68981,161211
a4d54cd80e8cd9467c24e84f35b37dd3,78,62,149948,41481,108467,101,90,211664,55827,155837
00a34aae164a6868f8116aa913223911,20,21,5181,3486,1695,24,22,5620,2228,3392
80b3dceb9e253399d60efb2be8bb4e7e,144,113,464150,111425,352725,170,126,484538,85466,399072
4075e734d2c2204d0e49d086592c3e3c,175,108,514428,80083,434345,158,110,391128,118057,273071
1a7a7c6e81349ec3b6a1926acf57f162,109,68,282584,74568,208016,121,64,338471,98368,240103
58fa59f5bfefe0e63175588ebb02fdad,37,28,34842,14504,20338,33,27,38199,11351,26848
ddd568a0d8a9c9074a82ac3893494edc,79,61,147516,47461,100055,99,69,161259,70173,91086
ef27da68b4641488ee7dc7ca6ce01f4c,50,32,37840,15995,21845,43,39,46901,15190,31711
c0c8dacdadd3cf26c8b6852e334684fa,65,53,110317,27400,82917,69,59,116617,39712,76905
579ea3493062529dd4fd107c370c5e33,137,102,360086,146150,213936,157,118,591883,102146,489737
83757af7fb4540ff83050741b741c1d9,152,137,814953,185481,629472,200,151,835650,178038,657612
161c9e9742168ec87d907f58859afa59,177,123,509513,51548,457965,106,95,292073,97945,194128
970140da673e1bd72cff9f2cce45391f,68,60,85001,36100,48901,78,54,126243,23995,102248
d14eae5c943e89a435ff2fb1863471df,109,74,222648,45141,177507,91,70,190052,49442,140610
04c1cfedc88587b686391f7c221ccada,76,67,190755,50259,140496,102,76,202228,38485,163743
ff33324023b030dcb653fa9f615216d4,163,122,496325,70097,426228,165,128,415658,81721,333937
107f1ab9ec4729cf3bc1fa6840b702ea,174,142,456000,124597,331403,124,90,329878,113101,216777
fa5e0d3317e37598d2de8a40869765af,48,36,66132,22015,44117,46,35,61223,24482,36741
7d94636a8a18a5ad26f2ba3be80eb514,61,57,106009,27531,78478,76,50,97115,21193,75922
43cdd4744daa167cc1f193bbf540ec9b,31,21,22185,6841,15344,28,26,15830,8425,7405
d1f8b6c9107c90b528cce6f14eb56182,105,85,260189,89604,170585,166,124,370587,84463,286124
d2c9a4748fd509087ed489e272bce362,52,42,73587,24348,49239,92,67,162273,27580,134693
3800a4873598d7be6ce123e4a43c9574,155,120,360613,84797,275816,127,102,302410,71847,230563
1a5a9f325a66c0bdcc49938c1e68df9b,86,67,153316,43872,109444,100,66,129216,37229,91987
3feff694a99eff10e676ad84cf2a4388,128,106,225227,92776,132451,183,119,423745,60126,363619
1e9105c70bf0fee0b51d29e100d26caa,27,25,8574,5540,3034,30,25,12690,3603,9087
c13b9a35212cd94b7d5d3aaffdd380cd,78,55,163278,51781,111497,84,65,158806,51824,106982
b13041ed1bbbd1d11dee8cf1318eaf21,41,28,35035,12357,22678,42,31,34258,16284,17974
0c5073216f5b142f66ae264e9e1612e7,71,52,74631,23058,51573,72,60,101010,19950,81060
99848989b6ad9d6a4ce36e0791298cc6,194,147,655288,159026,496262,225,147,774605,165625,608980
b02262d9c13a6342126d5e4c6cb1ff1e,164,114,513474,105912,407562,143,115,593944,126574,467370
e39c1f40b652dace20046aa972c0c17e,82,67,121845,38635,83210,73,66,134592,36956,97636
1f9cc511b176b0950c2bd351ef132f68,23,20,26653,5437,21216,41,28,39737,5512,34225
8f053ad2a86c73f2791531dc8c3c4338,41,32,72267,24206,48061,47,40,60418,24859,35559
7ca489d79ab2ad07706dbff1b07fcc9c,63,47,81415,28961,52454,52,47,81593,28918,52675
b9d59c9593ca20f9a2e86455eeeb795f,34,23,32158,7924,24234,32,21,34174,9324,24850
8f7799e13761a634286e7f283ce32c9f,170,115,561827,76331,485496,121,89,295830,86308,209522
5e1885e83f1e25ce726083ead7d50c12,96,78,180948,43942,137006,114,98,331100,50782,280318
5f08567790715a87d2996f373e130e8b,90,66,106251,29140,77111,114,67,164312,28064,136248
d516341cf1c2e399bc62a7cc6166ce89,161,131,388787,110987,277800,191,127,467503,91147,376356
39525057349fd49aadc8fc2a7eb113ac,83,74,92107,27704,64403,49,36,60837,22648,38189
773afcdf6485b203e739e4525e966190,185,145,874088,189098,684990,224,145,929815,180431,749384
cba1a9f0c4bbe14702cd921e485dd19b,16,13,3092,1450,1642,23,17,5680,1671,4009
59b6e7f76ef4d3c5489e5206bc0160be,120,92,218901,36843,182058,93,79,122904,55698,67206
eb9bcd44ec8027dbb3ef2af8b660bc64,121,95,239594,67129,172465,126,98,266156,63814,202342
7a0e0abc74a31c76c2cdaa75dfca941c,8,10,3589,1724,1865,17,7,3946,1057,2889
2c4d3d80b5feea558ecfa4d70a79557b,40,32,39237,15582,23655,43,32,37287,13849,23438
e78b3a2c252ed75721660d3667e9ca80,129,92,293972,72176,221796,128,79,276197,66067,210130
a8b11bf74ee8ffc7578dd4594d12bf1d,51,42,69680,23562,46118,68,49,71201,23376,47825
39568e81b2b7209b5a7a436859372181,186,136,778907,199926,578981,207,153,1275753,215455,1060298
9cdcaa62ef3fa6dbe4734f11db9222f5,173,127,573402,174541,398861,191,148,736834,107038,629796
bf06c5eb9f9d256f7a5a48a096069b6c,104,90,168760,67410,101350,134,87,255442,46999,208443
7bfc3a3d3735c6078e08f4d82ed120d0,25,20,12277,6122,6155,33,26,13316,5989,7327
fe8465a639f6f9d2ae2674f9fe221a4b,152,105,364122,105282,258840,159,121,663373,102034,561339
cee1b21b997ed8c812d6a76ee54707ac,65,44,65094,29233,35861,70,36,94581,18343,76238
3f158812f34808cfd685eecf1f6dd864,170,133,694324,140571,553753,180,129,839538,117956,721582
8b73d4510e770662e446b9e5d3e85146,191,135,580278,107793,472485,184,120,643345,82670,560675
10283f89fed32167389da164bfbe0cbe,152,118,435739,68570,367169,163,130,513916,65244,448672
69a707e54303432428741423ebaf2d41,174,130,585587,115675,469912,239,157,609618,133322,476296
c7fce959a6ef6f58147c26b9f49d232e,92,74,138287,29769,108518,99,67,96988,38933,58055
fbcf8277587488157dd8ba1983869ea7,40,31,45153,13068,32085,43,28,34561,14698,19863
d7a8f78d6dcbed66409698d97dc2365f,169,127,636351,153122,483229,176,123,694173,218998,475175
14abfddd1cf8252b03e0a29dae871fb8,122,113,358292,80910,277382,144,123,331572,73161,258411
ecffd9e410023ba768afaf66671ec9a2,95,70,164853,38684,126169,112,96,234492,44772,189720
f9a01aa45bda3378576b50e85816b525,102,95,350182,102274,247908,107,91,343237,96971,246266
893f8ea825dfa191f43d7c708a0b45f6,58,45,91363,19711,71652,74,60,123673,32608,91065
b00b328f67d1bcfdc029ac58fe9ded07,40,33,65509,20509,45000,55,39,62445,22738,39707
72a27b4608fa4a07a4995f561abf062c,71,50,111840,27343,84497,76,50,121900,27275,94625
fcbcc0fd731eb2e316fb1d554d189106,43,40,51303,42553,8750,81,55,136399,35562,100837
59f8356ab59f2e19b2601f09b46cf8e0,40,33,45408,18478,26930,36,34,42846,18558,24288
c95c182deb16bc1af86ddd3c97aa8f39,139,90,247161,53970,193191,119,88,255200,63211,191989
eca57f449e375f56a72a23a6e403c2c2,137,96,333728,105324,228404,157,124,557988,88718,469270
a111816a44dceb9a2eba5e4450485dcc,78,72,117975,34468,83507,73,53,102177,25553,76624
ccbeae58693b8ec727e7ab4a6e7fdd85,128,108,359506,99926,259580,179,129,440648,68748,371900
c86ceda865dec3bdae2ed94bcc018b92,91,79,177170,58095,119075,102,88,243551,70114,173437
4e7e01e767f28eea9b1d50f4327ef56f,164,134,717264,186818,530446,203,160,781227,149240,631987
2a289cc923aae176030e34008f0e180b,148,99,384561,115636,268925,159,127,531271,112973,418298
79e9392bbc9c9189dcea02a30b54e5b6,11,8,1030,791,239,14,7,2131,668,1463
0b1b41d155af28714987c3fa57d8ccfe,79,71,156168,42917,113251,80,53,103991,39147,64844
3544881922a9450a0a6998a32ab52a13,30,27,19782,6403,13379,35,27,22275,9073,13202
e6b527a7d16c343b276c3786daac2eb6,118,98,543652,167738,375914,170,134,673695,174932,498763
fb55a4fcfeda40f392cdbd05da85d446,66,46,69812,17812,52000,60,46,53825,19445,34380
57c95f9ccbf352291f5ebaff3f674bd1,49,39,38322,13377,24945,40,36,41252,14978,26274
7790dbf8ae0a22ae2229cf451362b2c0,101,77,185064,53679,131385,143,114,322113,43275,278838
65ec42f946d5d766d0ec4bc5e4db9203,149,122,481417,112045,369372,159,117,563135,115453,447682
e0a927dfaeca9b2707a7306d9172e8cc,142,117,432475,77756,354719,153,130,463191,101002,362189
1536ea3b37e5fa04fbc81a9d7fb8337d,50,42,62784,27301,35483,55,36,71496,20584,50912
1bff0c1b0eb1f3dcdee7c7b8a9954751,55,40,68361,21750,46611,50,40,53210,20479,32731
1b4bb1b84a93250e8dc8c65eb847aab9,95,68,184340,45922,138418,71,59,129917,46624,83293
1c2e23466f974651c297db6cc7289160,121,85,216187,69863,146324,89,63,221585,44199,177386
1fe6c269ae0051fc79880f86a1308827,106,69,258258,67178,191080,120,77,360378,79593,280785
097486edb3c4f67e8386fbf8837130eb,134,107,317140,76990,240150,128,112,415717,68323,347394
5a96fcb315397ef887a3290a92e63338,78,56,132112,38462,93650,105,76,200304,42173,158131
ce2a7b13c3bef400c922a2c03487d688,110,68,143553,33182,110371,66,46,130872,24617,106255
7f4a9cb897e3db71aef4c0fcfc48400e,117,96,233894,61144,172750,111,97,263281,56565,206716
992aff337c6b7fde0cfd637f6f9163fa,27,22,13526,5901,7625,33,26,11499,5579,5920
df6c83db5d5646177ddfe963eb332953,97,81,136253,26270,109983,96,76,118027,33732,84295
13b511fa5d2745b475f4e04ad28cb4e9,114,93,286977,50715,236262,94,74,206985,45193,161792
c60abc86fda43c24f6d5b8e14302c4d0,58,37,86148,24365,61783,90,79,109105,36860,72245
fffcf580381d053be1a250c9d55c85f4,13,17,2819,2247,572,17,10,2620,2199,421
6c960db41a0c5e1b655355a3d7ac55da,46,40,33266,9938,23328,43,32,24922,11216,13706
244df3dac14e021db6a9f71705a4904c,136,108,311131,61725,249406,149,99,404486,65733,338753
f2624006c59e3ebc99f797c6e7d786da,26,15,7582,2621,4961,19,18,6508,2653,3855
0f83759cbaaf403ff136d242bd015c5a,22,20,6287,3985,2302,16,15,4102,3688,414
76fa9e1903c1ef5d3c0835ed23e33d8a,84,71,123771,29379,94392,88,58,109316,31868,77448
389a9b49bce2727c7788762d290cbee3,29,20,15468,8174,7294,28,20,17332,6127,11205
c5de01c94180dfd2fbff7aca894428e7,179,137,1283910,187078,1096832,232,185,1398711,197850,1200861
0e0adb81e0f1848ff1252996cd93ff95,96,78,192051,63222,128829,134,113,289385,65738,223647
01333663dd327fbd7ea54243df9551ec,127,97,244250,56254,187996,139,103,341700,57155,284545
1c1ca0dc7a2f73e7867c17a133cc5616,74,61,136737,30730,106007,110,93,222224,37928,184296
039a28035b59e3cc4626e9cdb08cef21,169,135,644555,152709,491846,115,89,431851,121270,310581
30865afca25999c946f9c81481709ede,54,44,67873,31580,36293,56,38,85081,23878,61203
76280463fc5ab9a15379481b60233ef7,114,71,283805,46728,237077,159,122,431802,73900,357902
4913de22db6bdd45cd283e970900dc08,23,16,9718,2466,7252,24,17,6790,2679,4111
56a9d999cbea1b2fa49227c4187bc3f0,33,29,31996,10958,21038,40,27,26515,12106,14409
ff572b9bbb441195b530773c1d783d9c,23,20,13974,5333,8641,29,24,21627,5215,16412
8832dbae23462a907183698732d5264f,53,48,94427,27244,67183,50,38,81669,14864,66805
613f2f98fa1485a109005c73ced98e95,36,30,35511,17170,18341,58,39,47869,18257,29612
c1490dced9fe895db679c0ec8bbf5f02,98,70,161491,40535,120956,95,75,133995,41582,92413
8b9c6bb4c6e23ab8dd9ed7f0a5350781,62,45,91388,24699,66689,56,53,59519,27856,31663
90d00f5b20f0fa59c774e07a27bfa146,4,4,892,393,499,5,5,441,940,-499
398bbbc9de2f3cd0ce20075679040a1a,196,150,664435,213213,451222,177,127,636718,213958,422760
fae16450683b6f0b2983463078365898,30,24,14160,7509,6651,24,22,13983,4860,9123
a74bbaa6e45620b833d643b121b60847,228,137,649820,81220,568600,215,140,725995,105750,620245
ba9355dfaddac57232a2704778711033,131,87,245638,69487,176151,141,102,290377,68194,222183
994cfccd2e8d117d0881f81072e99278,36,35,23228,7553,15675,37,23,17696,7763,9933
d0f55e2c162689a6ed75bedd52cb3369,76,69,159532,94884,64648,122,105,287411,73566,213845
e3679812c3aa764722ebd93dda640089,21,17,6694,2131,4563,24,14,6273,1272,5001
9ddafa45c612ff7e3215001deb1f40d6,57,30,34545,13724,20821,50,39,53841,11983,41858
2c597cc4f6c54f2ba8fb13b4464a8c24,76,58,146631,34893,111738,60,55,75465,34991,40474
9b3e3f62ca0101d20e5b27c69204e677,109,93,188499,53585,134914,101,85,246010,49232,196778
02f8fc0439e83cdc6d30094771f91ee6,88,63,272036,57230,214806,182,142,463858,85663,378195
c74dc1ea18d956f3bc18247b5c07e3fe,24,18,18700,3909,14791,32,27,13541,6716,6825
4a8a0e2ec9457b268093235bfb133d37,43,41,46153,32935,13218,51,44,71594,23620,47974
12295513c3033770ec214032b1e39a0f,181,122,692783,116167,576616,181,152,705353,138908,566445
aec1310e83c69c8f7852cdf00c50843a,62,50,121765,44374,77391,51,39,106196,29411,76785
7e48774da0164abdeb016f1f56a894d6,140,104,484634,86949,397685,161,112,397446,107731,289715
b86d408796d2029cb94cf08b57d5b5e8,87,69,134060,25789,108271,104,78,188820,43974,144846
fdf8cccb1fe9cc4655441a7e845363c9,197,133,646637,131110,515527,160,115,497908,113024,384884
dfd5b6cf212ae3a507a79575e8cfe0e5,103,89,260655,56485,204170,137,112,312658,91634,221024
497073a2407b5d9e5b28be93ffc5420f,167,111,535791,158486,377305,156,121,560677,129132,431545
8dfca1543289d2df322962cd775db6ff,22,19,12221,3092,9129,13,13,6707,3838,2869
1c3aba0fb39314c5e0b586342ea086d1,110,84,248324,93168,155156,147,101,438184,98136,340048
0e6f85c302dabd4fb6fbd1874e89ce35,77,73,129064,56558,72506,90,77,178689,49695,128994
b3fd49296ea5c486f207080798c2b5f5,34,27,21129,8089,13040,25,27,18451,7234,11217
7e5790aebbf3dd1df875da61ab913ecf,136,100,330003,107737,222266,155,108,408903,100992,307911
a600da9447b61237d0c5e9f1f615958a,177,122,688768,127800,560968,185,155,788525,207177,581348
534166a56893de5a95f0e39ba9fb64c0,156,109,600037,68709,531328,123,104,297818,77983,219835
bb24fdfe7cf167512020cd13b0dea471,43,25,28547,10647,17900,43,38,40494,11996,28498
f0d6fbe24f1adb853c9375ade33b9fc5,153,131,355812,53843,301969,110,103,271220,84445,186775
65b2e4e36634232eaea2954d746eaa4d,39,34,31112,9367,21745,29,22,18411,10998,7413
099f709f61c06efb908941f7bb7ea35d,148,90,289478,43497,245981,121,91,297109,47210,249899
6444530bb96256b440cbb34b7ca172c9,140,84,250207,51680,198527,97,80,222301,54011,168290
a16a86b2d6308a0fa9538b13d417138c,153,111,412528,103475,309053,126,107,290617,79704,210913
5a4a5ce15b3337d02b53ed68c1d521cf,34,29,20363,8006,12357,40,36,21555,8963,12592
50b7c4a8b40402480af3ec3b7869c002,43,32,41417,14882,26535,42,34,29080,16410,12670
46061e2341890888fc68a5f74addce63,7,5,1211,683,528,6,5,927,1060,-133
a41e245fd7e14c49af7488a0e31b6ea6,142,88,504223,130266,373957,130,91,505448,114173,391275
e1b78f246e5671f545ddb047d4bce519,118,95,265226,38680,226546,99,84,159644,42020,117624
a6212a0152fc2c73141992802d937587,46,30,30156,5456,24700,34,23,15023,4704,10319
d154d26eda1874742474d2606a3ba7a7,103,74,178633,43809,134824,95,78,165502,44928,120574
a331359e73cd7a547c6f99848770e153,23,15,4929,2045,2884,18,16,3893,2247,1646
2bda942e268e600bffa9089da3ce6dcf,119,88,235847,42942,192905,105,87,224612,64420,160192
91579a9281a844d79598c2017b51d54e,83,56,115162,26438,88724,75,55,117354,31071,86283
9bc684e1239b568e5688b5334803d18a,130,113,394366,134651,259715,170,136,436501,141744,294757
ecc49089a2ac0126728d2454c54b61fd,45,40,72282,19183,53099,67,44,88135,19962,68173
0de85ed041f3bd9be2fa94bb16669351,116,78,197108,61707,135401,165,122,424798,54331,370467
450beabbfbbd64a3b4ce3616f244ea3d,41,27,38106,12790,25316,30,28,42953,13629,29324
b7c3a2487b7dd00b6fa6474e57c813b2,111,88,359100,86926,272174,178,153,496213,115065,381148
bef9b962d73f9e8ad4549b777144459c,69,56,104692,40484,64208,63,51,111947,37805,74142
8a7e673dcd11241d4db68f998eb5e30e,152,121,526685,137118,389567,182,144,664959,132512,532447
ec2782ede514600c9dc6a7a7587591ab,141,98,415256,94162,321094,162,119,549236,70682,478554
5827778ea24ab6c078b49d147b307d23,76,69,147002,32070,114932,78,68,152114,37345,114769
f150d9147b82053eb1fd7bbf90d71ef1,22,21,11711,4445,7266,25,23,9124,5158,3966
1b6f6c1243c0e26e67454214da45427f,127,96,294893,62086,232807,112,91,252359,63424,188935
a97eb62c305acf515fe7ea2d5a8b9847,59,49,60113,16137,43976,58,48,90249,19029,71220
9609a3956bc6fefc0fa91486f61e728f,111,88,254063,56501,197562,142,102,315170,51200,263970
109e0f7926574d964f1a21dffb67c2c2,32,25,23747,11054,12693,33,25,33189,9933,23256
8ba778721e10e94327e7dac9d604e971,66,45,70560,30153,40407,60,45,98245,26248,71997
169501d1fd90289cfd6de54b950d3e66,127,91,276151,57701,218450,159,135,402462,74084,328378
1d05f6edad628c598c8e923f658faf54,151,127,480937,91875,389062,120,94,281251,97807,183444
a3f1d118f4cbf7c812a78cfb54337edd,58,49,71130,27133,43997,54,43,67290,18634,48656
13281fa8f4012ed046d57ee93b099376,69,56,98119,24570,73549,65,54,95816,36909,58907
6dd38d93efa0c40d65b1124d743ba8a4,52,40,56498,20036,36462,44,30,53878,16268,37610
9a6dec87402b9fa09e1bfad2814df89c,125,106,382154,112877,269277,166,105,452567,94100,358467
ded057e03c081f059284493c2cf209f3,132,91,229121,65373,163748,89,74,178307,48988,129319
48b7fdc8c49f92af40192c74156959dc,95,69,328871,71192,257679,138,103,344956,71413,273543
8fb6ab0a063bab0bf2ab0aaa9132887a,149,109,344209,81471,262738,162,107,394815,59244,335571
2479dd526291af6d4bf605baa1dd7a03,69,45,107095,32093,75002,45,36,76517,24653,51864
ccc9d48ac6f453b642c89b93d5dba796,137,109,344803,81052,263751,138,102,350833,71957,278876
76e17d27a73919d8684fd9e15ace63cd,139,112,367320,106316,261004,167,128,473884,93234,380650
aa622e189a4331171dba5d9b1dbccf4d,142,99,303440,51236,252204,139,105,402426,78808,323618
bd324eee56feb1c0f1f3a605d389d7e2,122,102,286066,82830,203236,118,104,379195,77476,301719
1dfbc2d898652417e8f8363009abce5c,157,123,392423,108603,283820,161,117,394095,93946,300149
94d040f0c450609b0316fb3378d103fe,97,73,201517,88118,113399,121,87,238619,72796,165823
d038134ec18d8cf9e7336e1e9409965f,35,23,38315,13383,24932,27,24,30710,12246,18464
9ed0a71d69139231ea92958c83b815fd,100,77,156322,44112,112210,74,56,137329,26098,111231
519e889b62821f71fde74ab34ae793d7,163,111,404588,67205,337383,133,93,326949,48925,278024
527d6a9f12ae3cfd077f3df316feb628,31,29,31848,12770,19078,44,24,43870,10123,33747
e012257ee1a85045c5d6e496ea1d115f,142,113,420271,87563,332708,162,104,367481,68785,298696
f07a9cbde44b8b954eb2bfc1b77444ad,196,123,601236,98945,502291,163,134,468709,107954,360755
435362220f5dc63c0487f7ba453a3258,108,86,169608,51055,118553,104,92,238773,54951,183822
40a6cb9e17ff2be6348bc9ffecbf8245,68,58,132309,25767,106542,100,81,136085,36305,99780
35dc162a7597174d28ae18b4de7ce5eb,72,62,128451,39395,89056,67,52,121109,31645,89464
40f3f2a401ad1dcdfeb7d53e4ce71ddc,74,54,110439,36625,73814,127,91,211590,25583,186007
54f658f94aa97f05f2988b6e6949f0fd,116,94,244229,112073,132156,128,103,273113,81875,191238
7ed25ffe50caba519fc3aea141aff7a9,46,30,67689,28165,39524,67,52,86255,25860,60395
f4895f327f45c6d8ea4cccbd46ae1ad7,119,99,346999,55563,291436,132,96,347269,39357,307912
18d58d575ca4f741b0797d8139ed2211,49,43,75017,21990,53027,48,32,47929,17323,30606
0fb1a36eeec3c740da250b6c121a4e57,175,135,407322,105871,301451,170,133,540645,90430,450215
d38fb24b22147f9acef50beccc8d383b,82,53,124420,34854,89566,77,52,98917,30493,68424
1bfcde34d56a2eb49f6b7ab810bf27ac,103,79,200268,33045,167223,92,70,153088,46316,106772
882c6f1444096f34c0ce37de91111b7a,95,84,208797,60852,147945,112,84,238460,44364,194096
a7f2abc392c158f63cddee0d2805159a,111,83,235154,37204,197950,147,107,325955,44992,280963
91ad89f14b31c31e28f5248294a6da6c,106,89,259466,45265,214201,135,120,266928,50694,216234
8082896352f6226e0632998008e42ade,34,19,33966,7478,26488,31,25,23422,13453,9969
fc1acad839e867d8c4a4010ca2d2d1fe,36,27,20340,9668,10672,44,35,35363,9927,25436
58631cfd9e34dab8a399093d3ad66139,43,26,61056,6242,54814,44,42,38708,16107,22601
ad9e40497655e3ddd67593a0413aa099,1,1,111,18,93,2,0,43,0,43
0d24845388e311a4e90f355a79434336,37,27,27839,13133,14706,38,36,45824,13210,32614
2069e1cdb9e1d93c4353c1c7652e30ca,143,87,224861,53978,170883,93,76,194609,57444,137165
30746436be02ae036ecae59e2b9720b7,45,39,21747,11057,10690,47,30,23739,9286,14453
53043a9fe8264725cb0714d10ddf781f,166,135,550824,96221,454603,171,146,571541,122627,448914
12cd4daa156e95f3568ef22d1ae18588,109,90,156806,26852,129954,103,89,181267,35997,145270
6efbcaf964593ced789cdc963d7deff4,75,53,133854,41280,92574,83,74,151116,32688,118428
9f354b7acfda0e41161c171c9ce7457c,30,26,27211,11160,16051,33,23,26218,8728,17490
317457335f9a8135f0d563b2f739f797,42,28,36267,16389,19878,58,46,90534,14455,76079
145dee1a1116edb75a45a64a1ee07b5a,51,38,64697,28192,36505,50,37,73249,25616,47633
6e925229aa286f52f77b595a86bcf0fa,57,44,93111,26550,66561,86,51,151050,21152,129898
21cf5a49202e65dad535e12a581c0f91,115,78,180882,44528,136354,104,77,189460,51803,137657
09960b416c99a622dbdcaaa5d1f1513b,52,47,71563,30273,41290,47,33,62479,22070,40409
984839ce1d967af406387df65e3923bc,56,49,92452,38660,53792,68,55,113990,29749,84241
8c9de826ce7d3db9c90e608b594333bf,139,122,403683,54689,348994,113,92,215511,59913,155598
61ef5ea09e5c587d026d3931f9bde5bf,68,58,87568,38421,49147,98,68,124449,33037,91412
84503426b342d1f14c6f3b921a10478e,139,113,379178,62263,316915,117,104,315802,79809,235993
e878c68d7c23d7c203221c7ab2d3c239,54,52,59854,24034,35820,42,41,51074,16664,34410
d90e343003e722dd2345a2dfef29bd25,142,100,300302,80320,219982,139,115,376513,80950,295563
427c1001d455bdf7a2021d4fa1bcaf1d,173,117,447571,91402,356169,194,129,541843,88646,453197
7e5fa8aec4b8813824f8c5922bee5165,149,78,223215,36593,186622,137,96,235470,58384,177086
2edb355bd4b7e3556ca8209159428300,56,49,82663,36569,46094,98,74,185593,32960,152633
342dd146587b027b80eb258ff5a14131,29,25,15620,8311,7309,33,26,27770,8751,19019
100280412088a42d3813dc5494aaba18,53,48,63956,17002,46954,51,43,43296,20955,22341
005e2a9ce4bfc242dc8ce59bd3fea83b,41,33,37660,14189,23471,63,48,58334,22853,35481
e5b1bd18812b9fa862128505beabfd99,39,37,48312,19479,28833,46,31,48267,20090,28177
377de3f812fa184e41ed497bd5a058a3,125,110,251873,68023,183850,134,110,289991,45109,244882
8b1b2990cdbbc4e400bab1e3f4dd4cf4,27,27,16451,4994,11457,30,22,11195,5386,5809
a30e720803623a8bc1e8a4d30e4df669,156,104,469598,85344,384254,150,118,460042,111368,348674
b68aa628870127aa6c6f3290829ff2b8,9,7,1667,894,773,10,5,1473,1222,251
d01621e8a7ae97dfaa00b429d46d1fcc,134,116,314311,82313,231998,139,100,303460,64288,239172
3381fd3911ca39a01632a4f65e448b23,173,133,619640,115337,504303,163,108,658227,98196,560031
d320df4b5133846b943395f1e8bc6989,30,26,20785,7361,13424,28,23,13035,9561,3474
b48b5d97b266a61aadfdff5c047dc752,37,26,41783,7418,34365,39,29,24325,12505,11820
e9d88a73b8c0d1d1423d295494cec405,194,151,661003,108092,552911,165,109,461692,107169,354523
504d9bac2eef3bbe2647677d9ea9f5b7,25,20,9397,5253,4144,24,18,9337,3866,5471
1ca418173e3cfcf4f3fb582a47d48d06,51,43,46268,20474,25794,47,36,51767,17319,34448
56f9cfdeb94da4c41bf4155cfb3a5bad,126,96,291322,72828,218494,183,147,395984,84644,311340
5145f14842f4a31125d0ae5c4a876a15,139,103,309362,59950,249412,139,98,343100,72480,270620
c7f60d02f627d56139ff383b5de2a470,188,129,719001,143722,575279,173,140,767426,171178,596248
aeafb7ba7399ad8fb5e93f7ea201cb3c,3,2,177,248,-71,4,2,319,45,274
44a7b839c31ac609d02bd4414223e0ec,106,80,221938,57755,164183,108,88,206936,52163,154773
4e61d4870987ef861b9338d7f1d900a9,28,21,11231,4131,7100,29,24,18867,7080,11787
9dadd0dc80870f788539c53df19edc2a,122,89,251264,49338,201926,134,107,261238,46358,214880
9d1245f677b7b88d7a0bee926270a5bf,55,50,79561,28695,50866,65,53,72016,38480,33536
271de4706d4e17207b215e03f23aece8,40,34,29633,14839,14794,41,32,54955,13873,41082
a5b0ba38b1f5ee9b7efda14ae3890c5e,139,115,487857,108127,379730,173,131,522464,97306,425158
d506d9f5ee4c05ed44289ea25a4c8317,88,63,138313,40689,97624,89,67,126393,44133,82260
f9c60e4d5bba9e556f2be8fb1884fc0b,137,106,373370,113211,260159,172,159,604422,129344,475078
f87170ec876e12cadf92dc35ecf3a04e,70,42,110882,27082,83800,75,50,68436,24269,44167
81918d77b185e8e5b204c509824673bf,119,108,243247,62473,180774,123,90,263348,46647,216701
73f0913c7a1f508406f911b871e129ef,99,62,135638,32431,103207,61,59,68120,41528,26592
c5bed7244264bc730e3d2b4af02ca53f,117,95,331282,101445,229837,155,124,454834,92284,362550
a79639709df1be80c7dd61aba4a58c56,134,102,340869,84749,256120,157,107,333178,92663,240515
d80b1b1a25bc83cf1e1b18d4b1002fce,27,16,5160,4531,629,20,18,9059,3091,5968
276f27cee3128a2b6e07c30a364894d8,180,164,617845,102393,515452,147,116,451347,78628,372719
7cf54920f43c1b5bca9dad38d3368bef,82,57,147340,44337,103003,87,68,144189,46765,97424
be993d35b01c4655116920ce6d02283c,114,88,275446,67448,207998,128,85,319588,130872,188716
a53b551cfb132ef042fcc6e6a87160ff,24,15,8711,1951,6760,21,12,4680,3041,1639
c438072bb7bcf2e31f717210edeccd57,33,23,37447,9598,27849,32,29,26362,14496,11866
0217b7ba274c4ca6c436b2326022f669,38,32,42209,16987,25222,60,48,84128,17418,66710
893a7c6ae3c1190c44582e015782b870,92,61,193865,62316,131549,83,81,175437,67161,108276
e2a047ec08f9fdd4f77179adbef9fd14,143,110,322354,97395,224959,128,93,282629,82984,199645
4b927922393b9b958c195ec2a3d5f03d,136,107,312886,78064,234822,179,105,399720,47086,352634
6c6037f2d53ddc5362c63ad48fc4f1a3,20,15,9053,4089,4964,17,18,13299,4579,8720
61d2bab1c7ef9db1a166fcf72cf88770,152,132,441377,91166,350211,133,104,411944,77117,334827
177e7f3b9518e92c026d666779051ff6,160,111,585007,116898,468109,202,150,675343,144811,530532
765bd33cb2ce6f13cab84f452fe4c7cd,86,67,175899,54820,121079,131,113,257223,70932,186291
a6004dc2fd6908cfa1ef213002ff90cf,92,79,115861,38830,77031,95,78,154205,36368,117837
ec7e6c9891df4bf41858477e43a7cb0a,43,35,34758,12620,22138,47,31,33385,10843,22542
84b078123066e37a9a68fa58ed9c78f5,80,53,129399,55855,73544,108,84,199284,39212,160072
8690f94da2045b4f29ba2865aa2fb8a0,69,52,92492,27036,65456,63,55,82288,29555,52733
8730b14c54fca84b1b446862ac0e0226,51,44,62654,30749,31905,77,72,110099,25568,84531
6881b8b140cfef554baac85f0229b228,5,6,585,432,153,12,4,1119,130,989
c32eacef4b78c754616cf887faeb2b9d,32,25,26983,10285,16698,36,29,33358,11825,21533
a7cc5f4a3c5e486cf38a7bb1b0085cac,68,64,93652,25212,68440,46,43,62037,18092,43945
024fd094da4022bc01fa62e17f22ff0c,66,58,112197,43383,68814,90,71,116968,34560,82408
e6a2ac59278bc630b1046c92355a1e4d,149,111,341349,69119,272230,145,102,444065,61860,382205
e6e0d4a87e18b3f76dc7b7cb345279eb,136,94,256937,66662,190275,117,94,241535,66328,175207
67d9e4f93cea2b2f051d612448ebef04,118,80,278441,67545,210896,152,100,420123,58962,361161
bb0e1a7ac8785228a6f7f18dc790d8e0,34,30,32064,11015,21049,31,25,29015,10163,18852
3359b57b944a645c54f8df4505c5f29f,90,64,171060,76052,95008,134,93,355305,63238,292067
b489e5af3e7d3ade4c1c9ce83f1d8758,62,46,102216,33407,68809,61,52,124817,27928,96889
22b78dd4a8fe303c38eb034d407e7b81,5,4,901,752,149,6,6,904,916,-12
2c3d4d0bea256017df3ace5b9d48f9fa,30,26,15393,6370,9023,26,20,12820,6521,6299
f29b949f650d4b33adc7fcf8c98ba61f,40,40,29368,12391,16977,39,34,25401,9633,15768
14e7d979e524c34e7b15b663bf445e56,2,2,122,46,76,3,1,115,72,43
6679a463ade9e83df77f40026811acf2,69,53,87580,36735,50845,72,58,83784,36036,47748
1e6c2e337e4142920c53619b2e433dc3,109,79,241650,57442,184208,145,109,403098,63325,339773
3332d5a86086e5b3eb4a46538f565d98,156,81,233384,52520,180864,139,94,225108,77608,147500
c6d6371b1eab4dd8c88959fdbe91b92c,29,25,17400,7118,10282,34,25,15380,8150,7230
d471ac9547314f6a930929ddecdcdfba,128,102,275707,73778,201929,156,121,355655,89800,265855
6d19e709793b7a085f38d217d706342f,119,100,300438,56935,243503,118,103,275678,65970,209708
4b35a04a2521388fc59a57f6df5ef7cb,138,97,324903,71315,253588,141,102,310081,72774,237307
70cbd0888a543ddf4d91a325e15e99f2,38,23,47350,9754,37596,28,26,28732,17418,11314
2516c7dd399dc16c96119e7afd9946f0,83,65,139564,34233,105331,92,55,114322,33339,80983
d2cb7fba1cc32b909651b1005f7992e6,56,44,61356,12518,48838,50,43,57300,15362,41938
2315adc4d9d7f77c6d365d217304809e,68,58,108015,30437,77578,67,41,77876,17322,60554
348589a280b81c8412bed2e4474a3cc8,42,29,34984,7184,27800,31,25,17493,8501,8992
cd9dddbe83066fd6f5670c36091d9c4f,47,27,28095,6256,21839,37,31,28084,10095,17989
eb8c69a3a553bd2c6e4c3857655ffd57,7,6,843,881,-38,8,4,1308,586,722
18e90afde471644bb6e291789fc2d854,99,80,186442,42700,143742,119,87,211383,38602,172781
6db28203f4f5e69ed754de03808d7c77,46,33,35577,13924,21653,47,47,44520,16343,28177
c3014ee8d7345fb4ab2ea7a42a755cff,34,18,33192,7485,25707,34,21,25095,11247,13848
38103871672328dbbea574893ed5843e,202,152,901752,115387,786365,214,147,918399,147469,770930
f137a5fe5a5d2e69575370d4236dd052,55,43,96457,32462,63995,62,58,100450,33577,66873
6fab72d9a7c4fd4b852802279c231126,142,124,346791,89613,257178,145,101,349778,68336,281442
2f7663c16bba59891d842a9cc6f0ce2f,159,94,399451,117544,281907,136,96,382630,65662,316968
66b93e9d21b8fa0475ca57bf972ec7fb,89,66,136714,36821,99893,101,70,169426,25855,143571
06a646fd176cf9b5d30873198b388aa0,192,141,479625,86083,393542,157,113,407438,96740,310698
cf145030e9e4e1c2b786aa9e3f849bf4,75,54,93240,37998,55242,88,59,144333,29089,115244
23fa3830e1b0e0b496a0b3e3b079b77b,44,38,72807,19257,53550,40,36,51698,26033,25665
67e4f4f15879a93169f2f3b48f6d4a83,146,126,444544,108661,335883,154,123,476973,111193,365780
064959aa88f376b9ac9bfd88d9d43c98,165,131,532935,71508,461427,154,127,405466,82700,322766
5ea35fbecd5d869aa524900e3ce855f5,147,110,432997,159981,273016,163,117,585899,122313,463586
cba31ed4d1d302fe0b83cf51f1a90683,27,23,17746,7081,10665,29,32,20910,8893,12017
37bd5041455fccd42ca7bfdf86511bd7,115,89,270349,68974,201375,146,119,376628,90576,286052
0f9a9cb8b46a3f86edd0c5a1f9283716,80,68,153193,33165,120028,77,65,122452,33948,88504
ef9aa27580670e0ca1dea552ccfa6442,116,87,421589,68820,352769,153,107,375594,81000,294594
5668e55eb8180271ede8b8748f391d4d,24,21,20140,8473,11667,38,23,29772,6799,22973
0e48fb201575b0ab2a3db58de06c0c35,144,98,346973,61987,284986,211,138,443078,51405,391673
299b720dd3a55e9304a85cbf7beaa422,222,109,505555,57273,448282,161,110,417747,76762,340985
82d66c984f90382c05461d423ada3f9c,177,137,508054,130310,377744,185,122,543198,110047,433151
df5e99090475c1eea7073b463835c5e4,102,72,203304,55639,147665,154,136,411749,80359,331390
2a19bb5955ac06e60163e43d7fcb1d52,46,36,60139,11398,48741,53,36,43342,15095,28247
3865accad09d941ba0860a6682756ae1,107,99,275667,69932,205735,102,90,245344,57207,188137
1dfbdb9430e4cbd26ba4231a7f57eca4,168,124,582877,129027,453850,145,111,457084,107289,349795
2a7cb5b9efa14cba95e20953fb259c87,15,17,6016,3688,2328,24,17,7020,3573,3447
3d888051fec5065f8d81f7e7e99004d5,96,74,190449,55191,135258,94,71,169174,47234,121940
346bad71fac3bcc3a2485ee668664e4d,55,50,75303,17867,57436,67,54,75615,20550,55065
b648dc5a07d6fc66f6ef25226ab83b96,32,21,13788,5256,8532,27,21,16945,5920,11025
befc59d090ea98d0b5ee9f4d7f979139,105,81,217515,50404,167111,89,58,186518,45966,140552
1417d6a6ce954190d5b5a5a7bc6c1d50,65,46,80146,28584,51562,70,50,102430,31118,71312
2a736d7d9c74941d2817df0ba93b06ee,39,33,26278,12188,14090,43,31,23103,9245,13858
ee123def7326b40e0bf7c55d595f3d12,151,110,345914,59822,286092,141,107,311377,62139,249238
a4541ee66593abf3fde7ad988a63416a,180,142,819688,210010,609678,185,137,802308,123831,678477
15d625a61a790e517df6501c845df96f,123,121,426184,140635,285549,127,102,385149,114321,270828
80ae5d02bb85a713352cecd1e927770b,146,94,219230,59577,159653,140,107,334784,57210,277574
10230febfee80ebd94c72f454fe703e6,116,88,232488,62541,169947,122,99,266047,65423,200624
b166d5fb15e268654e9f6ed554f70499,69,53,151230,41284,109946,84,63,142764,50689,92075
c3035a39bd6b221bb033af6c3952506d,27,20,13091,7598,5493,22,23,14365,6221,8144
87179a8d89fc0c20dd0d2d2b1d963ba0,111,72,224930,49076,175854,145,78,252410,41851,210559
176533d37eb902ac65ea1ac8dd272ed1,78,60,120451,40600,79851,98,92,173347,54967,118380
40e77d99ce06907c0530a3914a91b5fe,41,30,30503,7570,22933,36,28,18804,12810,5994
524caca05de20c3ce96d31820d312d4c,83,79,166474,54959,111515,100,74,234217,44001,190216
4269c84d23ff497e995961e6a26bd6bc,87,58,95166,27745,67421,78,65,138061,26559,111502
741b0754b64a6ca92cb7c3c2122c84f3,28,19,16523,4424,12099,27,24,13373,6967,6406
8e8df819c1cf39ec2bd4e1b56b0c103b,141,118,433196,64269,368927,98,65,260520,50278,210242
557bcca1ae8ed367da04d25b02c2f22e,46,36,63853,21045,42808,45,37,59039,19123,39916
dc9c9908e5fe59057d5e0810319c9221,134,101,278055,48144,229911,108,101,249726,56380,193346
17b15414c0f168e0a10e8291a2b920d7,107,85,301439,43075,258364,146,121,306488,67415,239073
e77ed22b87bb339e139776c4cfe2543b,88,88,161018,54730,106288,101,77,168703,40492,128211
e10f6c64c5e9b87844041303b06fa8f3,112,89,240029,52843,187186,96,88,165694,39172,126522
c91d7ee69bcbfdec8ae7bef747c454d3,124,99,218307,49769,168538,124,95,188083,41873,146210
672d888d68595bd923f97dd27a35ba15,50,33,60783,16505,44278,55,37,50186,18844,31342
ec04d971d8f2c2d295a91a64d17898dc,160,135,388740,86821,301919,143,109,336163,98052,238111
199a204c3ef910de93761227eabe5305,92,75,181946,54991,126955,90,77,159673,45250,114423
42645a8ccefdac9df61f2f59180a82c8,43,38,40852,15128,25724,48,36,31292,14289,17003
382b41c6d031bdd0fb912d33b9d68d49,100,85,303689,65077,238612,118,96,279792,64540,215252
9a0ca3620e2e2b8bff0ed2309f9dc537,118,102,227715,74787,152928,114,94,206214,51995,154219
b5e09a4671490ef26dc2d91e1628187d,99,85,370521,109932,260589,175,128,593414,92358,501056
72c552df0375534e1487bdd11dfec632,124,94,381794,98420,283374,149,116,483880,104745,379135
641e4b06741e67ccec31898c990d4397,33,30,20263,11286,8977,38,26,19034,10736,8298
7cd56006a217d31442770053b7635b3d,114,94,268209,74875,193334,118,95,280933,99837,181096
9180af6263c30e7421a23710d13d4fec,57,41,96271,18416,77855,71,57,73835,27135,46700
94c98e0798a1137f82ed0230fb05e2b7,136,90,276303,55212,221091,126,86,219465,57798,161667
a6d43dafe17510adc52d110551fb2297,188,142,707467,153785,553682,197,139,627380,144354,483026
0e815a974aed6240a5aa73a17dfc44c9,34,27,9634,4468,5166,32,25,10183,3645,6538
1fdd805cbd497accee75feb1fd2496e5,4,2,587,318,269,2,4,318,587,-269
e07a60d4e81233cd2249c2ca316caba3,34,15,17994,6087,11907,25,19,15507,6677,8830
084850c41358794327ead06f0961d454,26,19,10624,3893,6731,30,20,15693,3357,12336
76542f03ecf12195afa6deadc1b945a4,129,108,309792,66747,243045,190,120,483570,54793,428777
c17aaa833335c174fba0753006c49506,108,81,184958,46216,138742,105,80,183660,66899,116761
209a9c2507d6ad2de5a030a0274ad47f,33,23,21288,6482,14806,41,36,36961,10889,26072
b41b95a252b7867654f1a9cbc439389d,106,93,269237,47762,221475,82,71,175078,78575,96503
f925183dc439ddea1374b4fa4b859ac7,225,135,700116,116605,583511,155,98,431818,108715,323103
4f70ba5dfe1003b5c0a9d6c680c5c2ee,27,20,13762,4339,9423,29,28,19879,7530,12349
d0dae5dcc48b6976db8403f6f09f4a40,46,34,63420,16088,47332,54,36,58388,20400,37988
0eae399bbf629c1036003f59437f0c19,53,43,87429,23196,64233,56,41,65858,22721,43137
05812f05410e88013bbe6e92b906228b,131,105,315300,77598,237702,163,114,294983,72307,222676
e927737e612569bad70b5b0480ff88ea,102,82,164017,35798,128219,120,84,194071,39828,154243
348f3effc82c968031800e6918391f0d,54,41,92224,27396,64828,50,38,91932,29482,62450
764c71c62255ab5ed6576f178194d56f,23,22,9050,3372,5678,23,17,7750,3614,4136
b814ab2785de25bd2f80dfd712b6aeff,2,6,133,750,-617,7,3,1014,397,617
0c126fae5b3e29ba1e0e8f1da6854828,85,65,93166,24404,68762,73,54,76370,24946,51424
7ae54db1fc477e9474ed1598689b8abc,60,39,78016,12523,65493,83,59,75317,25252,50065
730559c16fd42be639ea35af18d56be7,67,55,123628,36778,86850,64,58,129031,32811,96220
c9394585c3c784f87c87fb82947019af,117,90,269688,66365,203323,165,118,423823,69304,354519
3f29c87e853ea1d9421aacdd82484779,77,56,120971,35795,85176,110,87,196612,40346,156266
5481c67b017fb2c2d2380053f948ed1d,70,54,111018,31635,79383,76,53,115999,36061,79938
ca527f28f4ecbd09fd065bfa5f8cf481,13,12,2904,1339,1565,12,10,1869,1582,287
85878440c65f6f76aae78de2bbbb96ae,51,42,68736,26937,41799,56,48,73580,25959,47621
0bdeda22952401b09e6cbcb302a30b0a,78,71,92839,49950,42889,101,76,182552,27272,155280
c8d2221c8de18d3b08c3d661896b3db6,27,22,13897,7094,6803,28,26,13921,7435,6486
b4c81cd75cfbc01b9ade60d9a56bc8b0,143,99,373434,71102,302332,138,104,376004,71296,304708
1c1d5f3caf6cdc790f350f364d6e9857,87,67,157480,39406,118074,101,85,146150,41414,104736
671d43387338ed406926b94cf3819184,127,103,407905,90293,317612,140,102,409703,102161,307542
15bde07ca8b3932615e57fcf6251260c,97,81,216296,57711,158585,72,49,177295,46434,130861
a0f893df9914332c56eacc299c4994b4,207,126,667733,138030,529703,190,136,715332,126435,588897
808d647e9ee9ba1839cbe81e0b5d83c3,118,96,241113,58062,183051,82,63,130389,53150,77239
a311838023b86c77213cc4ea7c8780da,155,121,415639,63771,351868,148,119,348038,71748,276290
c3ac7f94bc2d963bb7f6ec5194339282,74,62,105627,37554,68073,56,38,105889,24039,81850
3083609bdb85c29d2a0f0b400d2a4e2c,163,111,629518,108830,520688,159,114,458926,150838,308088
8722b6aa999f0456c2b9a22dab76eb17,65,52,93970,19951,74019,59,46,55384,31937,23447
4c52a7b77834fa1ab546a020d18faf07,118,81,293780,46110,247670,97,76,190517,82067,108450
b90d656c92959c1d48cb112dc0f17a74,87,79,150431,61028,89403,88,69,144021,47181,96840
c5780df65e9ad1c799ecf52b8b22d26a,71,74,71934,27053,44881,67,59,87441,20325,67116
008a9cf772f25e9b073cd22b3296e41a,165,92,472453,83999,388454,202,155,667636,83859,583777
d67c1a9a2e608c285dab953a55a74ab9,126,89,274220,78563,195657,133,109,359634,68843,290791
10b1a1b2f852bc5600f13028ab26f0a2,197,128,920112,118587,801525,220,138,997313,189610,807703
a8fb639a7649fd93fdb31f4f26e90025,19,19,11733,7571,4162,28,20,15707,7940,7767
f9a2e9a74b862f4ad37e1e4cfb481531,171,117,535227,138811,396416,176,117,566815,114571,452244
1f34ef4575cb4c2272d52274eec12dc9,29,22,33981,13761,20220,36,24,41072,12974,28098
7b104390bc7574cc539a7b6fd319121e,122,95,288855,66920,221935,86,69,139399,71826,67573
aab8e75cf0037f82012115d42c747dfc,64,51,67539,29226,38313,74,56,108165,22763,85402
5a232dd259889085bbd836fc60bb18d3,161,115,497451,92234,405217,184,116,401973,127142,274831
878a04eadf27e08de0361f2d178ee611,28,23,19078,5451,13627,32,27,18682,7763,10919
054e8aa99c601c77d646dd6aeba612b0,42,21,51009,10320,40689,31,23,41368,13477,27891
bb77a37465c2f450eb147e687c72da41,205,139,962504,168179,794325,228,147,978707,259637,719070
744afd25ff947e9e9d228657cc2d7eaf,112,91,213893,28501,185392,110,88,182663,30241,152422
5206c06e8b70adcb0c92355cb6fd4476,156,118,467154,95973,371181,126,105,538218,106784,431434
824eb750bade8b8212c6f258633905a0,105,97,233376,66012,167364,112,64,152045,48602,103443
ad0e4fea18cd9c9f8ee176a6a029f615,56,34,60649,23195,37454,49,44,70684,24708,45976
7ddff7d7e3ecacc92f16b43fbe456af0,164,128,528421,130844,397577,141,108,517818,126083,391735
330879984d05bf14457721afd5cac2b8,28,25,16488,6237,10251,28,25,12166,7349,4817
40ebddd86fe888c0de7f32c1a4beaec6,141,107,245586,97246,148340,158,102,343684,61813,281871
a6eb0f89a94336f10f63c5d0b2090c15,32,27,13268,6121,7147,29,26,10000,5803,4197
ce1420fbcfc3785ce487f729ef392766,23,20,13351,4788,8563,30,20,15322,5195,10127
fe8ce31c78039b678796a893ce4e0231,52,43,65797,21278,44519,41,33,32312,21498,10814
a593a0090b75a2df5625df336ed591f6,134,107,347174,112010,235164,174,124,426488,93207,333281
c5be4987fb145b7d50ac2f7abc4b09cb,163,100,546566,83389,463177,185,159,671406,112002,559404
7c8c537b789f58c1f0a5aa2634584308,34,30,22272,8389,13883,29,22,16926,10281,6645
628ad467acfb17d9a0a00ca66855f699,141,86,650731,148901,501830,193,128,661351,135025,526326
7708d606885112916b6d5fb3cf173112,151,129,460364,127854,332510,153,122,437315,95799,341516
6f3a1be75985bb0b3201aaec0e911807,154,116,296081,64140,231941,79,63,163035,71610,91425
2ef73632eeb79a8727d19ad398762019,188,150,487200,100178,387022,146,116,418075,86342,331733
2d47b79febc7222407507ebd348116a2,158,101,494376,131166,363210,202,152,690633,83454,607179
87406ce56182f64e663813f90fe2fbc8,151,134,414130,78705,335425,137,97,390588,64146,326442
ab258d89900d8c3ef521bd9bba10f33e,160,125,400474,89446,311028,154,133,523127,93068,430059
0be18e39d24a7cad218642197463689a,30,28,14538,7296,7242,29,25,17132,7084,10048
d1666b53859c38febbbe05b1cbe86edc,124,108,352386,75371,277015,95,83,276101,85445,190656
613c7eaceff6bb55ef65f294b5c458fd,160,115,476200,77477,398723,158,124,454652,116250,338402
89c332bdb38b8bbd97c82b0df25eb0b1,6,9,1023,1128,-105,10,9,1312,1045,267
b8aba4a835a3294755045c49cf6b30fa,146,109,362073,100006,262067,133,105,368894,100532,268362
6716c411310d52f3297eeb815afad539,35,23,20796,6903,13893,34,32,20052,7003,13049
241e243d1076da43e9220ec369eacd02,78,72,153512,58524,94988,80,81,191361,59905,131456
78417ac4a8e700971058f896e6f7644b,74,66,106640,34309,72331,76,59,126566,27966,98600
4111f412d8302336df816c31eec6658d,87,55,173619,25570,148049,76,65,125289,42123,83166
7b3ec3ea91dd9b8961b00386ab190222,147,96,338029,92722,245307,98,91,205364,81432,123932
c6e5b22842e03d19394b809d179f051c,13,15,2435,1335,1100,17,8,2294,1379,915
9c6fa1c26b9085b9a76145ba1be1e34f,107,81,228928,50502,178426,89,70,203436,45697,157739
898264c11fb2fa44c3fba6b20d9b4214,154,131,453297,155712,297585,213,168,742655,103138,639517
fd702a619ba96d600987286941ce9788,107,77,160449,36915,123534,88,65,161135,38678,122457
5946dd0e729c7f38c60a14489d3291ff,97,80,223954,64543,159411,119,84,259220,44595,214625
37669f15d7b11c4cf6b1757255ecd7f9,82,57,167445,40946,126499,95,65,161301,50121,111180
c00aa93b3bcb122fa4c8edfe6af76cd2,128,114,279554,64022,215532,119,102,295042,47780,247262
4640c5ca74a43f67be29510787332da0,92,75,209815,60165,149650,96,73,232203,63777,168426
8749cdf51a0c682e9c185cd0f51c09ae,114,88,297142,94089,203053,136,113,367065,87130,279935
48140f0fe153ecce505a00c1267b2ea7,63,48,40655,19085,21570,48,43,60679,14437,46242
e82cf34fdb18fd58b278f3e8afa80539,71,56,93490,30852,62638,134,99,205959,31065,174894
0c8e5c6e9ea644f67338bbf14f478ef1,66,60,126365,48120,78245,97,85,174723,44166,130557
859b939ed53b801918a73f4ba056cf61,0,3,0,102,-102,2,0,120,0,120
25e1033b5ee99b506bbb2e682bdf5ab2,53,40,70969,22163,48806,70,57,84222,27442,56780
98bfed06ea5a9d3133b26665e6d4918a,158,138,403842,57590,346252,102,84,171024,48592,122432
f320b186e6ff19a2931a71e3d7007cba,113,81,219287,55375,163912,139,113,327311,63740,263571
1f8e024fb80e5d8318a883250356f0f6,221,141,858551,224066,634485,220,180,992700,239945,752755
6d1f580ec5609c4b90d5ba568a94bc8a,51,37,35831,13667,22164,46,36,30882,13644,17238
135f93469bba6fc013670bcaa7805a3a,29,18,8212,1517,6695,18,16,4976,2488,2488
37a3a272d781259500ff3497ad6d7af4,14,9,1853,1244,609,14,13,2824,1185,1639
91c1bdc008eef676ae252ccac8f9f175,50,38,57874,13136,44738,33,19,37304,10082,27222
5abbb0994801cc120ab58e36f50ac368,123,95,457813,63284,394529,109,88,251725,72832,178893
7c0d2ab47ff1b650b75b76acf5642bce,59,43,67972,24173,43799,65,50,83467,22096,61371
1aaab17bcb1f7471d78ab06f5d10f463,132,94,341724,64355,277369,168,139,548283,84646,463637
714de21fe449fb2c4c8dcd6275a14480,43,37,29355,12851,16504,48,38,43041,10052,32989
b2c11dd06b873d94c68e4d2a89ddf25d,40,30,42598,17781,24817,45,31,43382,13820,29562
05e7db5cbf11bb641f7094fe0699b6bb,230,163,1182304,220322,961982,196,131,898819,185506,713313
819a29ffd45cce6e8d83becb48564721,34,27,29975,9130,20845,44,35,29052,11614,17438
18401513969f6c9587b256e4aa787a0e,76,60,103681,30665,73016,92,77,144497,29124,115373
f218653d69df534949bf350a74a25d12,54,40,85228,33823,51405,68,62,93010,32122,60888
e68c302f1c8a63b7c7ae4354b82b346b,130,99,331842,85417,246425,145,96,367989,55901,312088
ab2e4a739662b9be9e686a54258cd1d0,101,79,270457,90731,179726,158,115,442730,68666,374064
1c7a7a214dc7f1b0cf6f0d959d2c7e81,100,73,150707,32555,118152,126,92,187621,44865,142756
a2fe7c0f27841c697aa16e9664e90b07,145,101,313983,71904,242079,132,109,360311,55617,304694
1f7c456fc1ae7c18d2720e56f0c026ed,134,107,330136,71700,258436,122,90,244321,76966,167355
802656432a5ac1b0f245206aac83a137,31,24,23106,10158,12948,31,20,25820,10648,15172
6fa0e86fd7424b52c8c0fa38794e4acd,56,44,54030,23433,30597,68,47,73174,21014,52160
e9648f01282f6c28db8b261a0e6b01e8,171,128,590356,107443,482913,130,98,345232,125535,219697
284263a91a8a6fc0c29c19d71d27f8d1,173,116,605667,96110,509557,176,125,564494,123586,440908
4a944a9e677a8a741492d9d3a91b1f02,95,76,294084,95693,198391,168,135,388121,108697,279424
be4e16c5858b03bf6eb78ffdd9b70665,39,30,34306,12481,21825,40,32,27791,13096,14695
a88c1ea116b1b851cc3a42d18d1f258d,120,102,367086,85882,281204,177,131,510360,79270,431090
48d2f84982c33dd74f87ae0138d9a4a7,115,76,287549,58891,228658,159,125,370632,61969,308663
5b3973d20fe26d0e4b2bd7e2d4d99f09,180,156,503160,82327,420833,85,62,170577,70472,100105
f9fd7dc8399c23e53b837b792a71e29e,159,120,544901,103769,441132,97,64,519027,120369,398658
bf2227393913dab6c2f2b9024c63279e,96,87,210263,49804,160459,94,76,138366,46400,91966
048c982622f2a05d195a19772ce4b473,117,89,285825,88232,197593,167,99,289163,57690,231473
3bfaa59486915f37cce70528d27e8735,54,42,65328,18336,46992,45,37,59310,16713,42597
0fa7fcc5e160fb232c57da3b465c1ae7,38,36,28396,15820,12576,40,30,49225,9447,39778
7b8e095e41f840614d73035afb28e201,161,122,404543,82409,322134,130,105,351458,75661,275797
2fe4d6cfb34a8e110ae4c1f2a32ee8e9,68,65,176582,34084,142498,83,58,107490,34173,73317
c23c96c5e3c68f62d5c857a07ffb05f9,165,101,393860,124605,269255,179,106,530375,80396,449979
2dfa31f0e2d8c687dcba580c7f6ee956,128,111,306481,46447,260034,117,83,201305,51484,149821
b3660f1db0c412591bbfbf3d60174728,73,59,66487,28045,38442,64,55,83802,23334,60468
b0e161eeb42483fcba75a38f6e7c9652,107,79,331898,102637,229261,164,112,456698,95603,361095
21f6d33c94c47a765d561e58248c6418,85,65,137841,57962,79879,95,67,164213,39572,124641
90f5a025fff08a4a46eb00803a7eec81,199,155,1176479,309110,867369,230,146,1070129,134883,935246
d12b578f1f6d1812f711cc1a14a0ac26,160,111,438385,101400,336985,150,95,370924,106206,264718
7f7e49bf768e06fcb22145aa0a4d0b40,45,37,51205,20254,30951,59,48,91555,20233,71322
bd9d4b5372b05de3e2ffbb6ea6fea636,91,76,222149,62355,159794,122,104,330835,57573,273262
1efff62530406a14985c5790da735f9a,96,84,161024,30022,131002,73,65,118438,36170,82268
64bfb17ddc3d35d80cb3c884227e0f18,34,26,16993,6970,10023,30,24,19225,8064,11161
b3202ce8e1ba75ebc2d5817b13ddbcee,52,47,28710,11705,17005,37,34,30404,10554,19850
2f08c0caaf7341f64d8b90b05aecc79e,30,21,28268,9717,18551,34,28,27439,12844,14595
da87cd7f4420b7884b8129058f5d9c27,4,2,514,191,323,3,3,255,380,-125
a52878e03b5353282474411710aa38cd,83,64,96716,32988,63728,83,70,124353,31678,92675
75f2cfcf343238170389e1d74c6c0115,93,84,148283,38426,109857,96,72,162887,49450,113437
b30cc10edd65c771ad61795252051688,28,13,12986,1430,11556,22,19,7959,4335,3624
cf7dd42553bf071fcbe7265df46dcf33,63,46,65149,18057,47092,64,46,78431,17293,61138
73a4267abacee5c5b9081f2306e2e756,104,85,288983,70357,218626,118,77,257870,87812,170058
83150cae0fdac6f97db41e2a4e680e15,92,79,174881,39194,135687,78,57,115585,39089,76496
c99489d8680a748c762a4e26b2ec8c9d,58,56,71242,21314,49928,52,34,36455,13340,23115
bdbaea19702d3768eb1b00191bbda168,71,61,101414,38777,62637,77,64,133082,33777,99305
503bead5d3eee8776c5026079f6b4263,0,0,0,0,0,0,0,0,0,0
2864c95648db0ef7f520faea4147243a,139,112,248532,58878,189654,104,85,228459,55308,173151
557143337f404ae33c8af71b65478b79,41,35,36805,10165,26640,34,23,23203,9843,13360
316b5f860e377472ee3c2e02410eb878,152,99,286628,80909,205719,128,83,262764,66768,195996
f611aa9a188fa628dde40b1b09af559c,55,45,73697,35082,38615,81,56,130535,27898,102637
0edd90d28b0b6c9be8c7adc845df9805,107,82,228735,35312,193423,97,89,201577,57642,143935
e40f0355a935db522f780767b9c510d4,143,119,323643,116446,207197,159,104,422679,73139,349540
1fcd949ca77e5f7778c360218438e46a,187,129,667420,114367,553053,154,119,477550,130936,346614
77d77363c2ac5b8f3409d7e367c65616,42,30,36001,11257,24744,33,28,23259,11651,11608
dfd46d8b4f330311fa853d2ef4e8c6cb,164,123,427918,103282,324636,171,134,682103,94906,587197
c1a392a4dc16013d5cc55fbb5e3aad52,23,18,4785,3362,1423,23,18,7238,2392,4846
47622a03a39467dea4d590ca6963c9c3,72,59,129394,36060,93334,65,50,139259,37869,101390
14e1817fa7cc51654d796dbcdf4cdf22,62,48,78799,39954,38845,85,61,117133,26249,90884
1d3b686259f1aa5ce9d19e10f2e94c22,182,131,704804,186919,517885,203,129,688653,121204,567449
b3ae7d65f48c5fb02c1b155a931e35af,71,62,89418,28200,61218,62,44,81388,25285,56103
98f0173abb32d1b81082a9d2e29dd2b3,50,36,61387,19766,41621,42,43,47234,19950,27284
c0f139f10dfd08c576ed08c535cfb2e1,95,81,172570,48224,124346,99,70,178353,33534,144819
b0195820448075faf90fbbf37af44a50,30,31,19834,11726,8108,46,31,32911,11744,21167
0b65df58ffe2d5647cfc86f621d007bb,21,18,9313,3239,6074,24,19,7038,5592,1446
52ecbf30d26f4bbb1c0fa8cdb1b22dfb,88,72,226646,62608,164038,142,111,461601,69589,392012
0f353bea4a6d8567872ea420ba8bd0b5,50,36,44140,9867,34273,52,47,45047,14606,30441
03e667958f4367451b944dac79a38774,49,37,38788,19572,19216,59,44,58009,17215,40794
1fbba77d6dd36f77d3d02e766244346e,24,22,9728,3867,5861,20,18,7594,4281,3313
78f0b371b1e132203df0202ef9e9c964,127,95,240505,31367,209138,77,58,104896,33006,71890
477938aee74614ad9cd9d6ec150c4d53,54,35,77704,35829,41875,57,47,95239,32873,62366
0e80760228dd093a1b93b5ef8e02fa3e,131,101,294735,61090,233645,115,80,262713,57338,205375
8d2e7bb3eb965ea9ddbbc48255f03c89,60,48,82894,37953,44941,82,69,129548,41084,88464
7d7e587e0f7b7d214b2c8dd4cd3e4041,77,64,118979,54850,64129,72,58,142389,42585,99804
20106ddba1f6c544d59cc7fd7d2f602e,44,38,72620,21885,50735,44,34,48182,22885,25297
2e539ffbeba983ac1b1b0878fea5f5c2,176,128,439940,113647,326293,132,98,333545,98290,235255
d76a02ac50bc00665ac866a8852d4bd5,31,19,33216,7085,26131,29,25,29988,11363,18625
68f8ed2e586f8e013b13214c3c12ee64,206,117,454511,78046,376465,148,109,345290,157243,188047
2a898d4daa07a00e5c0eedfa7b826bfc,34,22,21927,6242,15685,35,29,25057,8459,16598
7fbc1f00a2a582bd20d442969bdf29a1,112,81,216150,60444,155706,114,77,237783,68880,168903
3b69307bef1961d1abf859f6428c3f4a,194,129,554840,139340,415500,228,131,715465,118054,597411
8784f71156afd3d77a21553ae1c54fb6,13,10,2794,2276,518,17,14,4908,1268,3640
637e72336b21517d835bad5ab6af6fe3,157,122,393089,103717,289372,169,132,415981,131572,284409
8b4a0e7f1c50eac225026799d31c606b,51,45,48320,20978,27342,46,36,45666,17343,28323
65cb669f279deb8e8d6f0f0253090c80,138,104,393797,79085,314712,154,122,358691,88020,270671
d6a034a27f3ba65dd686c4a92ce90c93,51,45,53117,29654,23463,58,48,83014,29569,53445
61f4aea222a018933b8e977f30882dbc,72,64,115042,29164,85878,80,64,129627,36519,93108
0ad4bec25b249bdbaa35d45dbc3ad21a,64,43,66590,15124,51466,70,53,89260,14461,74799
12759b826043f58a574743ae1e47125d,116,81,245027,45444,199583,101,76,141418,53937,87481
edd424e2cfd5415599da4d0938526a2d,21,18,5679,2695,2984,22,17,8924,2937,5987
1d7edb91a7fa867fb0c751929ddb324f,36,28,23671,10694,12977,42,30,35250,9580,25670
d1c0ce10b68472809a52cd2ce3f8a0e9,167,114,399722,110680,289042,182,140,596420,94471,501949
746162223ce0f7ca011b8f314660096a,107,81,162552,38090,124462,139,96,260349,30073,230276
f71294df07620bf376ff669a2e297de1,56,46,55583,25360,30223,72,58,101403,20349,81054
06da77f722017263341e56d09c9bac11,69,54,94511,16438,78073,66,55,80447,21235,59212
8770afe65b25b923ad217c74cad57ae2,104,76,272074,47400,224674,100,74,190405,61259,129146
9e356d3e559950080246218f207b737e,68,58,113445,36590,76855,87,70,134458,42078,92380
1a130bbded38515bb961fb0fb8b44711,137,98,368402,110471,257931,196,119,485859,71525,414334
dfc0bb8117c3b098b7bb91e0a0c3ed37,43,29,34773,12681,22092,47,37,39360,15809,23551
778ccb26fd8fe9ee9b9070a512e3b28d,155,131,421688,84751,336937,138,115,373296,80625,292671
dcca52fd08d1ce69d853b597ffb780be,21,14,2596,848,1748,17,12,2854,1201,1653
44fd3ca4ac64cef2e06e174ea779266d,46,42,66195,21322,44873,54,45,67028,26275,40753
d7d01486d3582e507263ceddc1c851c3,146,119,361790,52590,309200,119,92,252172,61535,190637
584e86dad23aafc0eca1f132e6d087bb,120,90,306289,83711,222578,118,90,237621,90586,147035
e3ba668d9da8938aaccf41a894acafff,42,41,53418,25395,28023,58,38,71216,22209,49007
16049a6b4f1e428e68bc443af1b2e2d6,36,33,22756,7598,15158,29,23,19009,5746,13263
a5afd4567db9b259ccc1ff070a1184a1,57,50,58334,24985,33349,81,66,125475,27837,97638
2933e23fd08ed0a80d35f8cb8e6c1164,79,72,134704,33553,101151,85,75,133431,32964,100467
3597a2797a4efbfc6905d73af875ab2d,167,112,462208,56866,405342,84,75,164041,80695,83346
3737eda52f224ca921dbe207bca37994,104,80,216839,41994,174845,104,88,238636,48071,190565
260d9cc0afebf3c6d37deec00218c028,103,75,174639,34230,140409,126,88,185618,46139,139479
18a48f45c8a960cf88ef352263795f82,146,106,288239,55618,232621,174,118,366782,48717,318065
589fa8273c46b7a8e8ca44f7e7c3f2f8,162,111,595000,80904,514096,174,131,549500,83548,465952
c48c6bde980e2a0df47105b2335716e7,31,33,17365,11797,5568,44,30,37749,10373,27376
34f9758d91762f63201af26ee895ec45,99,67,172981,41364,131617,125,100,302593,55061,247532
3bbf718ceed9fe2ecb5075dd37471cd0,87,68,138138,38858,99280,73,61,114606,33781,80825
665aabc07cf715ebbd81673e0bba04e9,45,40,53982,16733,37249,49,38,40676,9743,30933
33f5d953130f74bb1703d6cb39484305,112,95,199899,72383,127516,144,96,262444,66304,196140
ad3e61bc34efd6a7d3bfb65f910af73d,166,130,580470,116223,464247,151,105,506652,102617,404035
8bf6cd21f116b81bb5fb2b76bfb3db75,47,35,63826,20073,43753,66,50,90967,21105,69862
b4aaf3c69de54a323cac8e1f66a41553,108,72,212295,44074,168221,158,110,337178,41384,295794
034fff1be8b7c2d556a48816ef851d72,14,13,2840,1216,1624,15,16,1852,2031,-179
7d984950109ccfba2540b65c788b173a,72,52,121431,31638,89793,89,82,186478,44423,142055
8cf3ee81a5909a6a6a899272d29f4bd6,99,86,121822,64726,57096,134,107,223706,42183,181523
b63d0cc63235ce413a0c7a47b5792716,32,28,30011,19998,10013,47,35,51282,17614,33668
7b066b990d592d5fd8547e465f3e769a,164,119,554015,120859,433156,183,149,685768,107752,578016
1a084789b54de13c029986e3d1916112,45,38,63221,18222,44999,65,50,76710,24416,52294
71784979ad71f3b9a5e8c0e3505ef2c8,156,108,373810,66716,307094,172,138,414468,103288,311180
4ae6748f09f20df20152ef682d3f6e8d,139,112,362266,83481,278785,142,122,471647,82892,388755
d3fa10a6fb1d7379a5a6d754c509fd7b,60,42,75728,29130,46598,71,61,79985,31685,48300
9764030f350130bc817a8f125c942586,44,43,57233,17222,40011,76,45,74585,15624,58961
5079bf42c8de9bcdbca665db5c63aa43,146,108,329371,50266,279105,114,82,250397,61734,188663
108d54b94d549fd6abb90a039f5b1cd2,41,24,36138,9841,26297,49,46,54481,16970,37511
6435646e1e64b142a4b77166ca57e994,112,94,274379,89147,185232,127,109,352838,60573,292265
f06a5ce0b1ae1ddf4441d4d1c6a97def,15,14,4545,1264,3281,15,9,3547,1076,2471
5903588906475865ede091ccb90afc8d,130,99,290828,46980,243848,126,111,264297,74097,190200
b4292595600fa9c4f9b2edd2a3f6ab36,66,54,58851,23436,35415,41,42,58826,18496,40330
442573aa64f272601f5d4e3d3359a0d3,37,31,15377,7602,7775,26,21,13257,7171,6086
d212a1e7e2cff80fb48fca80605cfdb8,25,22,17416,7943,9473,28,17,18019,7414,10605
5b994e869e9f300d01d7943a3e1373f7,73,57,119985,41012,78973,83,69,141775,34581,107194
080baacbfdce0ee229f5c5dac0f13691,114,99,308160,98471,209689,113,86,367947,54503,313444
5207e786aa0a0722a7d243c8a77f581a,94,63,195401,42639,152762,69,54,100009,49807,50202
861cc60a206fbb0ff4ef4a301e14ca66,144,104,390231,98822,291409,148,132,607582,87572,520010
32cb14984ba7f1f43ee1c342f317119f,218,161,1093228,268095,825133,193,157,1127524,235961,891563
bc6d2bf3f711315d03ccf050c015b6b0,125,99,277276,101185,176091,97,72,308333,93002,215331
a35c3a60cbef5965741ed4fc68c1b232,95,81,149261,41661,107600,106,82,172748,42444,130304
079a7081e49c9dc4de8afe1f9c8aa640,65,54,89829,24165,65664,61,52,69165,24794,44371
ef3b11778be98b783eb597e86c16fb02,143,101,372156,66929,305227,175,141,493973,68066,425907
d50533fe382ef396f5375c937adbe743,102,78,142774,37566,105208,74,68,119294,37784,81510
f682881949439478930a654e7ce004c3,30,25,26318,17903,8415,34,22,35536,12099,23437
db06ee7e59f9ed221091cb11a069cf79,14,16,3593,1741,1852,16,8,4020,1463,2557
f3c59590f7a5c3987c369f9438023713,155,122,413749,86686,327063,185,130,461831,73695,388136
7b081ae464904aaabe41fbb9450deea9,85,57,115550,31716,83834,55,37,82133,34820,47313
851e1f69eb7479e7c76d422301fb2118,122,105,404414,98197,306217,140,134,549429,97289,452140
ea0bac813c8df88eea8a02acccc68c01,66,55,107833,39781,68052,72,56,119794,35141,84653
17a8a11c9b4fcbcaf089a0230fb47144,134,104,260716,101100,159616,120,92,289184,49266,239918
c68c6775c24773c4ab81a34ff7d8df59,128,92,209360,65020,144340,133,108,237616,56546,181070
7b3bc049de1e695f5b58f51584cb38d6,176,135,888011,176797,711214,194,132,977957,199674,778283
bd7e0c54d9d9d998eb6a04863b91824e,64,50,89643,37980,51663,76,64,130964,35073,95891
049ff7c215af58c98834d74dbb5aa222,138,93,351756,81971,269785,134,128,394927,85904,309023
17404963d47d9697c604775ee673b7e5,45,49,59807,26953,32854,59,42,67338,22293,45045
fb2616e439eee95624ebb0996c0066d7,142,102,479236,102262,376974,143,113,433931,101139,332792
55e6da243c28439b2c97bff1cf93b3b8,39,29,29058,6353,22705,31,29,16506,5286,11220
261f2e0fc70a8ec1fd2686f782e4b699,22,34,15749,7766,7983,36,25,16999,6495,10504
922d3e59bfc8d5ebaa6c735a5affd821,35,32,34118,9684,24434,27,22,17089,8938,8151
7b845adfc2f4d9fa114512e13c6ad588,64,48,90374,22007,68367,63,52,89672,26845,62827
e207eeb79545c7fb0e632007a97fe12e,179,129,542349,237356,304993,165,135,725029,147057,577972
e174f1f0c53db8851aef683948c60ea0,147,126,374558,120483,254075,169,109,512607,86045,426562
47ac515f60da5be370811eabb40d03b9,50,33,67989,17691,50298,65,49,74264,23322,50942
e722ed1f509c93316b418e9c369ef7c6,113,97,228438,65853,162585,113,84,291217,65559,225658
c94bbd17dad00de6c50772c360e9d620,44,38,46660,23223,23437,60,36,70401,19906,50495
0f104d246e12bbddad946348b84749db,52,30,57805,17367,40438,35,34,42517,23486,19031
a62e7bd29854765b11e57c2905703093,95,69,175252,54829,120423,127,97,324005,55478,268527
6832a664ed70e00af7b31a1856182c65,176,138,809205,100344,708861,169,121,530243,109076,421167
ebb97cf3f423422fb1eb46fb81c744aa,101,77,131260,24638,106622,100,69,96347,25560,70787
21ea5fbc32b09482dbdab08e2bb88e2d,131,117,184537,49049,135488,94,80,153855,39746,114109
3d5a03ff821a1728bc366231fc9b3fea,24,20,7861,4011,3850,20,16,8277,4102,4175
73d64ded1cba5f748a6faadaa6bda78d,98,80,190754,60635,130119,126,95,255163,43579,211584
dde3080d5126850a21e8d9f3d8046831,91,65,150805,39576,111229,71,53,95398,43004,52394
84c12b38056360b0a14a5d6a7c795e1d,26,18,17692,4497,13195,28,18,12445,6288,6157
627c6e05e6a79f87a0200f41d3d45539,160,133,349344,70065,279279,113,88,220184,75663,144521
0a46e0b93f6fae788f5377bd9e1eae2f,55,48,112596,57039,55557,94,66,223134,60455,162679
6d80ccc8891a104297fa5469659a3380,144,110,390474,80561,309913,156,124,403915,69469,334446
ea5ba6f8a979565ea990d414508917bf,98,71,172501,58960,113541,91,77,149288,51264,98024
3fcdefe8036f6951c2a6bc7f39a36e4e,67,45,95258,17306,77952,45,43,56304,22268,34036
7a8d2ce9b9ccf87b47521c623fae4d0f,164,127,384300,107596,276704,175,131,514337,85608,428729
abb70110822ba697241aed28b57c2a47,96,83,215246,78697,136549,109,76,207678,79428,128250
8349fc9bc3dd579e56f999a36db980c8,21,19,6503,2820,3683,22,18,6437,4073,2364
efa4ddaba404eb377e2442b15af98f1c,175,144,469755,97322,372433,193,158,598280,75665,522615
2997e16035a547a7f1d732a0975429e8,83,65,103913,35241,68672,99,79,138687,33727,104960
dfc6f4cf09265e12296c2c089ec942c2,73,70,103466,33832,69634,49,30,86065,22593,63472
1b6383e3becb6542ecf320957c817f70,148,125,422238,110118,312120,168,124,420904,82453,338451
08255afb0bb2266aecf2eb10fee70a37,153,98,461612,99094,362518,163,124,641717,122931,518786
3ef83aa2b713d8f380112877bb352f19,53,44,78212,27643,50569,41,33,70378,26353,44025
fac8c0d92b6feed983ec4ee4dec79003,60,39,61508,22109,39399,48,39,91210,18521,72689
81c9fac84c97301978991dc5adc0f3d2,60,44,85566,30711,54855,65,52,103252,32638,70614
1c266ec8b8b7f6dbc7e5cee26df5540a,163,95,382708,48157,334551,115,86,237470,59766,177704
f6d6ccbe736af9e59b84489c9b2eef16,31,29,28975,12376,16599,45,31,36095,14722,21373
dc9cfb384b9719f31e3028282fb9a7d4,168,133,517897,170184,347713,204,169,710606,139832,570774
2704499d506984c02ae966eb1c229f58,36,24,34105,11389,22716,45,38,40642,15405,25237
31f88c3e6d551b356e869b743fac125a,36,27,67810,24108,43702,33,24,55131,20339,34792
5291c33d7a35f9ee3c59fc70039aa0ad,42,27,32491,8672,23819,49,33,37969,11332,26637
78cbe2a1ccc3f0c10411b19e0a85bcd9,152,126,416407,150875,265532,149,129,493316,145225,348091
72b33943144699c67afdf24c278c8052,28,22,23674,5763,17911,26,15,18483,5701,12782
b7e5aba5bc524581993cf19d0526572e,21,22,7079,3915,3164,22,15,5753,2302,3451
de95f6f70ad339fe28cc79e1b4f6bffb,40,27,51292,13457,37835,33,26,37928,15685,22243
a5b6dd8f0e24ab9ff03ec80834d9b2ea,42,33,65558,13849,51709,27,26,35394,17096,18298
ec273fda9eb6a01f9f85c627eb172595,89,73,190177,34338,155839,80,68,138251,48235,90016
a5ee7f8e535c58c4c10269097ade0097,66,55,98052,29261,68791,49,44,79436,29147,50289
7308b439780313b4b6ee48b96843667e,124,107,285746,51736,234010,105,89,234072,38381,195691
e8c49fe23b3200bf8ab045429b58d325,126,94,327942,98758,229184,168,104,375610,102031,273579
b3108ee3cb71c9b38da17a17c9c971ff,112,105,402228,122788,279440,174,144,623479,113824,509655
fc23fce4c1c7b8f6bbbe15cda5bfa9e7,30,24,16549,6422,10127,28,22,15877,6201,9676
93d4562b3121576db8c2018059bbfa46,75,54,120220,29043,91177,71,51,92565,22275,70290
2bca3b3545644df2a368e20c681dedfa,120,101,307699,80582,227117,129,116,345132,93142,251990
4db54fa5231f548fc994ec0c9529c655,4,3,280,238,42,3,3,238,168,70
e1cf74e88ab7eb873f9337c326422f33,168,118,406247,124858,281389,126,94,341649,115230,226419
d2e45e7516ff83da518a0d2bf69c4b52,84,74,138454,36080,102374,84,60,98564,23737,74827
843b2093e122e0eb1cf4c3497d8a6887,137,108,318304,87825,230479,136,115,372007,74895,297112
52d7f571ef3e88f4d0bd6e2e98d26314,87,72,168416,37683,130733,78,59,140366,28764,111602
92ce3b0eb2af94369fa52328baec7f03,70,59,116654,34019,82635,70,60,101250,19788,81462
2ffc8b4b022e6b230b11f5cc377b9297,51,38,57472,23998,33474,52,34,67709,23340,44369
6897050fd0d1cd694d29fbee2d16af32,112,94,257018,63799,193219,143,105,364679,85988,278691
3ef169b6bd160f032ba178433bc2d2f7,174,121,350599,98938,251661,159,128,397505,104541,292964
dedd2749def6d1c58ab641993d8d2a4b,27,23,10158,7504,2654,27,21,16499,4878,11621
277ad8dd99c78a213c43c1b2547021b0,23,20,9406,3480,5926,21,15,7906,4254,3652
2ed1a65f2f3754c5a1aca4e8a7daf3af,29,31,12768,16096,-3328,40,25,29937,5491,24446
d4cea933526ee62dbea831da1f439ab1,64,45,82230,18716,63514,59,47,77426,20239,57187
151251413f5fb111b18202fc9f700bbe,4,4,362,335,27,4,4,335,362,-27
2f94f9b1becdd6d4ab74a4d618a61320,86,54,119545,33363,86182,79,58,114698,35142,79556
84a4821b89dda380c8eca86f5183dd3d,55,39,74383,23634,50749,54,40,65687,23447,42240
8b318034e25a04d303a9c3b004736055,83,61,134380,49530,84850,79,72,194760,41122,153638
31007f00e8d48186de53cade0ef8de25,182,133,508644,137054,371590,180,122,444323,113509,330814
a80d2c6a8143aa7e988abb5a98aebf8d,208,139,597107,107898,489209,145,104,424613,146343,278270
e2c3defb9aa030d9605ee242cc2ca4f6,12,8,1152,309,843,10,8,1323,617,706
4f669e2936949c9edee97c32ac29f3a2,62,42,97535,30775,66760,45,41,89256,34107,55149
cad0f7990df8ef05d39903d5c8bc75c1,56,42,78586,40972,37614,86,64,165729,28176,137553
590e274eb527b4ea5c459f59f9ec1aa4,118,101,318269,76527,241742,94,82,188387,55122,133265
7c1e5866088194947c00a38aa58736ae,102,87,290176,77376,212800,122,101,313133,73223,239910
5ae33bfded751bd21c2f4586f2032507,34,27,13237,6375,6862,26,26,18032,6002,12030
af9691e65198d58f80efbfc6a371a639,155,108,348608,75508,273100,119,78,313556,70914,242642
f18dd0612618c9049269afe52908ec13,96,74,182504,33264,149240,75,69,125377,40539,84838
8088aa5d659d038ba0a396966475e6de,80,60,100749,37467,63282,55,48,81554,35760,45794
157d1ea1853553dc6ebc1a099a6bfcfa,51,40,51171,24053,27118,44,40,45370,16553,28817
28bfe7553c3c1c0b83e886dc7ef56512,17,13,6300,1785,4515,17,12,3583,1396,2187
41b3f324f52de61eac8ff373468f4440,28,19,11972,4270,7702,26,21,13321,4491,8830
63db6b9375b2dbbbe0effaed76859684,117,89,275844,70599,205245,107,76,266218,58469,207749
558e83fce4cb14e1de5d04c4f4cee54d,102,85,178220,52939,125281,116,94,178314,49936,128378
fdc071ef38fb7d1ee5ee5af071c0ac84,10,12,1188,811,377,10,8,1575,824,751
0de34f47539f6fd007d877283a4c679f,155,132,574431,118763,455668,133,97,447282,128274,319008
47a00181f663fa85a2887f00ce88d13e,156,89,304594,71691,232903,162,115,395418,84910,310508
fcba43264af7d76ec0b977df13a85fca,151,103,497182,130160,367022,146,93,480173,131396,348777
d96fcf2a0ac3526f176dd7bcdb21c9d6,149,114,540991,76456,464535,175,139,599495,155104,444391
fd6be8212c79091a95e84339e89466c7,74,54,100487,24735,75752,82,71,94691,31921,62770
259cbc4f4eea36e7b37ed879446d1cc2,23,15,6450,2963,3487,28,18,11056,2812,8244
38f718dbca57d12a0eee549b80bd4578,193,135,705045,174501,530544,175,135,648721,137320,511401
3e86a580bfca734f8c1be90e6bf34cc3,44,31,31500,15324,16176,46,38,39702,12846,26856
8320863ae10370c18e417ac6ed54b223,125,94,276298,83086,193212,160,123,465665,67667,397998
53d543b893ddbe503ee98835640e15b6,41,32,37925,14996,22929,37,34,49060,15191,33869
36761cd95362f4f959b38e674bd51258,140,110,542350,113863,428487,173,158,556793,89019,467774
ea6a2bc7399a0dbd214ff48b1d97634d,93,70,138294,36851,101443,110,95,233378,32751,200627
1743d17fbdc5c28d30169a73e9781b76,46,39,72689,28758,43931,48,45,93507,26308,67199
6dd675fc9c95c8cab7d7f89a6b684c8a,73,70,166840,46946,119894,85,70,185330,43159,142171
33cc6cef44723cab2f5a5819e20a18ae,205,145,1179784,222819,956965,203,141,1370220,197784,1172436
8c4ed43f3c26fb3a0c6505a8c25dfb12,17,20,8975,4016,4959,28,20,10662,4193,6469
e6cbd4effeb0ec0a2afc7ada02c844b0,19,12,3840,2048,1792,20,18,5419,2259,3160
0aa502b69aa2eac07148286d5a4edc9d,31,23,25011,12416,12595,41,33,38084,13163,24921
6dab18d33c4e298c6234faba7305fe47,41,31,37251,13587,23664,33,22,30191,14088,16103
64e3fac17eaed7fe2f492d333af742b2,31,24,20246,6292,13954,32,26,13379,6631,6748
67153e1bc0092e5ff76c7fa8ef10b739,131,93,244690,67964,176726,84,75,164756,61227,103529
1eb3262461cf962383fa343ca7f3134d,52,39,64537,23531,41006,50,43,72781,22655,50126
ab1d8f9d0b4e5f99f7fc340ff8b60716,140,119,471458,103812,367646,147,85,373739,71580,302159
5af11d41ad50ee6acc000bd3a35417f8,83,64,118254,24300,93954,78,67,93375,27433,65942
3694bf6078280a8a0f7b335ac88fa05b,58,38,65621,12954,52667,38,38,44232,17749,26483
17514ba2fa60583c85218b6b36bad545,44,43,55560,23419,32141,56,45,62032,28874,33158
f2857bdaa7e5abe557053c780e9dd94e,163,121,1076212,152856,923356,226,185,1200370,173918,1026452
7f14bab2d3bf67c000b348aabacf3394,14,15,3681,3198,483,24,14,4932,3227,1705
d3c49b96e7d36b4afb6d850e52d14097,39,32,34113,16097,18016,41,24,33604,13922,19682
647fed134288f713a69dd1c8dbec7b49,63,45,62786,16800,45986,52,32,54925,17118,37807
50b2c441be73ba6e86b596c739b82208,0,0,0,0,0,0,0,0,0,0
b71af98287694bd4a9ff777ae4f308ed,53,37,63722,28985,34737,50,38,79751,21283,58468
7fc10b09c86fe7818d21967c39e19257,1,2,71,134,-63,2,1,134,71,63
1435e9dca6d30f8437f0cc05e03d8883,164,131,618265,72510,545755,187,155,681148,84046,597102
c5c17039aae1661a6d564559f0692b50,93,69,133545,42558,90987,66,56,85332,46193,39139
1f6c2052717e15fc7986f3e16c7c7f25,62,59,95748,34067,61681,72,68,113902,28975,84927
eacebc2fb6ea73d11fdfcf1ba3eb4019,157,128,423590,102464,321126,90,74,241470,104864,136606
56254e0593d53e0e439cea4b5f487a23,35,33,24571,12215,12356,44,26,26563,9398,17165
a7bbb45c180384a464d104b33cae62af,21,11,4047,988,3059,14,17,2659,2333,326
0bb8d33beff03f07fc470e6a92a5899f,56,45,72269,18913,53356,71,47,65564,23488,42076
24d08ccf9f06cce9f22151f4d3e856b4,148,109,458087,137164,320923,160,106,458431,132853,325578
0ed5df54a176d9f95f742259a7e80c9e,31,24,30275,7884,22391,23,23,13302,12062,1240
62809d548039144db4c3ad48bee11130,63,64,112154,24054,88100,48,35,64424,24115,40309
a8188e948ced7c8444ce07e8291030fc,92,66,194744,89393,105351,138,106,271525,104656,166869
c06139fdc1ba4c9eed70b8e9390e68d1,61,37,96790,36003,60787,59,49,94053,32225,61828
b41d1101e3f0929b2993d55ff75d6d2e,207,153,783583,280320,503263,192,145,958807,185502,773305
ec844375bad7b1719169b62689e93076,101,77,179151,46221,132930,136,102,287233,42577,244656
8c677e56cd1e2f02a51f49caaa4c4687,170,149,659903,220651,439252,122,87,445940,125402,320538
73158b12a150e3ef1f81152339ba2239,132,114,373058,122935,250123,142,103,457701,91565,366136
48e573509f543a7233fa4651bd8b1f7c,43,30,67078,19028,48050,36,27,54195,12470,41725
be733a02c869ee44e0f4062b61f6e260,57,46,79570,17448,62122,50,36,59512,20703,38809
d1a8c2f2748ebb24a07889045b9011ea,97,80,153481,30475,123006,97,83,122279,23226,99053
76086370cdd72b1b915cbd8730ed019d,181,114,573073,72181,500892,150,114,462120,97524,364596
5bc118a0d9f9b9287bbd5627e87a3998,55,39,44435,19739,24696,64,37,82062,15069,66993
12443668a27b0d8db4951c74f4cbc2ca,65,47,57995,16160,41835,48,35,49243,12545,36698
199d65dad4b6758a338ffb4f1a7ba663,88,71,136415,43877,92538,94,73,202869,37457,165412
099332f4aac6153258396b7f20266b4f,107,84,244700,56365,188335,122,85,192678,46951,145727
efb1be3684ea35d850aeb4661d056add,66,42,76454,27096,49358,63,37,68180,20048,48132
9b6408904414b403652d0e00f32b9454,102,87,234087,65192,168895,141,118,367819,77356,290463
c715e7170110ac4e2e0ec306ed14f186,43,40,63735,25105,38630,63,49,66597,23562,43035
90cca3395f7d206ae0ffcfac7229caf6,143,89,275517,64447,211070,162,135,316247,77239,239008
ca36a6c67fa9a51f6f29c23f5ed36c9a,25,23,22100,12111,9989,26,20,28878,9208,19670
f3cbbd090e8748131062313e31f6f5a9,76,76,96798,32419,64379,78,59,98633,20946,77687
256bc6c476a5f8d529748f975c47a5a7,125,115,306472,81844,224628,131,93,320635,74175,246460
08451875bd9d5b959f1cbb7f17094d99,154,96,401922,67382,334540,211,148,490512,77961,412551
216042f392670d37a6632f659aefe326,21,16,6115,2263,3852,21,15,6239,3333,2906
8b0ac76466d632239e45fb1ab8a2cb80,166,116,739727,101341,638386,160,123,614205,120895,493310
d45190e2bcbc0a262769fbb92f23bde2,192,143,660477,144492,515985,169,130,619460,172703,446757
7eba218a8a3f01de9d0a1f2beb0ccfc3,59,51,65153,29866,35287,52,44,51495,21007,30488
6d9c0b3d0f2e90689e3f422e37585843,122,110,303110,89521,213589,132,112,335368,53123,282245
c827845f69b074d1d3ceef5185e69657,92,75,166057,51904,114153,88,72,171777,54532,117245
4f128419d76fe91add77abeda83f451b,164,111,450684,125153,325531,96,71,282236,122282,159954
293a6ddd8e6a75c7ce13ddde8b8d2460,140,101,224310,83753,140557,175,118,302987,62642,240345
818c0aa087cf8486a2b1e3ffc22899c4,105,88,222728,58014,164714,125,102,291438,65249,226189
ab049b9fa00452364457aff1bd0c8beb,51,46,73913,33222,40691,57,41,112105,28410,83695
676cda4f37c551c172aa4983ad6ac6f0,81,65,118427,23754,94673,73,53,95490,27890,67600
746cb5a33b60c56aaa782f9dd382dcea,193,135,556536,112556,443980,176,153,655581,142455,513126
e5353763c6f36dacfd7c1bfd3ba3b588,78,64,103388,28999,74389,87,66,128805,23294,105511
101f769f11fd83ea64eaed3e1703545a,16,10,2195,1108,1087,14,11,1831,1635,196
ad43361aeebf2501355618cd4355dff9,50,31,60852,12694,48158,44,38,41041,20568,20473
2a2e4077b144b6e61f6fc87d12db29e9,93,71,124232,44128,80104,105,80,230713,39664,191049
463152b818d7ec3d57af8933cad156f5,70,52,95295,33881,61414,105,88,156772,51131,105641
534ad704f133fe53e60de68bf602d2b4,157,126,547136,123958,423178,166,122,480143,125545,354598
e44d71e80c97f2a615306dda0959e1e9,172,126,513854,114608,399246,179,129,645864,98205,547659
c876456b2c3ab1b0d759d7d188787c0a,155,106,668133,156105,512028,166,125,688787,186604,502183
dd9ef736c631a901ba36cca2d52e8bb6,98,78,196854,59061,137793,123,84,234044,50838,183206
2c36a2a3ae87e888257a265c34e6bde2,130,109,331587,109327,222260,139,119,347189,64659,282530
25b09df9ee8fbda5910e51ed2030edaa,109,79,306649,104591,202058,130,75,370185,94027,276158
76d1e071565131f703d377a6ed238390,51,40,55453,16542,38911,69,57,93976,17798,76178
dda5e332b7f5bd0c0f7443696ada5e3d,184,127,651698,119468,532230,165,104,613012,122872,490140
a2807e8dcc37bcfd186d0157e185e763,106,93,227329,56386,170943,160,140,409831,43537,366294
bd7b7e3f39d6285e098fa79d915f36d6,58,40,54448,13354,41094,53,33,47686,12190,35496
119fa2d6bdcbe4867e634aa48a33917a,50,45,88780,45805,42975,60,45,111769,38071,73698
527ff6dc34009bdcc903aa89765ca2b0,78,67,108386,28370,80016,100,84,184253,33442,150811
1462cba3d00110300953ce7419900fbc,26,25,12701,2929,9772,20,16,10210,3481,6729
95fbb35ad4797f616060e148ee74e720,103,82,214561,73609,140952,118,92,244397,54714,189683
7ee123472646b19217ca700ecac00245,167,106,424498,60732,363766,112,91,224362,84372,139990
ba5b297397b35ede3e72b3297373fbbf,184,121,476468,68835,407633,200,163,604105,104183,499922
48cd3bdd4f0c47e24322195222a78fa0,25,23,7397,3272,4125,20,17,7850,3060,4790
25181d764d9a5d5c5a60afb9828bba9b,92,64,189801,42809,146992,127,97,193287,66200,127087
aa526c17174dbe21f78b16e5560df4bb,42,31,34636,13564,21072,50,35,40987,13212,27775
466575c8d9aa3711b06c5cab794ba3f0,88,58,193525,50800,142725,78,69,143344,64586,78758
532ae47a3c0180b4023fe82f8f4cda04,166,137,419477,150292,269185,188,152,496080,163375,332705
7dbed9e9a262dc4d3288063ff1504e45,109,80,208538,29902,178636,117,91,169180,36173,133007
c324f42d868b4b5569e11dc20f6f6b04,36,26,24364,6617,17747,30,22,21868,11910,9958
926886d98bbc2fe3d6e1f0e41a97a7fb,71,69,113533,33617,79916,53,37,68996,21172,47824
b07b4269b88661dc073cc876d3d1698a,67,51,91919,33599,58320,72,68,130017,48609,81408
6184554f9d8a338c19db83f3d0d66792,70,53,76116,19412,56704,84,65,92628,27775,64853
c5223899ae0d00f9eaf522e26fdbb588,152,107,435360,98949,336411,150,98,439731,98782,340949
7f78bd604d48d6896291bda42a060171,126,82,218221,38278,179943,112,82,183434,28237,155197
8efe78d280dd4321b067b1febcfbcc58,134,75,322838,59771,263067,106,68,224105,65556,158549
aa9f9e568bbca9e495eb659b8f8b52d0,109,91,431695,128484,303211,211,155,633426,90566,542860
ab513a5fb46f25cc592d108ba0c44410,123,91,222129,47304,174825,115,92,258737,56632,202105
f79441adc1817eb9fa7fcd6f0a192de8,54,36,64182,24644,39538,50,47,58880,31066,27814
6395e57fb064082ff8e1c05a34b55617,35,27,39710,9853,29857,43,41,40817,14465,26352
57ccbaecfbd19ddc9e33d272ef9433d6,146,115,390273,110149,280124,143,112,338432,109648,228784
0b602e582b0f0dabb117b65f7d5638a3,161,128,378053,68972,309081,104,95,211884,89471,122413
4441fa4109c6da4b7e94bb96586e8b6c,110,94,251803,72544,179259,109,95,254593,70359,184234
7a91435c40b8879e1e36888aae03b2bc,34,27,47501,9603,37898,38,29,39476,13447,26029
c21eff70f937f4b33f6fa76cf889277e,59,50,61979,14748,47231,51,37,40145,14651,25494
65fd556b4c1a9594ea9b86b11bbe2ed1,55,39,54696,19773,34923,53,48,93658,23940,69718
7c54f531c6cb7d7f5628770a9ec329b8,146,125,450691,79224,371467,148,93,345785,61769,284016
c227cffd87d9c124bd82438502fb84b8,119,95,347392,80494,266898,120,82,218088,72033,146055
293315d8bd1b6420a25d685da98b6633,159,118,464660,134463,330197,130,94,475389,140681,334708
40c2ff0aa23b9fcb4223594ca292f6da,149,104,559814,121642,438172,143,109,514320,115926,398394
4d7a6225303aa6df82c4a756b6ad2491,81,69,108690,27040,81650,94,93,147834,31328,116506
e097b3789a4c9342004776f6de28ec67,37,32,33164,11926,21238,37,30,23310,12553,10757
ffe27c59d126e86638083f0933bd6789,67,52,108569,39308,69261,93,67,105466,38775,66691
e75491d4d65ae12d2723d4cd1053a4a1,53,39,73438,23648,49790,47,35,55861,25639,30222
1435a343bacb2cd6e119c61374020a43,49,32,38335,9339,28996,51,31,28651,9190,19461
2b40b3845be399d1689e797a6aba4f19,36,24,31404,6986,24418,23,27,22767,7236,15531
b1e8525d0130d7324f1e717d809fa8dc,93,75,210655,61345,149310,113,96,185978,80196,105782
ab00ab3c63e4e6a0b7801540b49b86b2,44,32,61974,19073,42901,57,40,66093,26829,39264
c03c211c303457283be257d2798909ef,62,38,49963,14056,35907,47,45,44050,21494,22556
0031c0ee827f23ca6c4cc5b66d0d3d79,20,16,11037,4338,6699,23,15,7812,4562,3250
73e1028d5cfec8d62ec003672da4e13b,26,21,12404,5346,7058,35,29,14224,5726,8498
12608842a492230f64206559c5b1d458,24,19,8357,3102,5255,23,18,8580,3241,5339
a33a59cfbced0ea894bb83b9dd827530,165,123,504171,59018,445153,153,131,555308,121830,433478
e084a3b0ba5d90910998e5a90e1879ea,137,95,276717,74063,202654,148,99,269966,61067,208899
52e9fd88d1dc404c404928f92fa13138,216,150,1126579,274202,852377,216,124,894928,226389,668539
a0bf7b044e608514dfd3de28b4dfa1b8,149,112,516675,73458,443217,144,109,350342,74589,275753
47717e9375a9a537e755560bfe46b375,151,130,352079,66268,285811,127,109,288123,70443,217680
546d28dc9245ee377d95e4a62841ae58,82,65,158244,32830,125414,100,89,187281,55698,131583
61746dfd2df0e299e13a4456416c2eac,52,40,73550,17323,56227,79,51,99228,20002,79226
b2e0329e2601511796840b07e15b40a1,143,91,436662,128230,308432,174,114,597401,112867,484534
d582da198cc2578f35ba4f8a2cf55503,102,78,214097,84595,129502,99,71,195373,75015,120358
fc66933dcd8a2994974c0a20b2ff86ac,13,13,2268,1369,899,12,6,1993,741,1252
d75975e0e8675cc8cfb17be3642be78d,142,125,484366,114229,370137,158,119,541925,113219,428706
a79df47bf1d1b33b694304a3118825fc,169,123,394566,68841,325725,131,108,346186,88495,257691
08b8b0feb1a09374953eaae294a78222,33,27,38487,12003,26484,44,33,38886,13577,25309
4d69bea7ee0866f761eb66292efa3f9f,172,121,705365,188496,516869,145,122,605602,173837,431765
3ea6e3bae81d0b327685ad8817e5e0d8,50,37,70912,23009,47903,79,53,124198,26449,97749
66250f6780297b7fc3b49810985216b9,24,19,12962,4523,8439,21,17,9250,5203,4047
b6ecf372168bc9fbeb3aae93414b8b8b,129,114,430524,95313,335211,161,132,461366,88064,373302
74a1a2542b6f8d25bc1d43a89b999f94,83,68,114894,22965,91929,63,54,69189,32884,36305
59091e24f7edfe66a77c4caa850627d4,75,55,83123,26890,56233,82,69,148653,31968,116685
70a72b0d64f6b703548a6c85a8ea2cb2,26,21,8868,3495,5373,27,16,10092,3943,6149
19c46dae6384525fd7262433bea5ee36,128,95,319498,61672,257826,120,80,237105,65144,171961
67bffc50529f137f20a72d7b9ed252c0,50,43,82089,25723,56366,56,40,86328,24457,61871
ec728a6c9152b4155d7c127994f0c061,27,20,21630,5447,16183,30,26,34276,7464,26812
14c5cd2b3729d056dd473356687e6454,28,24,12385,5502,6883,30,23,15019,6082,8937
9ada03c4b99568edfd2fd450aff831c3,120,94,263071,66481,196590,160,119,340094,73780,266314
b83091d3265670c683ec49e3485bf332,23,17,9965,5609,4356,22,18,13656,4054,9602
2b7fa96ab5fa9e49ddd478e2abd49bf3,49,41,52371,18530,33841,66,52,64813,15519,49294
a116d67e1b4e43bd8765e0adcd59468d,134,117,378755,69157,309598,118,88,255067,77269,177798
4bc7782e0d60ed1ed4693b1c2695e5d4,219,156,1338261,213858,1124403,231,146,1325324,161513,1163811
0d4ca6f7095afcb9b7b4d4e48608c93c,131,94,279762,108042,171720,178,153,407976,96743,311233
6528493b5621def5fd11f5fecf1bcdfb,94,78,167089,57579,109510,124,99,243864,46050,197814
e4c7af19ef925b3238ad8629a3447de9,24,22,16791,5753,11038,27,21,10048,6638,3410
c09152705e339d468fd29c1e0a3e8c73,165,110,473345,88295,385050,215,169,655461,135906,519555
45ab5e0898dd295f73ab12c6bf9785fd,9,9,592,925,-333,11,6,982,416,566
c9e07a1f5b5608661b3462c441597c0a,56,38,41607,12495,29112,59,46,47601,15593,32008
4b818399c915487af8a5cca57ef923ad,122,101,300312,77705,222607,123,103,396488,78174,318314
92f0eee408e587f940943e09ef1c806c,55,30,55564,11436,44128,52,51,35144,19088,16056
e2930e6428d6eec4f65c9e1e8d262ff4,99,74,159745,39642,120103,90,73,152008,30513,121495
6fd86fea6f82d03a74819a34defbeae2,81,65,109194,31539,77655,63,58,60147,26194,33953
e6a302d9f9922323b18ef24816ba0a95,184,142,597111,77881,519230,151,127,392738,79792,312946
354a8797f98fa17c17d6982afc99b875,160,124,425551,101032,324519,104,86,271142,90518,180624
1a6b3baf0f786afb445d54a9ed454eb7,151,100,410188,148505,261683,167,133,697488,110842,586646
f7c1acca818966b85d05839b74a590a4,197,141,676401,202839,473562,204,163,743503,186747,556756
cb6d16d3c5b16ac463d252b5f35a8918,114,85,310913,87149,223764,105,88,251815,75525,176290
3416c7916997e3863172df03837d44e9,56,46,108482,36510,71972,70,50,142063,45339,96724
da16bc0e2bd8258faf0785dcc1fa34ba,105,87,223741,67270,156471,140,102,336200,58704,277496
ddf543570d28ffe6c0cf8e731a1f7fa1,119,71,280678,65708,214970,148,99,379087,71845,307242
a06bdecf341b601e473b4615ab21bb0b,102,74,161888,34235,127653,85,72,147638,38369,109269
a6b4e2ba803b6582881e5f191b1019cd,151,104,434579,87191,347388,181,143,572518,87412,485106
c24852ef37e10597bf430ba0c71625a1,96,73,210617,49300,161317,96,74,177807,48203,129604
f2cffc68a36c61d7c8a0df9805df70b9,37,36,25789,11687,14102,43,27,27402,7093,20309
97b1fc3df2fc12bec55fca6985603446,38,29,37354,9763,27591,46,36,36624,13936,22688
ad5a1d199ddcb0d4df3f4d4c5201521e,147,100,288613,72585,216028,83,76,230560,91077,139483
cdbbf51b8fb6058fdf5c9a865c7599e5,171,134,646069,92869,553200,136,108,383207,99674,283533
2904145e86e73a3cfcbfd4216a74abf0,124,82,232365,34343,198022,120,97,219652,42245,177407
ef1770323ccac9b76ed4fe188d626afb,62,45,93074,37803,55271,81,70,113185,46566,66619
976f40705ac8055f0e604863294daecf,82,67,144253,53566,90687,90,84,173066,65510,107556
c0f8eb64b1c9fbf84be349ee5f3e8152,92,86,243502,88999,154503,103,79,218833,71219,147614
b130a0dc00a245456ee9629ffd1fe8ac,181,147,680471,106696,573775,179,126,785710,93121,692589
ae9f31eba57ff3f545f6382416a09d2a,83,64,141414,37836,103578,95,70,190861,36352,154509
7a56690ed209f5ce2586078e626f6fa6,22,20,7699,4571,3128,23,17,13441,5549,7892
e7ad68131701095f9a631acf3eeba09a,153,115,362047,69668,292379,169,97,367611,59796,307815
696c45466c7c71ce004a3a29c5c8530f,95,73,208984,69124,139860,124,92,329154,60098,269056
861d92134824c93909f680f439530c16,56,47,101120,37917,63203,99,90,233361,43492,189869
069b993a9cdf95c784e61d4c391e00e3,5,3,772,247,525,4,6,275,800,-525
e2e7f99a0b1244c01dde0c9a1a8c4cfb,53,42,84705,18923,65782,32,28,43822,16013,27809
d7d247029ee4102b99a187ebefbefe0a,161,120,378199,92860,285339,124,94,354093,82355,271738
9e7ccadc9bea25e342f500b877d27838,131,89,231717,54957,176760,100,86,215069,62658,152411
c50e5b022948b92ec3093d33cccfb7c9,197,130,877263,143402,733861,215,149,826382,163820,662562
7e126c29c07ce36cf90bbafccd8130d6,53,39,52078,24984,27094,54,41,70734,23724,47010
6dcffa73f4c5ec18c4a3d2043fedd9f8,136,114,550107,136584,413523,163,84,492512,102331,390181
6e4b9be986a79d9f38d5579a481d18c1,71,55,115677,30058,85619,78,71,109393,43248,66145
5767a4fe2feadc09e56665cd7f40d295,122,82,181407,32671,148736,114,94,228034,50904,177130
43334a3f10959fa06fc8daa0c26a34b3,121,88,257549,70009,187540,116,95,259543,64550,194993
66e465c7a60425f855681c0104956079,38,32,47708,17698,30010,41,31,34920,15959,18961
43fbedb340e90f50a003b9aec63479a6,52,35,77146,19707,57439,49,45,47860,16737,31123
89c2e0387467d8e9a3f950f2385e7dc4,97,81,164148,57398,106750,86,63,139401,46497,92904
f4e8f2817db055b85c74b3daaef0559d,34,32,30710,13358,17352,41,32,28550,13345,15205
69fcf87c53f9894f075c6a9508b9905c,56,48,56134,14935,41199,48,45,45308,16962,28346
b318ebe3e8f51c9099cce703ba6ac8be,143,107,439668,106093,333575,161,101,436977,103894,333083
daecbff9354c363955bf172bbc350fe4,69,49,95993,33836,62157,68,54,102456,28535,73921
d5ef2cf67b0431596f296507515f1ea3,152,116,282306,94085,188221,122,95,307468,79944,227524
e3b9445272c7b32751090c837599ca6d,76,55,245606,81969,163637,132,113,352205,87677,264528
2b4deabfd8f506009f7e95aada998695,29,25,19606,13839,5767,34,27,28200,9559,18641
185a71eb9eaea0ddd1e6a1123ce4df24,90,85,181975,64616,117359,146,107,298345,56785,241560
7a3b54184b951137e14fbc9c57c7df5d,70,45,160235,60228,100007,119,95,238208,98331,139877
09c1320720e8a654085cebed6c38b58f,153,108,634768,118146,516622,210,157,752570,112095,640475
adc617c9dab0fe2912e06c54d44c65b0,81,63,113821,36430,77391,88,66,135404,29587,105817
480fbfb6228c5b9e0c4560a59430b472,106,81,258032,72812,185220,172,113,421510,58063,363447
f134c1907eee6830c9aa7620bae1d00f,32,27,19173,9700,9473,32,24,17999,9344,8655
43caf3867548fd3949ea052eca82dcf4,31,23,25881,14563,11318,48,34,36985,12103,24882
cf92ddd03cdfd7bf0d1d20838499579f,167,128,490175,132823,357352,146,113,453079,102156,350923
0adb6c6f283d579920e9e63b4911d121,254,143,1066881,205521,861360,239,137,985726,206773,778953
0ca6d6c4903960fc621235478b0de1bf,55,41,80218,27315,52903,84,67,104441,32602,71839
fea611c4f05d4bbe51e3e3a6bc66c784,83,55,141748,32588,109160,89,72,180637,33586,147051
7ae2acf31ceaf063108b4415c1b96981,87,61,95456,42384,53072,63,51,101904,33469,68435
1c634370685339a105b1884ef2a7c0ca,96,69,228757,41049,187708,124,99,281065,60123,220942
bfc2f19440eeef8b22015a636d15c81d,168,141,517111,95552,421559,194,137,593827,86014,507813
3889cd7de8706c64d7139bdd4aaa5c10,74,54,122460,27820,94640,101,79,137567,34302,103265
9aa484aa676ded98d49d6031afffa89f,90,74,230530,87928,142602,95,84,278981,93259,185722
deb8157a95535b53334427a9d1d12530,13,10,2167,1403,764,14,11,1702,1770,-68
c3cfab57a96c840ff88eaab7d2c4aaa6,73,55,141673,32342,109331,101,71,198828,45928,152900
c56ca7f098092d8a9e602ef39081b36a,77,69,112628,34609,78019,101,70,172143,38443,133700
f82e9e2638d7698d5d120ca78ec65103,15,13,4847,1995,2852,18,12,6543,1834,4709
80786e9eeef422a956eee6c4daa8f135,79,62,108775,28971,79804,71,53,98023,31215,66808
1f8dc98577e3149911edb86d087393f7,61,50,58275,20182,38093,48,42,36788,17143,19645
0abdc4a4415ab300bc472d30dfe36e46,175,152,515227,127234,387993,160,138,585375,133890,451485
9c07ff6d7088b3d21364df937cbcc68b,78,51,106188,19442,86746,84,70,117883,27374,90509
6189bea32bd45c11452234ee73abc8d1,19,17,5763,4093,1670,27,18,8920,2976,5944
589473876cc22eb1ced1822b8d224b8a,186,147,710861,99359,611502,176,123,598904,87323,511581
49fb2ee734c6195e95fa6b701950ef7a,35,25,20432,8496,11936,25,25,18119,8419,9700
b95fae2e915651ca7a1ce7651848825e,153,111,374669,96318,278351,141,101,413371,79867,333504
e57d411522b587129a97de2c2b46e5e1,106,93,273437,72428,201009,150,122,309073,65792,243281
ecf3584a8797edcdc42b0a042228e713,154,102,439383,76991,362392,174,138,600079,94441,505638
82f1a71259ae79eaa420f1a3aa5e1729,161,111,331258,71199,260059,135,119,434466,91014,343452
b33bf9dd241eaf91857abb540c4828e2,42,30,34315,12975,21340,40,30,36516,11762,24754
bbf81e80e50c0145a5911cdc2f513a17,53,39,41480,15761,25719,39,31,39007,16738,22269
8a362931ec1610f63e88a2f0e2e5a976,151,115,481677,73081,408596,154,104,599902,63330,536572
59a7f4db363aede16abcd2aca61f2202,29,23,17088,7542,9546,37,19,28381,3923,24458
ee744ad455316f2677024b700142a41a,32,27,24391,9412,14979,31,23,23142,8320,14822
bac8da889920036964657f690e40ebda,9,9,1826,1022,804,9,5,1902,1494,408
3c0cf62e684bce5485ca15134f628fa4,34,25,22743,7738,15005,28,24,14519,8836,5683
0259c631c843900bafa71fed64045513,193,151,954728,172241,782487,196,151,690124,176610,513514
089a328bb1ad00c7b502548001d2a644,97,79,203032,54650,148382,123,107,296287,46893,249394
34cb8832c0813667a8b7886edbae1f54,164,139,437192,94319,342873,140,123,368645,82718,285927
6b14d4d3d6cea549fa3c4ce926ab84cb,141,118,341069,89148,251921,133,105,292794,84699,208095
0ad7ebcd53b5650269e40f9f4b4714a6,51,39,53082,13372,39710,69,53,66318,18914,47404
11b80840cf515c7e2b8c343e635cc16b,42,35,56371,18158,38213,58,38,67851,18635,49216
e58246e23f676c2de459262620e779a2,192,133,560594,105251,455343,144,107,484161,84604,399557
6c82be674b206ed9567d6a3bd8db659b,78,68,139644,47505,92139,64,50,107596,39151,68445
a46994a55354ebbcd6d87a69567c9189,191,130,762976,88908,674068,181,136,592482,102979,489503
3d566d1c18f80afa418a96c961be36f1,201,135,704372,135245,569127,157,114,601614,143032,458582
ced246f904d05d10974996dd4ef89aef,57,48,79075,30496,48579,57,41,75669,29057,46612
2e0c1a618332d745cd88a0af95af4c24,119,83,280199,104634,175565,130,88,307949,103325,204624
4488a37afcdb7d4315f7cd26c1179866,137,118,328454,84048,244406,128,97,311675,68072,243603
b9db151556f7b366a5649a04a801a4f3,120,96,330564,108629,221935,158,121,444233,127262,316971
eafff0ff140314dbe2794b61e7c9d318,23,18,10171,2978,7193,25,23,6731,4136,2595
2b1961ac8e48431e6387eb1f6050f37a,46,33,51592,16883,34709,55,42,60092,21737,38355
de2a5caa46a4c3839105d89458833625,202,126,506501,120659,385842,173,134,582293,158021,424272
5e13dc92033e4ed44d1acedc028f0616,30,20,11479,4469,7010,18,23,9660,4255,5405
4aec501f2a1e3ca06c5cd6d5616b0556,61,47,57058,32014,25044,71,58,98518,24944,73574
6fd7f4257513f82e918d63affe79f910,114,76,212588,33394,179194,100,78,184519,37241,147278
6ad345805059fad729b275826c7085e7,24,20,10383,3845,6538,22,20,7510,3706,3804
3b012c8c5b85f84f9646aa98a41ee937,155,119,438158,92096,346062,136,124,368684,88319,280365
7fc087897958b36a17af6a790704119b,40,28,30282,8413,21869,46,34,34141,10522,23619
35de78ffa6c538c5cd1675457abd98a4,139,113,420589,72707,347882,179,118,419406,55842,363564
dbed598cc7c2753d2bd0741ec1839592,117,100,308950,100873,208077,112,82,254937,82251,172686
931da486a04ce74b8911f4faa590524a,106,88,253277,42225,211052,82,52,165069,44056,121013
6d944a71b40aca961ecf6dc9e59ca241,168,114,452235,55357,396878,134,107,364780,71641,293139
28d155c85802624ad64cbfb866e3262b,49,42,41629,18275,23354,49,46,50738,17638,33100
4f3b2e6ac20a4d4b86c86d7a334987de,79,67,139163,24451,114712,77,52,152684,23230,129454
bcf047b829e492cdad444203ec203d8d,238,189,1115008,231797,883211,203,149,1646074,188393,1457681
6fb5f9582432c2852b7e1da5ad1fc34c,49,37,39755,14790,24965,43,30,30870,12447,18423
05306b29d81055bea0c72ad535964b94,15,13,3901,1003,2898,13,10,2356,979,1377
4e8a0ef9ec762991df44b802f5260ed2,106,79,185142,32907,152235,87,84,151219,37102,114117
49724420bb716e75440198ae6ac73d5f,128,109,239438,56955,182483,127,112,218012,53780,164232
d534b3a38a5d7e6b88188c929a85c88b,82,62,149680,51520,98160,93,85,276176,37326,238850
050522fa2435fa11107c584526b6f901,96,79,245337,75784,169553,130,106,290005,59835,230170
a7de17c0edc9556b4f3a004f9647be0d,111,83,309494,63744,245750,106,83,280839,62438,218401
a25ef4d4aedc878ff912059a89deac73,130,86,269127,33282,235845,109,88,169999,44583,125416
fb6ed42157f33847cd5ddcd0a7991101,107,77,290949,90487,200462,154,128,425225,88789,336436
b877d7a345c707822043c4b33f71e98d,122,89,287307,49481,237826,118,91,206450,58525,147925
454192730a6a2629b0f6d989fd219461,159,149,431392,137513,293879,130,101,401896,65759,336137
36ffdffe7c166259f3c183bcb1080a2d,86,74,136998,42118,94880,68,50,116215,49404,66811
e6562149365912760307e8565fbf73d6,39,30,71296,17364,53932,68,54,122381,31933,90448
485cf9d3c8ee558d278c47fae6c4c079,106,91,195751,59497,136254,113,75,190045,44927,145118
75c34f6cb92bceab9b60d177a14c9cd9,49,43,107401,23829,83572,47,33,62916,19117,43799
4c0465cb402ac82001f0e6d005e60fde,37,31,29926,14477,15449,41,28,27518,16516,11002
8032395f2678f1865b89bb2d1544c378,162,137,692196,169691,522505,220,174,845416,172172,673244
ea40f3e88c6e4e96c36f6d9f4436c39c,21,20,9483,2288,7195,24,19,7037,3525,3512
6c4ff82667dd39610201ffd65d188293,2,2,86,127,-41,2,2,127,86,41
02dc1b2b8680fcb90457ea07fa332fec,18,12,6487,2577,3910,22,12,5877,2448,3429
bf792edeb588bb5a0f4705c0530f8e67,140,107,426126,104667,321459,139,96,382015,106243,275772
88b74e741be9b4d88f201cf0d67d7a68,91,54,137388,36202,101186,86,59,173135,26043,147092
a8f79b974f7839c3f353caa2bbbcd70d,128,89,195685,49089,146596,134,106,247871,55930,191941
51aca73a6d8852b55044e3aee4729385,208,138,943530,137946,805584,190,138,753100,167850,585250
807a9ed6cdce66686aaef3b261157570,168,125,441806,112201,329605,189,131,546888,131833,415055
cbc973cee5d1d6f8298c5b17946f503f,70,49,92489,24091,68398,44,34,54087,23771,30316
09cd9538785ed2dc4df019576d5fdfae,29,28,11872,6165,5707,28,31,16634,7735,8899
a19815015db883d4ae9e3e28ac98dc3f,89,83,134554,42756,91798,71,51,110043,36966,73077
434960de669bc4278789a163852e12a9,93,69,148010,26211,121799,90,66,122950,33314,89636
43bde9fbfc6df6a4f9f2b74554bc5341,161,114,617586,124175,493411,164,114,552934,127526,425408
d0745170469a4199884131373b8baae4,168,131,856720,121791,734929,146,127,591264,157487,433777
63ee987f113f6017a3ac3ac4aab6ed86,168,121,802026,113179,688847,231,162,1001354,118733,882621
a5cb761040ce5a817b1e8267727a4cb6,77,62,84529,23485,61044,80,65,102525,25491,77034
984f2244e71eeed584cb51068026fa69,44,35,57238,15450,41788,45,36,63719,19593,44126
21e5a08d59411169cc55c219c9fd1b82,35,29,42570,11687,30883,34,28,30198,15101,15097
83ccc2a8b3e15f9f03c1f75bde38aeb4,66,51,88510,23518,64992,59,50,70223,32375,37848
e47006aa0dfff04b4da943fb93d1ab14,150,105,324572,98931,225641,128,75,444890,88809,356081
687dfbc7db9f23c84d78e53a553ea968,145,105,322652,67469,255183,150,122,375930,78964,296966
ca5afcd6247cde25bb96f56431abf4d1,122,94,267893,49018,218875,96,78,155218,32191,123027
12fd5880834927bd7f6ecbd848d75ad3,196,148,726229,155424,570805,200,142,938662,132490,806172
450acb82bad0e2a48b8afb2844bc1de9,22,17,7878,4186,3692,27,23,15231,4056,11175
90db2776139818e47b7b994123f1738a,119,105,207092,52655,154437,88,74,164661,51403,113258
43ff6b1c816d476751a7f65a9db2be76,176,100,400111,115318,284793,124,76,264003,107665,156338
683b2863eac755943242ff934f5ee2a0,102,55,212663,38454,174209,71,53,107488,36781,70707
41ba62cf7390eebdd5a9f9f7ee270269,79,56,87770,22353,65417,83,56,107560,22165,85395
d5d64b6185af0394386b14c293e2fd12,142,104,371968,87496,284472,178,132,500942,83903,417039
fadfcff6cba65841aae65efd8ba96e7b,43,34,43741,14045,29696,31,22,28833,14984,13849
b32e0f0f510028379c967e08a6aa1475,155,116,610320,145932,464388,160,136,637971,122602,515369
414c34d824e356228a01152271ee004e,71,53,102748,25061,77687,69,55,64787,28668,36119
b121d5a56c5abce4e91404c38eb608dc,101,85,252130,51994,200136,95,68,188442,49620,138822
44f5b1553739e39f94b00106a79dab1e,30,25,16847,8000,8847,30,25,25584,8476,17108
3bf0e97269e98e5e65eed304d0e3ec84,68,50,122815,27527,95288,57,49,95675,19662,76013
e358feabe300684efc63ab682aff5701,145,92,310426,51617,258809,139,98,235012,54492,180520
60d1214f12c3a7d98649ea2a9567e6d7,157,97,308399,48934,259465,128,102,239832,74258,165574
608a04552648399d66ad6cc1d6c6a045,39,26,25973,8906,17067,33,28,20251,8446,11805
4b46c3e93df68d8273761dd076c06a9a,96,79,165275,33963,131312,87,72,135282,26262,109020
caf1f27f776bdbb6e3e60b69121d71b0,96,73,204611,66310,138301,153,102,287693,96543,191150
44f16d04ee19db4a9c84fd26dd20ea7c,43,38,41129,15083,26046,36,30,29368,11390,17978
878deae01535d2ab5da6dd50f6da36a5,58,40,67398,17111,50287,90,50,111024,16857,94167
c02f837055d32772b94615fcdaca30ac,153,102,248834,33607,215227,104,89,135239,34236,101003
6ac693a2f087f79182cbfd7aa20983f2,125,92,258713,70555,188158,157,138,359816,79068,280748
2235f03afdd8ebfe5cf965db3bc71d83,68,63,117442,33410,84032,87,58,119162,37007,82155
38ceb184d648c904a4c4e3e6a0c2862e,170,112,353425,42988,310437,120,91,286395,40205,246190
d4db704727acf32f8cc2520c5b358f9d,40,39,61628,22029,39599,45,37,33644,23343,10301
0af77aff3872f331d811be736798cceb,84,61,138768,27437,111331,76,65,109812,35655,74157
3d72bc6cccae44b022fbd95a56ecff41,120,87,198390,45036,153354,105,76,199294,32045,167249
e9c5c1c7adcca308c84e8d6d36a9b46d,80,62,138069,25504,112565,87,60,103838,29303,74535
7e001d5b8094fceb6c581610c34d7d59,103,84,151334,33747,117587,112,71,189823,35671,154152
701770a1bfe3faf9a78084137e58e0f1,21,16,8060,3804,4256,18,17,5894,3942,1952
cede2901e4f23301d6db431d3ff3f626,60,47,113669,44203,69466,108,86,239924,56894,183030
6d6e2efa75c348fd724f55e9f80d8204,60,45,73578,21791,51787,64,42,76044,25922,50122
4747993817692b32b0b75c48300c3e94,149,110,480130,71288,408842,136,105,377282,103863,273419
d656bb1169f7b822aa2ab3ae71a30574,189,138,917393,159308,758085,179,140,747923,220376,527547
4e12da474ef37851a0f333d45f82a787,100,87,225341,55130,170211,130,86,239404,40532,198872
bc5e5ea48b861bf0ae826265d8435d1a,76,57,133417,36825,96592,80,54,140041,35042,104999
63f809cd9b35588b266eb00998326009,160,128,636647,111532,525115,142,117,481885,114540,367345
978ba8071807ed03b8a9c71e09a7ce2c,126,106,414011,88497,325514,132,96,342994,56277,286717
3a365a027c4c773c61fbe14d233b541a,89,70,131864,25475,106389,79,72,109169,26406,82763
804658ef4701ede8de6d95c4f3fd4370,78,50,132159,47950,84209,94,71,163001,55565,107436
03f2f0403836fac07706d9965ecef12f,152,129,716793,160311,556482,137,125,504888,137534,367354
5787eb676651259ae2695e80103785e5,161,130,691105,190942,500163,213,160,917604,210893,706711
43a4072dbdd17481969a236ab0785288,11,8,2060,991,1069,9,8,1174,1497,-323
60fd133a5ed37fc6540b08df41db501e,58,47,67734,23051,44683,44,33,50994,21563,29431
c128dcc5d996822e16431a34e4317e82,99,73,214380,59050,155330,104,65,168437,55599,112838
3388aad4b02e5ae18e4be1542de41512,109,83,211978,68794,143184,95,74,218801,73247,145554
30c359d4d7a08abc9e9498192badfe91,154,132,487089,87300,399789,171,130,439068,90971,348097
6d6d168b56109536465b962d75649a70,44,36,23427,9566,13861,48,41,25840,14335,11505
da59ae3fd1ae9f5ee1e81364215d193a,90,71,239793,59454,180339,108,95,286004,72207,213797
f17be4cdddc5b25f54dc567a317c84c3,87,53,100493,33255,67238,65,47,88632,30695,57937
55f73a9f9f939cf667abc1745ab55934,84,65,131881,50152,81729,102,79,163810,35676,128134
7fc66f2b9c5f0727c5f63085b91915cf,178,127,519351,123490,395861,179,134,533707,130830,402877
284519adffb45a622ee7de9cf900bbc0,19,18,6602,3343,3259,27,23,8326,3505,4821
701f0ac123310a746093b02173e0edf9,159,136,450112,132520,317592,170,130,451271,125109,326162
45049be94772398daead315e8af9f27b,43,31,44775,19837,24938,57,40,77274,15511,61763
e45071c71f55266a35a9bfa6afc27551,21,16,7268,3698,3570,20,20,9222,3670,5552
d11df3b59d08eac7fdb63d5fd5fe113a,92,69,185810,53349,132461,114,96,178331,49869,128462
1661f1cb116acab568aaf7dc37eade38,88,49,95068,16753,78315,55,45,75498,28117,47381
e43fb8cc48810931a0cff18132d4be87,25,21,5929,4110,1819,23,19,9129,3007,6122
71d561c302166138c915fec2bd707773,17,14,5392,2201,3191,20,14,5819,2427,3392
f6738ce1f5665b4676dfe66ce1ed2756,26,27,15818,8159,7659,32,22,17675,8736,8939
d1cd03544ab192edf2c0e8d1377681d0,63,51,107971,34602,73369,63,44,90354,24121,66233
b36d5439ae33244a35e9f4aa0e905e45,149,115,369513,113019,256494,139,119,352873,89682,263191
3601cff146e0073b2101bda0e89988b1,35,30,50045,20706,29339,32,23,45475,16923,28552
d56666b50552f411a83b283cb1161537,38,32,33080,9356,23724,34,31,27401,12278,15123
edc571458393f04b5c0ff60a7fb72652,79,51,77805,26036,51769,77,63,106694,18544,88150
876f176bc63fe9b5f410d46c66ede5da,121,101,317872,61542,256330,102,71,224155,54710,169445
88e6705c7b3a08bfe958fb3b4086e10a,119,64,353018,125239,227779,118,89,405064,129920,275144
cec042ed17ca34c65ed7971ba385765b,89,72,174052,43616,130436,126,109,284304,36196,248108
3c12949f2978b3ac78dbfe45b3893db9,46,32,23814,15923,7891,39,35,47603,10809,36794
f6b85aa58aa806bd53d9961e988e540c,41,32,57258,13113,44145,62,55,92390,22413,69977
d16ed49ca1276da36d61afb8d475ace1,89,78,167881,39067,128814,76,56,110359,39783,70576
727317edfa9f40c75b235656accda172,165,135,465098,117047,348051,161,134,507649,72106,435543
59a532891410d42ac58efea8c0963590,119,101,372652,86043,286609,178,130,457387,80188,377199
914f8b93b660a81267850461e1b136e9,174,96,598284,106026,492258,216,183,712466,197060,515406
c3fc5c1b4e2e9784b4c1b47cbe4b71e7,181,130,542046,98116,443930,177,113,582715,69200,513515
238c64c42d7c0abe0c6b89e06da34158,75,69,87998,42332,45666,117,85,200439,35522,164917
add5b1735d167285b113f554dbcaa493,134,103,303780,72180,231600,114,110,258556,87862,170694
bc63363bc2364be2f1ae8e409f4139ee,90,69,189515,39749,149766,94,77,174714,38456,136258
eed5db1a1c4a6c5fb60036d4dc3885bf,65,53,94364,21806,72558,67,69,93052,26084,66968
1ef101ca5c615b8c06c89209f93f223f,60,43,101437,21003,80434,42,49,76083,26865,49218
a6d2b9d2c68f634fa71ef7507fca0f5d,117,93,235005,67716,167289,101,87,273375,55441,217934
4be6ccd903a0cda53fb25924c33fe9cd,48,37,42048,12094,29954,46,33,29981,14045,15936
40843cb3388547927c48c61ac252d3ad,128,99,312494,56346,256148,115,94,253002,50948,202054
86c4ac999def177a4cefcea53fdc1ea0,169,128,538848,107098,431750,219,149,730639,93214,637425
8e699c54afcb30224f07a81dccd7601b,47,34,55985,13756,42229,54,38,70548,13266,57282
a838fc1c27f7fe218f30e127cde0a9fb,60,49,94537,24341,70196,43,38,53321,30476,22845
369fb2eff62906c68c62403da0b13682,110,96,279817,122996,156821,133,75,465186,92637,372549
1d86652a77bd6db985dbaad8c5c67444,32,24,36935,19114,17821,37,31,46351,18587,27764
9859270b0b137d9316d86a26eb233f31,158,102,420375,66450,353925,162,119,329061,72638,256423
6d6984d584c61e1e26c70afd4c3fb22f,156,133,438915,97760,341155,145,115,337107,97059,240048
856ec4a424b1d905e30600a7389c69ab,0,0,0,0,0,0,0,0,0,0
5d19c75f1a6bf444db62dee23010f2c6,98,78,209707,61407,148300,147,129,360935,64287,296648
7652f0ecfcbc88b19d46d2dc218e1eaf,40,33,48941,22275,26666,47,34,53632,22497,31135
34129bfe74db9ae54cb92058ee5aedb9,44,36,64915,19510,45405,53,44,72969,21312,51657
35fb32b9989b2385b81d3f5c09fa69bc,146,105,288502,82166,206336,144,95,318124,75462,242662
70426186a859a21f0fab46b99f467401,132,89,168098,46586,121512,86,74,168388,45664,122724
7488ff98cc5499cbbfd5182eab77eb1f,212,148,696549,132427,564122,195,144,738936,168233,570703
82a2ae7d3338575e2b3ee9fd33565367,174,146,529137,81197,447940,107,84,231458,83438,148020
20a036cd0ec6a981293d38fb6063bdab,21,22,6646,4000,2646,22,22,7444,5049,2395
52e2a7161662caba2701b6f9f51341fd,63,47,117243,29540,87703,71,62,141873,37677,104196
6c5e4806d42f8bc87270207de76bac2e,87,75,180364,41196,139168,98,87,203746,66870,136876
8531c1bf3eaa402b285f864e133ac4c8,58,40,83936,28380,55556,58,44,89044,30600,58444
42024891790bf200fdb4503c26e83970,22,18,4215,2463,1752,21,14,5055,2593,2462
511c3ecf597af5fb70f1f9738d667b0b,112,67,147203,31998,115205,80,47,111204,45756,65448
5f2eee13d4b9e77ff3351318dd3a2fdf,163,129,433408,69569,363839,146,126,399951,85161,314790
d211c6e75a2cd2b6af2bd3591921d166,158,113,280009,47571,232438,123,92,209754,38873,170881
b4ee3e908b1499aff4bf9fbf356ad0d7,152,127,739982,200285,539697,172,115,753673,150954,602719
d49a7dd1f24ef0ed9f9db451f17d3d83,20,16,3589,2342,1247,16,13,5037,2037,3000
8449c41e1e1400df4eed747be389a62a,32,24,38857,12650,26207,39,27,38143,18078,20065
9a8f8c091d4bd8bbf9a4dfe58aa5d0c7,37,28,26457,8198,18259,36,31,14013,10179,3834
27246a1245c1df5449e07f0e30035445,63,44,159629,42257,117372,94,72,153764,68041,85723
0c699cda34a1888b8c33824935e1730e,56,51,94251,28666,65585,53,45,91824,22969,68855
896c2f7b10bdb3cff268099c3e00a60d,22,19,12036,5096,6940,25,19,12698,6207,6491
bdd036151aa3c929d14f5cde3d01abd4,141,100,272174,60565,211609,141,103,320071,42411,277660
cd83420bdd4a9a2534a76344a0d7f42a,126,97,276346,55018,221328,144,89,252101,58191,193910
6d07aea8c6369a316963e6fc6b59d710,32,26,25030,15707,9323,36,27,33941,11726,22215
c898ac3537a754e2b9cba3fbb440083c,146,115,424328,87122,337206,140,116,363905,93961,269944
f36c3dcd110e600250b3a35d348e6993,43,31,36045,10773,25272,42,30,27817,10612,17205
a99140cf2536464561559f525779ece4,80,74,125883,30336,95547,64,50,82765,17985,64780
e95ec6526eb68cc9616e826866924374,166,138,527370,131012,396358,95,76,311404,190290,121114
0e7d4ef9be50a5d5d5f8dd0a3bf750db,82,70,111524,36221,75303,79,65,102017,37754,64263
1a1bc384735ce1b6107f99078ee17af1,41,35,44461,13716,30745,49,36,42790,17212,25578
f1f28ea98e142a6112d0507de9629de4,126,97,435379,103359,332020,117,85,278770,90429,188341
e72b943fa2889e8e3e660d56a1b67199,34,21,23595,6320,17275,29,23,14358,9351,5007
76714cd2540f64d5d31b39ab41296c51,34,32,61862,15302,46560,40,33,31303,16569,14734
a477ebd02e47335fec49f32a9bded2d8,14,15,3411,1219,2192,17,10,4158,1239,2919
4a70da13a521bf425a9d2997e3781cab,115,74,160758,41357,119401,76,63,114880,33273,81607
37f935f9a00e5c02df9e0aa7332aff7e,61,43,113518,43932,69586,69,64,115820,42345,73475
66a9a730a6c51628bdd69e1705feb186,118,96,249807,84493,165314,167,108,301117,92452,208665
c952e3a419d3c438233becaa784f05c3,59,56,60092,23605,36487,53,43,59120,17522,41598
12e9a504451fd0d421c5918d341b002c,40,37,56741,36002,20739,50,39,99991,24140,75851
df5236cdc2d6c1cd6d72ffd13873655f,74,50,105407,18857,86550,44,41,42744,19457,23287
5fd35adb1dfcb2700f58d9f454b9da29,36,28,27749,6310,21439,30,23,12446,8176,4270
9e66d66af9ba6bf13ddab2d5357a4e0a,88,57,175152,40183,134969,79,59,133590,37011,96579
9396cc5265db1592be616b8d1998cfbd,16,14,2338,1310,1028,21,14,5173,1020,4153
9dc15d268776b16dcb750b8d772b0c52,53,39,57565,27451,30114,51,37,68866,24622,44244
e316096f7e2e148f5dd98398a9c26f1e,129,87,173187,43487,129700,95,82,197272,46646,150626
af89c2613f482c4dcc74f9caaefd402d,129,93,532039,99693,432346,128,103,321068,85910,235158
0b426c030ac95d6ccdccf2b3e8e9d98d,158,107,376449,102734,273715,143,109,419685,103626,316059
207a5be9eb394176a5492c9f1d2fddeb,20,19,7881,6431,1450,27,23,17367,5188,12179
141dc7c7d8eef9b56fbfa671fc3458ad,63,44,115902,53031,62871,126,102,231234,50377,180857
6332a1c3d42ce8a7d2bcbbd727f33ea7,74,42,57226,22741,34485,60,56,85835,22022,63813
b96291815fb7b9ab5f96204a592bff2d,28,25,24876,5797,19079,34,25,15908,5680,10228
1e37693d36f07502d4ee4639334c7be0,109,84,282356,79540,202816,134,114,320713,64004,256709
96e57777742c85d47672b0442cf7b1af,4,2,965,473,492,3,5,524,978,-454
002686b2675f817fac1fea8dd016ebc0,122,83,247060,71956,175104,143,105,332179,71344,260835
e7c8fc9cc39f8e45f75b52860079d153,121,100,306335,66703,239632,125,82,299065,68588,230477
fe222e7255871eaf2ac0ea796369d1a0,44,38,74453,16590,57863,44,33,48632,14236,34396
08672512aca908029b4b3d4255f54890,27,20,17581,8233,9348,29,25,21826,8434,13392
4e2247ccbfef305fe58b44b386bfd22f,115,83,279514,79120,200394,121,89,268057,67480,200577
522e21d8258548e6955fc566c6b4db82,36,24,48271,13674,34597,50,34,64002,16227,47775
38aae6433936f71d65a70a9d2a1d61a1,107,86,155455,29370,126085,87,72,105749,35735,70014
35356212450461cd91dfdc0d42fb277e,88,81,163254,53476,109778,110,80,143322,49047,94275
1092462703a28fa2404cb0882886290e,33,18,19437,4947,14490,36,29,20918,11756,9162
48e5d660e1b6100a70101a2811122ce4,34,27,29759,8745,21014,33,27,21094,10117,10977
88b14b2eae12770254c9f6a6a95c9b67,57,50,60626,13423,47203,40,32,44909,12522,32387
2ac941ed9e0a0eda391c9ebebacbd96f,82,61,154167,46848,107319,87,64,127185,40733,86452
53491de2127de557845beef2e26d0a19,62,42,128048,39178,88870,76,68,149034,32786,116248
e9ac5c91f0eb2c7a243d6278c7d0ed4a,44,36,42678,13947,28731,39,31,35820,17279,18541
4f0007e4fd536e43fce6c76036776ca6,85,76,133011,49206,83805,72,61,136881,34685,102196
55a8f2267e9ebf1778fe75b2a5030468,56,40,62438,24784,37654,79,65,132155,25161,106994
9f902438ed1aee965256fe261ab55f7a,89,62,173923,52984,120939,119,54,218281,35839,182442
d2e41055d7eb9ebce63719328ff7bc3b,70,59,118929,28723,90206,73,52,140297,30162,110135
8c5436cbc14401444e7a9496a3215fff,23,12,6888,2499,4389,17,11,4739,2041,2698
30cf286c13ed3163d38b40bba5da762b,35,25,33565,7813,25752,35,32,29373,11752,17621
46a272d9eb2d100724839fd83405f1e4,43,29,46847,14837,32010,44,46,47483,17315,30168
b3ba4afe3601032cdae890912993fc52,49,38,42297,15054,27243,50,35,56676,14146,42530
2cf2278b5a66bb9996f74179f363543a,93,43,101121,40024,61097,101,59,133029,38253,94776
bd738121f215325191ef0b27d094c7a0,107,83,239477,73079,166398,146,102,378335,48277,330058
2950d10be1c12e65cb2d0ac95d40e0d6,39,29,28732,9108,19624,36,29,19833,8729,11104
058d2de560f7864e870e3d9932bcad76,49,35,45545,11651,33894,49,35,59771,12221,47550
d84abbdc6ad151ad55e2222ff6014ca0,108,81,208078,43058,165020,103,71,241403,40462,200941
5e2e1e09429603accbc599cc85707fc5,98,71,160817,45263,115554,132,91,237982,43303,194679
23b4bf034f7925690b250245c7efe19e,67,45,99291,25552,73739,69,50,46804,26615,20189
f95f3d5c961565595f16b1ee5379a7c4,24,19,10585,3659,6926,24,19,9338,5074,4264
1ebbecf19587ccc08b812b7e15f76c2d,97,82,197995,45170,152825,72,57,132524,41647,90877
69e2d8b41abcfa938e72216f8b8212eb,33,19,21124,5211,15913,26,16,16202,2137,14065
e9467ba3ea7a0c7e53b8a85286a6c3ab,128,85,379823,74788,305035,191,147,564410,96446,467964
1699a2eb7c9745b379c87363cea100de,136,107,304261,81887,222374,141,94,289404,70026,219378
4d84c063c4d8d8bf9af8702a470412fa,73,57,108632,30780,77852,89,70,139797,35055,104742
3cf8c1f0cabb4b55a22978468725e99b,103,95,302483,72388,230095,110,82,212673,54251,158422
328a577f7752231af7900983a97907f4,155,111,351732,83437,268295,174,139,496088,66561,429527
b77c9c44ef46ee93fa43b489016d84bf,131,92,352806,100918,251888,121,95,308011,136155,171856
40aefd07e8ff6be13d8453ba82da7f9b,170,128,489151,128210,360941,141,124,474382,130090,344292
9bed9a2489c233c31c04a1bb7bac72b7,139,90,328050,107310,220740,166,136,414487,99894,314593
97e25046dfb2c9d24da4a0e8d47bfaad,54,41,36656,17725,18931,38,28,30111,13557,16554
dd79a2440bf527c4ba222b03329a8b08,111,78,277134,60801,216333,115,101,256172,71255,184917
c2c36920c506cf448c35c452addafc69,84,67,96357,24344,72013,77,64,86235,21351,64884
f7ddb0895796e0202f3fedbaeb480480,72,60,86873,35236,51637,107,82,142765,20543,122222
b7a3d9b16a624897e53d8154e1058204,82,68,119269,28865,90404,95,66,207666,37320,170346
9e5b71c7903650c286eacbf0f595c2ab,24,18,6299,4060,2239,24,21,8075,3346,4729
a9ca6226f3d750c056302d3c46e03f06,140,96,295871,49664,246207,118,92,171656,59439,112217
66dee79f8bec69c0a3bbc25830c8686e,53,44,50185,20259,29926,45,34,38481,18405,20076
a53377df7eded3a8e00b7ae0e12f36ad,129,92,279783,70891,208892,147,114,291731,79208,212523
81f9940ca58eb679d5ffb76be71a3c4f,140,102,415364,118471,296893,147,109,365086,103568,261518
0c1d5f10a55ac235ea796d8359c8f03b,161,91,313512,55613,257899,86,77,167445,70811,96634
5192f022cffd54e909b7623be67d7b48,93,71,154696,39476,115220,66,55,86121,27306,58815
cd318531a9016b3da290b62255b8b19e,66,51,80241,24941,55300,72,64,144928,24724,120204
6530d968ceafdffc9080a6be63cbb552,83,69,175510,54397,121113,79,59,132336,40089,92247
2c8e744bfbcc2a7f6c1c6da37c86fe2f,33,26,16975,7022,9953,31,29,15368,8153,7215
3d7b12f9c25db5e2415861ff439c8804,132,96,376786,129721,247065,166,121,535640,85600,450040
4928d4d50f47ab2bbe37c44bc1776ab0,134,104,265920,47775,218145,105,83,196693,40981,155712
4706f902ea00df5a2a66a20b11374079,71,59,101207,30380,70827,80,69,145200,25279,119921
0033b23e6ff50ae2a5ed9cee18eab7d1,60,47,42282,20600,21682,59,41,66092,16456,49636
382b2dfd6f36d741ad6cb29c39f62efe,178,140,510565,146233,364332,140,97,378295,119524,258771
f4eb1ba37bcc7a7ba09ead01342617d6,157,121,1021599,144287,877312,229,145,827265,109535,717730
04c9b8ab6ba774087642d7e06097d329,38,32,33556,9785,23771,50,42,38079,11820,26259
52d74e744a1bf28a6b438d3484016f2f,29,25,21719,7738,13981,27,22,23253,8151,15102
c9b04cc4ccb9a16c863898f87949fac4,89,77,152923,66211,86712,134,74,218046,76518,141528
f84e36257ba9c4b0a8929f25807f613f,54,48,67839,23397,44442,62,47,111416,24360,87056
38bedde234074b2e6ad856af818ba4c6,86,69,145357,33356,112001,82,62,142896,28812,114084
8d82122aeff4846fae08fcc5169380d1,83,56,111785,38176,73609,95,72,174553,31727,142826
c4c4ab1f969ee8db9f91772156984c48,72,59,105637,29528,76109,60,48,75646,30413,45233
bb30627cba8151a8db189351872af43a,30,27,18054,5365,12689,32,32,12817,6901,5916
7509097762b88ab25ad58abed322144f,38,26,28697,12679,16018,47,35,31499,12000,19499
cb3817e13039a145db24a80c9b54915d,15,13,3114,1523,1591,13,11,1905,2009,-104
2abe909518f720f3c8965712ea858e75,138,105,354923,69938,284985,151,112,349413,64311,285102
19d35774d9c66364dcc70064563c9cae,38,31,29574,10173,19401,38,32,23614,10702,12912
66d20fe7479332c5dab84a6f7be43a13,159,117,554917,111394,443523,186,162,685169,90821,594348
82a3ba18505ac973553e5625edd5f7c1,226,139,991337,128637,862700,213,167,1038993,158015,880978
d80719bd7621b665a8259319dc6e63e8,142,104,312641,50307,262334,151,131,354150,79893,274257
334696d27dd0708fab11b0d65a431ea2,23,24,10399,6161,4238,22,19,9753,4806,4947
7cc5e4a8c8dec1b34c717abb790e6819,25,24,9607,4354,5253,26,17,7615,4711,2904
50e3362af06ca367c5f5505845663ebd,125,100,229573,62418,167155,88,69,161840,51110,110730
07d6f691c7c855bcde51aea7fada9a41,146,101,469801,87318,382483,167,139,567275,121061,446214
b204b0552cbda0c14f7e2214ed9d517c,44,36,37088,16318,20770,43,34,42708,11527,31181
620acf6177063678df518bffde138e2f,181,136,759020,168504,590516,216,139,872491,118524,753967
07d327b34d9609b1d56f5f6d97c29bdd,156,134,731706,147355,584351,157,116,769371,160533,608838
bc1363bd7f29cc9d00e763582c717f33,87,57,124645,36167,88478,94,85,169441,69221,100220
3bca890694d076e672a7d968ae0a08bd,78,66,176326,60269,116057,102,76,234742,55085,179657
dc9686ddb27ce1b5f33da6688a7f6245,30,23,21263,6409,14854,27,20,14746,5595,9151
be2a1bcb0ab2c76f33451da07ddfac74,29,24,17916,5630,12286,32,24,10505,4474,6031
64000d7adf9afa7e00a2b58c4fdf0e9b,38,27,44034,11295,32739,38,30,37626,12762,24864
d685aa1c28c9f977d16d65397bbff8c9,118,90,307117,50464,256653,105,75,235810,60369,175441
e96c16572c42cb77360ec617d8e59271,209,175,1148811,231213,917598,245,147,843115,145052,698063
ce6e3bc5c96455c55a19d0bd5618e69e,121,98,339894,61247,278647,117,90,254968,52692,202276
e821599fc3607284f4958c918eea13ae,4,2,382,166,216,2,3,166,335,-169
6e7f0fd458f2e65847ecff5f9799b6c3,47,31,66478,14766,51712,57,49,85205,22835,62370
fde7f685944ad6f092d758ae8ee894dc,1,0,101,0,101,1,1,53,101,-48
6cbc72210d379b4c03a885dc994cbbd9,121,97,274752,105095,169657,147,114,384308,112330,271978
c6f943899401fb722b6889cbe10bcaea,14,9,1605,962,643,14,9,1778,1085,693
3eb72803bf9b072f8b61760386951a22,124,100,496844,70125,426719,201,168,542636,98633,444003
75df190c0089ddc6f28ffaf44e7ff8eb,171,135,537148,129387,407761,188,128,469981,107068,362913
991cd9b82541590cc808a79810c45992,124,90,317918,85759,232159,69,47,137569,88533,49036
f9dd81523821d3d9644be320ab3982d6,179,136,591737,210693,381044,184,146,654108,130626,523482
8e5d0ea9e5739865818e5476cc213220,172,94,410540,60152,350388,132,101,351283,111519,239764
bca80fb914cc82326b6c798156df6d73,50,40,49732,18260,31472,51,34,66371,11101,55270
0dd3f40a0b616d7ce4caf2ec90d5e0f1,88,62,122700,24952,97748,71,54,86250,26084,60166
5f9612b8241e84fac132f6f839aad695,86,58,125165,32488,92677,73,54,90853,36308,54545
b65f32d086906b8cdd5727b14d238590,196,146,812862,155789,657073,180,126,623995,251582,372413
1d191a95e0377d820a5c25c9588b6c54,83,66,202169,55335,146834,123,102,272164,49651,222513
0777e0e22b908803e85b00807eaca165,71,56,106364,33490,72874,96,61,136665,25403,111262
3d3e48d6bc36834d8273f12675855bc6,156,130,542738,101268,441470,183,151,548843,103120,445723
2011395b1a3b3cab6bd9953b06b7d883,53,40,54063,22932,31131,53,38,58730,22261,36469
fb9501f71601719bda55fc5e4c65cf76,135,94,362615,81557,281058,168,147,441598,87247,354351
fd7d123ee7670da796593af6cdbe2092,18,13,4984,1439,3545,21,16,3201,2625,576
7db3cb6166cdc35b326ed7e210d48ac3,156,122,727009,112063,614946,140,99,299277,103858,195419
23ade61f698946c2fa8d88851640261b,70,51,95095,22099,72996,72,49,101363,28249,73114
a83ce23e9c850605153344d1025f0e7e,139,110,446497,158904,287593,198,137,634341,117221,517120
1bc42deb8ab0f34ed319d0560cbc45d0,125,107,350218,105283,244935,137,84,284708,75037,209671
2d917fc01d66f07e4172486e6fab796a,120,88,308614,50204,258410,91,69,167191,41338,125853
f6ec7abaf8c69166bfcb1eb4a0794812,144,111,314664,70459,244205,115,85,301663,66927,234736
b93a8ef3e0f2d194e302df0c0a116d0b,103,83,245034,58545,186489,117,100,249903,54716,195187
f3e3f105e3d4379dec58cea2a77d09fc,116,97,287694,93898,193796,115,81,322924,86386,236538
7779d70b77ffb346da4ed0e53f7e3521,59,46,71366,20115,51251,73,56,94100,26790,67310
7342e122aa5a33e504016989d17bd564,197,129,535181,117264,417917,145,111,438145,129274,308871
d2cd6bada16878bf9a3331682e099f03,131,114,489280,130397,358883,177,136,555111,94051,461060
b2bde4f01c0d0b378cfc42e050a2e5d2,92,81,235535,79584,155951,113,85,280737,49942,230795
a88063eecede68938c1ae2752c6cc0ce,120,99,266134,68404,197730,124,96,320013,57302,262711
b0838f3062f9cb1ec9e9bad11f46f0a4,142,109,491163,102108,389055,165,141,542855,87730,455125
bd0cbbe44220321cbbc2db10e7496635,49,38,61684,13673,48011,48,44,40740,16355,24385
c8a7f078843811ce3505663797666b51,92,76,194317,74509,119808,137,110,276004,66966,209038
2e2de89e23bbf0cd5b24cefe8d3a2a7c,50,39,42928,13107,29821,49,35,35741,14574,21167
edb2d9a23052987a10a2217c1d696849,54,40,61297,30227,31070,70,52,131925,32782,99143
09fbe968400e912f74c437ab790d1b42,99,75,133255,28343,104912,76,59,127640,26135,101505
73d3dda88e521b8c8564934d6a27fe27,137,103,316055,80723,235332,94,77,235921,70233,165688
6100bb4fbceb3753139bc2490f82677d,28,21,9863,5087,4776,25,17,12619,4833,7786
7579c60b70b500a129c19a8984f9ca28,150,94,372376,64432,307944,127,92,295577,86830,208747
b6280f658de97419865de613e79f8b09,25,21,8717,3458,5259,27,17,8622,3098,5524
babc42a3b24309112f536b0e1321a8e6,69,53,103034,27000,76034,87,51,123660,27450,96210
923f5ac3e8a39f406d07248923d3a9af,30,24,17250,8487,8763,30,29,17544,8997,8547
283f125e3e03a52e5e5e3a7c0ac28576,67,64,75579,37598,37981,54,45,70598,19354,51244
4a44e8a0ca7dc23b87307f22e055ee16,79,57,156690,45109,111581,126,99,247933,44894,203039
5f66b830690f0a9688e28e6ad99c194c,20,19,11227,4120,7107,24,21,8175,4974,3201
cca3b5d4d6cb3b884ccf734b25d46e3d,146,107,501096,91158,409938,148,127,542910,112452,430458
bd3fc0bb718f9aa23891052bad90e847,74,59,102600,39671,62929,84,76,156126,37958,118168
db8398477f49d4acc4a674bbab2903da,134,114,223588,57333,166255,99,77,190857,51428,139429
c91544c7227aa730451dbfedc0c8b7b9,135,96,332121,84612,247509,158,120,357562,73660,283902
ab8242aa4a86ef06b11951f2248eb8cd,34,27,32512,12237,20275,34,26,35701,14226,21475
8d445d6de4ec98f7d888ef76a3974173,100,85,260318,92332,167986,113,83,233102,65158,167944
ab5b5de427dea844787807f9bcb93894,82,75,158811,48453,110358,95,67,161274,39784,121490
4e5c0e98ecba3742861a926d68e1b14a,12,12,3041,1738,1303,15,13,4357,1665,2692
2658cf6be17e44600a04c2150e112c1d,49,31,74214,32507,41707,43,40,88691,29244,59447
50db37a8f149387ce2196cd0ad33f460,162,107,332036,54488,277548,106,92,268673,88253,180420
58126c68a9e2c72741051b61a96e7c6b,18,11,5193,2303,2890,19,16,6776,2906,3870
5e667c1bbee745ea5744975136128894,87,71,208716,58644,150072,145,123,330464,53293,277171
ab7bd9db26d9c535d60ffb2699d503bd,139,102,260467,92326,168141,175,112,382643,81667,300976
33820b931e21f3ca78bab8be79636e01,102,82,195455,39233,156222,80,70,127199,40394,86805
8e335b8da23ac44d8075b51cb7cc5139,107,84,204383,76728,127655,83,87,177209,60602,116607
0d51247bf85b7ed466156c85a23fb9c2,157,129,492166,158074,334092,133,112,485706,152373,333333
2f8d10ef9f8b92343b6e3c82dc1c8fed,164,118,415650,81070,334580,157,114,382329,108202,274127
81d00910ab87c464ba5ba54b7009a835,82,57,141504,25824,115680,83,51,98340,18869,79471
02687e0fc1598a35d9ced9cd3ba21a21,45,38,94071,21562,72509,53,40,59226,20634,38592
31c764461d887232b87b2609fe804df2,126,99,315226,104966,210260,105,82,195098,69438,125660
17ef76aaf968570ad7f0f807c867ddd6,162,107,321176,104308,216868,168,127,547898,99229,448669
fa3b1964248060e0aaaaa5cce0dcd4cb,188,147,565063,100060,465003,164,138,530258,109439,420819
d5d3c5ca774d9d81033a66cf7f0fae59,52,39,55991,15158,40833,56,43,52411,18441,33970
2abe9242de1d9f90279811b81b429e93,209,169,1092575,197522,895053,216,163,832134,242775,589359
75364f6f7f6efdb7a3a0e486c89255cb,93,77,235721,52195,183526,143,118,296284,65164,231120
00aa313bd7eee816ad73364ce209ee81,119,101,316732,71048,245684,133,118,312665,65774,246891
1883962f885c47e9788368c1cce61de4,105,87,253236,65685,187551,189,128,431233,68676,362557
c588cd61d51c89b96337b3c4105b5b04,90,60,132627,27894,104733,75,59,129107,34782,94325
9b901988ea50714fda21a8e4d547b7a6,40,32,33716,17192,16524,39,24,37435,12630,24805
98a1bc8247aa30ae5f24d14634c31355,57,44,58684,13047,45637,49,28,43510,8888,34622
53789f92bfee3951d079dd74b63752e1,9,12,1204,1651,-447,16,11,2051,975,1076
36655272c2ec8cd83b872fc8639616ba,107,76,156569,52660,103909,99,68,172495,38272,134223
cfc90657851adb9069d1eef0040d1447,55,33,68616,18965,49651,49,44,58762,24636,34126
162d70ac3aed3e8e248e161a11369565,51,32,63567,14191,49376,42,39,47195,19379,27816
682c4360542f95e1d832aa7a177931fe,108,74,297482,88829,208653,155,122,317676,92178,225498
34752558f98d1c319dbd542a227d9daa,51,42,47315,18212,29103,55,53,64625,9860,54765
43fcb6120134cf497a93f28c798ed5d6,178,149,824150,181644,642506,184,140,1249931,149039,1100892
7e43eacd00c60407cfc512845683fc40,10,10,1996,1709,287,13,9,3724,959,2765
3a6bb84221b136f92d4fe0debeaaf5f8,56,42,69734,15089,54645,37,28,39402,11288,28114
cd1873043e2c50f46e6d2ee094698ce6,45,36,75955,18626,57329,50,35,53918,21071,32847
181645ee7c3a72f8b31e2787dae9e785,81,68,143453,33641,109812,95,52,167593,33715,133878
44d5ae27fd2c5bb6b5dc60a7b8c93183,52,48,79405,17249,62156,80,70,106688,23748,82940
3ea0905767e741a768c2162619e87aa2,38,24,25642,5114,20528,47,39,44474,9678,34796
705dc80c8f17a7b4e33fddbebda3593a,62,56,79539,37835,41704,65,45,92768,24639,68129
77f92ab2f8d5aa6c1c0d271014bae063,180,109,621593,120741,500852,215,174,827519,110977,716542
ff5ecd47e2e749b6886743a9f8d0ff94,136,100,450238,142667,307571,166,132,422520,162234,260286
08c9559f6310d6bd8d5782701c9f9cf4,95,86,212046,51360,160686,93,83,199028,63572,135456
f53d3cb110b6f51661df1b899babd79a,152,129,427965,64637,363328,138,108,352078,50474,301604
bea6e97d51263b7e2c8013278dca5db1,56,47,66551,26546,40005,77,54,76475,21091,55384
fe0d1795c2cd6ca5aae5d4689e828480,100,72,186023,53335,132688,110,79,269277,50930,218347
0d17eaddb42f1f533376ea7eb2387008,20,16,9386,1874,7512,23,18,5923,3617,2306
aeec86e628f6a46c959314b7c7ab356f,22,17,5431,3185,2246,18,15,5728,3061,2667
2b40610368c4a0d2c0dc547d95391a59,49,30,67392,14379,53013,54,33,61537,19091,42446
b8db8e9ae34912c2e07f1c68b93d38eb,110,87,212717,88848,123869,147,109,361581,70531,291050
9380b7b9b7a4839165e89ef02721da29,51,39,99372,33185,66187,62,34,92055,27605,64450
7e9c34342fda78f2c1202549b85a71e2,78,61,84364,29657,54707,78,60,76992,26588,50404
36f2d05f1ad960f6b38bf19d21f15674,200,148,1328023,262731,1065292,216,152,1304661,258117,1046544
1995e3ec3b0d220197ce103f4a37bfbe,27,19,13756,4024,9732,19,20,7998,6323,1675
87cfe31d79b5ea9793d47a396f660097,108,73,169872,33140,136732,110,73,188403,50961,137442
63efe43389426a9b8900fbe823552e89,52,36,52325,18826,33499,42,41,46903,20372,26531
151878fb35fcf5ab8a4fbb9876acdf5b,42,32,80567,15371,65196,44,45,72113,26722,45391
7e740ea68647c7dad93b7143669036d5,179,150,912423,179051,733372,177,146,1294215,139378,1154837
7889571fe913a54a74c0172bcd9f6a05,75,64,92997,34202,58795,71,45,119621,26128,93493
61525569c77cda95927e3806b1c207e4,14,15,2763,2397,366,22,11,3774,1488,2286
ad12d9d627918a4fbfc95bd328b942fb,63,57,142308,57344,84964,107,91,226213,70712,155501
32d40705b057739d1531ce6c6f3ad40f,80,65,185514,69562,115952,112,84,287023,61039,225984
bd64ae17cf5d5402177f77b7ca8e8f42,54,38,116752,22246,94506,44,37,66609,22879,43730
b636885088801956a1bf10b75b415f47,62,56,126420,31063,95357,99,81,172764,45765,126999
d330e1582dba660744740766c70f3bf9,106,97,199447,40347,159100,110,88,198892,41563,157329
bc015d7f1efb3c0655ab9911bb3814a5,82,65,138935,39410,99525,77,67,156947,46846,110101
f3cf57c4a537798098863944d635e6d4,57,42,57903,21639,36264,67,48,56652,21522,35130
d9237286fd33bce5e15db7a9cedcb7b6,60,47,65292,16030,49262,53,50,82341,23753,58588
9c919592cabc49701fbaf0f187148607,93,79,109272,44947,64325,122,93,215536,45603,169933
59fce9949876be5c5ebf977fa34b0dd2,163,119,500133,127838,372295,193,127,613954,128853,485101
6eeee150ef79a257fee48b8081c2f8fd,98,82,163059,68748,94311,122,70,216884,32663,184221
5a005a9de2caae34a60e4bf1b46cbe05,144,102,285122,71000,214122,107,85,254076,70041,184035
922eec0e94b8cf84ce0d334ba2afbeed,102,83,290668,88432,202236,162,120,400721,82240,318481
c6419fde9b09eedb2784017375d23d64,140,103,522767,115187,407580,147,103,499645,102202,397443
87a0698cd172fffcf16ba83bdc65dce4,107,103,262622,85103,177519,150,121,316565,57195,259370
0d38ee05f91271f47bd0e780ed6d6c76,163,130,433397,93163,340234,134,103,385785,104050,281735
a071d3bb030a31ad901f0b6b022cc537,91,56,153013,29190,123823,81,63,114135,38148,75987
f6625bc8b188dabf912d3d07e24455c9,108,76,195647,24784,170863,78,64,104206,45270,58936
60420a092e382323bd04151daa76e968,63,50,65944,22976,42968,66,54,92328,23294,69034
fd65115246508f9c8633413c8224793a,46,40,62050,25124,36926,54,46,76403,26366,50037
c8cee50ec6ea89deeea505fe59674772,10,12,2984,1191,1793,14,11,3873,1093,2780
858398617dca2e428cb667d55cd8b6f6,199,137,961313,112667,848646,192,147,786638,148790,637848
b1c46bbbc80060b6692160372c5e3c98,37,36,37719,11959,25760,42,33,30813,13389,17424
89b6044dd33828cfdaefae6c92a6d8cc,61,47,79442,25000,54442,67,50,94064,24534,69530
e9a747bb8526562f0a7944198d5449d8,88,71,173869,56208,117661,120,98,304607,70190,234417
b369614ad91886b6e878750837dfd2af,73,66,119693,36859,82834,43,31,68691,19105,49586
93518e742216814a95283c14160c43e8,36,33,32109,12120,19989,37,25,25392,12191,13201
26a99da4c4c9ceb8644cef964e22757a,97,52,170484,39764,130720,83,56,110378,35787,74591
5dc18d047430091c572d66f5a4fba017,22,18,8283,2485,5798,16,10,6061,2550,3511
bd7f88d73791b2811e69edc2eb5154bb,71,60,116125,25431,90694,56,44,80188,20550,59638
0da4ff30a4457d429a74f158c664bfd1,75,53,95120,21255,73865,67,54,94683,25693,68990
b085b042582a417d443c8e7016185b1f,144,112,476628,93652,382976,182,136,672586,89759,582827
a54151dabc3ce8a17f752d7c8d800f7d,66,55,83314,29358,53956,39,31,60560,27577,32983
4b4eb67b18a7d198a1a724c61d1accd8,107,74,202232,64758,137474,113,78,236190,62306,173884
87d51e30fe5ba920d8b10a19b49402dc,5,3,704,727,-23,3,3,684,560,124
6f61ab914eeaf885654c3e77e392afed,151,101,416600,103306,313294,112,107,450423,116431,333992
0e0fe56c313f5217666de9158e97cc50,97,72,118730,33649,85081,86,66,103918,28193,75725
051e6b69083cf47673cdae27b5aca614,121,102,264589,71968,192621,163,134,462722,90529,372193
e54841238074465de3d267b86a03a9d4,37,33,46229,16278,29951,28,28,34836,12750,22086
2880e32a4cd0084efa8628c49f00749e,33,31,15996,11529,4467,36,25,22471,7538,14933
5cba2cacf5302abbebfc695c6d8c224b,123,92,328930,82873,246057,153,133,491511,82314,409197
78b0f2887b65ab8e039f09796e1f7221,210,138,697357,88870,608487,143,121,372789,116321,256468
1bc5e918312f394d7c6a31b6fba66ca6,123,91,216043,66217,149826,120,86,237780,68053,169727
230ef1d1b05e637f580b1bc062cd03e9,166,115,371640,104667,266973,208,146,481995,102828,379167
587f2bc002136652e94c9d9f7331551a,39,27,40288,9870,30418,48,40,46095,12949,33146
ca2cffa2cfee670a6f16a5542673264b,76,66,132876,28318,104558,61,46,85345,33365,51980
2c0e2edc60ab54ebb7f4dc0c0e3e4afe,146,100,387276,55814,331462,136,102,332987,59237,273750
8aea15ad2b27faec5e9342fd3d1ef86a,27,23,15138,7837,7301,28,23,19199,6707,12492
5b34906fc98ec1b9f574e13a9ad625ab,77,65,122825,27023,95802,95,65,112262,31128,81134
217305e6abc4abfaed07a71134a4beb8,58,48,49877,16997,32880,47,37,33539,17159,16380
49c1a7879344adc5acb9ed21661878fc,178,120,465317,109392,355925,144,116,421735,128582,293153
9cc5f43fa5bb1c4a235cac8c882be861,144,124,405461,79327,326134,159,142,432672,74204,358468
0543b075cd727f9e8b8a48f29480c6c6,66,44,72480,15046,57434,64,45,69668,15639,54029
f83faf0a26f968ddaadd82d280ea8f78,59,38,57375,14699,42676,65,47,69163,15078,54085
93bf5b81057d16ada788bdfa2a35916c,127,93,355423,77558,277865,158,132,481559,104177,377382
0f51e541ce413ba8ffd49a63bc12643b,10,8,1116,590,526,8,6,965,568,397
06d1c713bc70c0a7b43292d98a524e5d,129,107,342063,58320,283743,99,80,208705,63987,144718
bc11c1e61dc80517594685332fb6b01d,62,60,101825,26714,75111,70,64,133200,29860,103340
95d39ec6ae1215bf297a05e09a9534c5,160,123,466889,96339,370550,120,89,324259,121599,202660
1cda4206beee897add22652c7d29b5d6,123,96,221712,78407,143305,146,116,232172,76012,156160
db938d0d2184c2c2b4919105f99dcf70,205,166,913761,178516,735245,184,128,817403,165683,651720
06be291657c94acb3a3a05b74d8360fe,199,148,573205,123372,449833,165,102,401879,76830,325049
cd42202dcb58ff33b103be75823039e6,54,39,94567,13908,80659,57,48,76643,26021,50622
2ec8dd94c27d0a3310b3def096aaeafd,92,76,141123,54119,87004,91,72,140646,35593,105053
10cf59bfcff17523dffebc2ad9e24390,42,30,40981,11713,29268,48,30,40635,12197,28438
7aec275cdafea0a6f2de0c156f0fb855,78,57,96615,33633,62982,97,57,151861,28180,123681
ff5375759155101439d55ef826ffde07,157,101,505495,83690,421805,178,101,493381,75864,417517
d5ae1e640f95d04d83381abadc04d304,120,90,214338,54027,160311,118,81,171166,40579,130587
819c706bae82878588aa2f4aeff3c127,28,25,23970,10016,13954,34,25,26236,8112,18124
1d5c8a551bc6c23d737a91dacf9cf2a3,179,123,624318,139515,484803,227,139,678710,160145,518565
a7f89ffda7ec2764d85e5d6d21c5e9a5,27,24,18895,4396,14499,31,23,13159,5503,7656
890f95cffb74f8f95d4409c9afc3033f,30,25,19328,7548,11780,34,23,23862,7954,15908
25099628dd1f0bb644395864d15b70e1,41,29,42217,12860,29357,30,24,23374,13869,9505
20b24f19de34442a6e166a699e98a61f,29,25,19135,9648,9487,34,25,29345,9169,20176
d72a92ab2287011139061e8399843678,146,106,411472,62593,348879,170,114,422849,78079,344770
bef1b81101ad520525dacbf0a58b0c67,225,158,820757,159371,661386,212,173,894399,231413,662986
ccd999f848acfe426301f02bf456c103,18,17,3527,2808,719,26,12,6015,955,5060
efe8b7dbd0494887893267be5b9adbae,126,87,220169,77174,142995,92,62,174477,67579,106898
928b631b7370d8e966cf3679a05fb762,31,23,15286,7677,7609,39,30,24978,6454,18524
c3eb91327835eff2023a688906ef7809,203,162,948122,183371,764751,183,146,1027755,151383,876372
3c73993066eb437379e4c4497a86d8cb,120,86,370714,80791,289923,194,164,630908,107728,523180
21c7fdfd0b71743d8ab554608ed862e2,179,145,729261,84226,645035,139,89,382785,96829,285956
d1e4eca30049b1277c7e273575d3dd3f,96,81,193747,53696,140051,112,91,234078,48555,185523
054c320b5a82a0648e24b6dc3fec4240,12,13,2524,2478,46,17,13,4457,1339,3118
8c8ae1ce7eb382c1a69a6bcc9014c290,117,94,216665,55809,160856,140,122,238767,72578,166189
8be977dafef34618e543aa3cf874e61f,64,56,85715,28442,57273,105,71,142073,24498,117575
e38946275a7cef65386ab5482df84d17,44,34,31517,14405,17112,56,45,42033,9066,32967
502535071a05713085ea60e4aa22dfee,51,43,31697,17307,14390,36,33,50876,13780,37096
38e5df045d467abb6f3a85bd9efd62d2,41,32,35177,16054,19123,38,28,27954,12324,15630
b0519c939da9fcb6904b028c425add2c,77,50,94682,25640,69042,59,56,87025,33884,53141
85112e462d7fc71bb78c098f18b8451d,59,46,69415,23781,45634,57,52,56195,21940,34255
4fc93877459b90a963fba8444a6d0ac4,117,95,300693,107021,193672,146,113,468770,61761,407009
59d6aa7ee4ac4c42d4353c30049a3254,80,62,147983,48246,99737,99,66,148982,34771,114211
5c64483d0f2934b7ec4d6356cac466a5,83,68,97788,35820,61968,100,82,167530,37530,130000
5272d4f6413c2b1058167811fb8ea13c,135,117,310918,73913,237005,78,60,213398,55772,157626
afba16053073f7825cd56dab1835aa17,107,93,266213,66237,199976,93,78,176952,73746,103206
325ebcbfbbeb578ad09fbd097d4a20b8,87,61,145060,22662,122398,47,47,49409,29501,19908
59047c4eddb450daeb751a773dd787ae,15,3,2898,739,2159,8,12,2503,1227,1276
3f3c7b1fda672ca2d8777bf4977fbb2d,67,47,110204,22913,87291,63,57,79325,30993,48332
e6d321ff96bc908ff3650d08db9de6c4,46,33,63894,18126,45768,59,54,59707,21826,37881
93bfe81f9b85f907c0ff5cb90dc0a1f5,175,114,317741,79524,238217,150,109,344676,79631,265045
e8433ffba34b33c67bb386a65e5699c4,68,51,103737,19636,84101,52,38,56588,21109,35479
05dfbbd85c2e9ecc666d8ee056a45327,81,64,151108,42414,108694,83,69,142272,39559,102713
2820af43e6191fe63d8cb68938f9b439,95,83,161044,47594,113450,95,79,207024,47126,159898
769f6612d51f773eeb20c6d053ffb9d0,138,91,391884,85808,306076,170,132,386731,69358,317373
88c79f7060fba12edd4adadc25524e28,24,25,6881,4937,1944,23,18,10773,3253,7520
f21185ebd38e1336ad97e5fd13067d25,27,20,9754,3635,6119,29,20,13694,4299,9395
b6aa05bc8b006ca32cb3dec97b72cb11,29,25,18062,8482,9580,31,23,17383,6598,10785
8fae96974dda975301954c5be78a8007,99,76,200939,44142,156797,127,110,286333,64970,221363
91b17db4390ed993cf0e0e314eba5116,115,92,328926,86973,241953,142,91,355656,64816,290840
cd41ad83e5eab5a35c4b8c3680fb1d66,89,73,219162,57631,161531,100,92,205606,82506,123100
c1552bb4d2da6cc67a1f801857863a3d,39,29,53914,20592,33322,45,31,56499,21183,35316
74da363b4d70eb56b1d286cb7a45283b,91,75,156362,35272,121090,79,62,121682,37234,84448
b57ce20e0aa39ffe8fa0d6d6b5456dab,153,111,350184,75371,274813,152,120,449672,96070,353602
ea7c2cf760cd5e879cded6a418f61f6c,164,116,419323,119675,299648,132,108,401667,105777,295890
cd2d900f2886f4370698cdc6c38e165b,88,64,150180,26218,123962,107,68,168572,35801,132771
7d274c0da8034ff4044218f1baaf472f,249,152,1204857,212611,992246,219,151,1147565,210010,937555
c649cad7020e973f9aa92214566d7f2a,112,88,288258,56145,232113,117,84,193420,60226,133194
c15c490b33387cc321dd63ef8e29f86b,109,99,264241,84726,179515,113,101,274887,70684,204203
a2dcf9e5ce778fa3a2fc73cfdf24ca4e,44,37,31076,15122,15954,43,34,25571,15204,10367
f834f79514ece20226fe285cfcc29eff,50,43,65065,22541,42524,55,47,66224,21906,44318
61ea230f1a1a6c7f2ab970885d41e96e,119,80,366665,79369,287296,160,113,536368,86232,450136
1e39699b67acc858182991fb8401d949,146,107,495309,68132,427177,140,97,308442,68519,239923
0f5183a43cc9b51afed8e430e8a65d2d,146,123,551319,115276,436043,148,119,397333,118542,278791
9ccbdec4c38543cd3682ee6a05e096ad,150,106,418349,58021,360328,125,87,286346,81184,205162
1385192cc33f50141e69aaed88209a12,168,128,478202,124338,353864,173,144,659038,76706,582332
7894938285113b1b303343781a6b4876,20,16,4067,3060,1007,17,16,4034,2479,1555
a74669878d63ed6be402c152f17fa8a9,83,75,147076,33604,113472,78,54,105799,21904,83895
55f3d04ac9064918537a736b8cdec223,21,17,7491,3533,3958,23,12,7110,2183,4927
65c6eb906bb61a3b42586d9616f4dee8,25,22,8687,5032,3655,25,19,16959,5572,11387
b31c089780e58ced730afafd39097356,197,141,640926,75952,564974,193,133,555430,115934,439496
5b2244ad48ed4752733ca0b7bd0a3bbe,31,29,21880,12568,9312,38,22,31573,9618,21955
34c47d7b4b7fb59e5538946fd7ec4499,25,22,13117,5821,7296,27,19,12500,3576,8924
6445f5e7df2d846c05a98cb5beefb955,100,69,352604,108841,243763,170,113,559462,75666,483796
85dee4c3bd8987381b9c30da10ff55f7,140,103,229965,50546,179419,116,92,312877,51223,261654
7f247202b52d01f7cf5b0224e65e4c91,68,48,130110,35334,94776,82,55,123591,26370,97221
ba9fa5a9c34a7d44c54224355e032a4c,64,50,87913,24693,63220,45,37,71609,21400,50209
de81a39e59baea16c4ab088c1417a394,50,42,41443,16406,25037,56,48,54649,16964,37685
a33050c207234242a7d60ffa29fb0896,90,75,118940,30595,88345,118,99,231085,56419,174666
9240cd9049f8c6ce742c1228b39a3257,26,26,31745,10050,21695,42,34,31176,12589,18587
57c95b59d47cdba0faad703f25bcd1bc,115,82,260157,35892,224265,97,82,165255,61791,103464
9ef5afb4dabbe0655e1ffcb37914f6d5,177,114,471612,132121,339491,185,130,530647,119623,411024
5a8509a2075d4fb03f2a4ca5faa298c4,126,113,351920,83554,268366,154,119,416930,94132,322798
46116f2d79cdab0594004b19606fbc15,181,123,715641,167398,548243,189,116,811533,116728,694805
a00ed1046b5ca754a2c6abe45fe9d4d4,27,23,21626,9218,12408,44,32,28533,7523,21010
13464bfc4f962a4c13cc3195f6d495af,78,56,117226,27652,89574,73,59,88957,30240,58717
a43d121d7112f2da6a84266fbb1e6034,171,131,463199,105999,357200,124,103,392274,118747,273527
d0c9e8d4f77f22134560b46be4cf67cc,36,28,29877,12983,16894,33,30,31255,13281,17974
1d1797a3b83306e261604ef18143fa44,156,123,366793,68804,297989,140,104,323941,65611,258330
807c89ba0b6b8794ab9d2be0fdc4205e,142,95,357070,90894,266176,170,129,383031,98518,284513
fd22a823f18c091e8bab821651cd55e8,112,100,224806,57395,167411,97,70,186495,50761,135734
9b7a8f46b19b82affdfc9c954ae2fc7e,39,25,42430,8858,33572,34,26,39555,12863,26692
36c5f0ab2c92288fcdafca84726081f6,147,100,362809,107631,255178,156,119,510460,132030,378430
7b8d3c44a367107f24323d27c96e9212,70,65,89466,42301,47165,91,76,145670,37421,108249
6e79f2d89f2766548cb71bf1fc5ca71f,78,49,183633,58559,125074,92,68,190526,43178,147348
069973272eff0bc8b589a38f8229f0f6,80,62,170237,35858,134379,123,101,264747,57632,207115
734b27a674aad7cde0f5119d8f6dd13c,157,132,453866,72160,381706,113,100,310682,93627,217055
8f76f84c3cbf1908b828b4faf86c0a6b,113,83,385245,72397,312848,189,143,533917,90350,443567
cf98bc1973fc088909191e72fe229144,132,112,440174,123603,316571,155,120,603142,130099,473043
900b573d8186ba3468b620c852ce352b,103,70,183162,47662,135500,119,79,177759,56696,121063
ad380850bfb76a20fe48b88750f129ea,145,119,519391,123497,395894,155,133,569916,98878,471038
818881caa74c758e8cdec6179a0b111c,90,66,196513,38591,157922,62,40,100697,26974,73723
d920ec204e33c2a0efd3d0c3c0300dce,71,58,133352,39273,94079,44,39,78601,32511,46090
c02e9c6a60b7aa2faa649cc28f581d0c,48,39,54017,14741,39276,57,47,43572,17606,25966
15bd9e9042b492b2fec863a959289105,101,54,179692,34965,144727,121,78,257837,36549,221288
a2da33265577aff1b952154c5098bc22,32,25,25168,17127,8041,51,34,64939,9335,55604
95824ed378d0e3be652346953c57b691,44,34,62998,20421,42577,53,33,75409,16609,58800
fc67bea409556d359a27a39256320128,27,19,8094,4389,3705,24,19,13346,3511,9835
1b8f772d6133a37c99a04ebc62782638,171,121,452484,91989,360495,133,101,350968,70952,280016
62f80d0b9e4777aac009e368f6293c0b,105,99,228124,53694,174430,97,74,164040,66948,97092
518ed41ac06ba3430bdd44f8ff0e59e0,88,73,156553,33842,122711,83,50,110419,24867,85552
0739b24c8eaa0b13476f608c7cbaf68c,71,64,185258,64485,120773,155,119,353550,55405,298145
a80b80c01e5c5dc456281de7a95594c9,29,19,6375,2297,4078,28,25,7276,3846,3430
1ce6667be8c43a75ab93164ee90a1219,83,72,117585,42810,74775,95,79,130428,40551,89877
e5281f5818682c0c8c29ae7ee5088b9d,91,70,146760,52234,94526,157,112,351192,52876,298316
27e07b349cf05039ee4358b33691fc70,46,30,34436,15650,18786,43,37,35823,8523,27300
707b5696aee3018bd9e2d0d116cee206,12,11,2128,2037,91,13,9,2348,1457,891
742397c5c0424662708870d9fd94a4c2,19,17,6435,2144,4291,24,15,7180,2156,5024
7a6f85f4908c692b23531c5da434a6c1,107,69,383061,112323,270738,248,187,757129,132926,624203
72bdb088118eeb10b28dda0ac01d18ed,54,48,59313,20622,38691,51,39,69712,19606,50106
7bb72d64d4c9343f8b5273ed889c8814,66,56,98374,28167,70207,55,38,55066,31682,23384
6a898acddd3a851853d86386aaad8644,144,104,483732,100730,383002,205,147,722509,90279,632230
39e98cafa186900e71a213b88c4c0278,123,97,355699,93664,262035,136,110,286018,93448,192570
66811fd1c46e4ceb44c1cb8e3946fc9f,39,34,49932,26103,23829,46,32,47913,21338,26575
b490af30f09e578572ede551e2408a29,58,37,104977,30328,74649,43,38,51113,35979,15134
2263e4b220f326a9deaf981bbd5ebc7d,58,42,41334,14404,26930,43,32,33563,16658,16905
bd5fbda9a3bda7e1ebfa40d13a03a3e0,48,43,100353,25002,75351,64,49,94441,36216,58225
f043b6e082793472f09c57e7e705ff8e,66,46,83059,19404,63655,76,70,99421,28897,70524
79fa5bc2977f1328a6ba53955143d2fc,145,111,482657,120771,361886,145,121,556331,161578,394753
a305482081ee632709371b47bfd36f72,70,55,112819,48552,64267,53,43,134813,39618,95195
f92ab5876178887d0e7ee52d1910a65c,47,39,46575,25714,20861,51,41,75308,20572,54736
8718391e945bccb9a11f7f7bcfd4f296,86,73,183887,55720,128167,90,76,189597,61248,128349
7f921c11e4c3b4f375495b6ed2c50571,124,101,453825,136484,317341,163,122,634741,110792,523949
587f905890c65fea7fa42c34ee9124a0,129,115,339771,87382,252389,134,121,423120,77538,345582
639fcaa30705a212434e8492a8149c0a,37,26,16669,7292,9377,32,27,19485,7996,11489
f8378a231c7be654209645a883c8dbf6,123,88,238614,80802,157812,141,108,290145,81308,208837
3f00b6abf197a143bae389d0444b57fc,14,8,1961,773,1188,7,5,1356,1047,309
ae48f2cc5ccac0ab4bbbc920324080a4,104,95,200470,61943,138527,92,72,184455,56622,127833
d45277ad4965392cc4d6d7668b71aa7d,7,7,891,882,9,7,6,882,845,37
69b0f5e3b247e0bb39031c6d0423045e,100,75,171174,55247,115927,106,81,207369,53435,153934
ce3890668a62bcf45580a964f670c7f1,25,22,23267,7872,15395,28,25,26246,8427,17819
08ae20891d9fdfb45bef92c876ad720f,122,87,283318,62504,220814,158,150,481510,91695,389815
ea08bcba51e4536637702537fc11b760,61,48,68960,21661,47299,52,36,57675,25327,32348
cd371b24d762034eaed418cf6bdfc1b1,94,71,131860,34989,96871,93,76,121371,42280,79091
d4406963dbafe314d5b86989162d2b82,155,139,323779,72451,251328,142,123,357020,79500,277520
6dc330bf489f4ec5ff619689af63b7fb,105,79,272451,67906,204545,123,101,323102,106778,216324
4c5ccaa24e4c4e9fe5c95c9505e6fe11,59,41,54976,15981,38995,64,45,75724,15198,60526
74888519411710ed6177f7d5d22c716e,45,29,31670,10656,21014,40,35,30117,15011,15106
dec65600c9d9055b8ac259f1c6933c27,161,122,418938,89440,329498,169,118,465498,85164,380334
de7b976889dc34467367c0289e9a840d,127,104,253637,56429,197208,124,86,246845,56564,190281
3c6c305cc38a162ee5e92c361655331a,101,78,193164,40726,152438,108,92,202349,46097,156252
9e5432e1461d8eabdf433a916ee92e14,128,94,433802,101938,331864,140,121,397109,111581,285528
e66d4ab2815af53bf8e4e718c06656c2,47,37,36090,13486,22604,42,36,35958,16521,19437
a5ce728616913e08a9873faecf66b7c3,146,97,942160,174477,767683,199,151,642211,143395,498816
504fcacd22615c97072e47b312cebd44,63,52,82449,21383,61066,46,39,43525,17296,26229
a2e7fb06963577c908b24e5130ed3a18,135,124,493443,105329,388114,167,135,596693,114107,482586
e3088ea3b1dbe501b2cf702639c19713,104,96,197889,43851,154038,75,54,132694,27577,105117
982a61ebc6912f95ad1487f30f82bea4,96,74,115617,30068,85549,59,46,101172,30327,70845
4ea30da8b583ac08da13ddf4148d2020,106,80,205848,40545,165303,90,74,135903,49154,86749
6830b2b0730dd49c213ed4dbc7015b99,132,100,496663,105933,390730,131,112,435253,123563,311690
2cd7127c5672f3a4885a2f782938c4dd,148,109,360460,70748,289712,155,102,389033,62039,326994
8c9635bf122512c1f8c4f9cdac999f88,112,88,216694,70100,146594,121,98,259517,60834,198683
43262059309491a0d2ab99ac94b827ab,57,40,65047,22023,43024,79,73,106336,31614,74722
6f9f9de43e15597f2a71322ad44eeed0,50,45,37996,11572,26424,50,32,48618,9381,39237
d5865889483d5b81ad193ea40b7060fc,16,18,2761,2116,645,17,13,2668,2204,464
8232c0dbe7577863834349ae145983a8,160,124,459393,81739,377654,126,96,293477,96563,196914
9eee35f2209949344c8303d4bffc3376,115,89,259649,61543,198106,134,107,318211,53157,265054
c22064d5e08344c85c9f13572cd7ce24,30,25,19484,6637,12847,28,24,18900,9959,8941
5cd1d1ac31f31f1e3455e5aef2678e4d,86,74,135689,51251,84438,92,76,210736,43643,167093
46f70c559c3c5a2cdfd250845a830b2d,171,126,554532,114580,439952,124,97,460701,135016,325685
bfa9b6e4836b4041b220e8244501301a,97,84,112717,50838,61879,101,82,145302,40612,104690
177f48fe8d30aba81fec654366138501,140,116,314059,93368,220691,141,93,360981,77640,283341
2e97639e4ee5b5c797122e076da5531d,111,93,228644,43936,184708,111,86,220542,42282,178260
c977ec099acc89d47e643c58ff032be7,112,95,223134,47227,175907,111,95,211136,49696,161440
4cdfe63f85659ac659315c26832b8c46,94,78,150076,57456,92620,105,87,255894,49041,206853
48b355d12d5188e3b6f21cd8f4ff32f4,101,69,153564,41637,111927,64,56,101586,48193,53393
c4ba40e91578a1619cc6f6e7996f7b46,30,27,9661,5863,3798,26,19,9914,4167,5747
f75c37525ffdbe36f2a5aa9b51a03a77,33,26,20933,10807,10126,30,29,22740,11547,11193
80aadd675becb1990495895dabeacc9b,91,77,212164,83668,128496,72,60,172972,63403,109569
65165ff52ffbc94eef712ad540510603,33,24,30971,9729,21242,44,41,39567,13255,26312
762ff4459c991d989eb1dcaaab59fbb1,140,109,297739,48143,249596,112,81,206641,41368,165273
a67465be89c6d03531b9c1b1e3d1b8d2,26,20,6952,2998,3954,22,20,5742,2338,3404
d28d18f433aac123b67b4fd3ed9f3ee6,46,34,59240,17791,41449,44,42,49296,22454,26842
0a984fe59417946b688724873087c6a3,47,43,114114,62385,51729,77,65,198820,75935,122885
d5cf50436fba1b4a2acc686c7d588bf4,21,21,9473,3158,6315,27,21,6410,3635,2775
1a6429b78a3e99d74d9f22704b185663,46,39,89984,24831,65153,69,58,78103,24741,53362
30d76bb9713e26758a0c3254b6abb369,27,20,11755,5666,6089,20,20,9183,4968,4215
789e6cebb875a387f0009930a9af42e6,140,102,409894,87668,322226,153,132,460942,98997,361945
cd74de7fbacf3096e44943070fa2869b,79,66,114240,23494,90746,41,31,58692,22447,36245
08b78b47763604ace317185fd91377cc,132,107,317717,58859,258858,193,149,439755,76170,363585
46ef0810f61970d14728cb9c6b4b76ab,158,124,342946,73024,269922,158,130,449525,85946,363579
f50e3c72924aef4bc3be01a3aa4d3169,104,93,254879,62927,191952,129,105,287110,46652,240458
c910a70f37ec7330ed96aedfa105bdad,108,93,260552,66035,194517,121,95,250442,54392,196050
bf2fd9727f2aa905ab504a40ef7b0ebc,157,116,360785,85500,275285,156,118,467778,103851,363927
40e2b74dfded97c199578821684a98f2,17,14,3139,2124,1015,16,15,3211,1708,1503
cb0615da1e12b9a2a311c06e5fddc3b9,144,115,444187,73762,370425,126,98,307025,91887,215138
d29d761e330a669ee27d1febe98f05c9,27,22,16031,6946,9085,33,23,19354,5768,13586
606d2ac82d694e1a66523c9b83680ca6,37,26,27852,13627,14225,40,32,43185,12805,30380
f1238df7e53c2eb47078d099da410f0b,113,70,183913,58854,125059,71,62,105043,60721,44322
3a413e0f0b7d35a0c3f562d2a4e00b9f,140,104,225958,46203,179755,143,102,244442,38288,206154
501c40b4b53747a9d4f7c54748060835,29,23,14130,4242,9888,28,21,9901,4676,5225
7cbe6519c2d8220b17c72f6da5fef1af,100,83,209249,72517,136732,129,117,339645,66114,273531
70f58b04e86e731d920f054df63006a8,123,103,273355,56277,217078,140,124,326482,68290,258192
b09d52abf4450831dcbee5e842790b2d,103,75,262332,75709,186623,154,108,365955,70236,295719
cb2ff75fd08fb3e5a232e232bc0005d5,123,84,325578,91357,234221,181,119,391240,96714,294526
4891412786a53a0f4154353ccf588f20,142,109,358397,52480,305917,145,116,371570,61282,310288
9f3b9f7b92b5a3dff39065d9b7bf5f73,140,107,282994,71897,211097,174,140,335620,79014,256606
7e64becfc6f506f66695d007f5834c2f,123,101,424564,99286,325278,149,124,454146,96137,358009
4edea8c697632d54947a9a8fb1f114ec,122,103,199997,63607,136390,112,84,233311,49829,183482
934770280687bdae0cc6121358c5039e,50,43,53999,16122,37877,57,37,71536,15747,55789
c6532ebb8246ed39b479a352184eaf5a,149,111,704657,137950,566707,196,152,819302,129265,690037
2bbee8f972e8725e0f49e4fbc495a412,47,36,43818,17346,26472,57,36,51103,13682,37421
6dbffa100f1d1ecbb78acf33f860c875,64,48,95962,27532,68430,72,63,117776,41940,75836
3e4d6f995d0bb23f7e437358aad60e55,71,41,118618,33539,85079,58,38,107170,40654,66516
e619d86b60e71a1a2bd49b3299c10bc5,42,29,33704,8983,24721,49,30,52515,13412,39103
0debf7e61cedc322bfc732ddd80c31e2,5,4,801,745,56,3,4,445,726,-281
858010e6ffc8b255487bef39c3d9b0a3,239,160,888720,202590,686130,212,168,885689,179939,705750
d179cd4018f7c7b3fed23e5e8e181274,193,139,801305,131110,670195,187,137,649235,118775,530460
51a40556c27508a7926b2467a5a2b6d2,45,37,40173,16892,23281,43,35,32702,14345,18357
6508337960d02116b71adf2a2975c826,42,35,42252,17249,25003,58,47,60222,16991,43231
e068f35bfb46023412548911eb9475f6,37,30,17335,5272,12063,30,23,10861,4623,6238
972a83a9f3832f4871bf24b7bfc657e3,49,35,50367,12755,37612,50,43,55029,18876,36153
4d7eebb1339328db3ed18c3f162efd44,38,31,26746,12228,14518,36,29,30807,9457,21350
0b4ad82264b6b7cc051e537410d46805,158,103,411514,88065,323449,118,98,362800,76671,286129
31c1a3a2d031340f2e8129d09d5dc135,157,115,462340,98159,364181,194,148,567914,80657,487257
f02d1fe9e961be201877480e8b67af74,1,2,264,578,-314,2,1,578,264,314
867ca4408e24bb386f905e9875daf845,190,144,771689,120017,651672,193,136,581521,103675,477846
915e25eceaaebd74d34f9f62b08493df,55,42,69904,19217,50687,43,35,39716,19059,20657
aa2db0164484aad69221f99ac0ea17fe,51,39,43450,10453,32997,48,30,32161,13263,18898
e444431cd442ca00a0f21a74ea81f30c,169,147,484222,162256,321966,165,131,493622,130477,363145
ba49dfe3a069b51ff22fd11849170e4e,86,65,180037,44705,135332,123,89,273421,35952,237469
d75370f43ddf58c7b084d631608f2fbe,29,25,21920,10185,11735,34,30,24841,9110,15731
b8785e201306f553c43911b608d9519e,114,90,223501,59569,163932,134,112,251858,59236,192622
e683e52bdd7c08cdc32ab8581104cee2,233,179,946571,135219,811352,165,109,756729,117024,639705
8618699d15d3eedb5a3d31fa3509e7c1,159,125,496544,118660,377884,215,153,674262,95924,578338
5347e84d03e8190c8ad1f74054cf6590,107,90,227650,70723,156927,111,101,271640,71879,199761
ec37329adf3ce43bb3ebd1e2eb4bc720,46,32,39075,13931,25144,39,36,30963,12362,18601
6b00644cda26381ce85b4041a0a8f571,106,65,233386,54430,178956,123,79,201858,67864,133994
a183f404be7996b5013737d6b0459a27,50,38,66750,14935,51815,36,34,48816,20132,28684
3a6a71c1d4746e14ff6c03cea2d95703,140,113,425399,68796,356603,118,90,369501,77978,291523
14676f0739b40265ad91fb64fe5f96f0,45,38,66519,16687,49832,38,30,54750,17741,37009
01d52ec795412c576641c6a444b92351,81,64,144774,33674,111100,91,66,141251,30378,110873
4e3cbccbc1bb0ba72f4c7299c3468a83,100,81,235181,47694,187487,103,93,255434,63889,191545
4c86342d12e7c90cdb533f4e2575879b,124,74,172301,16488,155813,112,89,147473,40211,107262
84e0ed9d180d5a58cca8afa43f081cca,115,69,232053,43693,188360,128,65,175171,55752,119419
c32c3b2f603ee47c4ef68163da8ab142,130,103,322641,79203,243438,165,136,516175,94252,421923
a01e52ffadeea9f8aa7c222f36162d74,50,39,45651,15058,30593,48,42,35936,14225,21711
cfb8c83a58a773008e62e035d18bc3b1,143,125,458999,87686,371313,98,67,240988,78017,162971
e9604d327164f0ac8ee62c703bfdb2b3,83,68,136872,36034,100838,79,64,135490,47190,88300
0459567c16f6e5fd73aeba0951b2b666,151,115,416439,57919,358520,140,121,358802,96949,261853
ee6bc83696b9df4cba117617cdffbd8e,49,39,42760,18254,24506,74,69,69210,16260,52950
b2c8aa75ff9414da25bf6fe1d2cac1c1,51,34,51462,10552,40910,41,35,34007,16662,17345
35efc843cdc05534505e622b6cedafaa,15,9,3294,2344,950,14,7,3447,1334,2113
c617cdaf297a5eac8db6e97705a98264,25,24,19038,6240,12798,29,22,14482,8085,6397
01cba84930e164bfbd11336187ba9fa5,92,72,242058,61596,180462,120,91,314056,81214,232842
a45ff8a3f09e40240fb0e9f4c357d721,32,28,23877,9623,14254,42,29,26391,8625,17766
3fd4ec504c5e53d66ea225fd5e26a386,148,119,509320,90090,419230,181,142,623638,111918,511720
9fb710cadc752e04acbcc60438e8672a,48,29,36916,12032,24884,44,38,43176,9277,33899
20ba8e395f27d2950e83b27eb8452ef0,35,27,26835,9435,17400,36,26,28826,9150,19676
cb24b811eb8651d5e72868ac949cb702,192,141,891396,236262,655134,185,145,702580,165322,537258
cb785932e194ef5c5ac356aee3011bf1,60,48,138826,42027,96799,105,86,170955,41154,129801
59d6a9cf2377204f01450ed5e2b3cec0,58,48,42111,16582,25529,41,24,40189,13521,26668
bb49420e1756a2b43b227c0d01774fee,170,116,1254498,179040,1075458,200,158,1043521,292030,751491
12a3824c90c68fec54145a9c0955b57b,118,84,241377,84454,156923,105,69,236813,63918,172895
d761eab9b410af233d790fe277ef0857,65,55,76960,17492,59468,55,34,61410,16636,44774
500e91d4c709318f48b6daea16d30ad9,131,110,341143,109070,232073,95,81,261385,75574,185811
e6b0ecfd1e61a6b9f695780e7cde5343,140,128,462320,62495,399825,132,96,286358,55154,231204
c2b705235cbb566f18a90a4a5693292f,90,69,177748,41871,135877,110,97,223369,42660,180709
64da7ab36b5f5d713d747f55d3236718,31,24,14213,5727,8486,23,20,9286,4994,4292
5b0f90e13a10b51a9eeb7b183c9ce826,45,31,55057,14948,40109,45,32,48782,19388,29394
1313d9a57375fc60d191a6fc8e703d95,28,24,25535,7083,18452,32,28,21288,9516,11772
1e13d53647d27bdee348b07eca486a6b,140,101,333560,132930,200630,143,112,389588,111176,278412
32b4677c8bc2f7da98bb0173b389b9f7,63,52,111471,26873,84598,77,65,124058,32628,91430
d706b9e3ecf3c05edcfb099b7c4ba15f,131,102,330719,85404,245315,126,106,350427,82538,267889
d663c498ace257600c5363f86d0fb35f,41,33,38540,24480,14060,64,40,72484,16364,56120
00cde315c8d028e2ad8a8831fd94f8b8,83,81,104179,37116,67063,96,77,93451,22378,71073
64543d238e9b902573fe8b7e8aa4af85,39,35,46612,16318,30294,33,29,54568,11423,43145
d6e8a08e82a6d679cb265a152deaef7a,69,51,74960,26557,48403,61,49,79784,32898,46886
49080ed824587e578bf239ab815bfbfb,70,48,86943,20913,66030,76,54,111617,23349,88268
992ba2e2037d3db2dcf459aeef85c2be,33,27,37365,11117,26248,39,27,37165,16332,20833
692771c2891c1a2403b261056838bde6,96,83,167303,52031,115272,117,101,208607,53839,154768
748be0786527a28480fbb32fcc633788,129,103,303654,85535,218119,165,114,421196,63844,357352
e8884a314e5b45e7aa875051947f0269,120,108,289039,63848,225191,111,87,248746,62380,186366
0a78e52fa9eaba3cc25a9987dd0ff412,56,52,83065,24031,59034,55,42,77656,24021,53635
c1a6ccb4937b388a7a118cecec14b3f2,113,88,322895,93237,229658,177,124,520817,79728,441089
9a0625623abac0920dfae07b8e5da250,35,23,13748,3685,10063,26,23,10769,6389,4380
588c2db3d5c01b267fa1695e19badbef,35,28,29536,10212,19324,33,26,23789,12122,11667
7aec979b5321d0672e2d42d4caab2504,111,84,352727,92072,260655,101,69,253771,80366,173405
515f004e634c7d07fda704a66b3284c9,60,44,89072,27187,61885,66,43,89784,26792,62992
00457047a730bc1d37709083ddf41639,52,38,71771,32256,39515,45,35,88733,30568,58165
e03023cc93bac191a3bae5fe1254a13a,102,83,156974,55502,101472,73,54,111048,40984,70064
f20e5cc2d72410556b631defa6d27104,41,29,38650,11453,27197,58,47,64959,14715,50244
2515215a1b96dcddb68f260e5af17d91,56,31,73131,17229,55902,56,39,70095,24712,45383
8c6594738eb5938f0a993b7805ea4848,33,32,16040,6222,9818,35,24,13522,3502,10020
ade542415bab2134caa7ace49fab32e4,28,21,13909,8886,5023,30,24,16832,7022,9810
d739d6a2785aee1bfa25ead8ebc08657,84,77,196262,49666,146596,101,84,226140,53996,172144
eaad7b6487a12a995a3e9e0277192e08,110,83,210972,47282,163690,103,90,194609,47157,147452
b79dc6c235deb7723dc709c1deee91a9,2,5,154,630,-476,5,2,630,154,476
641baae6534772275dc54b164107c4e3,39,30,55422,11211,44211,36,24,30063,16597,13466
2919c699d52e3928c7be5a56c9e5ef63,79,63,122345,46084,76261,68,62,131131,42271,88860
7d4cf7262d4f1d6142e5ae3072af46e1,32,28,25080,13959,11121,35,27,29182,12329,16853
3b1d6074a59056dc4fc7217e268773e9,96,67,174327,25221,149106,127,98,248518,35757,212761
c4df65dbdb60cfac00ace1a7d50cbc8a,122,99,220690,61406,159284,83,71,141981,69742,72239
a078ee5932eff867ecfba62c75f37526,134,109,321221,78235,242986,128,104,368626,112456,256170
9ef84273e4ae6c9af7c68c0e35826976,42,33,38095,20583,17512,48,39,63320,15096,48224
5fee09e9d6bef66e1a9fc5b0f900ea3f,143,116,396742,82630,314112,169,141,448856,80743,368113
56fe0a3a48d29a4c1aa4f9768c15e4f2,122,97,277156,65254,211902,130,107,354834,69093,285741
631de4888a67e823e9903feb3363036a,73,57,116400,22355,94045,72,63,111997,20894,91103
166da9de81861fa823de1a6af5b3d994,78,56,102848,22454,80394,66,55,78570,22240,56330
ed1e90dada2aa8becf67402fb9f4a30a,153,116,391256,85267,305989,187,141,508230,92147,416083
ccb0977e00faca885861c5314425753a,135,95,278024,40955,237069,89,58,180311,58287,122024
f8caaa965f085aafa3d1f1abdc30873b,189,128,932211,182383,749828,189,143,817795,194818,622977
8ff6df8f40355a95e85b3b45b0ef2536,207,148,883049,143914,739135,167,145,623770,195023,428747
619db8c79367542117a095b809564983,105,73,207025,47465,159560,100,86,195327,44822,150505
b98828dadcf297bb0446222cbedd1994,36,31,32296,15384,16912,43,35,44614,14495,30119
3d102b731090b949e2cd7cbcc2afa178,33,28,24263,5399,18864,35,29,24352,7854,16498
49b4352a8854e46b15f8483e939fea6e,97,75,146776,39017,107759,99,70,132104,35310,96794
444d68a616a27f26f29ef4dbb4644f47,129,87,264148,50813,213335,126,94,240554,60317,180237
b0f73d2b44f1fa664e29f0fbccbe42b9,96,70,150708,46255,104453,134,100,258971,41065,217906
c2e386b5ec1c1f770d85ce7251582e31,141,114,457303,149481,307822,157,115,565446,112128,453318
8e139c69288379707a9696eafc3a96cd,94,51,175271,36083,139188,130,70,221880,37243,184637
0a1938932f901b11786056c579c5099d,193,146,641927,127812,514115,181,118,478487,129560,348927
b199490e9c3afd2ebc58670fb47d9b51,85,50,74181,16982,57199,101,90,90811,30574,60237
a4b18eb269265b6a1a632562c80d403a,161,118,386761,87471,299290,131,104,310259,68724,241535
36bd78d49012a6c964e76bc8834e9acd,35,29,32936,16747,16189,48,37,44436,13366,31070
bedf20340f79e0ad5243a639080ca31a,97,84,208164,50581,157583,119,94,229025,45207,183818
93f4a6926c9bf0d688a383724b2db9b1,16,7,3262,1232,2030,15,14,3252,2200,1052
3b195face8d16a9b6c95f46fae8ba241,93,74,163268,46160,117108,90,81,162476,53229,109247
7dc33f46aa54125ebad58ae8f86e5da2,34,32,23450,9269,14181,44,32,38082,8875,29207
869181244bb2b5be0baab745b93af3b5,33,28,17951,5295,12656,27,23,10093,9374,719
cb7875de7309f0cc66e34c508421d6da,114,97,218778,65024,153754,144,131,407603,66188,341415
024884a6f48d2a8957e28bd087f70777,124,94,387957,97241,290716,147,118,461219,86624,374595
cda4406439dd7781cec971606369fb14,122,96,256052,73692,182360,142,115,303786,48868,254918
319341dd37da89ebad2379bb07ee7985,46,31,70201,18489,51712,52,38,79253,23858,55395
284c4ba690ef8de866a258160dda3087,85,50,114847,25828,89019,78,57,88607,34376,54231
e51505b06ef62eb920c0fb33c024ccef,145,112,394503,65208,329295,87,73,171097,65541,105556
a32a820365f2f9f52f79b6b4bbb92ae1,25,23,7835,3467,4368,32,22,9691,3122,6569
7143091b11a7312852e7cf28b41b1c3e,53,47,69557,19814,49743,53,35,66662,13483,53179
264e16917471226c7bee6850eda97c2b,151,111,478872,123979,354893,165,100,419688,90051,329637
5e102102d3fc009d867a09e5ecd95d32,17,12,6524,1784,4740,14,9,3185,1207,1978
3b2de553c2cf995ed6d86b889ff074b3,108,90,261194,75439,185755,146,116,346733,55308,291425
778c11097cd41556751d4f7985373892,42,36,40679,20744,19935,44,40,50870,18399,32471
06da37de246072739a30823a3eadabe8,29,24,25402,8922,16480,31,24,17493,10247,7246
c36ca643e7b66169a6e19cfb5e3baffc,89,80,116338,40972,75366,76,61,82498,36205,46293
8329dab7b4bc4724f68ab16fd1fd44f0,110,91,201079,58491,142588,105,78,217719,46457,171262
b24af2e4f6bc5a363de81c2ac42e7c95,88,68,160497,37983,122514,115,74,210890,37088,173802
6dea09f9badc655072a9f625ab72d20a,39,29,40509,15534,24975,36,28,37186,16524,20662
f9123e545586d22265575ef4527896e8,20,18,8111,2698,5413,24,20,9108,5070,4038
40b488d3bab5457bbbd373deb5a20f82,140,104,341880,88811,253069,124,104,232421,80335,152086
e5ac61485126b54f94cf88837c8e1ca3,158,112,451508,103451,348057,160,123,562490,103895,458595
142447cf198e031e7ebfa27d41705e5a,19,17,9320,4001,5319,24,19,11178,2927,8251
6160de6d8eaa8b47aaea4e10b44b7769,134,106,287146,35885,251261,76,53,147889,41359,106530
00c0e5f861ed255533d35fa09c22d285,30,27,21561,10205,11356,26,20,21658,6424,15234
7e0fd583e8edeb5b6238cffd51be13cf,30,23,20250,7003,13247,23,20,20009,8081,11928
3cdeebc6c56f7d5e3fa0f13920832a6e,156,126,387223,63227,323996,119,101,328795,56301,272494
93bd662948e66db9e1eeec86b66f9bc4,122,101,216408,53146,163262,126,95,269113,36990,232123
789f58b2b5f966c0518f81c0e0823404,22,15,3745,1768,1977,16,12,3189,1530,1659
c8651a0c77dbc6a77124e834017f6b7e,84,70,172969,32887,140082,86,69,119228,35723,83505
52f1db13e16a256fa1d425b18841e622,80,54,136680,38824,97856,36,35,51470,27482,23988
7026ad804dd51da9242c017ef4f933cc,56,39,61541,16400,45141,59,39,45149,26363,18786
5ce5231e1322af5579f222977010b1b1,46,33,60037,22310,37727,77,47,114104,23268,90836
5a7f0579992dc9878e93fbca002b21dc,145,112,425382,92751,332631,108,72,293662,124160,169502
5ab07aca41bbe198a697afc136d17035,87,74,190645,77895,112750,110,84,241654,73314,168340
f7f3c6af7c3bd95d0b4a34398832d2c9,90,63,53907,21801,32106,89,58,101137,13491,87646
88d08a06c1c32b67e1607f7edd1145bf,106,81,233333,82314,151019,135,91,264766,71859,192907
ebd20b8850029d0255326cbd489125db,60,42,80820,18203,62617,39,33,42367,15833,26534
07fbb1822a84a485ae6f1ebd136d3f1d,76,63,128511,52087,76424,126,90,236322,67031,169291
b73a881002d3b03c555fcfa7c9031ac1,44,37,30489,14307,16182,43,32,30651,15594,15057
d66241e174d427733bb37600dd7c034b,77,57,111919,21190,90729,59,57,69916,28124,41792
857ce4857c4adab2a51f68e564e81935,149,102,300632,47503,253129,102,71,158294,74709,83585
7791317b8f3f486ee7275706acb0a34f,150,114,464301,72889,391412,124,94,262212,72691,189521
d36e4e37e8fdcd9eeeb2eebb7851218f,92,72,166072,47788,118284,96,81,172550,44203,128347
9f69481a6368e99bb30f933771873ed4,66,45,127673,39227,88446,86,73,147146,33508,113638
d79e06272243811bc31467b983c5e6e9,132,97,351460,133306,218154,101,93,321576,110666,210910
2ffa26ca986e83eec9afc593a439b74b,227,155,1013724,192482,821242,233,154,1159463,202533,956930
c53897067335749a9cf1694c0c74ec5e,31,31,26487,11740,14747,35,27,33729,10035,23694
245cc0cc7cf06651f02ccca73606b26a,124,94,160180,31168,129012,123,74,201968,28117,173851
661b342a9e3b7ea435cbe66af00272f8,91,68,158951,60702,98249,77,62,134591,38191,96400
8f5f81d348d480eb7d1b519b08382bf4,187,132,458742,95096,363646,177,142,561337,141168,420169
e6f69ffb5a1a03c899cd46e29fe60ad1,20,16,9968,2473,7495,23,16,6278,3375,2903
470c44890dfd795095d48bb3b6d760a9,141,121,425485,79499,345986,124,108,305192,104886,200306
a556da263d477113cce4bf3163a954b6,50,38,57648,25451,32197,76,63,110814,27892,82922
840a0642bdbf1b7706cded60bde90019,16,10,3600,1734,1866,20,13,4237,2142,2095
fe431098a5f743f11ce9c203a8dbfbec,22,15,4771,1750,3021,22,19,6168,2879,3289
48bf0cbb7f9c24aca3e56f81f7b484da,30,25,21208,8892,12316,24,20,21112,6874,14238
c522333f238b6d8b3c962c46148f24fe,141,95,261937,49960,211977,126,96,254129,55093,199036
d5c6d5d88f49f05c8cf8d7d02dadc198,83,71,162843,53998,108845,104,74,160815,48821,111994
b18417393e96a9cea01581ab5a10acb3,89,65,116466,63207,53259,120,82,230595,45829,184766
c554efb22ef0c8bd4e6dcc354b78a4e5,225,167,1698480,298036,1400444,214,173,1224492,276484,948008
478b220e29156340b29c315757ddf625,38,34,62031,20047,41984,107,61,175099,28207,146892
3c68eba8913caa4a8dd1050d8f8cf6f3,40,37,54432,18766,35666,57,44,66708,23574,43134
f22931c413b6dfd7980912a2fc9ed890,59,47,52761,25442,27319,72,55,101670,21197,80473
076120daa2b98daa6a9afebf4110ede5,141,92,249427,52516,196911,118,72,236239,47914,188325
5b77879fd830daaaf419c4525cf138c2,54,38,70966,20065,50901,64,43,52379,23189,29190
2d60060e55c128fe1d0bf758e8244736,24,24,20109,7387,12722,32,19,22893,4613,18280
3729b5283a3e01edebfaeb34344644b9,155,110,373232,84711,288521,160,107,416151,85109,331042
e42b755304ed9412f7417c218092d047,150,110,502993,73809,429184,157,119,466059,82829,383230
e3d7c9da7b059851d9117bf88d70a53e,183,154,616193,109458,506735,203,147,593633,112590,481043
ec9d7f9778a4134589dc89a2e425d2db,86,66,152773,25684,127089,98,57,171265,30258,141007
ffe5111ce4c18625debc22ff78f89729,35,27,35610,6010,29600,30,31,14839,10666,4173
626c0848cfb9a1989e7a32e9e0d729b1,160,131,642456,159875,482581,183,149,645719,107978,537741
d71b0378990a037cd11330956e24223a,67,53,149134,30341,118793,46,44,93968,45967,48001
728bee576802ddc0ecf8c46fd8ec09cb,37,25,29029,9230,19799,37,36,24335,13000,11335
53f073d7308ac07099596f0d5f834633,143,102,341239,71087,270152,163,119,384158,89548,294610
a64c555e16cccbda734cfecc5a90efed,17,14,6812,2492,4320,20,13,5178,2206,2972
875ed69586e56ab5dcdd6ac536704a1d,130,110,265203,47875,217328,96,66,167164,36122,131042
e99c0b704f6e1c42151a8ab6700ac34b,114,99,241355,66738,174617,132,103,259440,63358,196082
1d1d4fb79414aa20f222bc733dfa298c,72,60,117603,35345,82258,85,64,160984,39944,121040
9d0845aa109e25c32d263c5c6c0815bd,115,96,266550,56024,210526,97,82,243783,64121,179662
6f40be35e9595aacd603bcb875ae4d56,163,137,490311,97054,393257,133,103,309314,92741,216573
6ce55c12ed0b7979858af887e90c76ff,140,107,283607,63556,220051,123,102,254714,71770,182944
80358897303762059fd9abf61bd98272,96,73,162810,52578,110232,82,66,136752,41624,95128
294ab96ae30b6e699e6c02e551f62c96,165,135,463904,117122,346782,140,106,457833,88354,369479
afc6454098fa3788cc9d87e8ebe56999,34,24,26465,9884,16581,33,26,30140,10385,19755
538fa0ab5282dca1882bb01b3fc2c865,210,135,639714,148920,490794,208,135,1037768,169181,868587
8a7eb75dc42f77ef27660acba4fafae6,67,57,81945,30223,51722,76,60,129589,29657,99932
ffaf91cc452a49fa1f07581f234ed606,30,29,22699,8952,13747,24,18,12523,5802,6721
ff096e0f0ac7d624874bf839582e6a76,116,91,236973,62498,174475,85,69,242010,55761,186249
e9e16247fd281d7a16044214832fc587,190,117,569794,89543,480251,154,124,470356,108959,361397
e2d7bcb97982ce497a8cc50e49ffefbd,181,132,554557,97337,457220,149,128,443340,97927,345413
4b0d348e5f814a953b41492f05c9e4d5,48,31,72236,16835,55401,65,52,93000,22749,70251
5c72d2794a9ce464657310ff40fe56bc,57,40,69329,18572,50757,55,47,80883,15875,65008
f47dc0a198653b9eed0df6e2267456f6,142,105,298137,53669,244468,131,100,287369,62138,225231
5b9374ca47949f2c9471e4cb5b94f16d,197,151,606769,88238,518531,143,126,402774,116932,285842
a15e4b8d6acd753fba8ff9dc1709c9c8,47,44,78369,21790,56579,52,37,63405,22946,40459
95e678510bf853b476811aa67665e603,121,113,241102,57519,183583,110,88,199049,48835,150214
4d5f7e7c313410cf03821ca7c1d2f468,112,92,318577,79399,239178,147,111,440680,76988,363692
d0c00aec2431522dbb0a7a8115f1bf9b,179,116,528630,103347,425283,198,140,677313,126147,551166
93ea6806c438eeccf23291e6052c629a,109,84,313194,119511,193683,107,72,270196,88965,181231
cdfde7e6eabe45041ff2128eb1a6fb45,144,115,472014,114035,357979,143,109,349462,95928,253534
c25bfaa51628c58703d39226afee9301,189,164,1010258,229238,781020,192,155,1015543,193088,822455
ec4b2d513f7d5e0cf9e862ebc5970bf4,49,27,31611,10909,20702,56,44,41786,12051,29735
53440220d9f37d41100ee3e191b6168f,36,26,32352,8839,23513,29,27,20533,13403,7130
5281029a371167aaf131ffc3bfe3132d,87,66,116545,43906,72639,73,53,125064,24530,100534
d48d178c93471267a152356ec1526b12,61,52,59828,25672,34156,54,49,72882,19432,53450
a24a928eef97fae765c0fc48087c8cfc,11,17,2923,1482,1441,15,9,3980,767,3213
7d4b2db1f5eac7b1a9acbe80b4445dd9,46,39,51255,21279,29976,50,36,54505,15571,38934
dbb04c77d7f2ae67d8c9be6f252260da,105,80,209733,38477,171256,78,66,150809,60910,89899
2004c5cf86552fcc156f2e4e08d41f94,129,111,377051,63333,313718,83,64,197779,61387,136392
6be52e14f082527f9a4d6c0ae8f0c2e7,28,22,8103,3611,4492,26,20,6671,4051,2620
bd00379cf3717bd13a00df4fd8608549,124,87,322662,80563,242099,116,92,300260,100304,199956
a4e5bc7cef9118175b8d832bd9630830,106,65,200981,52496,148485,109,88,167409,58448,108961
4f7b27b2ac5c86f28ebdef92971e17c7,177,123,422677,110093,312584,165,128,467322,100233,367089
c9d809a8d7fcfaa7763b1d2d05241185,123,92,219211,58983,160228,108,97,235793,74125,161668
544c5900bb1e993f8505d2de5b47d532,109,85,218548,55863,162685,127,103,223526,71661,151865
b1e4cdea8c1feefb150072f32a1d4f7d,197,147,707324,165368,541956,168,121,643157,152376,490781
dacc4fb4d816fed1ecbe0d812213415f,163,117,505450,121764,383686,138,107,353795,108703,245092
0b58a7fc97ab49a918f2ebf40177389a,124,102,305313,58983,246330,111,101,256547,81530,175017
d3a4aeb1756eb51b8fdca9964ad388db,58,50,102659,39520,63139,77,62,129600,37033,92567
bbdb6c863704b62be8af267bcb267b47,62,51,94025,43424,50601,68,54,82792,38125,44667
8adade80a9338ac4e0aab4d5de26ae0a,84,70,135169,38432,96737,67,56,88659,40436,48223
7c7e07a98e576c2ac5b7cb1110b208fa,15,11,2859,855,2004,19,13,2591,812,1779
e4b9a83c8da22af92cefa5b813bf4c06,21,15,5459,2806,2653,16,14,4046,2054,1992
4a6c464348ae80588c05a6fba45ea7c6,116,90,284947,65585,219362,102,68,210310,67876,142434
0659fb42c5ad0d08dbb7006c108f73c9,61,55,100607,30026,70581,86,67,138885,30374,108511
50214dd08023c27aaba7dee6820e7b01,104,83,172009,38234,133775,83,67,125463,57920,67543
7389e46a373bc01bf1af9dada06b7264,20,18,5058,3411,1647,21,18,8594,2456,6138
54848546c6cb5c7be0aaf21b61b4f74b,59,52,82530,34605,47925,66,49,101255,33175,68080
036f0f303d424c6537cb28a9033be036,144,113,567114,147535,419579,162,125,545506,161936,383570
83f5a3dbac2e8433ccb8c491cffdda74,27,24,18356,9105,9251,26,21,15361,9273,6088
dff4573a867a165a4188f3a722b6a694,75,66,148425,28180,120245,61,52,92910,37564,55346
2ed71895f3968100bd05e0299f742316,134,94,390824,34507,356317,98,90,222305,56899,165406
6ed4c29d97f069a077ac72fdada9e82a,134,102,259260,71107,188153,109,77,175316,52254,123062
c7d3e34a736eab0232a526b1f201f6a8,137,102,306536,66163,240373,112,96,224139,60058,164081
c26ed897ccfbb0472f1226b0d42282a2,40,36,43156,16926,26230,42,25,38638,11358,27280
fc974c06d873bb84b334c3ff3d3a1751,88,61,196217,84166,112051,119,92,272803,115370,157433
725ae9f59ff1bf2810bbca06399834cd,192,156,1023396,185930,837466,218,161,979560,194085,785475
ede2c9fc152c3f9c182f57e6285b03fa,127,98,237629,37033,200596,124,100,197444,39262,158182
270517f742236243ee1029a28d5fb9c0,142,104,318917,74019,244898,103,80,222722,66628,156094
16a4d7b396f181f28515d0ee6a640a92,33,26,25466,8223,17243,35,27,34647,7937,26710
0891a9d6a9dfe60f48dda58546bcef8a,24,19,10787,5672,5115,28,22,23863,5311,18552
b399721337c23b6db3cff88090dd9087,134,106,353565,75486,278079,124,80,251780,58423,193357
505198d3662e9b4b0be0c4d3325a7199,71,67,108845,35802,73043,61,47,98436,22447,75989
846a1e63c9a61e332727c75da1ba5a1f,104,72,206647,31176,175471,100,88,156924,61403,95521
a1700a1f3ee83c7a6b3d67bbc405884d,75,63,106025,30673,75352,96,76,136390,28770,107620
115714754003b7811617e2b733f20764,233,138,682808,137468,545340,167,115,639673,145499,494174
cd51629634d7d2a26098857ebe47ed16,197,133,602020,78252,523768,168,125,489331,96795,392536
848f6cb7638e0fd99b21bab5d218cade,127,105,278606,101472,177134,142,118,419344,72407,346937
922caf841676d10439fa266108f26edc,135,113,370942,90210,280732,168,133,440894,82544,358350
ad438ef59426d9e9fb85794bb7c41da9,124,77,254906,51444,203462,156,98,322423,54428,267995
baecd5cd8fde11013885afe87271e51b,150,102,441973,123924,318049,166,121,553131,110764,442367
6bcf056c1a05cc3985338e6bbd5018f1,85,66,136861,32111,104750,93,78,130822,37672,93150
fb9582b92dfae248660f291a49e64a68,29,24,28621,12393,16228,34,23,36774,12243,24531
406861e5c31775b5ab155607f59566c9,72,55,127449,32962,94487,73,61,114161,33857,80304
168e46b2fc0b81dfa0daf0afe7d1b57e,47,44,35250,16426,18824,40,39,30362,14803,15559
cdfb93d52eb5fece084f6f8775a45223,19,13,4320,1947,2373,24,15,6308,1796,4512
1538b8e8656a6d290c9f44085d3b31a5,28,23,12121,6946,5175,38,29,22809,6319,16490
7c7ea9ff9b2636a1164599947e8021f3,58,60,88024,34249,53775,61,53,92067,28355,63712
2dfc7177fbb3440e822148c7524f984c,172,135,447289,97293,349996,127,95,404388,76474,327914
df96938a2ddb87b1183aee5d6978b384,103,53,126584,32107,94477,100,72,127051,39395,87656
fd08bfac401a50a01c1d6abc2a9b4238,182,155,896495,163938,732557,190,124,733905,189155,544750
98cbb3b89efd76a8797d6ad940f54c7a,166,136,508835,85231,423604,205,145,616938,96204,520734
933162925d1ea8ad20fe7abd379e6bd5,88,73,153877,37006,116871,72,58,103565,32746,70819
b4dd4555600c3eea4ced4bd73971ee20,13,10,2156,1280,876,10,12,1711,1942,-231
46e63acf287ffcb896f0d68dc5e756cd,49,36,22257,12400,9857,47,39,37482,11832,25650
d639d4110cfaca07d2ed2953cb1261a9,136,114,352911,54411,298500,110,71,221195,62452,158743
00406d46b8260fa786a8ba265a6050ac,40,28,21951,7555,14396,39,26,25293,6842,18451
50ad77316aa279a60e599d729a468478,72,57,105276,26529,78747,89,72,112648,32139,80509
67a2fb91b4fc2cc1edb36ee5322c54c4,123,94,251635,76306,175329,110,85,242481,57390,185091
e803630a4d12d2ad78455462b7069740,2,0,177,0,177,1,0,58,0,58
c010fd467953031295c44929d20ba3c1,134,99,318537,73798,244739,134,98,298044,46344,251700
115da4f8b1c5e8d851846480c4cc6d1e,57,47,91168,30515,60653,54,45,74874,39902,34972
806f6dddd788bc7688eef30a7f533a06,70,63,109918,54712,55206,76,64,130393,63204,67189
37d9951c84d475062e3429e9cd584282,95,70,173763,51222,122541,97,78,158668,50576,108092
826800f831c3c6346a3bf0eb0062d2d1,73,62,89423,30438,58985,67,62,130790,25172,105618
5a43e4b3f9ff1b7430905c4d373441a6,194,124,698726,116131,582595,211,159,926537,119789,806748
1897cff7ba9d0ecb6b30781c86bfe493,44,39,30522,12981,17541,36,25,25803,10891,14912
0e6a9b505c81ff6065d844c8fb6e975d,190,128,763865,164274,599591,189,136,780542,184787,595755
93b3759151b0f4def2a87a8efa2c5dde,179,142,538079,131424,406655,187,159,528102,126045,402057
e68ce67831b027866611ae2af16bf7fe,114,89,260625,89445,171180,126,67,244697,59226,185471
2a3c53c78e7cec44e179670d5fe89607,154,81,563439,67488,495951,181,127,566398,128999,437399
7998536a4c697007991c2733dfb0fc5a,170,128,869649,190620,679029,213,148,894239,212071,682168
e418ed3745f7f045cd4c1f3b43f42eb5,212,136,623939,112984,510955,152,120,501295,117987,383308
1e7da2f07f9db09f8a86bb058e22ce5b,149,98,342874,93574,249300,172,124,408068,123254,284814
b22ade20b9ea205182c50ee0ac05d7a0,194,145,697046,102786,594260,179,123,591850,85458,506392
035e98024c0e5016ce233513a9aa2b76,208,133,816216,140515,675701,199,131,892944,195931,697013
1bd42ee29a459ac578dbb98645a24d44,189,147,645048,153213,491835,169,108,736259,69074,667185
ddcac0868c17615ee97509fef40c1b1e,110,92,255525,71931,183594,108,95,229181,74844,154337
9774ccc12e138632869ec9cbba943544,83,50,129014,52223,76791,78,52,163413,50763,112650
ca9520c96b6bb4320164b19918e23486,135,111,481647,120166,361481,170,126,490657,107404,383253
152ba49d13fd013abc3378286e7e7d9a,110,87,319631,75550,244081,223,158,549448,82134,467314
ee5b6604ffa7c07482771215958b6216,42,31,41611,10754,30857,51,44,54040,13479,40561
1883e5dc43cc489e13fd17f49fef324a,86,69,129521,27553,101968,103,78,209666,30420,179246
9c5bdd26a5cdf0f78a0f73ffa72c0fe1,56,48,52370,22142,30228,74,55,56121,19669,36452
57ff2cc1aa5c90ea8d3879dda35f004e,50,34,51708,19050,32658,38,38,54512,23539,30973
3e05aae644b7f2c3df6e08c809112b82,36,28,34388,7931,26457,27,23,21187,6757,14430
0253dab735f59cd2a7855ffeb30ed30e,186,147,691957,121660,570297,153,102,467410,114923,352487
d8a64dee71415a082351e07b0220c478,31,24,16050,4804,11246,27,24,11361,6448,4913
11f9acd6cfe2809b77f73975805a994e,57,41,82130,16451,65679,39,30,40118,18836,21282
63604e21801f935135db96bbceead86e,112,82,235356,63803,171553,127,117,315676,53052,262624
abed311b7f9c3484da06e9e20a1b52b9,64,50,101227,19211,82016,46,31,40564,17103,23461
ede8b5ee19dd6e8d3ed072f4c08eb15d,104,76,213795,24704,189091,98,76,158479,32319,126160
e54a7e9ac33f2f6224ee68006ceffd7c,33,28,21971,12682,9289,39,33,34376,12030,22346
e7e2942d39546f9479afa70c1c993190,116,98,250084,42608,207476,128,89,273147,55417,217730
2408add675ec4c782f364c29aae238eb,145,103,371221,68647,302574,159,138,527564,98000,429564
b6ad56127d573391ce3d5ecc2b828f18,89,73,160705,65074,95631,102,92,217532,44496,173036
bbb05fd8600f9b22cccaf4ea7177d136,40,35,32306,13507,18799,38,30,33823,13816,20007
f2e9829796b5bdbe65655b2e9fb9c5f7,153,101,392563,84444,308119,172,135,462159,113007,349152
7eae95e67a9bc8ecb7e88c692caa5a0d,175,120,575876,153741,422135,192,146,733280,150664,582616
aa17282412619c4a3297ca4c2334e018,256,176,1203681,203037,1000644,234,153,1083584,199837,883747
12efd08d517b757561002e189947a587,14,10,3135,1302,1833,11,12,2456,2215,241
3ab62f4f8823760980918e068add019f,165,128,446886,103006,343880,150,116,419699,93902,325797
3f800a4e845cc9154d3d395ddf803178,113,78,289675,71770,217905,162,113,334117,94813,239304
f0cc1dc5239c3a4d57ff866c54df6fb2,65,46,226233,65988,160245,72,69,204251,110492,93759
4633ceeeedbb4a579607ddc3dafb9a95,26,27,25106,5522,19584,29,23,14447,6801,7646
99570dbcf8e23b1f01450f3cd381c11c,147,100,444712,114565,330147,127,92,391991,120013,271978
3d7b0a70a6c7a928b00adc8a8375262d,119,92,334859,46149,288710,140,108,291293,71794,219499
85164917684d1eeac2277d29d9bcd0b5,41,34,44233,10805,33428,33,25,25655,14123,11532
8902b1bcdd23f435ae5c9c95ffd0a131,115,89,257996,57656,200340,103,87,232801,40987,191814
b63517758cd4158fd39ea983097b8dd2,26,24,24169,5219,18950,40,27,31554,8621,22933
1550ac0a299edce406e042e373913900,89,75,169440,39789,129651,69,52,126092,23850,102242
86f52ef0955f0516375ff5329cdf59bc,22,11,5868,1576,4292,16,20,4647,2979,1668
6374379f41be4657a866ef118865e0db,77,60,100186,34857,65329,83,61,139053,31371,107682
d150070820cf43190461e2acc29ecc95,110,93,198898,48092,150806,106,86,178107,36994,141113
f507615fb09e065af8d6662d936eb4f9,174,142,590890,96421,494469,149,118,539621,111941,427680
38003b6c9d146259150a5da6143867a0,70,54,99846,34562,65284,104,94,186452,42145,144307
0648e5cb99925abb4c512d06aa901f96,17,11,7055,1714,5341,25,15,9030,2665,6365
963aea256d249167eee29968e823368d,91,69,252463,100699,151764,124,80,341242,74646,266596
aad97749a669295a0325e07c9f6ab2a4,160,127,682341,172724,509617,223,161,899753,180980,718773
679c8799a3a0bfe04f42f5c25fe6930d,71,51,88918,32049,56869,69,59,90601,29977,60624
972e0199e489f88870ad3f99e874fb4c,54,35,62788,15427,47361,45,41,52000,14599,37401
5464731842914063fad4f48143a396b6,54,47,74962,25995,48967,103,80,235938,19355,216583
095d175d55da4fb2d84d0c0024759648,60,50,47976,24849,23127,50,41,64768,22970,41798
fa303f8af7278ef5991a93af8c5bfe16,28,22,12712,3710,9002,36,27,21086,5833,15253
53664b2eca2a336cdeb9aaf19f3a9727,104,80,207792,42691,165101,94,67,156717,48202,108515
e9e6c4d56092880c5da2c54b9e2d1165,38,29,28192,12725,15467,37,31,24396,11621,12775
b2dd120e35e7dd8f6a2f2cde8d46b80b,103,81,180151,47179,132972,165,111,291434,40891,250543
ef97bf95740d5fe1b7178262568026fa,198,142,547719,108333,439386,177,129,550094,113738,436356
28a5c399028de3cc3784f27acde1434c,37,19,21142,4245,16897,32,29,16888,7335,9553
98833b67c61caa125d555a9293201c61,186,131,536767,90775,445992,166,125,492650,118597,374053
a90bb5be9d1d637b554615a155c6feb6,182,144,511848,78795,433053,146,123,477434,80586,396848
af27a886d467a2408471e3ded35bced2,100,73,237707,46970,190737,68,49,121008,55551,65457
dfb36df150b99bd279491991279cb0fc,73,59,128353,38175,90178,72,56,91074,43839,47235
3b64c3a27a0fa9780a92802c2189147e,45,35,59081,18254,40827,51,45,56810,21499,35311
39ad24b9b0f081707a81ff2a29945ac3,163,115,480884,114576,366308,182,95,499069,86211,412858
fafc301b53b5c9d0358247d3b215a00a,62,40,65387,16105,49282,60,50,92398,16256,76142
76d3b4c2a89885b1c6ffc85c91d4391e,138,110,282720,44465,238255,110,87,202856,44385,158471
aa1bd8588342c80fbe39a3269a88956f,23,17,10579,3485,7094,20,24,10959,3999,6960
d35ba5776d9cf61b2f2356e083c5199b,221,155,981476,143696,837780,183,110,657331,110858,546473
0e8ac9d8c554b76af2dc2f8318647b6d,40,33,30479,11583,18896,30,33,23088,13424,9664
34c64a319384229fc764c9020ab83da0,38,29,59743,17532,42211,38,32,41693,21204,20489
d62157340ca8c031e658a2f6024dc9e2,50,45,54719,13262,41457,41,32,20963,16863,4100
fef5d167a1c93b46eff49b08dcfc2471,106,72,313897,103694,210203,179,111,453787,118074,335713
c46f4e15a9bdc9bce51254f73bc9b44e,25,20,8425,3534,4891,23,21,10832,4267,6565
d38e09ec8f218cdc71190942ea5f45be,52,39,82785,22811,59974,48,41,88787,28591,60196
2fa7ab32368ea26b93e8145b924455de,63,49,106701,27326,79375,105,87,130445,41681,88764
963fbe0bb45c3cdcbca90db425f861f1,36,31,34133,12378,21755,48,36,47023,14954,32069
0a9edd0e2965453b22edb0e86b7d2a6f,48,36,32783,13922,18861,54,41,47562,16448,31114
f01c29e20220c97e6438500fe97a6252,32,31,26975,8788,18187,38,27,24818,11557,13261
2b131afeb6928ff178d2ecfefc777254,84,67,164002,35433,128569,84,64,120641,33233,87408
1ec96ec35552f0d1c80cb1e254ac9e49,110,78,223799,55911,167888,128,100,248732,66923,181809
2fc73bfddc8f86d5f872342691fe36e2,115,71,185874,46669,139205,179,105,261188,44014,217174
189e5950c4510ca3511a2158581d352d,41,32,40317,9429,30888,31,19,22987,5745,17242
ffcf25b78d4a6f39c5015e0122926617,79,65,173640,47690,125950,72,57,167914,39138,128776
b451f836460501af7a14ea78c1474eda,80,64,131581,55595,75986,87,72,154815,84264,70551
82c19e1eb78c8e0450a0d2af34a3e316,87,63,196615,68672,127943,76,52,198171,54594,143577
7ae1eec61bd65d0c91b9ea6236dc6412,7,6,1015,252,763,3,5,212,736,-524
5b91fd4a65e19bae84ccdef663305f65,107,84,252921,47054,205867,92,63,157350,41478,115872
f07f2f5d5fa2c06a2377ad67ddfcae6c,133,92,319658,54818,264840,123,89,256198,47231,208967
24437660863ae61fe49f4d308d5652a8,53,38,59745,21646,38099,60,53,59892,19856,40036
2884855e0a646ab0a228e765ddb1ca3f,129,89,249879,48315,201564,106,97,206355,63677,142678
662f7e40d2a7045d6f0cf365a0e64e36,87,77,125120,60935,64185,130,113,276749,58810,217939
3ff8b3583dabc95c0cae7a37f2f24ec6,169,129,710577,170803,539774,180,131,596579,184184,412395
7f84b44add9cb3503fb98d615cab34a8,47,29,40553,11460,29093,48,40,49092,12453,36639
51bb0ddae0e4abca8d9a912d112f4a97,130,114,250327,77182,173145,104,88,191607,60621,130986
88ee1b5a501a0a269dcbe289a584216e,175,114,478361,168178,310183,153,111,575277,97481,477796
0ee301d26dcec8c5f3cf48a20dfa75e6,78,64,117487,27700,89787,43,33,35420,21836,13584
7d9d8d948445993deb879daaf4c2c550,47,38,86330,27688,58642,76,56,205353,40408,164945
e594f6c1aaf05ad484a1acf45d183d2b,62,49,83596,24195,59401,52,44,76995,23649,53346
b28c5abdd46d17de4aca48dd275a70e8,32,27,11304,6967,4337,34,23,17683,6145,11538
648a231953f7510b989d8e29143fb928,207,139,848402,214286,634116,237,172,975284,251102,724182
173bdcb7080bd12eb57727cb03f65600,55,40,59141,15372,43769,42,34,31184,20589,10595
7c1db0790ffd4a812458dac553cb023a,186,157,787979,170455,617524,158,122,519602,149831,369771
816f4655270b79f7531586abbe60248f,118,93,433092,72841,360251,165,133,575801,85696,490105
4fe84e5560ff9eaa9bea34fca08553be,101,75,197120,39775,157345,117,101,282529,39820,242709
d8282dc63a6ba94b522ef0e4c5d5acd8,59,52,85783,45648,40135,67,53,114187,22261,91926
f0f220a58a6151aa11bcbe3dfd7c8b9e,59,42,106630,30675,75955,55,45,88691,30536,58155
f8bb9eb724fe1fc6823cb48bcdd383d7,146,120,490243,127509,362734,211,123,590648,93159,497489
ca0de9b06349a529c17fb068188a028e,91,69,248313,84985,163328,117,97,303464,69574,233890
03fbe428aa4bca914972e31e9ab09e6a,128,93,427800,115481,312319,172,119,577248,107682,469566
edb8e6c8a9fdd3f530e295789998ec1b,153,126,388320,115432,272888,120,92,323354,83675,239679
593a82a69d19a15f5cfd3461ba143539,115,71,351440,104331,247109,171,122,691772,82448,609324
fcc1c75548d0dbef3b1988a6c9769eea,26,16,10430,8199,2231,28,20,16103,4464,11639
2ce0b3253dda14d099b7ce4d85a52629,152,116,446959,75152,371807,151,129,395704,76908,318796
d36598fd82a6d2b86aeb195250d661bc,38,25,40172,10796,29376,41,30,34702,11108,23594
a518912998dfc0de3d137c971fd41a15,70,50,105097,45802,59295,101,89,203206,45336,157870
36811134d762def90f1578ca0e7b98a8,22,22,17333,6642,10691,28,18,20220,5713,14507
48337cfe53d27b3330f5675d4b9da427,90,75,154143,26941,127202,68,57,106514,30368,76146
713a801d69bbb49f57cf77af11387e3f,29,23,21356,13027,8329,34,23,44579,10897,33682
83265f62382b9b6f17d42559b518b55f,168,140,707466,136027,571439,238,129,645446,112972,532474
b78487670ff49597aa3596300b041ab5,198,161,920900,97944,822956,153,113,604514,97190,507324
42be4de2dea760b466b17747965aaa4a,97,74,190230,43878,146352,80,74,152796,39934,112862
7a3e8c6f65cd6a20f9cdfd042efe2510,83,67,128882,34061,94821,74,54,108126,29792,78334
a18288d7ed0bd3dd18656105abe2286d,58,42,39740,15032,24708,41,41,37948,12380,25568
c97be8115404c68788cef41aad25b523,54,43,97438,16671,80767,49,44,58454,23383,35071
9ce05ab866b52cb790669c3825e9b978,59,52,76972,27981,48991,47,33,58845,25276,33569
08f3c7041d045af4558063f28625e57d,61,39,45744,15579,30165,58,43,48846,13261,35585
9dc96d33675bafff146209f245eed384,58,55,109735,27584,82151,68,49,95021,15258,79763
624cd333171d076852ba8746ef039c24,0,2,0,20,-20,0,0,0,0,0
fda69a8892f61a1f41aeb975665f8edf,30,23,14185,4049,10136,21,16,8599,3115,5484
62ae56f72b04f8d0b19707437c454743,126,72,218673,64542,154131,149,118,316691,57556,259135
72804fe9080fb4296b009f614de90856,102,82,198247,41316,156931,87,71,154619,35607,119012
6d7988b2c93c067431ec506d71c73b57,186,73,435924,60832,375092,140,97,308404,95402,213002
87cee563f3649ed1052a2ed901b816e9,145,117,583698,189524,394174,182,141,600712,150278,450434
64f97a4e27ddd26503c7c872349bfbc0,108,94,357611,86836,270775,172,145,523558,106952,416606
d17eea8e26d804d183a5ee992c89a94e,169,131,610637,131505,479132,179,119,608226,144967,463259
cafa572fd802be279ced24e94afe1196,49,35,60105,13921,46184,49,41,37438,19160,18278
cc4d0ab84fda41812ddef4b3fea4d44f,86,53,148194,27935,120259,60,55,90718,38744,51974
1fd3d65305c79ad2c1238d62dfa8e99d,110,82,225943,56736,169207,94,72,167939,54497,113442
52975667eb6911aa58191fe1e5f9fbb4,48,35,35113,15325,19788,43,39,48311,18317,29994
79432e18b60ad2b1f2f3013d9245e0d7,33,30,47414,13818,33596,46,31,50006,14525,35481
fd1c5a23a12a8ab4d67c573ea6e15260,110,94,322049,56116,265933,154,115,406577,52189,354388
ec4e6edfbb19160c548888cd92f9ccbb,91,75,122948,38814,84134,72,53,72224,38069,34155
aed12d77e25cd5408e0fc79ad86e0032,90,71,169614,52670,116944,91,77,161205,55171,106034
b144f3175a0229ffdedb8be2354079b6,67,51,127684,38332,89352,75,62,92464,43130,49334
082c367dfb9e381c85ef020f97450b58,0,1,0,35,-35,1,0,35,0,35
42f98346f32a3927e276f54fa1eaa39c,43,27,47597,11504,36093,47,33,36277,17447,18830
ea83a9cfb9c7ba31078dcb8b0d4233cb,63,40,100874,22775,78099,65,51,103257,31113,72144
77a15294dd76e1d705e9f0b382adbfef,61,46,66791,24809,41982,46,41,55887,21504,34383
e613b117d629d3f7ef5b6e6d73de56b9,72,57,127272,34187,93085,104,88,161256,44155,117101
bb9fcc9643cda6f3657a99f29364a07f,72,56,79449,26558,52891,56,52,70017,25111,44906
ecc4bc81774a258c0ff57ad0d8d6d32b,131,95,322353,45979,276374,111,98,244027,61900,182127
4e8c6e3197b1f98075f220568d1d6d5b,109,73,245122,59976,185146,84,58,170986,58456,112530
21d2dee175c9e1bda4972f2aeba6bc20,62,46,64892,17470,47422,53,39,52972,10254,42718
2abb2e83c126faee0fd5a8399b8a25c2,20,16,6380,2504,3876,18,16,4668,2846,1822
d6b9d909f31dd1e69808516fd94114e4,115,97,392689,84545,308144,147,116,436324,82501,353823
574c2e3f46422e00af55ca9dcdc1422a,86,72,148517,34984,113533,86,71,132977,49686,83291
a22df013821fc0c6312b28cfaf3af394,17,17,5170,3283,1887,20,15,5149,2196,2953
14d3cfa3a7b5ef38a93b7f110f388446,134,94,234816,63213,171603,99,77,196119,73772,122347
cc7d7d31afcfacfa0f9c4b6f72068e6e,24,21,9046,3967,5079,19,16,6508,3591,2917
b0a9de4968ad06df69ca083f4ad60c17,42,32,53255,20370,32885,41,32,56019,21268,34751
5d81fe8e023bf7cb07685a4ddc5fdc52,123,92,316229,79236,236993,138,104,313958,69223,244735
f3be3f988557757760d223f0239fa65d,55,48,71250,21849,49401,63,55,78397,22186,56211
b4010d8ff8f949ab50796e46c637b570,10,10,1138,982,156,10,7,1269,665,604
d3952b1230f5f52da1579f028d835813,69,42,91503,13371,78132,52,37,41169,15893,25276
753d5f342f574b4acccbd26faa3a01fa,94,69,168690,47462,121228,115,68,173816,35597,138219
f0424c5a7929d38bb704fcd3cd64612b,20,19,10272,4381,5891,28,16,14694,3286,11408
c96bce7cdb9f343d9c2c12cd6adb9f76,150,122,412004,90508,321496,152,132,477343,101499,375844
25ef8e9fd2508321120bcd3901095142,60,49,79025,23882,55143,55,45,90823,21209,69614
ad8bcfeabaa703ccd6d08a60e4edcab5,146,108,445221,100955,344266,185,141,543399,112658,430741
38343806f6d6576252fcf11677ebdba6,162,127,617072,98368,518704,151,125,586830,121487,465343
882cd138647455613a33aed699ec211e,50,38,76277,24470,51807,59,51,89659,29776,59883
2355040e2f8b59c8468c894d49402fdd,40,37,46619,19860,26759,41,30,49190,10904,38286
2136cde6dfcba77f1dca90880310acef,59,42,88316,16914,71402,44,33,48082,14753,33329
d7ce15ee0769bc50b1c44a042f49b905,119,75,306946,51257,255689,148,115,393403,64652,328751
3bfea31516cf40ecb5a40327af858e44,97,63,134085,32972,101113,99,75,154466,31714,122752
85f7e91a4a26e15b2df02fd2fed26b57,197,158,862232,143158,719074,224,166,865857,161903,703954
3ff41d47f003345cb3781c853eb40331,95,80,204092,83417,120675,104,69,200046,42629,157417
23901e7e3fec9fb4d071788679d786b1,185,124,687991,148574,539417,178,147,658433,178357,480076
4a5423d2b54223386c8a850f9eb754c0,77,62,143380,56841,86539,85,65,112276,42539,69737
c1caf1898f2a3b42c942cd22734b01b3,148,102,465991,102391,363600,139,110,386252,122332,263920
b858774d4c4d4500205284f27906cf00,23,20,8000,4777,3223,27,16,12302,3742,8560
5c2b2a762b1fe13de3e08e855e35020c,152,106,493245,68156,425089,153,123,437102,89191,347911
fa1fc3441cd4b52dca4c61317bbd4b09,81,48,96945,46751,50194,110,70,133409,27774,105635
6fb30412c41417a7b06d03d4f39ddc5c,164,111,711755,137816,573939,160,115,469535,101675,367860
b9a42e7feed7a54dff8ed429f97e9753,134,88,327870,55343,272527,135,119,444703,65148,379555
5031b5b6d647d26910531f755795fd75,42,36,52640,19389,33251,57,43,76319,17731,58588
22421ea6138d9412242f9662992eaa48,10,7,1266,829,437,9,5,1526,771,755
9acf81b27431728b627e61c07325a9c3,30,23,21289,10643,10646,30,27,26527,10008,16519
fa5cc8571ca7e9c1d3b6b91f30e09747,170,120,439137,83509,355628,115,97,328478,114652,213826
ffebf2ad9a3339ebd4acf7bfa869accb,89,75,150343,37325,113018,82,64,116121,38346,77775
f19af4a82c5000f0c1ef21cf2eaa94b0,69,57,115148,58666,56482,69,53,139054,52287,86767
0dd3ca363a520cb8cee7f98a546bad26,170,129,756049,176465,579584,216,149,913064,162202,750862
00abfe7dd8545a642547bb4450ca8cc5,25,18,12627,5053,7574,21,17,13205,6000,7205
f7f592284fb7ce5dc988f6fa0091014d,88,63,128901,31966,96935,68,46,93389,21311,72078
3aabeb4e42f4da747894e226833b422f,101,87,170638,45438,125200,87,62,165846,43205,122641
6782ccc3151708e75bfc05974334a639,80,56,106414,40439,65975,99,86,120258,48920,71338
cb6d67c7ff54816dbfce6b8695410515,1,4,272,894,-622,4,1,894,272,622
19ba1a7a82cc25bd4f0dd3ff31a3f2a8,122,72,179032,38309,140723,104,69,187601,45636,141965
20c3b7ba38ea72459f2742aebee40df1,2,4,259,362,-103,4,2,362,259,103
14a64eef8d0d75b6e9d396b42aaad511,51,48,60214,19166,41048,42,36,48471,17349,31122
b8149e245a2ced6a0b0049994c8c706b,189,139,877035,131818,745217,180,135,829462,138526,690936
f267805851c3944930bde06d3eee6849,50,39,46094,17106,28988,45,39,28196,18793,9403
326517d48638caa0c75fefe5cfadecdf,25,16,7566,2889,4677,22,18,7865,1809,6056
ac1484160798d52d861f9c56af448b73,135,116,291721,91793,199928,72,60,209694,61755,147939
dca4718cfc4b1beb7266607796722cac,46,30,51122,10898,40224,47,36,36802,15762,21040
f8dfad75d1d9fda46ad2a917a6bde357,36,26,24861,11420,13441,32,27,16956,12831,4125
4bcd0ca41ac9de4801e5f07a8b7070a4,102,62,220752,52900,167852,174,80,339922,48539,291383
5fc27389c959367e065a500ff161d003,104,91,179266,48568,130698,86,73,150390,40379,110011
7c38e22d5c73795e5bb3baa8970d0c42,63,44,93974,40979,52995,84,75,143084,51759,91325
0ec78cd5288f96e9db5d2d2b7270592f,81,68,82222,43786,38436,74,59,108621,37507,71114
51382b70821425e061b39b63c7a4bea4,87,60,208576,42032,166544,103,81,212016,51552,160464
c676282226f2cfb30e1710af52525eb3,72,64,130989,25506,105483,70,59,88724,26804,61920
2b1e334575c01036c2bfa553ea6fa5f6,46,34,41754,17491,24263,41,37,35199,9671,25528
45d44eb12a922cda2d986a57fbd14c11,59,52,109125,31051,78074,82,66,119430,40923,78507
39ebdbb146ac3cc22f9c59895e26ee31,58,42,128348,39333,89015,59,50,91239,37234,54005
6415a131347a3a05eb0fb8e5b75788ba,174,130,617261,83995,533266,190,124,616203,85894,530309
79929bf6ac9bc9b4d1392315fbb3d2b5,76,64,181608,56556,125052,162,119,372001,58768,313233
6bbabfdf8c987385e44b63e0815c40f3,24,17,8727,3566,5161,25,19,9406,1513,7893
a384b86b8e6bce80396d47ea1a31efce,29,19,6811,3696,3115,17,21,6626,4254,2372
d584943e238bc6444d14ac21b6f19deb,212,156,1036177,166533,869644,172,141,747493,140967,606526
40c8435537fe42a8c5bb38bb97e386db,99,77,305450,68546,236904,127,110,353028,80611,272417
ee19bcab612fe11adc6740c428d64548,92,67,126951,27823,99128,58,36,66137,15932,50205
795458344bb0abb84284e012d702ef96,22,21,7704,4755,2949,25,18,7473,5392,2081
3706dc1ba20065c9e8a609945e367f54,99,76,147620,46518,101102,107,84,223947,38439,185508
3d4280306f4167d9f19985f4eab08059,167,123,670013,97354,572659,149,119,421680,167766,253914
211267aab9551ff9611772ed69dac7dc,60,43,79134,26965,52169,53,43,79545,25279,54266
46dd0313901a37baea5855615de0e686,108,83,176970,53209,123761,147,108,368610,44059,324551
bf8cd50d432c06db19f5a002c59e4742,125,80,198966,39429,159537,102,86,160666,66213,94453
bc6f2b18b3506befe6fc93a8f72fef82,138,100,263240,74555,188685,97,75,180112,88712,91400
d80f74c76182bbf5ca28a0146f2ea5f2,55,40,54416,19543,34873,71,56,94443,23505,70938
3b33537a8a3de85844ac8ff5ade7dd92,66,43,69062,17652,51410,69,64,64149,29775,34374
5a419431851121279134cec4999a586a,162,112,634094,136525,497569,180,141,549361,153879,395482
f6be617cf6b3674d36ea17cb52d10d71,195,124,693945,162631,531314,169,94,522565,115290,407275
cf217057c4109ac1251cbda643650229,64,50,106329,21312,85017,64,47,91551,24042,67509
e1dc19da20a1f7e2ba592cc073f84ed9,3,5,419,792,-373,5,3,792,419,373
6ab3b6b58f59abb9f16d10d4d887f2b1,74,63,127029,26371,100658,45,42,57803,18678,39125
0de74222eac1c95f72dca8f9b4569dda,64,55,119790,52960,66830,85,63,205951,40619,165332
5db129c1891a948bee37ea36cb693d9b,100,73,252899,67143,185756,81,66,171885,41131,130754
483e48af5e882647eae2ad10d80f89d1,69,53,96374,32883,63491,62,51,100536,36656,63880
7f31adeea9df93dbad632b080e88b3cd,70,51,131359,27669,103690,89,69,129574,41032,88542
5fc9a32398cd8849e6eaba3c630d9e3a,90,81,127802,33695,94107,117,78,173645,31856,141789
ea09654974f8df8a35e48b99f30d49e6,91,80,214403,73240,141163,63,62,180193,63998,116195
b532d5f220eb114fcd23b17c79738d61,75,59,105270,32777,72493,64,57,75146,34860,40286
ca12f69fde63fd24a804ab108d25d024,49,30,61345,12328,49017,47,42,61838,20904,40934
f3691c9a2a2b5ae65807c2a8685531dc,174,122,577818,99268,478550,151,99,578091,86762,491329
b65b960b89be547c5cc62ae5be947171,126,93,219273,48290,170983,85,66,124712,56258,68454
ffd3fe0f8095f3f5062c35f53e6e137c,112,90,213570,52284,161286,128,96,226250,66014,160236
6386a960aabae9255dfb5ed7c8a22146,28,20,27002,7644,19358,37,31,30411,10073,20338
f67bdd295d9fe8f7ee4a48154136c0c1,159,131,572567,130917,441650,156,137,639348,148032,491316
c53c6774d7fbe0a4f2d85d8ac3803577,84,60,160943,67071,93872,84,62,184645,62370,122275
9f4380966a1fb62a17268f3e1d496292,84,62,142636,36630,106006,97,84,154794,35994,118800
e1a02efa5bff24dd0d28f55d322ce8df,59,45,71493,18483,53010,50,44,44300,23353,20947
79f0a403d4d3bf6ec1fde9fe27de0f7a,78,48,119497,27739,91758,59,48,108727,41457,67270
0d028119eba73b76b88d6dd71fe3fa62,159,114,589345,115171,474174,199,124,658257,192569,465688
dd5741c662978656e0de21032736d5e9,24,15,5183,3071,2112,21,18,7354,3642,3712
0618e1457527fe8544daca9cf28af4df,161,127,437122,68870,368252,154,121,361283,51105,310178
d7d3380d6eb05a79a1d8fa7ae2dbab46,22,13,8789,4977,3812,26,22,11759,5513,6246
09e5e1948bd9a5b0ac18c94a6e794ebe,115,89,188777,34205,154572,131,101,262519,49982,212537
0127b5f3e2c30040a81bb121db245d78,60,48,89291,25182,64109,48,40,63497,28025,35472
e97428298c8b76737c5eb8c7b19dd6bd,36,28,26208,11776,14432,35,29,28170,13258,14912
66c25ec49f0f62e167d031d0d136b94b,142,90,249346,30814,218532,85,48,112584,31792,80792
5428b82903401c646907df6bb9f37d62,143,115,541724,91026,450698,162,117,509846,85795,424051
5be05b3f1c4f7014e18991a194da9580,107,82,233639,56927,176712,101,77,174140,49394,124746
c31b9d4937ae0706e9654fe0f6177ae0,42,28,49300,19585,29715,42,35,54083,26220,27863
86d61320ed657663ee39c592c2b465ab,91,64,109323,27685,81638,62,61,77167,29779,47388
2d6749b2eac7194444a1a2239c9e7165,31,26,13676,7415,6261,28,25,17147,6757,10390
e30b1362aa84050cee89513b587fe0c2,93,76,221860,85679,136181,162,129,402157,83464,318693
e167df8d4011e089d72c2030ab73fb60,53,33,68511,17669,50842,41,34,43961,15714,28247
239009c9666f5d8b1f9a036ac175c687,60,48,45168,18896,26272,56,47,44756,18754,26002
a7e0d8e0c62b4ef639f7550db61e1754,64,58,84907,38137,46770,76,55,91244,31631,59613
49fd5c3cb89db5fc81907d7946574513,20,18,8999,3197,5802,24,10,9008,3220,5788
f206388d0567bb235960dd7e55cd3c03,130,88,394494,93099,301395,170,137,565763,145764,419999
48d63dc86df0bdaf9f3bbf0f6f1e6178,224,145,898798,124371,774427,222,133,630115,129257,500858
2648c301648e55e04578d2c0ed0c86a7,178,143,476842,89245,387597,184,139,627988,74124,553864
7d4e71e7c6ddfbde9585697ab582d996,83,74,117372,43795,73577,96,78,123842,37562,86280
10eeacab46e1c76db7f7ad40c1b822c7,173,137,545968,76568,469400,125,90,488124,91286,396838
4c8e41bb2f6d0adb7bcfc249cfe54a77,45,38,50655,24336,26319,56,42,78582,20726,57856
fec71a332d87f87351031f389e343cdf,105,67,124971,29885,95086,96,96,166782,38644,128138
5ff3890398aeaf6c01d3eacea32b5a45,129,92,210422,34725,175697,96,53,146256,29477,116779
ab1dc28c94113233b5285d00ef12087b,22,21,9338,4319,5019,24,21,9368,5813,3555
95b765c55f856bcd2d00c7d2201d4cc8,123,97,231411,48229,183182,107,88,188346,46454,141892
5f9b3aaa3a97a1cbcbefd93bcea36c79,125,92,253074,55676,197398,91,78,203780,61194,142586
0fbc47621980b137484880491138c597,78,61,117465,35583,81882,74,57,102041,35653,66388
8559f6fd7fc29d2dabb41f58813c3b5c,138,96,316431,70716,245715,193,133,430509,64055,366454
540783c982dcd6d968ed126385465251,210,131,770618,188917,581701,212,176,816431,204204,612227
4e67ef4a12aafab8dd96428ab0c73242,146,113,478987,138394,340593,133,97,493021,185242,307779
3817f00206a77fc51e901d8d643c238f,50,43,71657,22613,49044,43,33,51461,25322,26139
2d6428c063f8e52677f4432a27467972,162,120,431067,64534,366533,103,85,269178,58857,210321
9d39ce6b7824a892e224264b4bd5d063,169,139,681337,200851,480486,217,181,840642,154977,685665
666d14553b57fedf6f50691934a45639,83,73,164562,43907,120655,100,80,221106,37669,183437
4be27944a04dc2dfd68508c1b7c3dd27,162,134,471035,70334,400701,149,110,407160,69712,337448
21547601b8a80911d47ba2b6a22cb46f,186,148,748183,152136,596047,187,113,528480,140306,388174
5faea732fd04ca4e670e1f4fcd399291,109,65,133283,39218,94065,117,75,170937,31837,139100
72d5864e0f2eabeb76c1d0c2de5655fe,51,42,48073,27144,20929,79,55,94467,21153,73314
523c3cfb261c1e0063ee2d8d6c28a31f,97,76,185689,41851,143838,124,96,157588,56754,100834
58c4ed45e689f52d65c7908946387436,205,156,754615,135452,619163,160,127,581606,116984,464622
52a133117c3c3f650abc49286c7e3997,54,45,52473,15738,36735,57,35,47334,17114,30220
a9065d453553e3745915eb038673e9df,64,52,73261,24668,48593,38,34,52002,17309,34693
87203030545991743c423709b30ca5fd,36,29,42784,11238,31546,48,35,45101,12994,32107
3166a506e3c1893f53e5fd71fdeaeca1,132,105,331381,57332,274049,123,101,299366,46280,253086
c53bdca21c8851f481e1e145fa9ec621,169,115,635767,120372,515395,169,125,492066,144061,348005
b262aeb6455ff32da1ba3a3a5d56b8ff,154,115,603996,175110,428886,231,125,825618,113736,711882
fd8542723c236a6604fb0fa7304ae316,112,95,192144,47936,144208,91,80,141026,43225,97801
bea347debec561c3126361b4a39b0c90,145,118,616235,141702,474533,147,125,538978,146678,392300
7c8ed437d581cc3e13403e0fab227c3f,133,94,298273,72196,226077,181,142,553475,107515,445960
bc0dcf831e135cdf15630b675821f401,39,32,48767,20701,28066,38,31,44187,17935,26252
d79302f7d47a45eef79536a81f5134d6,67,48,123482,29352,94130,65,63,153345,34526,118819
7826465c18c09b5edafd51fa77f5695c,86,52,150979,27492,123487,63,39,72330,37904,34426
d0cdff589a96b03c3df0e3466ade675a,35,30,27693,11856,15837,43,31,36711,13342,23369
a27e50b6bbda685f1448ad866572610b,62,45,62836,21787,41049,78,57,80550,23011,57539
c85972ce425e346e391417e5cf4393c9,28,21,17426,5007,12419,28,21,20139,4432,15707
150bf1aec86a2445b3903a5caa4d6fd0,35,33,29579,10464,19115,27,22,22645,9145,13500
13f794834ee84f7b9a434cac08c71d6e,33,28,12581,6578,6003,29,26,18460,5963,12497
502626f5457fad78cc3a0bcb1f7dde5f,105,86,255511,59291,196220,116,92,246398,52215,194183
64c17ff4d05d22795ddf504fb31a97c7,61,44,96912,54131,42781,62,51,145766,40643,105123
1ca9d86140f39db811aac2fe4d27fe83,123,75,249231,48141,201090,100,73,199695,76996,122699
588b242d2a164e61ca0a5743ac593ae4,0,0,0,0,0,0,0,0,0,0
c7a06f06492edb01b035274e8e1bed53,137,105,430732,89427,341305,158,120,348487,81234,267253
ce1b82af8d4f4a81ca1cd6f6e6f48f49,13,13,3599,2461,1138,18,14,3996,2410,1586
7f8afabf38221c9ef38655f165e73844,29,24,14984,5344,9640,33,24,16002,7895,8107
2684ce4a33539fab61e02d45b78318f2,173,125,529147,76716,452431,123,80,360687,94181,266506
dea2e0c7679040bcc7b982d0b13238f6,71,53,90855,27735,63120,83,59,101925,22951,78974
6f2f5c65204bce361ebf69e3e2c45d9c,143,118,471236,103468,367768,141,101,455593,126033,329560
f66f79395b90d7de7d7018df87e112d2,76,63,115882,22315,93567,55,47,89102,21552,67550
390da3f9ce2d9a14939c8c188c4be916,45,33,39575,19602,19973,35,28,49445,19419,30026
45b329759396715b4fdb5521fbcaec99,77,66,147964,34227,113737,70,56,119226,31051,88175
8c629cf66e5718a96a65c67e3e4e5306,83,64,222789,53920,168869,108,83,301998,52196,249802
a3cb04d7fdaf78cdc7f0d179afa6fb5d,100,77,277849,66203,211646,132,92,356581,57568,299013
655301e637c36ed44c902ff6d8cb5421,35,22,18007,6809,11198,33,22,26905,7023,19882
3e771cc6167ed109273ced5588e26eb3,42,36,42023,24482,17541,62,58,104400,20262,84138
55d11ddf9e05ed44f03eb2a1cd344b23,77,58,130417,29763,100654,73,58,120649,35162,85487
343b81e98548873c3da3f3f02408fa4e,36,27,32753,11962,20791,29,24,16104,10076,6028
90c90a87180b67c0ba1e5f54af8ae611,11,13,3084,2435,649,12,14,2883,3500,-617
4ef8893f38a1b25efd1995cab71589c3,114,100,302981,52636,250345,102,80,229762,54221,175541
28176db3afb8b5e0d858a84e9e1509e9,122,77,255506,52483,203023,95,75,182961,56466,126495
342b0aaf74a03452f118a8eccb44a8d3,55,50,58431,20577,37854,50,43,54934,17681,37253
80a6c2e33b0dd7b98edc38aae0a42431,67,61,62044,32031,30013,76,54,144698,24003,120695
b86f51ca243f756d0cfb48e15237e550,74,53,133838,30335,103503,77,63,117526,27450,90076
749d1bc7d331c57a15021c065b6b87cd,56,48,94513,42094,52419,93,62,162214,47190,115024
301a0ff133c811ad76afc32e537e97a8,96,75,140560,38629,101931,81,63,122727,41616,81111
4c07eb604bbf15ff921fe8786e60a845,166,116,358448,53368,305080,135,96,265075,52033,213042
1573dfd3e175f34124712e88fe1c05e1,93,83,219958,74659,145299,132,104,354733,67197,287536
1156155b192f4796f40602b9a14bd260,123,107,313972,71062,242910,98,84,170157,81299,88858
f57a9d910ba3962c484a4d8082ec9a69,37,29,24022,7516,16506,42,27,28548,8602,19946
6659b8c17600a4f75d59de560a742add,39,27,27308,12209,15099,49,38,45730,11772,33958
f80d85e14209089ebe85470c17acb907,80,64,133718,37796,95922,90,73,117353,52010,65343
86574d30bbbe80240d4d580ddcacbae6,136,93,393137,82992,310145,127,106,347204,92048,255156
307afd94eaa55bd1438deacae210c68d,116,98,246533,64020,182513,99,86,191345,64299,127046
d9fed563765ac41179398c764fefa961,13,10,2373,1104,1269,14,10,2775,695,2080
20abc9db52857962c1bb9233226083d1,36,25,30997,9770,21227,43,34,34067,13184,20883
a245ee4f4cf844a05a71c5e4b45b194d,139,94,336587,84487,252100,165,134,521564,78192,443372
98c6da40511a5a875c32b9838f0635ec,20,14,5745,3173,2572,23,19,9170,2939,6231
5a52035ec7056cefcce06708d5676580,34,28,26078,10340,15738,33,29,20002,13978,6024
6c6a620f3629d270e57e244f3f7eb305,154,106,459624,125908,333716,187,141,567320,129143,438177
97d05b7f1c371880368a296e69ec76f5,50,38,72438,20275,52163,43,35,68418,21154,47264
c26dad5a1d2ed7fdf0cc20879a1df557,33,30,25321,12036,13285,44,36,37668,10739,26929
e996644990a0faa694acc3b8232924e8,33,32,38449,21161,17288,34,30,50230,15067,35163
eff300ccf9c53edc6fa7685a7fba1e8c,167,135,530872,141704,389168,171,125,566624,142214,424410
328cde59325f103af977bd5982437498,69,54,144086,45104,98982,61,55,87190,36623,50567
bf17bfbcd81d51b43f2af6c5a205f89b,123,101,289065,51588,237477,80,57,155676,39509,116167
fe7ff7701bdca852793c6cbd96d5ccda,129,98,353462,59252,294210,105,81,233940,63311,170629
3bf88bbce782e366714f0a4c9e20c6b7,152,114,453833,91190,362643,118,87,310323,75156,235167
e32499751ea916b5acc217525a672c45,102,80,305146,52814,252332,101,92,220607,63313,157294
33f36bf94675af23a5a9151724fbe7f6,127,82,186561,39394,147167,98,72,123430,45842,77588
5275fd2ccf8f76f7e5b736cd368403b3,29,20,17027,6739,10288,38,26,35317,5802,29515
edde8f57ca150dd895e90f67afab2f36,22,22,12143,4677,7466,34,30,20681,6346,14335
f0226b5f999fae894cd8536b086bbacd,20,19,5163,2195,2968,18,14,4346,2440,1906
88b3b3cdc462781d00391cf2e98a1973,124,89,302533,92619,209914,147,107,375566,78519,297047
0345bee585d2d1b0d80ad87d97927241,145,108,439082,91515,347567,154,140,457568,92290,365278
58f76e24fb0c3bcc0a4cdd5487be3106,117,88,246399,72919,173480,136,108,284158,73282,210876
dcc125f4202918685b88a8de293102a8,68,59,103950,29359,74591,93,71,109441,32721,76720
28e08fc6ecaa8ef24cc34268da0ef5d2,44,34,72318,23558,48760,65,53,99958,33160,66798
784ed30198ea477a876c8afb0774c4a9,28,21,19577,10334,9243,29,24,20634,10559,10075
526b92b8d3d22790b87472ed549ee3db,54,57,104730,36312,68418,49,44,93956,31303,62653
b70551cbb2105ef0e1dc3826357fdb08,43,35,42930,18306,24624,30,28,34375,15303,19072
0be2f29a48cb6637b190246e306afc77,55,50,75898,28091,47807,68,45,82819,26080,56739
1f67eaa746a4832050252db99de54bd2,207,163,628787,91330,537457,149,126,405778,67865,337913
fc610ac388d674724d5cb54b3fe5a62c,33,27,23219,11902,11317,31,29,22807,10615,12192
f25b788f29006c5d0d4c4e2b34a798a0,108,80,269567,81359,188208,107,85,236107,56451,179656
87d1ce73a40e9fe16ff600cc3d0663c7,195,128,562107,109831,452276,180,109,674308,91407,582901
f18f7810a1ccf6a38216f31b9b730af4,35,23,16930,5490,11440,28,22,20328,5209,15119
f64223f1ecb5f8e32d42495f2a897032,222,170,1010424,181227,829197,150,123,1092193,220995,871198
50fe9076e07b5ee901c7eae8a7cd274a,196,143,626232,104806,521426,159,124,531683,135148,396535
c3589c952ffb7501343404401d11b799,23,20,10703,7360,3343,25,23,12651,6612,6039
aa2c0fa1f6f2a97a62810b06d9532e7a,94,73,171502,50026,121476,74,55,137728,58310,79418
af951149e9cda2b089e61dfae9023300,85,62,133917,49522,84395,112,89,265217,53874,211343
bf5200290582433200666a424f8b7506,80,68,165888,30775,135113,72,60,113662,44787,68875
0f61d0f45b43bb95814eb6d76a3c92c2,30,24,26648,7411,19237,24,16,22410,9255,13155
32f78502cb8bd2fa3ddf2f21a88ea9d6,3,5,331,274,57,5,3,274,331,-57
062c8d5efcb12e937a3b29c431538b0a,33,29,20258,11144,9114,34,28,29781,8605,21176
adb9ca7c8c01d34db0f7d9266a2a1c28,27,24,16114,6963,9151,28,18,21532,5384,16148
e934a86bafaedab74ff01160ed5ca498,70,66,108409,55129,53280,83,62,133809,31871,101938
e2f336b0da950730b4df35710ec51eae,164,95,552344,102651,449693,200,143,559802,184412,375390
53b844713af40a82b4ec30523af6fcb4,106,86,181244,46512,134732,71,54,137950,48539,89411
0d3219c14a899d9d50fa85a4cec118d3,87,66,164091,36656,127435,85,71,120773,39159,81614
d44c8d7ad7b3c534e5eef2c23b06a52e,120,103,266345,53407,212938,95,71,161378,49966,111412
9013213daa34db0aae261b44ecedf432,131,108,430723,108827,321896,150,117,478412,104862,373550
2d8db839b024dd70af2ca43bbfb21233,83,75,119151,24653,94498,71,57,83901,25829,58072
d1cf96e6b4d89d23a128af1378a7819c,39,32,31336,13973,17363,48,39,44171,14294,29877
c36b222463ad4eb8178bf9c4e68dd00a,73,57,100299,26751,73548,71,58,100047,26811,73236
e688dba19e54b849f3591217213fc136,120,91,309122,55700,253422,109,81,209789,53657,156132
e96b2bf57c9333fa1960f7ee6295dece,74,52,158350,67961,90389,108,79,262087,64924,197163
4978fac3ee8b4e54e2aa3373ed9b664a,240,180,1250279,324775,925504,217,166,1838962,323351,1515611
09848bef23cff8e97576dc5ded6a6cfe,159,125,659290,131752,527538,242,156,926637,153558,773079
4b75542452c6d61e9d5be4bc03520ff2,135,118,372561,57929,314632,123,89,265743,46959,218784
c1d35354b32aec929a1b6b311209bf5d,170,113,1026885,181340,845545,241,169,1350581,248224,1102357
6644e368b46feb417134458c5a6c617a,61,44,75150,13543,61607,55,46,47720,22704,25016
5a96ba74a93e7756a7ab36c377bd6fa9,157,122,333122,54975,278147,147,123,260273,69613,190660
6ac01f3fc15c3602e78bc3e2282e0cbb,97,76,171564,37952,133612,81,68,136506,46178,90328
de362088a47c258154fa2b6c9bd77eb9,157,122,452474,72480,379994,117,90,295175,69912,225263
932d07804161c35f812e8afaa7328514,1,1,50,58,-8,1,0,58,0,58
591c9b77e9ca1809b694e6490850f015,148,104,328317,102314,226003,204,156,589945,120805,469140
2f7d20369fc66aaecbf28ff5e4eeadd6,91,74,191627,33590,158037,119,96,260171,35100,225071
59b15e830342d24833868a0d68821092,92,84,132611,39611,93000,92,68,155327,34163,121164
deebf357b27b5e3b84c6da1203665ba9,118,91,342175,95070,247105,107,89,294737,96650,198087
6e758703efe89fc1d3416d75b772adb9,58,35,62694,11767,50927,58,51,63627,22153,41474
d584d28d93b1eaca73b63ca83a7e4792,108,86,206837,52475,154362,112,84,237641,43506,194135
d7599f8617fdd145852e72bb390ec78a,41,32,43826,13050,30776,43,26,26455,13261,13194
42ec7e50a3315c01f176f5e27a12a9b3,66,42,85814,46269,39545,81,59,145616,37301,108315
37fbbb257c62bd16e943af77c5b36419,126,87,267212,38472,228740,136,108,311734,60992,250742
ba287629b850bbb7eb77e3a9930dba98,104,90,232832,61521,171311,131,126,310146,63580,246566
daab2d67af90c3e035d5144a0f463dab,33,32,38572,16063,22509,44,36,44095,16984,27111
d40e37299f6366ada5514adb2b9f5573,0,0,0,0,0,0,0,0,0,0
bbe7a48b4dfa0207e2459571f666e25f,143,109,315491,85707,229784,165,88,370331,57054,313277
0f6362034f8d505ed11936de3c21e1f3,154,143,477376,109636,367740,138,125,345747,91588,254159
8f4693f48a903e0ba591ec36b5bb5bc1,50,40,46569,14083,32486,46,37,43190,16947,26243
ee8eeff7a077a8cc6d3d69e80f924a1b,100,73,213167,67573,145594,98,78,247192,75956,171236
bdc8e8188348bc5e0ce7eb8f7a3b502a,166,133,443374,68181,375193,167,138,443398,94938,348460
63b54ff347bbe74f4c0ea350dd7f33b5,62,43,73864,33364,40500,65,52,96023,32010,64013
bd75f27491469a0eb38222868e0d822f,130,102,321167,48500,272667,118,92,269882,54821,215061
4d2ad71b033b015cc5f03da0495bb24f,36,26,31381,9121,22260,39,36,40362,11875,28487
ca1920b34b516ef37bb0f8d6f7ace2f2,22,19,6833,3453,3380,20,16,5525,3014,2511
88bb4a6ee9b13f0e31ad96a559ebd126,115,75,252397,52746,199651,105,86,227041,84133,142908
518bfdb8afea8601a3346a884664f83d,14,5,2133,171,1962,4,7,750,730,20
2e40fc5e9ddf7e6e60de6a59b7295c93,148,125,486801,86786,400015,142,121,475487,107251,368236
dcbcfdc8326756263565cbfd40d1aeb6,144,123,394523,101191,293332,194,141,457703,98306,359397
bc4a31868de6f54f427b36b9cb0bf82a,146,123,357421,54704,302717,129,111,305923,77929,227994
00b4c61fe749527e5702316e95166374,3,0,492,0,492,1,1,42,56,-14
8f1c1fef3cc85843fb5031d7f8f9846a,103,104,185787,44575,141212,85,58,126913,28482,98431
a4e75ab92eaf3a898f69c5026eb54280,22,18,17027,4949,12078,27,19,17937,4836,13101
d5827cc4eab207ad942f309ec90c08fd,89,80,166561,70856,95705,97,65,181401,53285,128116
4f22db8b2adb21d12a56e38b69355233,22,19,7998,4165,3833,26,18,8238,4091,4147
4c28d892d8b7d34ca6c574f55bd16571,111,84,249095,43002,206093,81,77,223726,59679,164047
07bd1de5a3a3cc8a697ef6b9326a61dd,123,98,390689,120163,270526,130,96,398734,101425,297309
6edae555cd1205546994364eabb8c459,131,92,198018,60188,137830,127,98,220664,44403,176261
e495f2829da6306c28fd34012ed93dd6,166,123,830372,216770,613602,153,133,901304,190462,710842
efa2b82d0b5b7d00b2968ec841d313ed,63,55,111652,22553,89099,67,58,105959,24366,81593
9a3a4f873d548e4364b2415120f907b5,88,67,174787,35767,139020,66,51,123392,49126,74266
09cb54137977171b657c607bce4bef6e,99,77,192193,61798,130395,98,80,230939,54580,176359
9505779764ca7244bd072e5b2f1981b4,134,87,407643,94423,313220,128,106,389735,141786,247949
1fda17420bd1eb744b90ff5f3c40ee8c,34,27,33394,11179,22215,28,28,20554,12386,8168
65904510e65ef3251be3a4dcd4deeeaa,68,48,138241,36727,101514,73,59,128124,38496,89628
cf67be4246fca048560708daf43105e9,123,105,332022,87536,244486,160,130,429528,88370,341158
98131b24539578c0bbb8fcb55765014a,46,32,46999,7225,39774,29,25,17577,8234,9343
457176b290a199a2af7aeb4b06f37722,86,69,166796,69788,97008,113,78,220682,58880,161802
f89aec33405ac66bd321390cc7b0755a,82,63,203667,51937,151730,112,93,255447,51572,203875
0bb6746c0a5ef8eeefd2679cf7477331,50,43,85072,31257,53815,66,51,103028,38314,64714
08d910d2de9e6c42e17e57b526121342,41,38,38432,17218,21214,53,38,39318,17801,21517
27172ec838cc60456ea2379706276c57,143,131,401100,119903,281197,157,123,539635,82512,457123
5ed4555a8ecb168f8be02f04b17430e4,31,24,30449,12880,17569,26,25,30840,13202,17638
0e59891cbdecef342512829d93d41fcb,23,16,8880,3126,5754,25,18,12604,3482,9122
4bb995d06cef3261e4a6f19cd08dd5ff,40,26,31476,11793,19683,50,43,48201,15694,32507
86a99e25a331138e1d0c6b8195148470,160,112,531864,127428,404436,199,169,875093,155648,719445
2856c20d06e87b2b6a15fb39cc89d99f,102,69,155113,33295,121818,75,59,106072,35728,70344
f13534b9b2357d20a4f9497427227789,61,44,112613,21310,91303,51,28,65437,19664,45773
eb5a103e739353f857a87980ecdda847,25,20,10537,6333,4204,25,19,14236,3524,10712
640e8030cd7937fc505593ed90367ccc,27,29,22858,11063,11795,34,21,24977,6052,18925
5993e764d7644b460b1260954097d6ce,167,105,393299,90564,302735,164,105,367272,71710,295562
c692eebe358d0329f1a3f849deafbe3e,144,103,392641,95612,297029,147,131,518997,143620,375377
4e7432063efa750f18166a4f08397adc,23,15,9203,3578,5625,27,16,11195,2042,9153
5915550473a93d28a57dbc4c70994afa,141,106,378877,86403,292474,210,129,553339,91129,462210
7a8aa5f7dae8f52c231533af70ffec27,64,46,92172,40330,51842,56,50,95910,37850,58060
e916c046f165371edaca5552a8ceb451,32,23,30814,14670,16144,32,28,33441,11096,22345
7009fda9f917474807fecc515f01d7d5,70,44,99301,26003,73298,71,49,63228,27574,35654
28f53772c6e74424ae7398f8522d11a4,40,25,23944,8740,15204,31,27,30311,7172,23139
cabd21298f08370a4ed63ff8bfeb5e01,146,97,252585,57294,195291,125,92,193842,69120,124722
655624f59e5090f24e08acd055f4a433,29,27,20122,10289,9833,35,22,34779,6983,27796
69435b7f28c717c08b9d47583557d269,68,44,97248,37826,59422,87,50,127012,26629,100383
11a0e9f034807a7b0fc4ea23a43225f5,164,126,776647,160474,616173,170,142,912377,153503,758874
e8b371a66089421e139d9517a9c32618,33,26,34646,16512,18134,44,31,44234,17114,27120
eee22eadaa4fee02725cc1a7d4bab1c6,126,101,211975,59482,152493,119,86,191837,50037,141800
f0cbc69fbb4200be45312cde35343162,171,107,786995,191842,595153,192,136,941708,164124,777584
e3c74f0d4721fdeb66a4184bb4187764,31,24,23244,10801,12443,33,28,28454,9577,18877
9b26bbb89da12ddcb5d858757a78a0bb,56,41,49291,15021,34270,43,35,40023,16172,23851
c17446e9d83dc9e8560892691c0b7ee0,116,90,285056,77981,207075,166,130,387646,60139,327507
f7a98e36653c8a299888a013add10b8c,71,60,168810,32952,135858,63,53,132294,26879,105415
24b13572b09f5d26ba68273d6a95d813,80,70,145317,36869,108448,69,52,82326,31067,51259
ec794e9e8b9bcaef4ae2c6f7c036ee48,22,18,4451,4804,-353,23,18,9272,2603,6669
2503be654bb9b47b5ccc35520bd919cb,60,46,101575,39555,62020,73,52,116925,30176,86749
3d75b7ca5430175c7ee3d9091c577015,6,8,749,563,186,6,4,516,450,66
4c09a08a61589d7da86e09c6c2c1291c,105,85,246471,62116,184355,113,83,258340,63717,194623
3a644ffd53dc742d4fd1602a4f3d97b8,39,34,44925,17302,27623,54,39,38241,20185,18056
dc2e640928fe7463b60b25655771660a,129,94,230137,48640,181497,138,109,254410,64374,190036
d966057b841253ba6e241bf792a053b7,190,134,1100498,204092,896406,218,170,1277756,160838,1116918
e8f07521f4cfb93180dbd63a1a73d6e1,108,87,216301,63188,153113,147,116,344799,48120,296679
23a6fcabb6ee6b460ff4ff8940fee3d5,47,44,56009,23010,32999,50,39,42682,22636,20046
bd93f8770fdebd84d0c887b2b22dc48d,22,16,5633,4011,1622,22,22,5958,4023,1935
7cf60caeb4486a024f063af4d76e06a2,71,51,91441,28453,62988,73,65,101748,30642,71106
84d1bb97b5124c000a6605a1df5d0cea,168,133,718579,163140,555439,160,118,480205,93587,386618
e2796dcb8f775d5dc08f90b97563f36c,112,79,301553,45858,255695,116,90,252784,61566,191218
0fb1dc5568a85d207399c00becd736ac,61,37,77963,12216,65747,36,27,47732,18021,29711
fd4545772039450be3cf3a3f5dde9406,88,68,162920,40586,122334,121,95,253125,39900,213225
1a9ee9be1280bac10f7f7b05668089dd,175,129,660566,71578,588988,176,136,482687,80491,402196
0edd6f2004d3429d18d3d9c50d3c6ce7,135,108,401947,90683,311264,156,128,434138,76977,357161
6f71052375c2396d69f261d1b2f52a8d,66,53,110396,34902,75494,68,63,124257,36465,87792
1910544080d41d94ee6a60de6bfa58eb,64,47,60241,24278,35963,62,62,81551,24304,57247
851b07c9d06f26a002d305ab45e63260,8,5,1290,562,728,10,3,775,244,531
284e7b50b9a280548d69845c6f18672e,71,64,95112,43392,51720,72,56,128540,37900,90640
e22739eee54bd2ad08aff038a8ef0d95,119,95,143997,65068,78929,75,64,177027,33442,143585
885add5e3ff70fe194adece686b90677,55,50,69202,28080,41122,44,34,65156,20665,44491
f8f1206771a33244dfa44f3fcbb70d44,182,123,694335,238810,455525,174,143,833832,235586,598246
3f2607889907b2fc0bdf28689faaacfb,133,97,259250,85778,173472,146,106,298837,72354,226483
386f80966d275044a853f6c7e989195d,100,77,156111,47575,108536,106,77,171409,28033,143376
6f1c832f4b4357312eab3e6a967eac98,98,69,161632,52942,108690,132,104,283927,66667,217260
d6a7632d20db318d3073221afa6d2639,39,26,43316,12323,30993,47,41,47333,16293,31040
84b980b1925904332881d144df63a0f7,87,65,108738,30394,78344,70,56,101465,35871,65594
0fe80b3abf60370390b0941008537a6a,156,121,577726,175696,402030,229,164,901968,140307,761661
400501b7a21864d03113c59f1e0712de,171,133,533391,88516,444875,184,135,485111,122710,362401
aad941ec96bf53a603ad004bbecf258a,21,11,4330,2212,2118,15,14,3369,1323,2046
30041a830d42d45c1021e628216b560d,55,40,77797,30423,47374,66,52,117333,35030,82303
477ef99df623cdfcf0e203bf17641b96,25,22,7767,3570,4197,32,25,14832,3717,11115
0ec8b03af259270b04f24af57cdfaef8,27,22,13249,4622,8627,23,19,10383,6588,3795
c804a3713a1773ea5dd0eead2d501308,54,55,90056,52690,37366,93,65,172033,36798,135235
c5d40fbd85f84003a6fbbeacc9a147fc,233,203,1822898,237538,1585360,201,152,1325806,297203,1028603
0c35ef2df18dfe2f5ef71084198119ee,72,60,114266,21220,93046,64,54,77489,26515,50974
912acd4bae4b2e09332c05305bf69f1e,18,16,10141,1464,8677,17,12,4128,1236,2892
527ed7fb00f6f3bac92c420f87ac0b10,149,111,287978,54753,233225,152,91,324899,46484,278415
4fee883a4da596c7ee461ac3f8002949,23,19,9089,5736,3353,25,20,11441,5277,6164
ab0f0f193de75ac7902e32e67e295ac1,34,24,34890,11015,23875,37,28,35172,13348,21824
706aa6c5ed76f7ac775a1e5222abe79e,156,123,493990,119051,374939,132,115,403389,131385,272004
2a4eada9ce25a97a937c0fb5deb05213,27,21,15702,7742,7960,31,28,20199,8458,11741
13ed071435325dea09369ead1a8dd71c,35,24,26321,13665,12656,30,27,24858,11545,13313
0b69921e555f3c5fb5f98f2889fb093d,40,30,40682,13313,27369,38,43,46805,16133,30672
d32174940e1f528c8fed524311685ad6,131,109,368508,111301,257207,150,111,370700,81012,289688
1db9f4188ed0fe8feb9c7d8c8d55a7dd,51,31,55940,15952,39988,58,45,64557,14905,49652
1af6ab21d23b343af175278468ee62dc,118,86,203147,39213,163934,85,72,123111,39209,83902
3e62356e133992f9d1f3d5b5d354c0a9,126,95,332908,66364,266544,99,88,263615,98326,165289
32a9c75cd933dc7ab2ba9a87e761d4cb,124,105,513169,146722,366447,131,101,506643,135259,371384
a60425a100ee4daa8e7719b957d31881,79,63,95735,28608,67127,73,62,78836,35132,43704
ea2c4f93ae04540f65f417e85698f225,162,116,369170,75848,293322,166,121,455552,65714,389838
a27f7001707434a349a28944bc36f4c4,72,50,104309,25074,79235,81,68,121553,34531,87022
c681da63d6f93a77ab46b7f25c1d3c9b,11,4,1344,345,999,9,5,837,636,201
0618f8dd4c347b59b090ea294bd904c9,55,40,87460,26600,60860,44,39,108911,27001,81910
cb6b6271d72fdc62a3b91b81024d6a71,137,108,308112,82149,225963,131,113,306979,86440,220539
e6785d7788c5cd04a3045d39b804aafb,112,81,285246,81078,204168,147,109,382578,77951,304627
303ddd9278d532f55dd2449843178429,45,31,33691,7569,26122,43,28,23817,10697,13120
dbb2612b9b70ff342f3c25dfe3e66d76,40,33,69732,28492,41240,48,34,89938,25822,64116
e4a8d4de498e9a18c679a8d4513111d8,114,97,177583,35169,142414,106,72,129680,37113,92567
d2bba0cc20de1efc9f5571c54d9daacf,71,53,141800,35626,106174,44,38,94719,28663,66056
91430176b36e031a27c49e085ff751ae,20,15,5148,2988,2160,20,14,8278,2646,5632
8e99b46cda4b95b76f0cf5d4bceb0d87,26,20,13180,6336,6844,30,23,12425,4852,7573
00d517394d767dbacc3c80bbcfe95798,72,56,71211,22857,48354,77,54,90162,27306,62856
28087495912d31978070ddf99fa524aa,33,25,27306,8238,19068,38,32,29272,9069,20203
05fb5aca43ea7447358afa53992186bb,40,24,29958,8530,21428,44,33,26098,9885,16213
af898da0f0fd24e31c556f1fe17b7f10,40,32,32367,9888,22479,48,38,39962,13322,26640
ed176a0a51906d76b113ebaf2787a17b,95,81,254629,89528,165101,91,77,187791,75419,112372
fe02663d4d82aa029ddc22998795dd15,47,37,43958,20103,23855,59,43,63047,20009,43038
96c8ee03642e1325086cb00de40a2fa9,141,107,400935,63688,337247,145,124,297946,78757,219189
44bfb5b83b8ebe9c68d8677b22a14ea2,0,0,0,0,0,0,0,0,0,0
1dd2399fb8f59fe9c85da3dd1e89f5a9,99,76,208606,39077,169529,87,77,160829,48737,112092
c79ebe517ff84851ef7a603592243b01,43,27,43732,9205,34527,52,46,50449,17233,33216
14ad445addb42d958f0c314e317a00ae,70,50,66694,22700,43994,67,41,54825,18980,35845
3822396d872b07fe738c521c8850d6b7,50,37,46652,23428,23224,59,46,104257,21520,82737
29ec54db31b9a148177cd8a33bcbd00f,131,86,286043,61549,224494,131,88,255767,76028,179739
cdf5d322203f338fb0c1d8033cefca5e,65,56,61851,16057,45794,42,32,41999,12093,29906
235546b902e74e01f580f6c61383fef4,27,20,23835,6745,17090,30,28,25853,9940,15913
687b9ad65ce15e6f10d8b47a50bf4c92,96,83,235797,60538,175259,133,92,315901,48414,267487
e85cb546d466482a4a7e10b765758a31,168,125,541096,126318,414778,167,141,535238,120905,414333
90f733a83d33fc00c046eff3d5db04d4,40,36,41718,15710,26008,57,40,79646,21857,57789
b41a64a8ca5abc6efac643dab5485188,110,89,211433,48789,162644,76,58,125222,35970,89252
080158545912f01d7ef16ba225cde0d9,72,47,85363,31078,54285,85,65,129468,25943,103525
0781ba9e1a2f59d70a33f0596b83aa08,143,79,254022,30870,223152,121,95,223287,49472,173815
50dee77733fbc1e7d4a848cd7033dba8,64,47,105209,33199,72010,67,53,83487,32639,50848
cebde2f3700b1a25d717dbbe0e232b99,79,76,125320,39982,85338,88,69,122890,34057,88833
ab23d99e437448eb131bceb283c62a39,60,40,45701,19391,26310,49,39,49088,18694,30394
deacf7aefbe3eeb2e2579be8a0b8ec13,153,122,469779,123702,346077,179,152,709437,92125,617312
45f5e6bfbb5aef22d8de14e692cf690c,39,29,38766,9131,29635,36,28,32195,11081,21114
7959c35f579cb98f563e45a233d055af,37,31,31319,15857,15462,53,38,59959,12334,47625
ae09ec8640828848ee9de7f2d16d660b,81,72,122585,39923,82662,64,49,80878,25288,55590
99b7328110898bacea3865e2d81bc639,37,31,30637,12604,18033,30,25,27730,16062,11668
9483e218486cda44f6c4b8e4de7cd6e2,125,108,321182,66768,254414,134,115,374834,58100,316734
49efdd6d521ceafd6bffc2a944e96125,25,17,5449,2588,2861,14,13,2881,3473,-592
37d616abe45c311030b3ee503a6e11e1,191,134,549691,73630,476061,149,108,384313,89447,294866
ebd9b8bb30fdc7872cc91a58505588bc,24,24,12886,8724,4162,27,25,28881,7179,21702
d318ca2f4d77869e70a9906ccb2e8e22,58,46,111833,20656,91177,48,40,37427,31430,5997
115e3a8f4af7caf37cce1a5a2dab5c11,116,92,292181,76488,215693,178,140,551517,75305,476212
fc5152f14890369da71dc29cbd828e6c,31,23,13682,5072,8610,26,21,12874,4755,8119
21eb78ffe6721bbfdda545f75b486eba,113,86,219755,49436,170319,100,63,202411,56572,145839
94e82b1f20a4ba7a4e7034b43677d02e,66,55,110640,36167,74473,77,61,109952,39271,70681
9f64aa689732941d0d953085db1af2a1,82,69,156113,49883,106230,128,110,322118,45903,276215
58ff95e8e39029f274cf15ed0ad897e9,56,38,43649,14386,29263,56,41,47483,15805,31678
4949dd366e2ba9d34618cadee80cb1ad,84,61,237525,45777,191748,120,103,294133,71144,222989
754c5465833ceb785e46cd2f7be88048,20,19,6709,2998,3711,21,17,6118,2852,3266
a11df6549bd14c2ed4c8169a5c3138a9,177,141,626464,123097,503367,175,126,598302,109037,489265
6b6611f5fbf196ee38b5e610b9112f7f,23,17,8387,4855,3532,28,27,16494,8026,8468
8519eed90dfd807178f975c5ff0a6080,135,100,318014,102222,215792,159,126,479144,106194,372950
d8a8fd6f0c4716df858ea92dbf233557,29,23,30004,13134,16870,34,22,43814,7075,36739
3077b6d2408d8175dea4d900d80ca734,41,33,47604,15626,31978,38,28,40920,10214,30706
fa4edc2262b9750babb01f9615735c05,111,94,253128,56035,197093,121,99,317872,49352,268520
0d16a300b486e0273ad255b9d7a2c14d,34,21,31791,8093,23698,38,33,30575,8263,22312
a260f533d35c591cffc75425c17f9298,155,110,489533,84925,404608,154,122,533249,106514,426735
82e8ea2d4fbeeb38c50c8f1f263bc91d,26,21,11646,3493,8153,26,25,7525,3776,3749
d0501817c621f46962b931cf3e7d8d0f,3,3,516,656,-140,4,3,782,516,266
8bbc3b2141da931e96692a7db4d59348,81,57,116315,36521,79794,113,68,160613,40518,120095
9001148a57758b22d00f44907883d43e,118,84,304728,64059,240669,144,99,329811,79361,250450
426344a6a1095e9852866c57329d6812,43,41,60863,24003,36860,69,62,74529,24709,49820
2c40dd60dc9eabd844efb06667b5a8a1,38,27,28384,9884,18500,30,32,22548,10897,11651
a70535dd41133c436539b3f9b6730aaf,137,108,351923,96812,255111,188,118,489702,84691,405011
42013c1f3520c6a04567a01861824451,27,19,10531,5695,4836,24,19,11429,3564,7865
cde395222e882e4beb3c10845919d959,38,25,41176,12115,29061,40,36,62907,15641,47266
b35648674b1f9aefb86351a12406e9aa,168,143,534416,102294,432122,153,118,424360,90043,334317
5b1537dafde5a3c94310aa433e3b77c8,120,102,384379,69648,314731,137,114,303181,82185,220996
f2ffcd5ec28e605aea6b8a0a5721b974,128,105,252353,73962,178391,83,51,161970,72141,89829
8d9ec7b85e59d5e9174d9561c5ad4b06,156,107,375833,68532,307301,133,118,288211,92745,195466
191126cef4399af5e7df820c1fddcfee,61,42,73922,31411,42511,96,60,145604,33573,112031
b676f4f46fe92313352d55136b93dd6a,33,30,26907,12631,14276,40,31,27965,9952,18013
f64bb6e20ba9d2addcd69099e40672ee,93,83,146281,35575,110706,120,91,184922,49830,135092
c39b1dad577871abd0c07ac25e5bac95,60,44,113270,35525,77745,105,91,181766,47914,133852
ca4371cd5e1b713a7cb64660eb6444c0,83,67,164893,46259,118634,79,70,165854,51981,113873
eb0a21e2ce6825944a7172cfe7d1241d,4,3,735,510,225,4,5,574,799,-225
651b32b49b043b241e37458d65daef78,153,116,422730,72181,350549,134,101,314329,65090,249239
e8da27d33496e24a600fb726dcefe261,186,162,956208,208175,748033,222,159,924255,175326,748929
b6aaa9d0b0d95ff8f10d78e80506ec55,29,17,17721,3566,14155,22,22,8615,6116,2499
9509b5982051448d0e304bdcd7306bbf,151,104,434476,89868,344608,145,94,315964,83738,232226
32a7505c2d9375a65c91feac0009cce6,130,116,362783,78720,284063,145,109,354370,60853,293517
ac9738592ca90a738505c7a06b517ae0,45,32,36813,19995,16818,74,53,87053,16801,70252
dc817923094a5513c4d3c8531cb1bed4,112,71,260840,102967,157873,155,118,459490,100693,358797
55d066d0a1b12e5cf881738744f71e31,150,99,509228,112275,396953,153,94,456841,101201,355640
f02741731caef49d8a164ffb3d340979,148,112,458475,101337,357138,196,166,712564,172678,539886
d630f4c1133d0a237442b3d5a0ea7e36,201,160,726742,144179,582563,205,135,955196,149728,805468
97bcc1b4091799e80f91810adbd3ffee,115,99,250996,64704,186292,143,103,292177,67345,224832
8cca88bc95e495fad75eeffc8b152ad0,201,159,928903,157022,771881,187,151,849787,163806,685981
51ad3cbc4f7f50b03fb1972e93d62ea4,39,34,24879,10646,14233,26,25,33065,12482,20583
622a21a71f19acb276ca1e095cf8f1c8,108,67,135645,33504,102141,127,92,157407,40675,116732
ffcebc8ffba7f93375dd7abaae089b80,150,109,398620,83331,315289,147,132,461831,129693,332138
dd472663b2789cff3661acb2f554db5c,164,135,571196,129866,441330,166,122,557310,123704,433606
99779be0c90fb69f6b39baff1ca5e10b,135,120,589205,188792,400413,173,134,754841,147526,607315
7a6efb6cd9422f7843ca09e843634785,36,32,23606,10281,13325,51,32,30085,8741,21344
49e306ef8b47dcfac15edc25db3839e2,14,15,2993,2412,581,18,13,4188,2340,1848
47173ce5690cd6f842449910c3dc6c9d,24,14,4705,1707,2998,18,15,3250,2280,970
e26368a2ae39e6982b12c94881119d08,76,60,122590,30449,92141,59,51,74870,22542,52328
ced8e38b4b03699a867c27426ac2b8f5,98,86,182366,44594,137772,121,106,198027,49969,148058
3963e2644818c72bf2c44198409dba2f,86,76,165036,39080,125956,105,78,184000,27822,156178
65f09ecb94be6d7cc52a60634c3827a7,30,22,17426,6648,10778,20,23,13865,5318,8547
31cf777480b69d7813ad715feef23051,171,112,398713,96722,301991,123,96,398755,136425,262330
ba6df62cd87271af4bb9de2ec033459c,81,70,126185,29848,96337,87,64,111929,32135,79794
a95213d7cfd26e7af1c868a035bdcd5b,79,59,118977,30322,88655,53,43,87849,29876,57973
69f32a4185a4bc5fd13b22f6642e7612,107,94,255468,75437,180031,140,88,296355,59383,236972
4a4dbc60f820ba975c966650c68ef64f,80,51,89340,23214,66126,60,43,90643,27391,63252
511b8da2f78cbb440922f86d9d0ae11a,105,85,214958,39971,174987,127,114,269469,49421,220048
f467353f945ee0b358d34f6bd5634be3,42,36,47076,17251,29825,51,36,42966,17160,25806
a97d5aad37450597517559a2355c7b2b,70,45,127143,31622,95521,65,56,108778,32176,76602
1adc1cb2aee6fdab933075d7a64592f6,108,87,313959,110774,203185,117,84,265092,84950,180142
40013585e3ce25fb77d6a1d1a464ddae,105,72,180122,33714,146408,70,60,102196,46684,55512
721f0d3e1868892e6fba5030425c2d30,25,25,14728,8281,6447,27,21,15677,6950,8727
0108bda0117eef8e7422a98e5d14d92e,24,16,9067,3647,5420,23,20,7796,4490,3306
7c540b8ec7c59450f8c6d63d57d28e7f,33,25,24872,10411,14461,32,31,21479,12202,9277
49dc9de31b010fa332fb5118e1e5d61d,139,103,257947,72495,185452,120,90,232846,54092,178754
865653aff0cc0a31fb0f16c782af9d83,151,116,438719,130013,308706,177,125,646229,95949,550280
31c660f3d11a81d8f4c32b5384cb7607,150,112,645284,169389,475895,212,135,818781,195462,623319
9f1fdf3ac235c50d3ff5b4fb64efc01e,18,17,3613,2142,1471,19,13,4791,1841,2950
523989eae18054fb9559ed199e746a5f,38,25,39912,11178,28734,46,38,46384,19038,27346
255b0af4d052ed6cbca385844577ac16,55,38,67981,16295,51686,57,47,45390,26998,18392
9ee7674421b60e4ccaac58353a5d1bcb,93,73,144747,38648,106099,105,86,195098,41139,153959
5cb1b47a4670ed11f78c3695f5a2364b,145,104,389310,69895,319415,171,106,442357,76965,365392
ee484c2a4eae0e0e2a48025af1baaf93,28,29,19647,6227,13420,27,21,11808,6722,5086
d4b38b6f44d3a4e8d7eaec00fb3b52dd,84,61,229899,45259,184640,87,60,171504,55503,116001
adf455e40d8dec9dd629f7f886051eb2,27,20,12830,4568,8262,23,23,12640,7012,5628
2d3569769b7b76b5af806bad04768a48,61,44,67501,20659,46842,50,38,73340,19363,53977
7503b7b01e6397f14cef3048e9bf5463,32,28,21522,9674,11848,35,27,24552,7024,17528
748b343f477304796c54867a7ad3e510,75,54,153383,59532,93851,88,71,204238,58212,146026
a3f198ffcc6bee63fe46eeca0611addc,50,31,61827,19208,42619,47,36,42810,21331,21479
a2ef7f1bc38293ac84acbba3a25225b5,196,115,651531,101652,549879,142,125,550818,101598,449220
0271245da714226cd7b75869b66ef59a,26,18,7735,5437,2298,27,19,10336,3332,7004
0e7da3ab723d536b5a9108b4404cb558,13,12,2277,1764,513,14,15,2497,2134,363
8753420ff6954c79294783389b004f57,40,30,34064,10517,23547,40,34,36640,13144,23496
94e3b6906862857570dfb441f4ed13e4,134,109,368356,66947,301409,176,145,386332,104109,282223
bea930255d2ef75837bb207c76626f83,91,74,139277,46994,92283,95,76,232532,39430,193102
7b90aa79900fa5a639cf695dd9d9c1b7,126,102,272072,53989,218083,105,87,229610,54325,175285
c1baa940daaf24be820c9f248cae076a,67,51,75749,27180,48569,70,51,112751,26161,86590
5ddc49fffb6d120e0df22755ea7980ce,122,94,352423,74520,277903,95,75,322584,73311,249273
e46cd75707b934d146b7ff450e2cdb27,203,149,800320,175809,624511,225,164,981345,182135,799210
1574f0ba4530fe09ae8465818fa668e6,43,36,63029,22750,40279,55,35,79060,22897,56163
87b4a33e922d82f2362a02384d852576,60,44,58885,21098,37787,59,42,67423,24240,43183
a1f4d1013e2f354e2757e52340df03f5,176,121,442503,69455,373048,138,86,313727,60416,253311
6768ba184f96a0f33d6eddd43cbc683b,30,22,14168,3383,10785,25,20,12333,5380,6953
ffdcce14e9e1d97afa0fd7b23071f19d,57,47,75457,27590,47867,60,48,69483,29007,40476
71f7312e84f4d88d6144049150f9564d,141,115,447130,84234,362896,171,115,446552,76767,369785
cc9ddec9d9d70a162e9c5bed2819f62c,39,33,24703,10357,14346,48,33,27703,8905,18798
17944733198d978cd31de40f70d340aa,40,33,68344,19376,48968,41,28,51860,16778,35082
57d6ef051f9aede4fab005a2e43d5b99,121,94,196719,50320,146399,169,136,424925,53411,371514
5b9214e1d5691fce239f5fd9a6b2257f,39,33,28654,10369,18285,54,43,41991,16266,25725
ad5a7cdf613f6ca37a40810b0a910b09,68,55,97924,27370,70554,70,49,91083,30633,60450
2de91878ac460c6c7925f1463fc21649,22,15,4546,2653,1893,24,20,9188,3505,5683
6ea7be4d7769a7b9305b7d6329a011f5,99,88,212635,43842,168793,131,110,302009,47997,254012
97bb808e8cdcc839b9bb75aa316a9baf,162,139,730410,106365,624045,145,102,488624,124714,363910
6a64f3510b39889641c393e5c0619351,118,105,216485,52346,164139,107,95,175714,55131,120583
49d4364a3863152184270cdbf10aad24,27,19,11612,5363,6249,27,21,12787,4101,8686
4c9bb8acda50d7ed95db0a42dc5b2e2f,136,87,499436,103511,395925,116,91,420030,105809,314221
8aac12c18e3e427042c0e3f1125020a5,153,118,420298,120960,299338,120,107,338009,124646,213363
3ebba67086d816b67de923bf13c87d1d,76,63,170980,48779,122201,83,69,168147,59561,108586
482151d64837f2c846648d0d0745e1f0,65,51,59990,17221,42769,46,34,53756,11013,42743
f7e350d4b08514f74766101b498fb1d3,23,19,9380,4145,5235,23,20,7047,4591,2456
08fde14e9c15844753c88ec38c63899e,37,23,30142,15412,14730,33,25,44694,12249,32445
648b1bdbb16c56ef13dfc4a2312e8803,31,26,9051,8924,127,33,26,30023,7076,22947
3fbc3aa92dd8350956a4d80a4d6f89aa,47,35,41272,12159,29113,40,34,47175,13414,33761
429a97a0ce57aaf0e7b7a0a00c01dff5,121,100,214400,43353,171047,106,93,173923,51551,122372
52d0c74f95e4deb613391f71c44dcacf,131,96,427478,69627,357851,131,107,355395,102012,253383
599d1127c410c47f8f20271657030711,17,20,4921,2281,2640,21,14,4337,2013,2324
e0a42e67963c86effcdb67e53a5bea07,116,80,270663,33424,237239,135,122,299415,59496,239919
0af1b93763ec932a7d0a7ef451cce592,28,20,10311,4864,5447,22,17,12681,4809,7872
a63cca42223ddfecf5e0e1f9ed9c8dd0,50,37,55249,26253,28996,54,40,72125,17908,54217
f991538dad16e240eaf1389ba6c9b76e,62,55,79845,26166,53679,69,54,85856,22159,63697
a7befffdbf6de9282219725e05b6ba53,28,22,15743,4272,11471,29,24,16648,6411,10237
c39b763b787cde1f4941d03744a152c5,140,104,370805,90392,280413,148,116,341529,76344,265185
676fa340b1831bbc6ecda85e99b48d00,191,141,799989,206979,593010,188,127,1418825,164379,1254446
f64b6025e9d77630ccd018475b09da89,59,48,57460,21297,36163,63,54,73528,29406,44122
5c47b6684fc83b411be3972113911f0a,106,92,229620,48811,180809,114,89,214644,46109,168535
da48912498ec45f30a4bdcd23a7e6ccf,176,125,512213,138704,373509,149,125,506220,151085,355135
81f031018f550b1e9fef4e9a64fc3ad3,119,100,200003,48502,151501,114,74,203412,50828,152584
8170adf33fff0fb90dc32a67553f9f15,166,113,333973,65195,268778,97,73,178126,67555,110571
d5e40e3dca625d38255e405239c18cd9,128,98,388331,75697,312634,82,56,223448,82280,141168
ebcecd33f46c31e588dea60f2feaaafd,127,100,186372,44914,141458,108,81,165188,53062,112126
6e6bd63139ad54fed36380ece3c52534,188,142,943117,198248,744869,253,164,1438662,179021,1259641
1d14e52df5e8d61733aabbadf1849ce2,58,51,102395,26945,75450,77,63,135276,36513,98763
4fbb44aab64a2d42da526ff1cbe8e28a,185,117,630127,125093,505034,153,110,492174,129582,362592
330c351972c6a20eaeaaa4b315f7c72b,63,55,111040,31800,79240,89,60,172119,35350,136769
d9dfd19d42b9a01f490e9709d4e8e8e9,63,49,57165,25138,32027,59,54,72074,23280,48794
a72728a8364b44c0ccc2806fd57d43b8,142,108,437617,118955,318662,159,129,544948,81435,463513
da5ed4bcc17a7fa3e0df2c7c2b5fa4bd,35,27,25902,9189,16713,34,31,19425,11487,7938
40ea3af4b23c4005cd26bf81ba0f896f,69,63,102134,31281,70853,90,66,139938,26093,113845
da56ff3a862570ee1712a9f00dfe4054,67,43,96005,19703,76302,65,61,103987,30381,73606
cc9e00cdc70efecced94e357553fc1fa,117,91,351192,81418,269774,139,103,406717,88655,318062
edfe667c2143e2e5480f5c94e821d7a7,47,33,58604,18150,40454,39,32,51356,15642,35714
6569f032b189ddc3f720f44483e3dee5,37,33,54822,16201,38621,51,29,45868,20061,25807
5e0e2e5fe173fc48eb6eb7344a4e4959,82,70,149288,38776,110512,75,54,93032,33640,59392
4f97bd7aa8fe57b67101bb76e69b207d,39,29,31670,12560,19110,45,31,41478,12026,29452
99e8ff67d6354190f81e6919cfb254c8,28,18,16158,5989,10169,30,24,23496,9371,14125
c0480d20711f62d9c8a64d32369e8cbf,20,17,4441,2448,1993,18,11,2745,1778,967
052613fb58e1b8c3cff4056e04e4585e,67,32,121921,19298,102623,77,57,113856,22538,91318
6dac1fe7532578e493326c1f41564b0b,66,50,76667,29445,47222,85,55,97587,33574,64013
d18189c7f71ba7f3b876133dcfc569b0,40,29,27899,8953,18946,33,24,29559,9116,20443
8261555e784cfc8fb77aa2db2d1c8994,18,16,12873,5668,7205,27,21,17552,5988,11564
2be5332cf0b8c31e152dee5a630e0f6a,106,79,161494,35286,126208,97,80,178937,29990,148947
5a8311062eda866fb555dc6664b785ae,75,59,159418,43095,116323,87,69,157908,36343,121565
fa1c85878de6b9093b11fc425d5782d7,77,65,94234,39407,54827,74,53,110381,33234,77147
bc16c1d7fd5a3fb86c0c261f81e102ce,95,63,137877,44008,93869,84,71,137439,49641,87798
7f38b3fc8db5294286ff6f938ab80f09,145,107,682382,114134,568248,149,121,709672,145736,563936
771ad48038ea761ae2e87c719e50abe2,172,143,672415,138189,534226,150,116,614056,111126,502930
f5540aff1e322f8ec529662449d9b408,20,23,17132,11249,5883,30,20,28265,8671,19594
70a0783d7925539178c93d9afab6caec,73,68,133179,37799,95380,67,57,122713,29076,93637
10cdd87333bf9ed691a66e500d0531c4,0,0,0,0,0,0,0,0,0,0
afc0f20a5b3bcb57c6e84d4c9ede33d5,56,34,72623,17683,54940,57,50,86152,28093,58059
ddfa5daeca77036d4306ac4e2e79d247,164,110,780810,163235,617575,189,144,781669,155877,625792
2e482ae162cfd4bf650b51ac64ecb8ba,24,16,4465,2044,2421,20,19,4082,2930,1152
a7c47f636fefa5065f8341b7a26ed3ab,118,85,177644,38692,138952,126,74,187572,30079,157493
580af0aff026058e88d57b1a556178fe,71,63,103460,57796,45664,117,91,193547,40914,152633
4a8779028752960745a26c655d246621,29,22,21702,9331,12371,27,23,23120,6013,17107
a3db89a76c83ae90dd31b650d09f9373,105,80,241079,68216,172863,114,99,300309,69708,230601
18f01a28c9c793a420fe9321dca28370,156,124,510272,176593,333679,160,132,529733,174622,355111
0fa4c749ba6911c2305a4c8040a06b24,91,66,183774,69459,114315,111,74,250332,60045,190287
3e97568e79e6a94c8f6a7dac65eed86a,116,88,235592,44694,190898,60,47,74870,46822,28048
c3135d2f72576b7cdbb2fc20acba3b7d,98,64,136422,36804,99618,106,77,155447,33374,122073
637f14404e0042c50b65240eda84eb5c,33,26,24455,11295,13160,28,22,18903,8337,10566
29b6fed82ea68f0b4bcd35f869ac3df3,44,37,60125,22091,38034,60,42,69960,20807,49153
6f6d61caca8e782c41e57cd7a9582d30,28,25,18412,10445,7967,35,23,27844,8437,19407
826018f7a6eebb650a0c08a6ca57f515,109,86,180404,46590,133814,93,82,153609,46850,106759
f1c0b057e2c5e3a1cb7c02f000454190,215,168,898225,115060,783165,140,124,616395,132056,484339
d69a19601ce1b635f405c534b7b0e47b,8,4,1307,497,810,5,10,547,1396,-849
c7019800a50129e27693e4c4cf318d92,28,20,5701,2683,3018,24,20,5986,2669,3317
71872643bf3684c494b2c83c357d0185,73,60,88936,37335,51601,96,78,165220,46234,118986
e8a6d243830001ae49dce8922ff579ad,107,71,233315,65711,167604,166,155,445521,78250,367271
0dd15558f22bb901783a1e54e1c3c826,162,106,340190,95804,244386,120,97,289554,95955,193599
cc01c40bfa20b3af4fcb3485f5f1d5b7,109,90,215418,71739,143679,116,92,225079,54336,170743
63d166427fbb6746b00cb7a6f94c95c9,199,164,690877,180484,510393,240,139,840101,126556,713545
6da0e2498689f10d434997186b6ccc81,27,20,18993,8459,10534,31,28,22474,10686,11788
d5f17a02460257d6edb11ca18e988120,35,33,25770,15615,10155,46,35,44155,10230,33925
d79e375c46cdb780a3e4112276fd4fd1,112,87,189500,49928,139572,105,95,182667,42145,140522
ffa03756355849832c426ff6d78c01ec,160,121,521582,113508,408074,196,134,929428,124243,805185
99285cccb28dd686bccc5736eb98f4cf,175,144,802619,143152,659467,135,102,570922,126404,444518
920a153f382b561b69fdf9f1c594f5fd,100,77,256264,64091,192173,155,100,254044,41283,212761
f7aeaf3216cc16056c789138854e165f,73,60,126608,44438,82170,88,66,190771,35936,154835
cc5441f20f3a6b3e725e13be07a3b8a1,121,100,250134,80335,169799,84,55,216977,54207,162770
500fbfba8d5445a4ebaba840f7aeb49e,20,14,4069,2602,1467,16,11,6403,1343,5060
d161a536090ed86632fc6fb5a4cd367f,42,26,48864,13793,35071,34,21,37885,13256,24629
124f7029e2322dc782149d811beffdb0,91,76,174004,49276,124728,86,78,161946,58006,103940
213a4313270504af87c9d4d9189248c4,35,35,33722,21192,12530,58,34,47811,13165,34646
8a6e9e92e937b83258ca7c622ab447a1,112,81,269578,63786,205792,126,103,310042,61663,248379
d4c4a403c2ae42ba0a44a0e3801de696,175,146,757253,136777,620476,160,126,552547,147227,405320
a2cd885353a54f3217f152c27a985489,82,83,159810,67509,92301,91,70,186742,44365,142377
442baff9771bbbcfa6e24c2d07a6f5b4,104,86,261251,63318,197933,134,102,345013,62006,283007
2eefd754f5d7bd946172b770ece1149e,141,79,339447,31597,307850,111,84,222892,53494,169398
3ff9eea6ae91995281ba1a1703c974e1,71,52,87768,17711,70057,72,55,64889,14696,50193
34b0190e5df2256fa2cda6c819ae7877,55,43,46773,20761,26012,58,46,55863,24074,31789
74cd13c902962c29449fd4a2441ad24c,72,51,78291,28498,49793,71,51,109940,29465,80475
eba282f99ece2eba694e4fb0e545a5c8,160,124,522148,108128,414020,145,114,407060,104113,302947
5287b67ae2b4328e466a7a3954801c6e,27,16,12453,3083,9370,29,18,13025,3624,9401
82eb0212b6dcf49805618b3c2399014e,185,143,493950,99822,394128,169,123,545647,100411,445236
045a73b8c61a5ad817377508af84bdd9,80,64,123658,40484,83174,104,69,130547,30169,100378
4f131a82553827aa52964763f67d6657,227,146,1357674,220753,1136921,205,134,937536,196276,741260
86d883f3d99cefbe3470d733e76d2765,176,110,452377,86291,366086,131,96,372060,108294,263766
24c5c034a95f492d6fb01de9c2804b8d,133,109,324973,140689,184284,135,99,360537,99710,260827
67f570a5a0b161b19fe68eafba60fad9,43,34,59370,19191,40179,46,31,52121,15725,36396
6c416b04c945db33083747d2b1b6e144,192,146,529133,145131,384002,198,132,564626,110684,453942
40ec2099abaf686825d245df5cc34e8f,86,74,241614,51840,189774,108,98,218027,57758,160269
9b01de8ed7e1e7ef553605b450545026,24,19,15048,5618,9430,32,28,28981,6768,22213
db6368dd7afe6303474daad90eb55875,51,38,67558,21500,46058,61,48,71949,20232,51717
4c248076a1a4d22bf75b1d1134f26452,59,51,91207,40750,50457,59,52,117203,35760,81443
c5371da90ca1347cd2276e23492ec887,94,83,163682,41614,122068,102,74,194590,37331,157259
ee0b71de62facf3814a31a5d7ab14a3d,111,78,176524,43001,133523,99,86,139757,47601,92156
e1085c2bf01a84c257787498a72342aa,95,74,113546,40679,72867,72,68,120874,39143,81731
3989c7b899b6d9c3b9de5232a6945152,30,22,27309,7170,20139,31,21,25049,7506,17543
43989cf243e05f63db9e83ba7b3b54e3,167,149,738795,100427,638368,120,81,477097,73284,403813
c7499edb62d14e0133ebc63b0f5cc76e,119,97,309265,89787,219478,121,96,300087,103916,196171
a7c5dbb78f2a21b491c5e727a9f8991c,153,94,314139,61849,252290,130,113,320143,63687,256456
e9de11d0b8ea0160f9dc9fc7503f538a,36,28,16811,5235,11576,37,27,15840,6179,9661
47e25dadb68184b4937674f477a20a07,86,69,187598,36843,150755,105,90,213741,32597,181144
abbf7c9bb9f1efaabebc177275fd009b,36,25,33102,17703,15399,36,30,42452,18627,23825
476ae90eac715c3b946bf364330b1a7e,19,17,3322,2682,640,21,14,5054,1475,3579
893894f67a77756af30333bf5bf11371,61,51,101268,41972,59296,89,74,152199,33077,119122
1176d38ac18ae9dc9af0a145b6013c38,22,15,7744,3323,4421,23,23,9229,4693,4536
2c563ac5bf37a62122072599fe9aa085,22,16,4209,1968,2241,19,15,4045,2014,2031
de603d4be3ef910708b56b049e6ab049,105,79,294084,56683,237401,130,117,391269,68322,322947
c0f7c745de4aca41c0cd4e1e423ababb,20,13,5240,3595,1645,14,15,7175,3596,3579
a68fb7178193207057a3a39349bc6a3b,168,132,627461,97588,529873,178,136,550865,102404,448461
b832b2fa63cbed79e07d2fdc5ab2e9ac,100,83,217439,49153,168286,88,69,144486,67973,76513
837d417456ce08d7a4f833bdc4971e5b,45,31,84372,21611,62761,31,25,48688,21210,27478
fef00a5d5f8c8a6eb88bc4e30e56cdba,114,84,289735,62335,227400,172,130,406542,66503,340039
87b82e44bd81d052b8c185a421be1112,102,91,243036,57885,185151,111,85,208481,65683,142798
5c81d9a07537d17251368c539535116b,29,22,10723,5026,5697,24,21,8872,4121,4751
837be83e581b7662d6a731e77446b8ff,47,40,94035,33761,60274,84,74,154458,38341,116117
b964e56bc418064c30474249fee769cd,110,81,150352,46636,103716,92,80,171166,48823,122343
6fab072b2ef464cd518c432c461cb428,81,65,153274,44707,108567,74,56,141317,40947,100370
fd7b02257cdc80f0e454dd558cf680b2,146,107,548044,121531,426513,159,122,594683,166761,427922
57e8ca4cd9b138fd089d4d0220fe71da,91,76,112878,30969,81909,74,59,98762,25455,73307
8feaa828022dc9d5ff515f6b3e14eae5,67,48,97987,26947,71040,75,66,118420,43957,74463
2cef3d8e984702da440512a8aae291fb,45,34,28581,22078,6503,65,57,101300,20707,80593
262af758f30edd926a2f3fdad82b3f59,44,39,54788,18126,36662,46,37,45264,19857,25407
ce511fd9015e0ecc0e2e3929b4d6d0b9,48,42,81837,24812,57025,55,39,66528,20136,46392
ea96c148677f477f616a9a6a7bfceb22,84,69,130253,46673,83580,86,65,163425,36366,127059
4108f6352eb25f022b1f319fc3b6b0a5,26,16,10953,4433,6520,33,30,21961,6297,15664
a591ab357fac52a40c0da0873869603e,103,85,209642,60858,148784,95,86,262380,70315,192065
cf85d0c1d560bd6c8b94d38a79a13d7c,156,117,533142,149798,383344,146,93,390766,169450,221316
c742e36d40661c16d9d2854644985dcd,204,145,1164359,141016,1023343,170,133,1136452,149157,987295
cefa1358dabf214079954a08419827cd,172,137,531010,107129,423881,128,105,324357,107021,217336
90f8ffe4e9e44da10c18da268c413f48,64,44,98704,22556,76148,77,53,134927,25659,109268
6dd6d3e3fe7f8075f6c64c4f92094d04,88,63,141322,43812,97510,89,70,146035,53915,92120
20f929fdb04c068abe070762408be0ef,34,27,36855,13826,23029,45,28,70274,8545,61729
7f14fed2a9816f70ca7d4c05c42c26d9,134,124,288458,78351,210107,117,93,316500,74508,241992
a55b01c3ec3340fb0bbb9db064fa49e9,22,17,5290,3259,2031,20,15,5201,3049,2152
7606826079d2ed4423fe671e149926a3,113,93,333080,70356,262724,120,87,306928,63312,243616
6eed4b62be873529f60d472c5073187e,59,46,72391,26313,46078,59,51,62354,32140,30214
796d65bbe843fb0eb2dc713bc5f2e7fa,72,70,78337,46769,31568,65,51,121096,30466,90630
1b945a12299adccce193a7635dbba357,42,32,66341,19932,46409,51,34,46460,19300,27160
0b9a16ab8ac94189f83446c67dfe3e1a,155,122,602375,134150,468225,174,119,538609,118051,420558
54272eb4a078e0a5d77a2ea3d735442e,150,113,462010,50738,411272,103,87,226412,63214,163198
274cc73444c3dd386dd8fc8e0657dacb,37,29,39613,16308,23305,60,51,82479,18572,63907
ac4e827c08cf7ecc4a814f7cf9ab72e2,120,94,279185,40088,239097,62,46,104659,31836,72823
408fa1cc89a427f9acea1b23aeeee7ba,160,121,428115,85803,342312,130,95,298613,117155,181458
50d843caf8a37c6ecc67bd78ea088137,70,52,135683,29134,106549,112,95,172578,41194,131384
995a117305717ceecf08daa3a26add2c,190,141,1182575,150312,1032263,205,160,1394637,210013,1184624
0f0e76c17bea97b8ecad61107e4d27b9,26,22,16740,5860,10880,29,23,16532,5441,11091
b371e6f22c906c81cd181d7a1f61cb5d,70,50,93621,25347,68274,62,52,91427,23434,67993
427d393202867affd269af4b99192e4b,56,47,44375,18760,25615,45,38,39525,15924,23601
b18b44b2753cd32d4eb12eca0469d69c,87,71,172449,50591,121858,86,65,156776,52199,104577
fcece8838c02bd5f9cbeed1afbfaac24,147,100,445880,57775,388105,143,96,429616,51758,377858
6238e02e7170fe275c32533d3a2acfdf,33,28,16978,12045,4933,35,29,25186,9665,15521
bb6aeeea266b63927189609ab87c5f6f,90,74,128698,45083,83615,97,81,171758,42514,129244
2ec9a4968b8fdd7e4653ddad00351e96,72,49,89320,25129,64191,108,73,173172,26879,146293
647e8942e02517e98e8eccf321dd21cd,34,31,29107,12713,16394,43,27,35032,10465,24567
aa15cc2291020886d682bc669ae8a737,97,78,237699,59623,178076,101,91,198643,62323,136320
2a9da1945b3395827e6f0ffb3d3334d3,84,63,116591,24671,91920,82,49,100469,17277,83192
6b52df29b4abb2fcc9095cc8fe8a7dbf,165,123,329380,102833,226547,137,93,463878,85570,378308
654ead030ee556013e8e62a7a7b156c3,150,104,597367,68628,528739,159,114,398370,70844,327526
7e74377fc578efcf9dc63f27283a2158,40,26,56431,19645,36786,38,23,39921,19040,20881
10c90cc30204122e36f13c7e5db63ff6,158,124,396361,90000,306361,140,129,417499,105782,311717
9889e92ab4066b352c59aa722aa9089c,45,34,60697,20154,40543,50,41,60944,24775,36169
5b9338bf24d2042daef69e5bc87f6024,87,77,171426,33881,137545,102,92,153369,46156,107213
64dbaf20f8af6ec7ff96da8b8b1b5ada,152,124,384582,73368,311214,172,127,521722,78464,443258
7dd4308ce84798012c281a5b80db7ad5,220,153,630970,113702,517268,228,153,651595,111034,540561
a24dcb656205c30e551cf1da1706d2a1,23,16,7612,3955,3657,22,17,8073,4257,3816
aa3de24c84036f143b68d40d1d8800e1,81,53,80664,18609,62055,70,56,56484,23223,33261
9ca998f21103cb6f03b97e2fa76c030f,79,70,112229,53794,58435,69,59,112963,45610,67353
ec64bfb1d8748774a2cf15e5cf519a33,18,17,3335,2306,1029,19,15,3576,1074,2502
872402b5e9c7e48e2f81b6516f7bf06c,1,3,43,380,-337,3,1,380,43,337
696a5db5386eb1ac83c18e4c367c3e0e,54,41,58988,24499,34489,74,63,109577,33742,75835
7f784f69e9bfb4db9e43095bea2d3f62,79,68,143157,36968,106189,66,52,106485,33835,72650
a47fd1937539f2131a419d302a3cccd9,38,28,21374,9479,11895,30,25,18798,9885,8913
80fbf94fbf1a75d577be93ad0a733b9d,65,38,94700,19502,75198,49,37,59356,27216,32140
443f4f4b3ae664cad267a7501e1d6e29,114,101,255566,67554,188012,121,113,309487,78880,230607
f7aee1e8ecb15d79174057109c795a2e,1,1,50,35,15,1,1,82,50,32
083e48840d9d08095a2ae9927b17e60e,34,29,41969,14332,27637,36,29,31551,17498,14053
4d7a71f593a3919ee049aee09c0aa207,170,96,363689,123389,240300,135,113,400369,169706,230663
3acdc7e735ceec8724d10a9978619f9f,27,20,8590,3505,5085,23,19,11368,3757,7611
452f37f457a42db4df79453f5748c4ba,60,37,65236,18876,46360,87,64,106609,22650,83959
a070ebe5971c52ad225c7444ca5ceb2d,218,152,987952,152160,835792,181,133,659510,146738,512772
f4c58b658028d38674dbca80dfef0cc5,118,97,261424,62843,198581,90,67,179112,51359,127753
5784ecaee45a89e416d6ee70acfc0a05,170,100,268952,86193,182759,144,119,338747,85401,253346
6134ecbebad2d763763b24321268d326,16,14,3583,1810,1773,21,15,3400,1689,1711
fe475dbb5dc81775b3c74d73c4cee62e,116,100,285900,84239,201661,119,92,342570,63931,278639
9b2440d3744f399548df9c3997aec719,28,19,18605,10325,8280,36,33,36449,11448,25001
6e1558bad59567c6fe970f0b00dfda94,13,13,2329,2210,119,15,11,3886,1725,2161
c5a536d901e4369a875f6d1a9cc9c259,50,33,62375,15897,46478,35,24,31574,15070,16504
aa83a58fba738e8eb8f180c97ca86b25,132,97,359447,120007,239440,185,113,497656,103981,393675
3a437bb0f4170c0cefecdd26f16d878e,157,145,528852,94995,433857,155,116,447866,79980,367886
93b91f2206ec2d2f4f98c1ef7d49bb6a,25,19,14691,5539,9152,29,22,23275,6776,16499
86b74a413a4ff6ff5e07ae7f37133523,136,95,286290,60858,225432,134,105,263939,63370,200569
7ede1346f3106e221d4b09f66d800a88,29,23,16480,6478,10002,25,21,8610,7038,1572
289fd424d960e1349b6ea42d89fccdfa,51,46,89882,28189,61693,46,36,83623,20788,62835
7b6d8707f028787a0e141daa1623b6bc,25,22,17574,3495,14079,23,16,8470,2912,5558
c5ec9912495c3c299d6ccc67cc7e2810,61,53,68199,14850,53349,30,24,28724,12262,16462
202888ede6b45ae95d90ea84e08175ba,28,19,9853,4237,5616,25,19,7271,5052,2219
98caab856568b234523cac5fded09f0d,95,84,239354,98312,141042,139,91,365041,101108,263933
390c6b42c56e200779e61507109eeba9,43,29,46205,14780,31425,45,26,41231,14826,26405
003d0faeb0ee57fe0d610885a4e5e413,12,8,2838,851,1987,15,10,2244,1907,337
42c52d1da8050b67efad61dda22d528f,178,133,510089,123199,386890,145,99,401718,102266,299452
2bc9a6f7bd95b5800ea03f10c465e382,101,54,136199,30119,106080,97,72,126821,42552,84269
106005c39eb679538b0143f2485cf674,140,95,293382,61652,231730,101,80,157664,57956,99708
8812d7814e8bfbfcd409bcc547c81477,23,22,17453,6544,10909,28,20,16167,5461,10706
bf936be6a5bda12a098c710d863f99ac,37,25,33011,9382,23629,32,27,27871,7951,19920
92eac62a11b0833b3ad46c11b964c17f,71,45,68571,25798,42773,83,53,142136,27183,114953
5a0db455f1da80255176cea700e2a5a2,120,99,228664,78182,150482,104,78,209616,71049,138567
dd49e8957a10485e76513c2755f18c62,72,47,117671,31458,86213,65,49,98775,29332,69443
0b0e191afeff7013185eddd1272c14f8,117,98,288894,85229,203665,113,85,311601,69142,242459
32b5e9b293fabc3213e2b49e5c444a67,88,81,158684,45506,113178,84,70,168473,44836,123637
64089b55efd5322bbc53d43cd41de60f,31,18,9231,2415,6816,21,17,5933,2666,3267
1fb5edd8824d90298fd034d0ea8d78cd,63,59,125367,38002,87365,116,95,206694,48706,157988
1a5de0d65e66b20516877847d9b42fe9,118,89,401669,114924,286745,177,111,567611,95885,471726
8baaeec51111e6aef4bb830b1e8553c3,38,31,21758,7433,14325,36,29,23399,7465,15934
087b2c91194a5e3073865d6b2ab51855,35,30,43545,15741,27804,57,37,58044,17168,40876
03211334bb06659da25d661804fb21c9,74,60,136944,39339,97605,92,74,114573,49976,64597
16f5251d2028c5a1b8f77f4fe7a09004,26,22,15817,5274,10543,31,17,13962,4781,9181
f54caab658956b28db3c397e2138dc16,72,51,81418,23446,57972,57,47,99900,22109,77791
81645b3d04974d927900b522d8a52420,51,40,74662,27118,47544,46,38,67983,26007,41976
3200d905da7a6bb81556dbf6ba8f94eb,34,28,39605,9780,29825,35,24,29417,9658,19759
8ecfd3c8ec0020e52e37b7b7aefc961b,75,48,164338,57901,106437,112,66,190235,57500,132735
92a1c34bf8dd5cef70853f09b5308375,35,23,30930,8891,22039,38,30,25895,11342,14553
6497318b68405475290e6303d56bf83a,140,105,403617,113892,289725,153,126,431214,85946,345268
6ce44ae0758653b356d8b0c9c8c7796b,29,22,14830,4759,10071,30,23,13868,6475,7393
4fe943c3c6ddb9ca190f3806db38a39b,47,34,23632,11456,12176,39,30,22756,8815,13941
e16962408811a45fc62f5719895ac999,79,65,100619,23738,76881,88,83,94126,26606,67520
c1f39ec124f3cf05da5cf345f6c0fa4e,120,90,343935,53849,290086,125,86,274721,49830,224891
b829612832f6773f8855d575f1f8e73d,93,76,128128,36757,91371,75,72,112062,35242,76820
7c1f5b52fb7d31ece1334c76fdfb12df,139,115,336038,78364,257674,160,121,352967,87728,265239
6911278508303114b813ec91697e2026,128,92,342986,59243,283743,132,104,375199,65555,309644
2189141c8e0c808132529c0781955b86,35,22,29380,8425,20955,45,27,32235,10108,22127
f480d0fbb0903508d44f0b358924a437,134,106,429073,107434,321639,193,156,633562,93778,539784
3479bf482ad5e4ce27c87189731caa79,37,32,26186,12471,13715,50,40,61244,14776,46468
d33e1d7a262d368aac4689c8c20b40e3,53,48,62683,23530,39153,55,43,65764,22430,43334
2acc8fd276f2a0d37a1b79cd9eb2678d,36,29,26837,15880,10957,32,25,37917,13471,24446
5806f4ac674b96426fc57ce80e12a026,194,137,1174829,108338,1066491,173,142,676261,105204,571057
95a553a1a800d2dda923d39c4945be20,149,107,379640,79501,300139,135,98,372239,93819,278420
b046572a8b58f982c9f2cc2bc99e91f7,153,108,431711,85860,345851,174,108,381645,113805,267840
1fc988bd753f271414422a0493780cdb,105,79,205501,56423,149078,93,68,183314,65881,117433
7ad08382064c04e7670ffe9121dd3fa3,114,81,198108,36835,161273,98,82,219990,39853,180137
f85ab5ae524552a235679cad367c7a57,73,43,84087,27438,56649,63,49,86701,24869,61832
9ff74905eeab09efca3ee510243c0261,144,102,372639,73088,299551,126,99,247995,80193,167802
a975d26855ca2be4f0f62b6bd44a75e8,22,25,17276,8860,8416,26,21,15475,6498,8977
c702041066b1fc907761b3c1861b92ee,116,96,199729,43541,156188,110,100,176190,65599,110591
f4614c9a72f36ac072446f6e7c87262c,113,94,200998,35722,165276,136,103,273585,45956,227629
f17f5f229336554c12596dfc055aae31,171,138,481995,97886,384109,156,116,443593,82990,360603
34aa250d53ca03cdc9ed5af489c52d99,150,143,435505,88329,347176,156,121,468885,95657,373228
b6c01fa0c3c114a726ee598982abc849,35,24,35287,12201,23086,30,25,24435,12543,11892
7177f3c04ba350a42ad238a8b18dac77,57,50,58230,17284,40946,51,36,51243,10618,40625
78b5a2d7180432a45abd253b9a4878e6,74,64,92952,30926,62026,67,54,93606,17414,76192
bb330b41a2ab0d300e1ac9722c3696c3,194,141,777694,103010,674684,149,109,640848,104109,536739
aa9272246b69fc47fbfd98c7f17d1b23,71,64,115775,40882,74893,74,58,101999,31160,70839
0f902fd7f005d6bd79a4d369dce66319,116,92,183010,47530,135480,93,74,146532,38178,108354
dd183380256325d63461a998083f1bf0,119,95,324218,68667,255551,164,129,384371,64184,320187
bf862afa1413f1e8aa00b3cae5a00651,58,36,50085,15929,34156,41,39,50599,14281,36318
b976c5c19685a919db17402e8a4ba004,117,96,305645,66970,238675,125,104,258938,81276,177662
457f9a4ed00604ce92d88a8fa5784a3a,25,17,10093,2979,7114,19,17,4049,3394,655
6c1e19e58cc6e163ecc6518c20e9392b,120,102,263948,62618,201330,131,95,271832,54994,216838
de43befcbca3839a14087195e7a223ff,176,123,491637,115341,376296,186,113,826224,115516,710708
f262161b0f2df4bea85966e84394fbc8,67,66,113540,40066,73474,60,40,69519,29368,40151
3e186fc7c330e261ff134778edbfef49,49,36,61777,23027,38750,51,39,52545,21896,30649
7dce04071b86d6444fdd671da14c313f,38,27,40211,19546,20665,37,32,48928,25011,23917
740f7a5f98a64b3856ca8d31bbf0fbf0,12,10,2341,1433,908,15,10,2155,1387,768
d2ed771b2475a27578cb0b8c4ad9bf19,172,134,429547,93316,336231,183,141,451119,78468,372651
e7654c1bcdd5ee5620ec34f8cfa69437,61,48,121664,40903,80761,114,82,180467,48310,132157
90923f99c737535be38ffb45a89a452e,85,56,154507,23948,130559,118,80,194777,26340,168437
126ce0822d4c93462f6a2cad5d5d4597,22,16,8526,2857,5669,23,15,7030,5288,1742
3d5cd66e1bceb6a9fa938df236d7d176,50,42,101781,36215,65566,66,57,107950,41140,66810
2f0e2c6c2d4c6750bc0066f8b59dee5d,28,30,23393,10631,12762,33,22,25971,7272,18699
f493d3b29c4655b662e39f11e920aecb,62,45,109822,29636,80186,65,60,138109,34690,103419
fd83f4ee0ddb26627df4f30b55a93875,115,93,282493,62184,220309,132,111,301944,60689,241255
313a9e66df554db028f4dc5e0815a85e,52,45,70006,21963,48043,49,37,51852,24224,27628
eb881674d6366059ca0015392ddd1c2c,60,49,76811,22147,54664,44,31,47770,17269,30501
be5eb0711169d14d85b5ed49c52c91e1,8,7,7585,2923,4662,6,8,419,1016,-597
6c4169669c905a7dddc8fdcc804f1df3,15,14,3198,1764,1434,11,12,2198,2314,-116
e70abad7283cc4b906cc9de97536408a,65,46,129330,37642,91688,94,85,156739,63689,93050
be59dbd0f8865e8af662a5761958a014,133,87,384011,156966,227045,150,96,582632,151259,431373
c9f4eaad4924500ec9800d43ed773062,21,17,5308,1043,4265,18,14,4404,1887,2517
b9911ff377ad4ad2ae069eafa8d5c547,92,75,238846,59760,179086,90,73,204097,65879,138218
8680ff053c1a78194610968dac02ddbf,29,22,16066,5318,10748,29,27,15537,6009,9528
27680c9521af57dcc8d1e33349a5e1bb,106,94,219190,53213,165977,113,83,184826,60387,124439
78c90ebd436fcf4a5bd683dc3a6d8b67,116,107,216797,50096,166701,101,80,208697,43354,165343
87bf8f8052a4284366529ca8e15e7753,82,53,101151,34947,66204,57,48,96257,34775,61482
71ac17f025c42ffef66c4d2b97e82416,52,29,42880,9472,33408,35,29,29101,10246,18855
5c22cb3983f68756ba227ee986652e1f,191,139,540682,105979,434703,180,131,546979,105468,441511
113587d62c5e7a99a409efd89dc03550,189,130,717458,149256,568202,166,131,640035,249270,390765
33c867cb38b4445c936208858df43fb4,101,57,84822,26110,58712,89,63,101230,28259,72971
adcdb8f9aec27b89127955bc9b31f93b,138,94,242612,50638,191974,125,97,303144,55689,247455
3931d3fdb9836eda7cd5375f08f201e7,53,34,57408,23302,34106,46,38,58005,18318,39687
d5d8b8005655e04a47114aa9a77c1471,106,85,184459,54734,129725,97,79,175876,52786,123090
e1aaf6606c13f980608e4349738537a5,69,55,116725,34656,82069,74,60,115796,42856,72940
e7c9de14ed5e5deea624f03eead690d8,98,80,219178,40659,178519,98,83,211802,44951,166851
a10ab5744e0327470967ec5a4e9e1e5f,47,26,20667,6974,13693,28,31,15926,7970,7956
a301501e57b4949f4699620b6bf7967b,42,29,47092,11869,35223,35,31,41375,16794,24581
e914318856815f1bad5437f2d75cf1dd,16,15,3382,1703,1679,15,13,3648,1961,1687
81475bb8c49311d35ae1e09337bfd5fa,100,76,206200,32376,173824,103,60,160040,33603,126437
17fcaef9295c8db19880924ed7e12e09,42,34,36391,9325,27066,37,28,20826,9610,11216
8c44daa84505fc3b20ca353882576aa9,27,19,9930,6549,3381,30,22,14933,6092,8841
0ec4c403a830dbd4edaa3325c775918a,108,87,268481,70778,197703,124,106,313470,77942,235528
f41a5fd8034a9a59ab87dc117a4ec280,140,114,331952,63348,268604,104,74,221486,44372,177114
5583209ce1a77a17898532d12e567a10,81,63,126203,45200,81003,122,88,199878,40851,159027
6fd7a99008360d4666ea129ad8910ecd,23,17,4609,1901,2708,21,18,3292,2552,740
57455963101b07a93742832c85264d9c,159,127,465971,88675,377296,173,133,490577,77560,413017
3d0ff8f6f0029cd85bb720bcda302429,130,92,240211,52358,187853,124,98,233676,60882,172794
bd6f6305f2cd8a49dd6ffd10cdeac0dc,170,132,483473,92556,390917,161,124,474220,85636,388584
a9ffbccf9e07a3ad34d72ef954ca3426,123,96,233741,67543,166198,173,124,350985,61677,289308
610190e0f22fdc65cc51083d4ba6f578,38,28,44788,11460,33328,22,23,9445,10034,-589
bf7e156003c513528be4bc570f958766,25,22,11970,5449,6521,35,21,15712,6247,9465
20ffd78c884293a0b5fcabec3e726b1a,54,40,87533,40982,46551,82,75,153336,59558,93778
1f56678e1d555518bdb262b551939381,136,104,520707,104324,416383,140,107,465694,83693,382001
eae901e8529f51b2173dddcac26ce81c,115,95,208473,44439,164034,90,67,158075,43253,114822
dbc9109254d245a7289d89832656ead3,116,87,341418,73044,268374,89,66,274717,87793,186924
a36acb27951ceee48770db2d5b7c64fa,61,46,74335,26087,48248,65,45,88470,23583,64887
bd1c3fbc35c58978f77e8ec2a2f7c13e,49,41,62489,19229,43260,50,36,48772,19195,29577
43038c6cf95cba79b7b3e6b689f68c6f,135,93,363359,75357,288002,170,143,479159,91171,387988
941c05e12b476c3258934e4ebf5b87b0,80,68,198234,44970,153264,72,63,151068,43901,107167
45a24c9560b180517531ea25fc5999cf,193,150,436289,94038,342251,153,106,334171,87298,246873
4f7594de5a3782a6bb83c633807d2da4,91,78,202544,66617,135927,124,90,215129,57135,157994
7f9c03c6bf26b1cb172c0b7495d17e32,24,21,9369,4879,4490,23,14,7847,2806,5041
b2d880929fb0f482e52610c886b7bc03,160,104,391527,84854,306673,140,116,323025,118597,204428
2d83331c9d77a56de4c773000bc5ced4,37,31,28882,11489,17393,30,26,20049,11268,8781
d6ce26340575830ce9f5202cbd4e65d9,67,44,96536,17444,79092,72,63,98079,31741,66338
70710f11254df6d69ef897d977a3c8fb,82,71,204218,58508,145710,114,88,216878,57868,159010
2628048628913eba5926ffb7d8fead2a,202,158,731015,169697,561318,218,154,807385,146660,660725
c04c6e2cc9fd0f4bb7af3ae0842e75c7,76,68,141012,43368,97644,84,68,108903,42177,66726
349f9533cd7fa1584b52e59124490b70,116,71,224646,34205,190441,125,86,201793,44530,157263
bd79478db650ad3d0ed8c172bc8f5444,83,51,121465,26933,94532,90,63,159181,36209,122972
ced52aa6425e72ff970b0de86e1d5797,9,7,1715,341,1374,7,8,851,791,60
3702cabeb15b9bc1d1bb68e8e622ceb9,159,127,507526,218128,289398,173,134,782081,164418,617663
2370db93ee8fee04621629e1cb30c5a4,102,87,195175,46309,148866,96,88,178802,41193,137609
84c17d87da2a34459560703708d34fc1,120,97,221776,41887,179889,104,72,173260,36689,136571
8d359ff92b77859e39a8f8f72f841717,120,102,329291,84839,244452,136,94,300374,55000,245374
47b8de63f7ffbadf72bb3d4c6a1b03c9,64,57,78598,35764,42834,85,63,91162,32033,59129
bdd80b3d81eb0323e3911b687bb4a688,139,108,375428,69854,305574,136,117,307979,80516,227463
e8b40b43c61bfa8e404df629adbecd23,127,92,297112,103429,193683,147,129,369989,77507,292482
3640b68532b600338487040596d9cf89,133,107,422275,120372,301903,140,94,571676,120388,451288
8853fffce5d79315631e2ccfcfccf9c8,30,21,12325,5611,6714,26,22,9006,4713,4293
7142945c9f201fecb5e9c5e535fb02b9,45,29,47233,15018,32215,39,38,44554,17344,27210
7fb80eb29759fb92da92c96df1679387,198,139,602133,91061,511072,131,117,455491,92753,362738
e1f27a7e256e36fbdcbe410dc9b67ec6,72,57,101914,43566,58348,104,69,193255,36260,156995
2c11e347847744b40f4febf77ef00dd9,147,97,382510,118221,264289,159,132,539082,97641,441441
4d48c216c94ba7cf4872410d82854d0f,178,148,401453,70744,330709,126,104,282289,52989,229300
f49ea3f356fece00a9b7d40c3e3454b9,124,83,279637,59022,220615,127,97,315986,62641,253345
84a1d03aef3e7cd045635cdbd4c4a59d,56,46,43724,15840,27884,36,26,33980,11060,22920
667647b87edcd7f9a47633a8ec549423,40,28,26895,12485,14410,42,26,27945,10358,17587
97d47a48110e98d548cc90447e14d06a,42,34,49466,19155,30311,40,33,44021,16552,27469
18b75f41251800fe02c5a31a3ed392f5,118,95,194603,38982,155621,117,87,181041,32600,148441
8276162048bd233b512e0155391836be,49,44,65372,18576,46796,39,32,43220,22334,20886
c540a4df6ee8f502de96c091d83da5ad,61,47,132555,38152,94403,65,60,133794,38255,95539
9608e2853fc5ad2a93a37cee97f2f5da,42,27,32309,11274,21035,67,45,71166,13053,58113
285a1c1eb6b68f474d178f8c45c4e4fc,122,92,618132,85449,532683,211,149,665537,105768,559769
ea89c1289f1d7e0c4070c71871de3be4,132,101,311441,76567,234874,146,118,380902,81596,299306
509e495070b807d9dc1e06812528573b,101,75,299977,103925,196052,137,116,388393,99162,289231
b6298123739d6e8ac83cb9855f938e26,28,26,31579,18315,13264,38,29,69391,16260,53131
2f4bd1ef5a71de1a1710fd36d596dd93,18,15,8072,3626,4446,19,14,5368,2718,2650
56223bb5e71f5d215e52a085daf1690d,85,72,200355,48968,151387,114,90,258840,60196,198644
3e3c64be0c7cc9af2fe05620b97d73f3,81,53,95698,34506,61192,77,59,121740,32108,89632
af2d92ae8eb1373ad9b909be971b078e,117,92,178838,50333,128505,72,58,121710,36853,84857
2d3af827de8b1aef45f004a6ea40cd1a,102,74,265701,59405,206296,108,96,232605,64845,167760
041ae48e66d337614bece8ff891ee7d0,174,138,523298,74355,448943,164,108,499199,71745,427454
e1cdcac7b8abbdaa95ec76932ef71722,112,84,304470,99184,205286,102,85,281679,81574,200105
ffb0d980924af61c182565ca7f9c156e,99,91,226557,51407,175150,96,64,211008,64018,146990
a2f3af5e5e38f132c1ab9d2f8ec74069,158,115,521603,75365,446238,149,115,520153,90034,430119
6a268ea7fdd40b05faf07dd17f97b50f,86,68,142144,38240,103904,129,82,239712,39170,200542
9b18d7ff7e7fa2af6235c5ff655b1903,145,115,356526,98917,257609,146,111,416516,86886,329630
ed02338ff62883fd2f8246387abb5081,257,178,829314,133977,695337,170,128,559816,116013,443803
7d6d699faf3a7ae2a7fd34fdd59ea92e,55,44,65923,18489,47434,44,41,48056,18246,29810
284b7b6817b63fed1d3ee159896cc2d0,159,118,408365,93506,314859,176,146,596163,110259,485904
2ec3ba75f8e239c982dd3b347b464b9f,60,48,79014,33911,45103,56,41,86603,20265,66338
b49b88a4931e0ae87301b62a8eddf197,49,35,71293,18678,52615,64,53,100997,22832,78165
286e3cf332f6c476eb0d8278d31d77ff,120,88,299284,61812,237472,130,85,342324,69731,272593
f2602434d30ec3784f73599696cc274c,24,21,9415,5415,4000,35,21,12834,3240,9594
38a1982c0564c10f6f62e798f848e000,127,104,403323,108304,295019,197,132,493133,118189,374944
68eb8301154ccbd0bb5c1d4419eb3463,30,21,15684,3502,12182,27,23,11833,5410,6423
17fc9717befd8a214638a4877ebfbcf1,34,30,22281,8300,13981,33,23,18574,8035,10539
af1160944e3ffea4594638574c4a2ced,33,28,30056,7046,23010,30,19,23102,8639,14463
4d9027fa176e6c59c8bfb9d8d4bd08f4,109,98,215262,59931,155331,103,104,189613,69239,120374
6769a1f47625f035c3ee5c4282e41255,71,49,107245,27963,79282,73,44,115754,33361,82393
a4df3cc91145be37fa473a6a599e2793,49,45,97265,29131,68134,77,50,111377,27170,84207
5ab45c86f8c6860713ecee2911f61f52,109,88,292376,62465,229911,143,111,337873,59792,278081
68371151c198e18eda335af471c90e9e,17,15,2413,745,1668,16,10,1590,946,644
b6308bd982a7dc57e517a791f32e3374,87,75,128040,28088,99952,43,38,66072,19430,46642
f80a13e67bec43343b5a84baff0d1fef,101,83,168180,60528,107652,101,65,151145,41696,109449
e12422f8854f73ee25baaf8b5ba8d689,30,22,16266,6672,9594,24,20,16118,6425,9693
463bc96533fc1c262c7e859383586640,31,26,30226,6587,23639,26,23,14136,7474,6662
aa960f4057d279180b6f57f6a442587a,145,106,445645,91182,354463,132,101,350400,68416,281984
26544fc36fdb9089e6aabd825957cad6,168,120,563570,104636,458934,210,146,776145,85044,691101
227ea94641edee367999eb2ba0a81278,70,42,63989,16305,47684,47,43,54149,18277,35872
8f752add7ae9b2371bee47bcefb7118a,151,119,449834,98233,351601,168,118,502518,87916,414602
6d5c3a310179ccfd3e7ef50b2683923b,68,53,86944,29163,57781,65,50,73789,28580,45209
c7ffec88c0e8c1b56080723eb3824bd1,116,105,297735,45758,251977,127,107,257354,63394,193960
95f9926b63e93eb0c6423675fdc82f81,98,85,244065,80297,163768,142,127,354820,83445,271375
816e52de8c15068505736cbd852fb18c,82,66,147230,38159,109071,91,87,156288,39121,117167
86c051c1a3963ea471a1ba8a4574962c,180,149,1376024,169831,1206193,143,111,706564,202908,503656
12be1c24c29e93bec7d0b2b29b455247,112,87,179687,55932,123755,75,61,131088,45130,85958
090e9ca13c4d4563eba1b1b0f515d2a0,80,61,136901,23463,113438,89,70,119389,27723,91666
d9fb3b2854d2bffa5c85311d29e43122,91,66,163196,37541,125655,51,41,104916,27500,77416
1c2b3c1e058bd3a1c534e2a9f1cc17bf,79,60,165290,38741,126549,102,83,202464,55468,146996
cac0b31c3875482edcd14e2db7d8c7c5,54,40,43743,14116,29627,43,35,25861,14813,11048
08da7e4a7a1c8d39d9280f3eb49b175a,147,108,529423,129173,400250,155,132,485172,127890,357282
57420ac66681fe18c798db028089b9af,144,115,356009,81933,274076,122,108,287488,86692,200796
f60713893b21de06931aa4cd27ad4362,100,77,183024,45579,137445,67,47,116559,53358,63201
48dcf5447047fc455008ea27995a4588,130,85,206560,32550,174010,114,87,194508,53151,141357
6427dffa9ddb66f103783201e9c5ef71,27,22,22857,8565,14292,29,22,16880,9870,7010
eda93b33f6201f89a9601fb88fa1c9ee,91,63,141364,25184,116180,85,66,159362,39330,120032
5318ae5b35dd4fa9d870a711bf18aad2,36,27,28766,8159,20607,42,32,20870,9868,11002
8605c174dfbbb486752dab41746aac2c,240,157,581540,113956,467584,144,103,437216,88139,349077
41d08ad651f33764b041f6d6f3b9a770,127,106,281463,55700,225763,117,104,314824,69693,245131
2f09bdf178d52f7fa54c075e93dba91a,68,45,143036,53510,89526,129,99,288085,63931,224154
59eb59ad1b88ec34130d036dae95fd76,111,84,234141,84462,149679,93,71,215803,101444,114359
ed6ad0b49ee7a4ec40a020fdb476f716,25,21,17167,6076,11091,38,29,33461,7665,25796
23f743316939b34db4abb15904164174,167,131,650612,97046,553566,145,124,500673,136695,363978
fe669b0718f8e828b5e0087be1d9739d,101,90,267737,76055,191682,134,106,345465,80690,264775
13e5429f285c2f367a2b696484fef884,179,109,450186,116705,333481,168,118,554487,111256,443231
eb44295db289d6d25c79dc2a07c1fc43,148,111,350471,98487,251984,154,122,539245,160288,378957
803bbb2e401cc34accc9a0c4d21cf93d,159,121,559592,123226,436366,154,88,489167,98711,390456
33e5a019f58b509696582a99b503e281,98,79,182429,62996,119433,101,90,233080,66043,167037
adb7bf3eb22bcd9df959dff86a91d417,132,93,371528,67934,303594,152,112,588816,65934,522882
7534e0c891f6ce55cf4347bbe9afd286,103,71,194898,53361,141537,110,84,222670,59958,162712
1a846fd15082c88c70e92aafbf2980bb,22,20,9611,4409,5202,23,20,9044,5483,3561
5475fd3d35dc470276fee26631254967,98,79,186370,61435,124935,93,64,152794,49432,103362
0414fa96bcce09621269746a52318e5c,122,93,336480,89876,246604,158,143,576836,103520,473316
f9530b65f61ada5d86887074924919d1,98,73,168040,45408,122632,87,59,200812,46364,154448
807813be3eb6f5ec6b2fcb1cc2eadf4f,110,77,177057,34401,142656,114,92,200251,42642,157609
79655838cd39bde7f4c501f24ccd464b,25,21,8870,6032,2838,23,17,9224,3777,5447
3452d587e3f90ba718523cabc8934f61,73,63,155021,41718,113303,93,78,141878,40267,101611
0c5bbc279a4a14d1d5ab42fc9a90f694,58,30,53252,20631,32621,53,39,71644,22462,49182
3148174c721b10784474655f73ac2676,0,1,0,56,-56,1,0,56,0,56
b5f28bb97f537fda38b6a63b4ccb3097,113,71,268887,55465,213422,85,75,189140,79307,109833
83a75b47713258efc716fca7a7eb21dd,56,43,118856,37145,81711,81,65,109401,41512,67889
330fdba45aa25409b8ac3c687e482d6a,170,109,473292,96260,377032,126,111,421330,97041,324289
f046698e8d3a7cc17d415c92aa6e9beb,187,151,925392,186467,738925,224,166,966342,165947,800395
5248d164d505b486625e392e16d6f429,79,71,138868,37551,101317,74,64,93596,37446,56150
4357777438f7fdbe973b3c78101f4738,65,50,128353,27521,100832,45,35,55961,21480,34481
c9bafb7f814f796fb8919be25338089d,179,130,461400,68189,393211,138,111,264250,59897,204353
a1b05e8dec1add5f2a8a2c6a8acdaffb,29,29,31959,10473,21486,35,24,32290,11408,20882
de724867d623b445c3a53559f9f09a70,138,99,352352,90318,262034,111,78,299733,76828,222905
19b7921e515d35dbf20e10fb39ecebc0,90,65,133353,42967,90386,106,77,160190,40390,119800
4a38eb620055a4786cd58861def794cc,119,84,239351,34224,205127,100,70,169467,44856,124611
fee77c4095f6dcbbb1a2cb192307fe8f,47,38,60232,15464,44768,55,40,51690,16829,34861
f88b9475a913b4d80fc689f7664530b7,151,134,558169,85078,473091,165,129,464737,67457,397280
cb74414019b787c5244d8af2881db25f,183,160,601604,119798,481806,166,130,490786,107218,383568
b9914748e1aa6625c3668448ee3c679a,26,20,9779,4808,4971,21,21,11983,4551,7432
96d4e09bcc6ed17778877992388c68e6,68,61,110115,39011,71104,60,49,95826,38976,56850
00ac8efb9236af6f47df0460dd5bc89f,136,106,288847,75089,213758,127,94,279314,60914,218400
4cf7d08155956d27a55fac02420de656,11,9,2651,636,2015,11,7,1780,796,984
cef641e3e7eadb371c2ea699b15f26dd,149,127,438675,83575,355100,162,123,513019,66576,446443
293bc5d032f2f497d6df8b7a90149eaa,29,24,22372,8987,13385,36,29,31279,8463,22816
74af699adef77652ebc50c39ab057adb,132,105,352873,96574,256299,110,87,268822,75294,193528
6b2e05b0fb6dac09865fd1c68e23dde1,60,37,110634,19055,91579,70,61,93124,24286,68838
f6e35e757b688369a8024008e76971c9,25,19,6231,3022,3209,24,18,7272,2953,4319
594c0a1ef21e0e1935ab0359c2bf22f0,118,91,297793,145250,152543,153,112,405704,83723,321981
1002e9ee30ff352d872f85d72f8a2107,61,44,50574,11822,38752,60,52,43560,14572,28988
9a7648be755dde665b560128becec300,86,69,131094,33341,97753,124,92,193336,66413,126923
9ec7ce78f10c01ffdcd23c25e797f3fb,26,23,15047,5230,9817,21,21,6937,5421,1516
fde06462645a13a2a5ffd9ae545fd023,88,72,196009,61791,134218,122,82,261327,55082,206245
98adb8ceb34b248d2035d67d90458aad,181,139,884468,178340,706128,198,155,842542,180914,661628
fe5a48d03958d4cc6d0ad2ed9e2d0224,34,25,56598,10764,45834,43,35,51728,15302,36426
4829cf6c66561c1e356768b0596d2877,131,106,348118,78457,269661,159,121,405525,85701,319824
a4cff84e03934679a779e6d2c997ff9f,65,48,89539,20825,68714,60,50,61783,25509,36274
64d4f3b1bc7ea169a7cecb3d0b95ce50,86,68,121000,39634,81366,77,60,165196,33306,131890
3bbc21e2e0aa297abb4d56eb2d76ee96,168,122,429598,86477,343121,102,74,244408,85763,158645
744a85f278b9e31cf56cefe0b337d86c,64,56,76410,30716,45694,57,45,82695,27271,55424
8e59b6fe2d3878ce9bf2080862ab3df0,169,121,538575,152265,386310,130,82,426501,152167,274334
655874e1f10bc5520f99d7bbe3291100,96,58,122465,31566,90899,91,58,116917,35108,81809
b80066f47e148095dcf4484c7ec1dd2f,54,43,40665,15719,24946,37,31,27219,14303,12916
87e846ce51c2e81315fa198912155478,53,40,52134,20149,31985,34,32,45394,17653,27741
9bd3829f2707e23e0e00b80b505db470,37,32,27347,9829,17518,32,23,27297,8031,19266
38332b20c0872450b3ba307889c73be9,3,1,541,113,428,1,3,113,541,-428
fcb9ad7b477e3e83174171d120260246,80,68,188099,56667,131432,103,79,236978,38729,198249
3be4e1eebe4fe43f2d0b3ce43b69af84,101,84,167811,24636,143175,100,81,157823,28935,128888
a46f886231c7fed2aa5059c450f9af14,173,140,516323,95180,421143,169,127,571525,102930,468595
f2a7c84bc0480c036e2e5f2a6987fb1d,91,76,148905,47795,101110,103,90,235361,43710,191651
4dd5d0fa924cfa69d70c17f192dd30b3,91,69,176054,48872,127182,124,109,272021,50358,221663
eb22550e254f4448fc93f792cd5d3e80,127,112,287707,57552,230155,148,111,323076,52682,270394
79e764c33002ee58fe1c064f12730990,59,47,91003,19979,71024,63,44,73204,15168,58036
3585e9998b1fad6b399b3016c1f69687,176,109,490203,78608,411595,154,106,415498,107536,307962
008cf3ba40f242be938e8a2c7093979c,81,73,138878,33652,105226,108,89,195998,33584,162414
37a4d2e09fefec87598fb0caf5637317,76,57,152658,53828,98830,109,96,282003,77081,204922
b771bc7ec38f70342557879964dc12cd,167,128,637395,179165,458230,220,169,813976,142448,671528
41dc68abd446da56b61ca6749719af66,135,104,432407,107634,324773,163,128,487431,119842,367589
3303d4938b7baee778b53f1442bc8ee4,138,106,384619,119348,265271,147,118,506195,153930,352265
6ef26a9f4740be82b2715415aee45921,188,142,676264,142173,534091,182,128,697203,143639,553564
b32c70bb198b84265d13fcb38c75ed5d,57,33,74124,12118,62006,39,42,27353,11675,15678
6ecb4c3544b448a15f2d91e41e2188c7,24,23,21355,7105,14250,23,21,23085,7435,15650
0dcbea813f86a49ea7b476baad4fafbb,146,120,474674,120286,354388,147,122,446309,110853,335456
bd153e0131fc622661be054059f10b64,31,27,27359,8987,18372,33,22,23717,9780,13937
3fd1f9169d16ddde890ea2519509e120,25,23,14500,4925,9575,24,19,9851,4602,5249
6ab7efb1c2bbeecd5427a3bed110b5e9,68,53,96930,28387,68543,85,63,130826,43734,87092
c82b18216f8e74b55c565c87c82b7db2,116,95,253397,66161,187236,139,111,321520,66637,254883
64e2378de3a675fa20617e44faf4b677,97,72,138139,50340,87799,143,111,332899,43085,289814
20385499730ff36693907fe3de928e07,153,113,332070,64957,267113,139,102,192259,65445,126814
bc143756c6d5218ce77bf2da14a63cb5,31,24,27212,7251,19961,34,25,22424,11581,10843
4d1bcaac097b0c7a3115fc5bcbb25001,45,31,39245,16870,22375,40,34,42512,15829,26683
c85f9c0f7add0c23e6f89a4939d1b98c,75,63,145711,47539,98172,102,74,169388,43821,125567
9c1f11f4609efc8175e1875cb98d2868,88,73,195775,43202,152573,99,89,250754,47341,203413
ee2a4f599d535c86261af073a15bc634,4,3,974,746,228,3,4,746,974,-228
ccc765bd93d286e7c214a03d2b2edb3f,22,19,4135,2616,1519,16,14,4212,2309,1903
cae598d3d27f764fa1b6b8835099135a,136,118,397311,91386,305925,135,104,348078,93580,254498
ee2a8064e20d5c92f2f0f8d7b0ce0531,34,25,28070,9395,18675,30,27,22317,12705,9612
a20a94b57916e7420ccb6c883a25b030,43,36,59189,16135,43054,52,40,60817,18556,42261
03011897ff7dbf5e4ac26fa821c1a61e,89,80,172207,45186,127021,121,105,206651,45015,161636
136178d9489a387ef0c0c65690ee1d61,207,134,945344,188638,756706,180,153,822069,210253,611816
a0a0f6e3bc810462cf4519bb4586dab1,156,119,437540,81807,355733,107,76,254460,79308,175152
7e5bee96f7e3e41228854e4835ed6eed,103,83,191712,72029,119683,130,93,279732,86327,193405
1a8b0d59b8f7d0505c92c898ed12f873,25,18,10010,4491,5519,20,15,6633,3045,3588
066888f2b010e8ab2a925c63b215299b,130,112,300624,75026,225598,127,67,287248,66153,221095
1160f232507f021fa908817130ae021a,61,45,89596,24987,64609,44,35,50776,27692,23084
d7ebb60773639eba135d81a0760525b3,155,118,524661,97187,427474,130,110,343141,80481,262660
2f537ad7d985a7f49f558fa332de255a,158,131,591616,149646,441970,228,182,829556,125166,704390
f276c80d0846d8f47a93251434a62568,54,41,55507,17251,38256,49,32,41678,18893,22785
bbc0b8b4292fa9f25cc6d6478b306e45,98,78,171716,35667,136049,83,68,135325,40940,94385
b0502114f361e8c2d077a4958da3ab26,47,39,56638,13913,42725,40,25,36582,8358,28224
d2f19d091c209d1f71840148258eecd8,149,114,465366,111511,353855,136,113,495918,95975,399943
a2463d9b024ab2e5f99fbee47b662ee3,42,41,64835,21746,43089,71,59,92611,31551,61060
286c80cb88ef07ea5139bcf4cb9827e8,62,51,95678,31530,64148,69,60,89275,31624,57651
ac1246ec88a4a9f17e5f601ee76beea5,33,27,34977,8783,26194,39,25,22820,8733,14087
894737ab057f5f244c2653cc10a12cc8,1,2,200,453,-253,2,1,453,200,253
4caa976b5ae3f9f14ababefc0219dd6a,75,62,128370,37687,90683,105,57,125938,39754,86184
3fbff2e658204671ad777126c97922cc,46,39,54103,18303,35800,38,30,42071,15563,26508
805fba38a2c24d408b6c789774381489,29,21,20018,5785,14233,34,27,27790,8149,19641
2ad23517d623fe229438e176fc063efe,180,103,536017,72648,463369,175,120,525072,76971,448101
8c076c75e9a7512b13d36461150dbb43,51,34,34189,9322,24867,46,34,26582,10121,16461
78f2c14f3c16188fc0f645871082b5a2,66,65,135079,44485,90594,75,56,115281,38679,76602
bcfd9e75b952bf1a4bc1373d37dd9c04,134,108,243282,38951,204331,97,80,156742,32335,124407
9c98092e3ea141008672347fdb5896ea,117,71,207230,45981,161249,129,89,196362,61707,134655
26d09f0a67f0272795b5e254d02a4eee,61,48,74030,24862,49168,65,51,50748,27481,23267
6683214130432399498456da828cb303,35,35,48370,15306,33064,46,30,44033,13686,30347
4f10148428810a206cf2d203d3c5e555,74,60,118955,43772,75183,75,60,144412,43354,101058
835f64b09d5c6a659530dd7a79c8636a,94,73,119610,46039,73571,74,67,113637,34966,78671
05563ae6f7a08ef1afecfb4b954a411f,118,98,256921,46172,210749,107,89,238736,78512,160224
cd6299b73e22cb6a4b8e5c9af6b0d03d,7,7,1815,1665,150,10,6,1924,1676,248
b0bba97a7800f2bf4a97cc7fb232e75b,106,94,259533,50258,209275,120,98,264457,74808,189649
d5031a75576c583b840cd3e39257b7b9,27,17,8746,4190,4556,22,18,6329,4234,2095
db901a7cef642c4fabcd458fef930701,127,95,235475,64155,171320,180,128,322267,49636,272631
57aa998b502506ce93dce3a49b3e8c4a,24,19,10594,3074,7520,31,16,14776,3447,11329
8aa55e7ccb3aa600c937070914ee6535,109,100,366837,96047,270790,138,90,289722,90113,199609
9e01f6a7420fcc8be52e27738464ebf7,35,21,31099,5276,25823,28,18,9275,8760,515
737a538f5576f25c07712910cc1e0aa9,143,88,333747,91328,242419,141,107,402960,78837,324123
c0770fe7e4295a366850beda55b97343,4,3,692,471,221,1,3,73,532,-459
7b5673b76f31fe7aa274bcc17be2e33b,135,113,342536,52093,290443,118,88,221534,40166,181368
f15ca766719659b9b51d9262c647bdf6,49,44,85545,20900,64645,62,45,74519,25505,49014
42c6c7c062f9adf01c82c6857529e1eb,57,46,65536,21152,44384,50,39,51219,20112,31107
cdb69b8ef3c736ce31d777d0e57809ec,25,25,14499,8950,5549,30,21,17086,7078,10008
3d9d5860347f1cf559fdcb8264f689b9,16,12,4956,2126,2830,24,17,5895,2272,3623
73f1ef820e97718bcc65b9d7319a6799,84,67,139865,39816,100049,67,50,109334,30312,79022
e9539b6797cb72e5f92817e5bb5760af,38,30,27214,11685,15529,42,39,30458,14487,15971
fa186523256eeeed8b416eb0d65edee8,125,93,313361,114179,199182,94,78,269552,83870,185682
58c92643d00dc4d68b31a1fa4739143e,69,65,88069,21632,66437,44,39,52432,20281,32151
67e80378840b9219c731c95374fcd052,101,87,158322,45334,112988,95,87,130695,36447,94248
ec36876b0cacd6ef17bff1a96782ecce,158,120,520611,85461,435150,152,117,425336,112435,312901
4ef737782facd8f2908fbeaad772e6ed,114,73,256895,53039,203856,121,87,259464,75038,184426
41b072cc9ac6be4e2100db80567ee4d4,217,149,633750,145810,487940,151,112,428491,106318,322173
2b0bedd3948c401c5fd4b3f5061e6cf2,3,0,745,0,745,0,3,0,745,-745
66a2def8c986225cc09d3b89c8f738d1,43,29,37963,8833,29130,32,30,19858,10847,9011
ac1c6c51cbb86fa5d7e991a0bc9c286a,147,104,375807,55073,320734,145,96,334380,50365,284015
cb8fbe7457d953b1f22c4eb539cd21d5,79,59,161394,39933,121461,81,67,114403,52668,61735
44430cbd352706e9fa59074e96ea8a3e,87,65,195156,49994,145162,109,86,197107,55116,141991
c348edfa5310ecbcac8e9906cb9c4363,123,68,283529,63898,219631,147,105,325700,70206,255494
bd7e5843fcf92ccfc94a59ce65501dc1,121,73,240557,38727,201830,114,94,307557,71080,236477
10dee8a000bb9da32c31127c489491cc,188,147,599827,87043,512784,172,147,421123,113697,307426
381cd8788ed77c351bc1de25fbbbcc69,97,71,151119,33679,117440,87,69,133461,43445,90016
7a88c216a74c7cdeca873fe53e69f7f3,28,22,19441,5115,14326,39,33,28140,9877,18263
2efc1b3cb129c4f35c443bd24f094071,23,19,7344,4705,2639,23,21,6997,3393,3604
81e879617a854e091291add2ee83ba6b,137,99,323728,109401,214327,158,117,374475,110400,264075
8a5350a6d3cf6ba5e4260f9f475eec7d,99,75,241502,55214,186288,122,94,262521,63886,198635
69fd5d0a5d8b7d25b362d4243aa7d728,54,38,52073,14682,37391,53,32,39890,14519,25371
3c798e9de513b275f9124e1e1da6eb74,28,26,9693,5078,4615,29,18,13369,3083,10286
497d70978eb4fe756fea263c53edbda9,77,63,144652,29413,115239,65,49,85619,24695,60924
0d3950c7b240cf0da3168f781895a488,188,131,643499,117350,526149,205,164,878106,114583,763523
29ec2bb6d8caddd402d6bcf4ee387b89,154,117,482931,115474,367457,123,98,457517,137507,320010
6649dabe8d2fe1eb8d2681619a0b4d38,85,71,123479,37784,85695,99,85,212816,39213,173603
c13711ce4cbdf378a5df1c55deb42fb0,70,64,130609,50866,79743,105,82,188823,42265,146558
fba321611b5619c1ff8542361c4f864f,58,49,79048,20351,58697,53,46,49557,24243,25314
90ea2fee73304a7529ba828811402b28,48,37,55053,16846,38207,38,29,32068,15491,16577
e1d1e17a009d383b0c4314431fd1b748,34,20,16258,6093,10165,27,27,14388,7192,7196
341a934e9a245ee65176113fb63e3ccc,43,36,56365,16683,39682,36,29,42999,11938,31061
51852a71fe98a29d51e63d24ef526954,134,111,391417,97735,293682,167,125,586300,88481,497819
97ea8a3d1a3d27ddd9cd971be76a2d9f,135,104,276740,55348,221392,141,96,331517,46669,284848
2f88ad240bb50dff41db3c68cc1e4e16,93,77,192936,47252,145684,112,70,206980,47183,159797
36b1840219daee471e1bfde249b8606c,87,70,179415,62337,117078,119,82,207692,51802,155890
5c5bef7fab9f10aab098fdd2bda3e4e8,72,54,110563,34334,76229,80,77,172701,50273,122428
0ba3227ce9a77fbebb9341a61e88ae7b,175,114,561131,173841,387290,203,131,635525,150146,485379
cf406b18255b4c3cef950bd0e03e3eab,196,130,1211846,196287,1015559,251,179,1127061,154325,972736
db5394202f27565de1aff3ae989a5535,39,25,40602,13024,27578,36,24,36206,15511,20695
1bfe890aec8e44100710805209d6c89b,100,86,202893,58259,144634,121,107,279975,53744,226231
e0b2aed9b41dcc0cd942f3e35a24f886,155,116,348972,54443,294529,85,66,169261,51323,117938
43871cd33391b4b2b0106390201e04f1,56,43,86030,55806,30224,72,53,118620,39309,79311
c5c9637a3dfdc824f6285f2ebd5e5777,50,48,41156,16332,24824,51,44,66205,21371,44834
6f2bf09232a143e720101e20fb098aea,13,10,2714,1226,1488,20,14,4092,1327,2765
2440aa8d7f0acc3c8aa49b99a74e0a5b,1,1,49,90,-41,2,3,133,98,35
e0992f4a47bb7bcfecac2ab5c7550b78,49,43,75868,27340,48528,71,45,96402,31003,65399
84fd61112a91fb4f911938a89055abcc,168,125,698110,151055,547055,206,133,706436,152407,554029
277abc6d9568507881a7de063c2d5878,153,85,414661,94331,320330,199,133,567280,101589,465691
817a28365ff6267be94d86f4fb5676f3,90,61,182039,51685,130354,114,93,204837,49349,155488
bbf054493d9d842c563404c28771ac1c,107,88,333044,40777,292267,109,84,242797,55626,187171
f9e10fcf163f5fb7c8e0d99731bbf5cc,31,24,14721,7362,7359,27,22,16735,6513,10222
2abffef2846caae2196d9ed653b9343f,9,8,1268,464,804,11,10,1789,952,837
85d2756ccfb84b87932bc2b5c2999aa0,173,122,688217,146503,541714,215,134,699791,107564,592227
6983d5cd833fd4181b2a277183ac1296,99,78,216368,31981,184387,70,58,114984,53143,61841
3ee0e8b7f0c330c53efaca22bbfbb49f,50,43,71138,29232,41906,47,39,59685,25603,34082
5c55945b928318fce7bee11f3fa0cd61,55,41,80237,23255,56982,74,59,120796,28415,92381
71fec08e8b10c047f872a65476460ee2,29,27,19851,8460,11391,30,24,21067,8839,12228
de31eadacfdcdbb49953a3fabd2afe9a,182,130,698212,122015,576197,187,134,603183,153057,450126
5625fc87c6cdbec092212dc059c98986,88,67,198909,48573,150336,95,75,205253,54629,150624
8bac6462513bc0c747a1c21f258201b8,31,27,13168,3381,9787,29,23,10165,4830,5335
8998a0f728e18da519907de626e939a8,56,50,60345,20370,39975,61,35,49602,13945,35657
93b8b3dc8926b3902ccacc6e26f51d7f,107,97,219188,50543,168645,99,76,159642,41098,118544
dda7dbe4c0ee1451be2f599877ad0c46,75,63,140711,39143,101568,93,72,137556,45597,91959
77d0af91e8ed2d7a5cb9fc656ec77a52,62,38,64593,14516,50077,54,40,65225,17737,47488
0c6d6ae479950f9e940803931b683771,7,6,952,952,0,6,7,952,952,0
7b82f87acf28130266976d74ecae431a,103,95,125316,38470,86846,87,79,174198,33092,141106
d64ccfc004772442fc06d259cba7c7f2,83,71,191365,66445,124920,165,124,393693,61483,332210
e1e22bec4ce177cf52040e05db670eea,103,75,179634,70360,109274,89,77,221416,68021,153395
b12d8f62fb12cbc10d986aedeb92f20e,168,131,517885,136648,381237,149,126,486892,148338,338554
ecbe877c34cc318caa385d3194c50044,35,29,35660,13758,21902,48,35,57272,17646,39626
658cf916290fc6f606376483b1161587,30,21,12397,6519,5878,28,22,14157,6518,7639
a9693fb426305ff224309de77cb19e9e,86,64,129120,59496,69624,95,76,178679,57369,121310
46473db92af9cb583bf27a3cab2080a4,92,77,153828,50983,102845,91,66,160904,47379,113525
1f61f6033b1daec7ee29d7f075fd9a89,34,22,34457,8945,25512,32,25,30172,15790,14382
8cdfbd112ccb6ecb93a2570a4f771eae,81,58,125340,26237,99103,87,74,120123,36303,83820
25d9364d5f2dd2e2f88612c8fe92a414,0,0,0,0,0,0,0,0,0,0
92493f0221b0c39fb618b10ae558df70,118,85,215814,54000,161814,113,91,226414,56951,169463
a251fa1a4d2314ea8b446be4f4905fd2,129,96,272649,68013,204636,100,74,204236,49501,154735
3839216c4d7cf6352140f861f0c3f301,138,92,372248,87698,284550,190,132,580469,142220,438249
c31d717705af39bb42b34ceb2958116b,62,48,93826,29869,63957,57,42,89181,32684,56497
f91855e239084eb2cd565f233bbc0ca1,93,75,203092,48212,154880,72,53,110250,51169,59081
340726bf71e0b1ca37d094ad91af0d9d,76,48,89988,52142,37846,105,68,182433,44756,137677
c9d4a510737e0c35c05580ee06662e4b,164,131,675696,77728,597968,188,113,488399,66334,422065
2789334bd6094583752352a2110b4697,23,18,5706,2502,3204,16,15,4330,1931,2399
0171ad8e2e2b2dc6c44d56c0663c96bc,22,15,8003,1817,6186,28,20,9059,3874,5185
63e2e9cb62e0a760c845dc5907bb143f,155,129,655743,139432,516311,194,146,671429,125456,545973
a6a09fcca9fbb497222721efb95fb64d,133,106,544305,143555,400750,152,114,372459,106314,266145
2915962d871d64660af42c70db981b80,54,51,97677,39690,57987,95,80,151107,37050,114057
931308a859aedffe8b6d66ee406f9af9,207,135,687371,119502,567869,211,143,813769,139892,673877
c4eb51b5556da3ffa2db5c28a304bbe9,30,29,17312,9683,7629,31,24,20412,8257,12155
085e879cdbd41c0f5d44d49513476d4e,52,35,60105,17829,42276,65,53,81731,24342,57389
366edde4acbeee4a1259fb584a193c88,69,52,111371,45016,66355,59,45,127226,28374,98852
7dffce9cf67f1fd0d00a8f7d89e2a542,86,68,121206,39396,81810,103,84,119779,38430,81349
9a33b0fdd1d1bc0fd11e525af00be80e,74,56,149194,39389,109805,116,97,242973,49060,193913
83da815f47ad4bbc947316d4260911c8,43,32,50959,17995,32964,40,32,57255,22292,34963
ea6b8326f33fdfb5eac12256f12c400f,104,93,186676,62984,123692,99,79,228003,49001,179002
35eaa29810b2012b8e31a8c4b2e856ab,33,25,20221,8494,11727,31,25,15818,9923,5895
68eb65baff787e2146bb77cea1d5dcbe,25,17,11092,4913,6179,22,19,10649,4533,6116
0d31aad47515be2c6c3df569ba211ece,102,74,353988,122735,231253,151,136,489900,176226,313674
8f9386bd3f7873b698bc753a0ad3af81,150,114,456189,106741,349448,184,142,536838,98949,437889
227a39bd08baf159a3f511db780d9ecb,34,25,20466,7965,12501,28,24,19462,6623,12839
fa96368d173da66d39dfdbf793db1e78,28,24,14615,5139,9476,26,24,14103,6335,7768
a51d61d1618ec6a6963b08781b7b2e35,212,151,966290,141544,824746,164,130,565602,110368,455234
7363d004bf0cb5b201e7e57db5939ce0,21,19,12486,5911,6575,29,28,13823,6593,7230
56ee2e6bacc23e799114455018630e71,27,24,24674,7811,16863,28,20,13131,4782,8349
b7a455afc4c25782ebf29467c3ab3ec9,0,1,0,259,-259,1,0,259,0,259
8ef5a9b8604e1d323da77e51d43b4c81,179,129,559862,147882,411980,176,139,602415,134111,468304
3af32a119ebdbc495cd83a8c7df9a294,113,86,322641,53832,268809,150,120,341745,75988,265757
04765f63a538239195bbb91916f50bbf,42,28,51635,12260,39375,33,22,30671,9927,20744
c9d8077d12dea946bd0ede127db2c4fd,163,125,589067,167882,421185,197,121,558687,120868,437819
ae88c8fedf24f3436c7fecbeb9bd81ec,36,35,54550,24229,30321,41,35,62359,23392,38967
1124bcd0a514ef2579703ff9f4a85ead,81,50,121079,41323,79756,106,87,229097,40525,188572
8bd2295dbf3d7332e9a52be5908d7a26,67,49,76657,27943,48714,42,32,56298,20446,35852
237929882e5f7184595ba32fa8b7e833,64,47,66265,14740,51525,44,37,42677,17278,25399
d415bd005cf515a450f7d49e335a8049,150,118,399729,121447,278282,157,124,513695,129029,384666
c06317c2104334d7077cf008d04dd393,44,32,39738,13293,26445,40,42,42160,14626,27534
633b4d2045784fcab7e73bac20fddc14,57,49,67771,26473,41298,54,44,84005,25706,58299
1319117a7e58c81b75d7a1366cfe26f5,120,101,306850,80692,226158,187,114,455786,68941,386845
780977c68ff342059ad1c06b778a34df,236,167,742106,144641,597465,158,114,593801,158028,435773
5240af23ccaa75942fe6c3c91b9359d7,38,23,28918,9319,19599,40,29,38467,10425,28042
e5f62fc9f1942b05e0326eae982b735e,45,37,80306,17770,62536,57,43,71065,23568,47497
6e8b42b79e0fecd671fe2f0408588f1e,151,118,410650,79172,331478,167,135,429390,64214,365176
1adbc284077825dbd5bc49026ae117b5,171,132,518429,75875,442554,158,112,332527,65689,266838
d0a2c0744739ea090d1c38b54850d655,173,144,704664,128681,575983,158,134,550170,120621,429549
63e63eb1c3153b6c3bac83c8debf9482,64,59,104855,27244,77611,67,58,106864,36672,70192
ae637484912c4e5f20dc458b74009fde,106,78,273347,123252,150095,117,86,332555,113528,219027
1b1eb7f11a08b1d5c251832913b6904c,58,47,99972,20498,79474,61,50,84547,25836,58711
5d53fec6787ac597b9a294fbb4dd3193,119,91,269139,45258,223881,161,119,391472,49306,342166
dc30165a59168c92c2107fa2d4c26ade,61,41,73271,25640,47631,53,47,87117,30134,56983
18873e56c2142af326b4e08ca41df63a,143,125,442480,86722,355758,150,97,417488,55649,361839
32f43186ff3619f0e3350b5e19bef1cc,151,104,515848,78458,437390,164,113,442602,99200,343402
4d3a9546ea4d9e27368289e47a1d4dae,42,36,71685,18663,53022,71,58,93193,24123,69070
e18ef2bb637a0d7ba2122b07914ecc6a,66,63,136214,29250,106964,64,46,67856,24398,43458
593117e37e2ac676c100357e9e29f1c1,178,120,440913,93411,347502,140,109,403600,132184,271416
5f538560894f4320798f51f52d577d88,11,11,1884,841,1043,9,6,1447,901,546
adef3c78c8d610afea0ae61fe47a61f8,23,18,7755,2351,5404,20,17,5026,2792,2234
b3292945b79e6c21da4fa1e8ac111111,88,65,212169,83748,128421,92,75,168002,81756,86246
0d5f5a1bd3fa2784440b361e16dc75de,108,84,315972,74910,241062,115,97,266717,92676,174041
f6543762291370ef649e8601cbedd68d,123,111,337189,68399,268790,164,125,369370,67841,301529
cbbf98b6875b740c8adaf6a9c8ecbfff,79,59,139871,18510,121361,68,51,88005,19719,68286
153c8448f940380851b38f12fbb4cdc7,59,41,52549,20669,31880,65,54,98413,19734,78679
b9a54d39088d80daa4a6f4ced1994237,143,104,595960,115107,480853,183,147,598629,75677,522952
214814b487e698c2a05f481cbcbce455,44,31,57144,13313,43831,59,43,64935,21741,43194
a1914ee7afd122a8519fbf818ecb4ff6,59,47,92160,45478,46682,126,92,221146,41968,179178
e23189908f1f99fc6f4962094e365495,133,99,316132,82952,233180,119,96,283594,58899,224695
cae4149622c6e148ef70d256671d22c1,180,140,504876,83523,421353,170,130,342444,85185,257259
33f8caf756f116086b5ba4af5fe23f68,44,39,25372,10999,14373,55,39,25605,11291,14314
a67daeb76b2ff3d07a3609f105528fdb,46,36,67034,21938,45096,77,47,89155,20135,69020
0e96381a6f24af2641f0d54b81a03f68,61,41,66291,19202,47089,66,50,79942,21859,58083
d540746d7387c6c9d43fee36cb828e76,111,57,153462,29602,123860,127,96,223469,44378,179091
f197567e1e885069f338b103c2b8d0f7,89,68,140899,37572,103327,124,95,189305,44580,144725
91901606b6ce39ecc7da54ff245346d8,23,19,17272,5807,11465,30,19,16966,7178,9788
356c7ba162a5dbd44aa1ea1267ab5cc4,159,130,506608,133898,372710,186,111,695548,130496,565052
c55fe6a6f37b810de2c822c573a35410,235,159,998104,127792,870312,232,174,853437,179513,673924
e732c4ea768c657d3c4caaa4bcf21d4a,105,83,173230,33934,139296,104,94,204872,37821,167051
57864ae0d68385ca706ed4236bd1f4b4,150,122,357016,60465,296551,161,134,372739,60218,312521
c31b750506e6226af38f3874034dc9c5,153,132,440056,82673,357383,110,82,242378,82400,159978
000df2fe7e83c885cb472c8ca97ff855,52,35,51630,18803,32827,46,38,50166,20441,29725
50e3cf7cbe4bc806c0887c202ad5da29,43,31,24674,10636,14038,42,34,27686,10401,17285
371db9bd7c47aec922684e9f938f09b6,110,94,274421,62660,211761,139,123,346025,81039,264986
3f781c8975dda6ae9b5f9dcd32de7984,188,128,500293,103718,396575,115,98,336329,74489,261840
a4531818c4602c8d143250673bb639c5,100,73,154059,52263,101796,69,54,101590,52309,49281
c452094636b40c8733bf8a0c12c8a60a,71,58,139273,48567,90706,68,63,112871,52214,60657
5830ed5d9627dbf42f44fd963f944c00,79,69,235803,40560,195243,78,53,127722,37944,89778
12366579568c54450a180520775314f4,118,85,266816,48340,218476,110,91,221135,48836,172299
219991ba5103bb994a47b5fb4c8d5b16,128,93,409124,92637,316487,169,129,600427,78651,521776
299eb989da5367a550358b5bab17d466,87,78,135234,39189,96045,103,59,158719,25857,132862
692893bb67042c0a06be7b89d828af3c,65,51,78710,24617,54093,44,35,45164,24322,20842
730296444bdae3905d6cf0eb5becabf8,36,25,32571,12264,20307,31,25,26484,12369,14115
c6e91102064b8a70abc755c4916c42fb,43,34,43891,9373,34518,41,27,32163,9463,22700
76fb769881deb1b3e43bf1803a968a6d,36,29,28509,12941,15568,33,31,33342,9065,24277
bbe39042f2097ba52dbc490a44d0d436,71,52,77477,19682,57795,49,44,61689,16793,44896
895f5099b712a5165d621aea39eeba99,50,39,51857,14686,37171,54,45,71567,16743,54824
2e79be2328a2dcd5e0217bb9edc47e5d,82,70,179274,66439,112835,83,67,194098,57086,137012
ad36ad86a4b68c820e691ede313dd040,156,107,415958,76621,339337,141,117,405672,79701,325971
da56b41d50643b900480bf0fffa2a35f,92,59,166236,51011,115225,91,79,162796,45757,117039
c232a21c342b04c866c59a28d31b3fc1,51,44,43313,24616,18697,54,45,72366,17968,54398
3082d98f13e1a11caca59f484bfc4615,110,99,321289,85230,236059,148,115,395971,70888,325083
b663d2092dc09600ac864a94e154848c,94,62,160069,40543,119526,100,90,160444,51398,109046
777e345755e9a85bcb0a9fff7b173755,112,83,304054,95045,209009,141,99,338900,93729,245171
c11437d5c338230619083e2f0cc84fe3,41,30,22574,6745,15829,39,29,22707,8905,13802
b36054d235e6f120697f9840660b25fa,80,50,178229,37642,140587,56,42,98142,31257,66885
ccdb4c90fbac314c122f5a4061142eda,47,43,52430,17714,34716,49,31,37943,13090,24853
f65f6d8aba420213499b58756f69e3fe,34,30,25544,7174,18370,29,19,20815,3483,17332
3917c1917d1807ce8c30d71804d75593,228,161,1068162,175372,892790,242,190,1356757,200682,1156075
9550f204a6ab17f6a2beb2a8c1fb2c22,92,56,134534,38402,96132,80,67,140457,45053,95404
aca67dbc186dc0d21829c20fdaf8e0d2,131,94,396164,80651,315513,126,107,317501,87278,230223
023293b99bafa69b2370f2a229e0524b,30,21,13229,8497,4732,30,24,18722,7270,11452
7543a39f6c64c1c025cf823bc5adc2b9,22,20,19795,7062,12733,22,25,22785,7810,14975
f08626ce801ef9cf474defe1ac885347,98,61,163027,42200,120827,111,65,176173,34648,141525
5c3907f5ba23b7636844a0cc876944e5,42,37,79465,16553,62912,46,39,67578,27449,40129
6d787500fc1f2d1e074abc8db4dbee7d,67,56,75526,22763,52763,79,73,136913,29321,107592
c754044d66d26481ce43f76001e3cb23,43,32,48418,21305,27113,50,45,63458,24145,39313
1eb9d3359aca439457069c62d3a9f1bc,67,58,118892,26888,92004,87,63,115225,36258,78967
1bcc59809b79162792b0dadf4a795e9b,165,130,787440,217835,569605,195,127,736975,150305,586670
ccdc5e6bdc4dbbe78976edef523b992a,254,174,1049055,184682,864373,222,167,740578,159469,581109
d5400c0897ccb2411c07fd88551b974d,79,59,177066,55751,121315,80,60,157820,52789,105031
b2f5c6c100c4e3e5e4c0486ba95741bd,51,33,56989,14260,42729,50,26,67094,10847,56247
3896e82acfa0bd029ebb8c02df0bcdca,115,96,266205,65674,200531,126,117,364304,63761,300543
af3a2c0193d61c242b434b38d86d4157,47,28,33102,5001,28101,35,21,20211,5620,14591
fd84cc9ec9b0b022b68381facd510a5a,97,74,188176,44465,143711,160,123,373077,66575,306502
789cb773ef075789fc4d897f6c917c2d,22,15,5831,3913,1918,23,19,10121,4625,5496
3663631df03b8e0a9097e17e866bd5a3,123,104,344968,86673,258295,149,123,384667,68985,315682
e67ceeadc84c16fc17dcdcca96998af2,22,14,4379,2331,2048,16,8,5928,1117,4811
7372d7fdd05ad3f80aaa313443a9a9ec,30,23,15734,5811,9923,34,24,21072,6908,14164
ce224d852ba36a7a4703951041c3846d,56,46,77745,20003,57742,52,39,62514,24980,37534
4da221d6d48bef1d40aca4f8b0468365,125,100,397875,80506,317369,105,84,260699,81103,179596
4f6522b92395db8d036b61a945bbe324,114,87,271048,56392,214656,112,99,272269,81042,191227
0648202c16988ccec129e7536acf4380,138,92,350483,83557,266926,195,109,467303,60861,406442
3a6e80090f0246c34d37b8751bdbc1ea,125,100,325127,90879,234248,148,128,408300,134073,274227
076f3ac4e03dba55bd78858f2295362e,52,44,66633,17645,48988,56,47,52047,18030,34017
c50e281582afd480bce6c5445241cc5c,141,111,450613,108598,342015,125,105,396807,107364,289443
3e53599ba7f90bd7db46e1afe62157ff,15,7,3926,697,3229,16,14,6969,1923,5046
9ad82c296ffeb4abe5f02667b31b88f0,113,99,260430,63376,197054,141,99,346014,52587,293427
fd77b735b96caf717185df7ae71f53b7,0,2,0,298,-298,2,0,298,0,298
504ffface772b4ee42a37265ad14add2,5,4,430,428,2,5,6,516,518,-2
6133e160919d85f626a8756008508aa7,175,131,511663,139019,372644,226,151,635417,124185,511232
124cb27d0613d1fd0ddcf1d460d49092,77,66,107009,31639,75370,59,45,63431,25697,37734
7ae14ceaf12493fb1729ee50be996041,50,39,72822,27474,45348,54,47,75164,35775,39389
e69fbaf6512d996e407371b93ef811e1,52,48,75749,22430,53319,48,39,63000,23449,39551
d60000b0d7bb67e7f915b70e8ffc112c,162,126,340049,78314,261735,127,103,326476,83255,243221
3fffa0623997e4d52c24e5d6909b9047,131,101,300622,65079,235543,121,109,301388,79302,222086
337c46df738f29516acd91f294d97ad6,142,102,311807,79437,232370,119,88,311235,72522,238713
61f4a1c24dbf9953f627ec80c005e73a,69,61,85639,27496,58143,62,54,85682,22663,63019
52228457ca7a212c0398095f507e5c58,127,103,304339,66001,238338,98,81,220406,54727,165679
bcdb050838fec405c2b339143426d93f,149,110,363706,116360,247346,131,117,353801,115277,238524
1d697cc0ed29e979f1e2d2332b72d772,83,70,172193,67654,104539,85,69,176759,48339,128420
b4ce75c173494ccadb3595670dc29ba0,161,120,501293,110239,391054,173,102,524615,96169,428446
5c5fcd53bf74bc1f8e63a139708f8029,20,20,4378,2565,1813,16,15,2802,2259,543
04c7d8fec2b4186a3947856bef756ffe,52,42,56637,20520,36117,46,43,66197,13972,52225
24e75b500774f00b51e8b65102457de9,138,123,392996,69785,323211,138,114,306129,82883,223246
15492daffda1b32902fcf547075ca946,34,31,30826,10806,20020,27,22,21050,6576,14474
63b04b1a10edd1d4f3737e4368478ab9,155,108,480477,95880,384597,165,111,505058,104634,400424
71b276d15a60771280d20993dcb5f94b,24,13,13565,2561,11004,21,15,9380,3680,5700
4f13bf9b2e03ca346cf4ec00e7cbae31,56,48,64178,33249,30929,69,44,99408,24630,74778
14994a90d442df2862595123e91f8010,30,20,11958,3661,8297,23,20,6225,4690,1535
1f5b96fe9a075dbf719795c2bd41232f,148,104,418281,92261,326020,162,109,526823,61476,465347
ce8b6e9786ba13c1090dbd37aa696586,69,66,113906,43426,70480,69,58,120479,35164,85315
6e91167318498ed433f556793b5e26d6,31,23,18985,8928,10057,38,31,31090,9556,21534
2c602c79e9ea3fcb5ed06dd3f7a36df2,190,150,599235,97193,502042,160,118,475837,96751,379086
926afe9b693aecb4b6a61bd2039abb74,52,32,57356,22036,35320,50,32,54006,15940,38066
e0ed48db5cabc291ee67413c7f713575,52,33,49729,22363,27366,51,35,61702,19644,42058
a8aba38c6e52ece55c0c15876ec85485,23,15,6789,1791,4998,24,18,4322,3052,1270
a70db5e3a91ab12451505324be0506b5,139,82,419328,86223,333105,128,112,362385,95081,267304
89a6e17a95c11e9dcc70b6ccf529bf3d,25,23,9439,4108,5331,28,26,13659,5817,7842
7dfdc8de998ba7c4f664b310e2403e15,111,90,295140,65541,229599,84,63,173826,90523,83303
865860e7b42c6583e4812d66f21b159e,79,60,107670,33985,73685,61,54,102800,32612,70188
62e78d9e845a45964dcb84bd7f5d3436,21,19,11878,3538,8340,23,15,5883,4021,1862
7b3ce12fdc7f819c13bad6f331b25433,40,31,31191,10997,20194,42,28,27161,8650,18511
576462465e3de2190cf8681ed7f7cf1d,71,50,97447,37749,59698,80,63,112154,40200,71954
1edfb855b6fd55eec1e6b721c5c9880c,68,52,101914,25652,76262,81,50,95669,30137,65532
0e69990a52fe3adb8df23599c3118e98,122,76,223844,69489,154355,107,80,285433,49129,236304
6a483e1be4b2befbddc16287d3f1e731,221,169,1367315,233721,1133594,245,180,1367318,214791,1152527
467a4c71aa4e40f36c6e871e8c024305,165,124,524397,112009,412388,150,120,511538,145305,366233
4944cc438f496d6532307abee286f184,107,70,181899,33138,148761,72,43,100501,31547,68954
e41245125dd7dd6977b62b35a0a356ff,138,115,452836,88543,364293,129,104,465480,102547,362933
98e51ec23bff9cf472d6e1a4985e46f0,54,39,61598,18922,42676,79,74,124948,28901,96047
90e6ab8825a92d23e95e7fbe86e6bb44,134,98,342027,83203,258824,125,93,379552,78911,300641
ba54dfa1e7b6bb0b846635a2a74b52f1,150,96,247026,64098,182928,109,90,220925,64135,156790
271d957367d9427890a95decec0681f9,92,80,132554,46607,85947,56,54,99391,40097,59294
f6c07c29e7259a99153b851dc392b4aa,150,113,372549,120952,251597,115,82,253919,111992,141927
656a21a8ba225e5eb9a1582a9c04a22e,26,21,12595,9044,3551,34,26,21516,8949,12567
816cc43410b2144b9001623aa2474c31,69,57,88096,29023,59073,56,48,64163,21261,42902
36a6bdf2177696f2e0c9d4fc5e742833,25,21,12137,5047,7090,30,18,22014,5788,16226
61df277f768464e2a19e86940891d238,184,150,709890,182894,526996,183,149,604406,181148,423258
a6c5fe5fb82a71e813144363f978bff6,166,121,761209,181270,579939,214,160,832723,171176,661547
52a38f959810333c069e818f112fac6d,117,104,314168,69877,244291,176,138,507494,68080,439414
c8ddbfeb3de7e68d18f7e1c8116a71ea,177,117,535330,124881,410449,136,102,451805,101664,350141
01268c9ec8d7cfabc36a339073fd1eca,63,58,111562,35820,75742,61,47,86217,32920,53297
cbcc889224e682ea47408367a968d07a,135,89,366237,78760,287477,113,70,217146,71470,145676
be77e21354485a93f5761f4b217cf4d2,66,53,87912,29838,58074,68,49,83357,20241,63116
0ed7d62c8920fa7d9a54e3b6b977e6d7,73,59,90241,22737,67504,67,53,65716,28421,37295
153477417501679a05caf311317ee1fa,78,70,133001,35109,97892,105,66,125414,43592,81822
180ed58de1e3dc2fb19ea7f6982f6762,38,30,37010,16941,20069,35,28,38861,14989,23872
9ea8bbded968697d337294085a5322d9,153,133,575750,152139,423611,184,155,862923,207235,655688
d6aac2813ba2f9495d3a04f7e81fda0e,31,23,20256,6757,13499,27,19,13747,7898,5849
003f5940420a04a0cc5dd2fe783d16ff,44,23,33271,8656,24615,48,38,68818,15845,52973
98815d69302a50861662ab42e440b398,35,34,41640,14417,27223,49,34,60605,15442,45163
2f5b1ca181b9a0af53b1aef6134f83af,103,74,269378,61910,207468,107,91,249159,68486,180673
0fdeaa9eaeabeaf0903bc84e8091bc0c,45,35,44505,20773,23732,44,41,61880,16655,45225
46ef07d0bb7ea543e073e84be5b4272a,25,23,15377,5378,9999,27,26,11411,6420,4991
cb859e49315fa9ea9002a2afdd49ff01,47,35,43643,15235,28408,43,31,56821,20749,36072
5ea556729d5cd09472c59bfaf14436ec,182,112,537259,97721,439538,174,103,457671,83170,374501
5349f7be7f6d063f616f126db3e6a032,84,52,215292,59463,155829,105,90,299858,64408,235450
ff099594586ba9e15e7abf85534ce25b,54,49,66201,21476,44725,57,50,38822,20411,18411
29e4107b18447e1bbfc0b500f8811390,101,81,294415,71004,223411,137,106,366139,70594,295545
d966267062a0e6118b18914cd16c3d6b,28,24,32729,8170,24559,26,25,19229,8020,11209
04e4e98fa887c65cf7b7d6ba31d4428c,114,90,234193,72558,161635,123,102,274926,58034,216892
b203e994b7acfa99c4e71cfb0447f256,85,63,164264,44126,120138,92,56,172149,35133,137016
38421d30a3f44da6f5faa949f9816201,38,32,55698,15952,39746,55,34,63075,16144,46931
9fa20b76907bbdab876bd7ca4577e107,85,71,159063,35528,123535,86,66,109417,29823,79594
5b617fd8bbb7b6853de5f126417c961c,200,149,527509,89900,437609,147,125,413573,103220,310353
874debdb73ac9408f07ba4fd4cf4273f,77,51,108206,22679,85527,79,59,105234,32443,72791
9672cb8100571f2b37ed8d715b0e251d,21,20,7658,3390,4268,25,17,9260,2111,7149
d8f6935bc77fc6e61088cc65db217b86,147,114,415196,65436,349760,139,117,367034,73565,293469
b91734dd8c4e60f08d4744c0adff7b0d,67,39,72453,29161,43292,79,65,83240,30297,52943
1ac823db2c4567569c705c6c04f44173,46,44,82003,23283,58720,49,41,57156,24948,32208
f37b6802451c6d0eac3583d9059f9e38,29,23,19486,6974,12512,29,24,12980,7974,5006
040612209bcaafbcaee5b6c86c2338c7,53,32,82559,24538,58021,82,56,107525,24151,83374
c20ef3582f8e8b8324417aa5f831a8df,13,11,1925,1258,667,15,5,4992,384,4608
1043524a0fbb711e2dba09f9ccc7908d,76,64,201634,52782,148852,71,55,173343,53572,119771
021e6085319f748d1bf70d96df0d0c77,109,93,193830,51201,142629,115,101,234592,52273,182319
2c16d4c72224c6bd80bfaceb5e78e8f6,33,26,32156,11676,20480,46,35,40869,12134,28735
118bfb46d261212fc507f54bf425ea23,27,17,11564,4104,7460,28,26,14089,6957,7132
700f25b7037ce41f2770cdf47c264057,162,125,684957,96612,588345,139,86,367382,77139,290243
a1ccd9a709a0b62047afe56000cb0735,23,21,13593,3579,10014,23,22,8846,4012,4834
2d732ea0c06645a17ef4f02fa29b55ac,120,77,323984,44965,279019,148,113,310387,69177,241210
55744f120aa11dfd9f7ac3c2922ade10,77,60,84646,22923,61723,80,58,95516,26974,68542
45fbcc075dea32ad7a9c4333660f8b10,89,67,131007,39209,91798,111,80,184622,37507,147115
724f9a21afc93b31fa6fd2148ff5e27e,96,64,156308,60401,95907,128,93,274830,52769,222061
a076c2452795729d85df76281d8e52d8,165,119,533566,76512,457054,173,133,446897,99019,347878
f3aacb2eed29b4a0de025cc894314466,54,43,68505,16558,51947,40,30,47208,9349,37859
b0337c526f55248b3010c0561e2d8d27,156,125,524492,119590,404902,146,107,438100,104160,333940
17595b16c3d3e54cfd42228812500d1d,111,69,146715,37780,108935,109,73,171018,39969,131049
ff1e05a09d6f6eb40ea8d478cebfc7d1,18,15,5685,2140,3545,19,15,6446,1514,4932
7ab375e1f89f2b28a39ff6a9637d2159,126,100,502198,140963,361235,168,117,548159,145837,402322
0480252fd8bcc9f73e7f2d19512a200b,45,32,26689,11323,15366,47,35,34928,9138,25790
3b64e064aee3d374c9406404b4970feb,29,23,14849,8304,6545,34,23,21020,6248,14772
fc86a209132a2a84a2890d9b1c8fcc8f,80,60,121338,20294,101044,67,61,90956,27285,63671
81dbeb04a902c2acc5aa4c30828ce252,122,88,315844,75768,240076,116,79,241617,66773,174844
e4bf100c379684b12a160baddd068a85,106,80,208489,33128,175361,98,82,140879,58560,82319
860a54c5577e7b3e2511adbc388f7cb4,44,37,47130,20383,26747,50,26,47584,16084,31500
d67ceb2ed84bbfc1eb714f45e6f48780,92,77,154772,38108,116664,116,96,257193,42546,214647
e9ac2d5eb15f40a09ba43d7ea38ad0d2,10,11,1226,857,369,11,6,1249,631,618
da1ef2a2b51c10620a1d36ecb9d34885,16,14,4776,2290,2486,15,10,5724,2000,3724
4e7581ce8d8404c1da9cd7114423c532,181,123,573081,111555,461526,182,147,539992,113019,426973
a5cb2b889e020a33ce81b5489512f605,36,33,36265,9362,26903,25,24,20516,8914,11602
88a67ac34a1a137b807c7a29bd14d1e1,45,38,48868,22295,26573,57,39,67471,17962,49509
8e7ae1cb9b1cb589a03f3af6d958f5da,23,21,12246,6748,5498,24,20,17047,5686,11361
0ae9285e66dd0d158b475bf506dad0bf,51,35,54599,17321,37278,53,33,54153,15671,38482
23564ebe19b482b1f26c66f06bd82910,44,35,27794,11276,16518,43,35,30987,13398,17589
227dc88b3d9272da6a4cb6480eb6268b,130,95,240067,45913,194154,83,58,179628,38300,141328
4adcedde31d6ba788f147f2f69548eef,59,43,90356,27241,63115,49,49,61817,33633,28184
852be6ddff76b25bf2464a52596f5368,162,117,323868,39958,283910,117,93,215571,54177,161394
64781488c7351b5fd3ec0d44b44f3d6b,192,137,534846,87229,447617,148,121,445278,91924,353354
3c0c758a2341793504c1739d8a0795fa,114,88,215919,61326,154593,124,78,294220,60747,233473
8a13c723736b16d63920b3bc0fc8c322,91,57,187054,38652,148402,76,48,123849,36312,87537
acf3bbad334719ac5abe99cb2a0bd79e,1,1,157,48,109,1,1,48,157,-109
1133fa6c34ce541e1ef2ba5aa89fd4e7,158,119,629797,106920,522877,208,145,711523,75899,635624
e9b3703597a7755e0cdd80d122b94dcb,48,31,38539,13859,24680,36,30,35718,14741,20977
3f02dd0ad834bdd3a43c1e915ce3d4f1,179,140,652295,64521,587774,119,79,323587,64410,259177
df0c384c9d3325c2559d260f0bb560eb,37,25,34962,9777,25185,28,19,32145,5982,26163
142139c4e3342efb4c447eebb2974c69,39,33,30750,13753,16997,33,24,27860,9201,18659
facfc5a2fa6d31428111745e52bfc693,176,131,629671,139933,489738,155,114,631641,118753,512888
a363a14704d64ef1d5e684da4fccae6d,64,42,70051,17568,52483,46,41,61443,18710,42733
d3f31922761966269fc5ba6ffd1cd3ce,152,121,363382,74319,289063,157,125,355594,57285,298309
fef36f4f783102b417e0c211d628d8d7,21,10,7574,1862,5712,17,18,6784,3330,3454
7f2b11ad34d70042d2b9ed06f10958f3,48,39,28099,10795,17304,43,32,33797,7505,26292
08a446fabf2028c3664c1f77b1847c10,46,42,43071,14032,29039,36,22,25729,6149,19580
81898a2be7a0a28d1e352927d7100ed7,23,23,8587,4363,4224,27,16,7837,3592,4245
99591af6cb19926e8ff66a6a398dfc4b,105,80,325240,59263,265977,115,77,236426,82926,153500
6b551d0bfa0222f9c351879568d2ad29,47,34,104972,23907,81065,46,31,78865,24576,54289
9bd5dbb90a67e74067a23869dedd8355,122,92,248922,59446,189476,89,72,168045,53424,114621
bc5cc9e0bc7970774f4c4333b6a28dea,27,20,14125,5929,8196,29,21,9953,5869,4084
4720fd862dafafbbbbad76750d69d4b6,21,16,5727,2839,2888,20,16,5212,2980,2232
c26e70d6cff05523b7db86d2187c65cd,59,45,101300,29259,72041,81,70,109293,31812,77481
72ec30ef38b90eeb4cae3f2c68be4494,35,25,23306,6317,16989,38,30,19543,7903,11640
4e03bd136ff446ee9e2b9221a9c95f2d,89,47,136421,46759,89662,112,72,215430,50497,164933
0979ed8d21d7f661be3f4c3b85de9e79,25,23,8910,3701,5209,23,21,7528,4716,2812
b44eee70563c8c0cde4c6f1439c53ae5,112,60,195539,66139,129400,108,93,196799,84903,111896
8bce9786691e31e1e99323d501580426,109,87,186533,71235,115298,92,70,154380,59543,94837
d2aab91d93f1525757f05b3ea58dab25,169,123,398983,99334,299649,148,119,490070,96933,393137
41b65ce26fa653cdef9b2a664f13425f,162,121,387028,66634,320394,117,85,251607,56180,195427
7e85853d5c615098ee648c50a346ce0b,70,62,69898,23835,46063,61,44,86174,15659,70515
588d1bb43c61d4743521be9cf14357d6,125,73,314195,47672,266523,137,102,245702,66701,179001
90c532829f75a1eaa970d0f68f7db3fc,106,88,178518,46919,131599,79,61,158091,36283,121808
2461d6d8181e55bfca1ebf827416d876,133,112,257748,76339,181409,149,112,247008,72366,174642
28b095903d59609e63949570f7b0c37e,38,32,44945,16481,28464,47,37,63664,16772,46892
68ad082cd2869b8fbec444fc14a37952,112,91,345344,68890,276454,108,83,233989,96857,137132
6f1c91510982f35b1c147a3ad97e1bab,29,25,16543,5775,10768,36,20,12471,5799,6672
34457bc25661fe1ebd54155adc9b15bf,100,92,241363,80659,160704,96,93,240416,62336,178080
270aa4e94e148a43bc2afe0bec5bf98f,14,14,5000,2357,2643,20,15,4236,2652,1584
775620c240032678bd0253a3ce7bf5dc,174,145,561677,96506,465171,170,135,726052,122957,603095
7d38788097bf5185356898f852798e96,85,66,218562,60716,157846,101,70,238532,42702,195830
d0c0f00fb3e628710ccf37e1d7612267,80,66,125646,40147,85499,78,64,110022,39227,70795
cd9141a74727182dca79318632432601,80,74,171919,49503,122416,69,53,115610,37359,78251
db5a85fecddc1d14029a5aeb13011e84,3,2,224,169,55,2,2,169,177,-8
cf560abc7d28be1b2ac08262bb225ccb,91,68,158965,59773,99192,122,91,200691,51802,148889
0f00cb8448168d75683be9ee85386b08,30,21,13354,4654,8700,33,27,14792,6999,7793
1655ba7851777c5bb38d7320356003b4,67,61,93640,20790,72850,61,42,61816,17919,43897
bd73498d526a9a2dd4857548abd8fa5d,72,63,76528,46983,29545,93,61,188858,53802,135056
c3df94e548ad9d6c66fe0eba5ab0eabb,49,47,84948,40127,44821,75,59,134470,27133,107337
6aee93be81ddbd70554a727c4c6497c1,45,40,38984,14948,24036,43,35,37481,11555,25926
68eace4007b910b836f1cd93eafee7ac,151,110,384298,72965,311333,136,108,409910,85941,323969
d020673c7cb5a536d39f26832f9bb106,16,11,2267,1216,1051,18,11,3372,670,2702
a0cc9ea164a8136fe0ba546234fe5160,61,36,54057,12450,41607,43,39,45289,11280,34009
8fc256ab1a645270470d1ca7094b5da1,116,83,279446,51419,228027,112,98,192716,39318,153398
325666603ba2478c1fe28ca5052ddcc5,82,64,132503,56425,76078,111,86,234901,54128,180773
6b6f06cde55fe601717f13db29772f18,137,107,445646,124579,321067,167,110,526512,112398,414114
6e902cdc63277b7b3bdbf8a5caaa7588,27,18,12902,4428,8474,25,21,14662,5581,9081
861433e11b8081ed1c3f600a3630ed79,182,154,1163419,140616,1022803,182,137,592904,184732,408172
26ebd63490ce2850949d7b86f9041133,193,171,938193,193389,744804,192,159,830677,180621,650056
1d17df5c7cc08ec74b99aa8e77490e97,16,16,2834,1423,1411,17,11,3391,1289,2102
d3b9f26f375f9d414d4861ea6d19a573,24,21,8222,3406,4816,23,20,5553,3954,1599
8e0e21bd018e9320fa47f6703ce67e67,47,38,81300,36886,44414,48,37,92288,36299,55989
5095707099eee5a8c8d1a59f8ff13de2,194,136,789065,117089,671976,170,109,634988,121317,513671
cd83b8fd8fface8a160f0b6811575765,47,37,56798,22213,34585,50,34,55109,22937,32172
381cb366a4b30fc6a96f5d9667316cbd,80,60,122309,36101,86208,59,49,103842,26369,77473
95537a326b141621c868535b4cc48de4,33,24,17520,9531,7989,33,27,33825,7155,26670
35b5d6e38d6ac1cf4937735ceec35db3,55,46,57554,20589,36965,50,42,65560,19312,46248
e2629dccd6c70616288e49afea40cbf3,21,15,6319,2048,4271,20,19,4234,3442,792
8ad274d7e76fa2c61fad0c88f2dc424c,63,51,83119,42329,40790,70,43,117189,26572,90617
4dcf24222f039071be373ec024e03b68,86,58,92628,20858,71770,74,56,97958,26106,71852
e201497579fbf55b7078c0266165dda6,50,29,38150,8902,29248,37,34,30071,10828,19243
985c72c766c08a216130aaf6f4064bd7,116,92,271071,60891,210180,149,109,251116,60641,190475
f7c29930f289cb74c788c4cc44354cd5,80,69,208414,68950,139464,121,100,285109,72270,212839
25e182c665341487141fcce8058becc1,110,75,238193,51426,186767,87,71,164787,61622,103165
8beb4d690a79526784c2690fe0b77e5d,131,88,246376,53875,192501,119,101,271452,38056,233396
0a35aff867781de3727aa036071026a6,93,74,202134,60615,141519,157,117,297490,73604,223886
dc3795b2810088483182cdab7210a205,153,117,296497,52744,243753,135,95,219094,73878,145216
bedeccace108f8b7d3a49c39bcc630e3,84,66,107426,40194,67232,72,61,134499,34922,99577
29dd19ebafc545e41cfa82dffbe83777,36,26,16885,4047,12838,28,24,10575,5612,4963
38819a6bc8cced26690e986d42921174,133,101,375937,123586,252351,134,110,376531,99729,276802
ccf4c8f8546d1e936545b96e1c75332d,154,116,397958,93348,304610,144,126,502178,109103,393075
5c5d916af8d12ea1109356a315df2910,159,128,499501,92470,407031,153,115,396048,106981,289067
867e6787cea4c59d37147e1731b993ca,112,92,231505,58288,173217,140,114,263242,73681,189561
8dc1a5c58abad7fca5f5431daa12c6db,89,71,201786,48808,152978,109,90,182733,54052,128681
4ae24faac59f03313a3111066f9794bf,57,39,73877,21276,52601,49,35,66567,23700,42867
05241f4764215774d4acdec99bd91ec3,102,88,240602,83762,156840,123,99,259851,72408,187443
fe82ed95cfffd9376fa6955cb514baf9,4,6,445,367,78,8,6,867,655,212
1e1db3e5531de3e755bd219ab0722e14,8,7,750,506,244,11,5,1335,379,956
343e35d1409ef4839b1ff9b4df392170,116,82,248291,68404,179887,117,91,245717,76920,168797
05e368241e63b23a5fa78998be21f39b,30,26,21316,10742,10574,29,25,18683,9319,9364
edda03e21dbdcfed89af584d944bc41b,94,86,187863,42632,145231,88,57,164092,39337,124755
0c117373fb0b704e76bc8de686e4cf08,99,61,150217,29626,120591,128,96,160933,38597,122336
6056a8b4c21ac7ba119488b3a202204c,60,40,74294,19970,54324,61,43,64405,20245,44160
51dc7566fdefd654a3abb8c00474f8ff,153,133,409402,91023,318379,100,73,233263,79594,153669
5413ff5f84e64fd07d8bfaba08b2ea7d,74,61,117437,22358,95079,63,50,69939,18616,51323
7017aee7835bd771599fc37e19309804,132,104,353227,74533,278694,118,92,361342,78075,283267
d07235400c122e716d7f3265420d59fb,104,82,302153,67271,234882,133,110,369952,75464,294488
2238a658fcf278f8dd93ae14647795e0,84,72,129586,29022,100564,60,43,73513,22134,51379
57ad4df511e722ef9d3b43ee7effc893,35,21,28283,7333,20950,28,19,17190,7253,9937
d8d3c298d60284917dc657d8cc08da5d,91,80,226586,60804,165782,103,71,197214,55443,141771
748cbe2364865524701fccc2cadaabbd,141,102,319306,77371,241935,136,102,322137,59174,262963
46e37bedfcfc81d38d0ffe9add7c01ea,91,74,143381,43117,100264,73,55,99376,33680,65696
148e5dff88a28deed2facfcb78a91bf7,36,22,27807,9354,18453,50,42,50301,14015,36286
908616ddc8e799b55df5916cebb275f5,40,31,28255,10823,17432,33,26,28290,11291,16999
347e4b9a4315c89c3a2251c27a1cf915,27,19,10784,3787,6997,19,21,6668,4368,2300
6ce8fd810c698a6cfe3025f7ee00d5c7,38,29,29308,17517,11791,37,30,42635,13759,28876
77b209fe875bc746eb9698f9600e7ed2,29,21,20587,7319,13268,31,21,19742,8158,11584
b0819f3d1d61b9e86c0ddc7e491c8808,111,92,260099,52100,207999,139,102,261688,48265,213423
184f102a7fafe650b3d9d4ecbb4a547c,129,101,388546,98218,290328,111,96,401538,91317,310221
8f9a3d0cc2280134b9cbefc47828b4e9,13,10,2658,725,1933,12,9,1920,1060,860
9741cdd82e8b843ab6b012631dbfb8cc,3,1,232,13,219,1,0,13,0,13
72858c5db071009ad12a4e9721313733,131,114,490413,104229,386184,116,76,428145,106765,321380
e375bf9fc2e4927fed0e483cf549abca,86,61,197808,54710,143098,80,58,148809,58456,90353
8cf53eb90611ca0baa7e84bba0351bf4,47,45,58225,20711,37514,43,26,43416,16947,26469
1c759dccfab1840e22dd3271a13f845a,153,85,432814,108167,324647,175,106,415347,115617,299730
6cb638f8b43b6b0914b354df26a2697b,22,16,4693,1836,2857,20,16,4391,2378,2013
c4fd999112db9de44d6ffbabf1e54c4f,11,8,2145,898,1247,9,7,1438,1253,185
5920fc6428296f60816e66a8f8642205,48,45,96699,25286,71413,71,55,109758,35873,73885
1c9ae375859263b9fb6b68ab89e7fce2,52,47,71317,28868,42449,64,52,67322,28821,38501
488aebdad3cbc72c0129e637318ca9da,106,74,170781,40947,129834,104,72,230720,27620,203100
a576eaca72b10a798d948c9ce6b185ea,15,13,4003,1901,2102,14,13,4490,1864,2626
df8f21a9e80bbde2be2c4d4824d53b21,149,113,409769,100458,309311,139,98,396844,69444,327400
9419d8f9d8cc160353dc0fa2dde0b0c5,44,36,48198,17122,31076,53,39,41959,24466,17493
9cfd1a744476c7aa3f841de3eb2c6301,94,69,209435,64207,145228,135,114,363060,62520,300540
5116545836358adcfdd0b6beed86e67d,138,108,395071,98337,296734,151,110,343279,85329,257950
2d1d738491d402eaac8161b93a6b8c69,16,13,3408,1953,1455,12,11,2959,1356,1603
bbdee759160e74b8cef5583f823bbf4f,88,65,207339,42335,165004,118,97,262349,57324,205025
841a6e8afc81f7c9fb0b07ff15870044,160,117,492844,142371,350473,157,121,496314,113274,383040
f837c5d4345baa1cb38f4ff6150d7941,115,82,155573,73251,82322,155,113,327123,69492,257631
596dd962e3469cb275d1b32a8d411702,92,76,160597,31308,129289,89,80,137095,32218,104877
60f28edf67b4a1b35b2be8f1210b65a2,181,119,400277,65425,334852,135,114,338830,75290,263540
5de061af8de6f5a1613d5ad35471dc6b,26,22,18252,6813,11439,27,24,14661,6277,8384
f1b86c708045823a2c674a840fbbbaeb,162,121,501754,113705,388049,194,138,655131,149577,505554
b8a127356934f2cce3b252bbbf067461,200,133,1097610,149671,947939,189,118,740105,116758,623347
89d7441e93630e22836d65773e0160ac,43,41,59605,21378,38227,56,45,79756,22786,56970
9d86b30572d31a8374183e4f4c90196a,150,112,421702,74506,347196,144,124,417650,84974,332676
73f8b9e4039d3acb8b80d7f92f55177f,115,96,243222,40622,202600,130,112,279608,59506,220102
3c418bb2ec3c9c436c29a8a1a2a105e4,6,5,825,1028,-203,6,6,1103,681,422
4f3d7956663be11f83832f3be4aeebac,70,46,71185,28814,42371,50,46,77748,29222,48526
afb8ee1bbff4c4e041baf81e84112653,104,74,209369,48236,161133,128,98,305891,43964,261927
8babc8ad45bfcdad3688a08e6f56d9c6,83,61,120802,26836,93966,104,78,107793,35669,72124
f75c408ba20d291f5a01eeebc8c46385,195,143,499583,61888,437695,124,95,282691,55572,227119
39cde7002cdf6101f4d615d8d3d55636,34,21,22948,9598,13350,32,27,22469,7703,14766
34992a122761cd343c7420b6cbb8e574,75,60,142023,23583,118440,70,60,113235,30615,82620
00dc410884165222d42a9a2dab0f329f,107,100,282942,84142,198800,135,103,298826,84852,213974
8b598b89c417f436cd5c27ab8c753e06,70,60,94336,30161,64175,62,48,79474,27807,51667
3797c28e7984af732ee5716ac339f5bf,32,22,15458,9142,6316,39,26,21557,7142,14415
32cdb63d800d6af19b0780effd3b85b2,129,122,218619,47114,171505,123,90,234188,36018,198170
025c1de699296b3016cb2817c4d05d0f,7,9,1319,1587,-268,11,6,1698,1279,419
0ca22e6b5f49a468092ff6a873fdc93c,83,68,144423,53205,91218,89,70,184328,42439,141889
d1062907eb958775e70db68384e05a13,194,136,756305,106681,649624,195,144,636201,93139,543062
b9c49aa452cfdbe3c567342df97a60d6,179,130,700200,103380,596820,132,106,459736,115080,344656
4d6e0d58c057b8b52000e6492765ad0d,32,29,22162,8811,13351,44,32,29331,7433,21898
c2018d45fc3718a6f1231d4279b5495b,112,87,286350,108646,177704,114,90,279579,121680,157899
641284ce6eaad063322027241bdfbfd8,113,95,239799,47077,192722,102,82,212072,42290,169782
bc9c772a4f6580aa91c99b243b8ed440,0,0,0,0,0,0,0,0,0,0
ed7ec35d387ef273d3fedae96969d566,36,27,58603,18809,39794,47,40,51337,23840,27497
f5ea834cfbacb04cced525dc1806bb7d,116,101,221644,50488,171156,99,87,191511,38993,152518
123303b2982a7636d0c934e413d93b97,95,71,186396,35780,150616,104,81,192834,45455,147379
28893c82d570f97be0521bf464ca1260,37,32,59116,22639,36477,66,39,75476,19386,56090
3fbeb0d70b997a66905adff57c4e3943,98,72,160410,50134,110276,136,80,235352,44485,190867
9bd60f4a2ae86e9f27cabdd5b3e589c6,74,64,143797,47409,96388,101,62,143522,31401,112121
df7927ef54f27856b02ba3a1050df75f,147,112,382760,75852,306908,136,110,356407,107119,249288
382936935f6242e1a27937038ed29c9a,54,47,55596,17258,38338,44,41,47408,18603,28805
23c34e1d40e8840299b48e78eb79e8f7,106,81,220819,50229,170590,95,86,167039,45141,121898
7aae1364a24914cadbfd332e4c9bf3ef,51,35,45779,10855,34924,56,37,43368,11773,31595
7751a5bc1f6d9dfa32a71cf4a10cf64d,24,20,10065,3547,6518,25,18,9630,2949,6681
053bbbbdd8bb99a8a52748c5ef2a536f,145,85,483537,127351,356186,157,100,425441,138592,286849
4a119dd5e3200d65c49923e671087db0,201,139,888767,94054,794713,179,140,591125,89602,501523
2c4f7b0fc4db33068dbf63adfb717b58,165,134,612126,140636,471490,146,109,719012,136638,582374
d16e2ea40804f42857d67a98954aba87,117,99,303863,93700,210163,140,114,354123,78726,275397
bdea3a736f06f1589822c15b77678b5c,38,27,40545,9959,30586,31,26,25011,11135,13876
38188d26adf082ce2bb49d3b6d026d41,42,33,31171,15160,16011,41,37,58462,12796,45666
da89249f37d59420d9cba9cd94159feb,34,27,31247,12376,18871,40,28,38187,14276,23911
b5867963ff95b187b9deab6a470619b9,46,42,55543,16819,38724,54,43,52807,17680,35127
b8819488995ce81a12d0f0d96b4a1be0,38,29,43820,14583,29237,41,31,41728,16266,25462
24b6951d6045f8fba54a5a4f1dc54604,75,61,103555,22506,81049,78,66,121264,23057,98207
82b13ba9841633340f6fee232067e001,64,62,133323,30374,102949,79,68,148157,37724,110433
315bd62f4876d75fa01480c01e461eae,16,11,2056,969,1087,11,5,1955,854,1101
aad71badefc6cbe117633ce2f61e113c,123,105,233371,45612,187759,110,91,195214,55175,140039
78448c675e8e542cb57dfc1559485420,126,82,239673,63463,176210,127,115,294321,62009,232312
1826f30a667677a6edce6608ed06af2e,85,61,167559,36226,131333,110,94,190254,38372,151882
6e25c13d03cae116c0eb0a538c8246f0,150,97,367313,74478,292835,124,98,269877,81561,188316
2e8fd6fd9d4cbf2a2d18b4877bb42f74,105,91,213709,50639,163070,100,73,170650,59484,111166
1fdf4c88c8c956cabed22fee193d5128,125,90,334568,58343,276225,157,135,432473,84343,348130
c60e0fd4f1d90c75a71a6ce923eb4a2f,83,52,116238,41993,74245,103,79,150576,50320,100256
a786cf6ecafd42b59f3b9baf1cfe4dc0,119,86,280174,98790,181384,153,122,442597,97093,345504
ffd4f7bb68f122a3fc2eb3e46d2ae6ea,151,95,396515,94241,302274,144,99,311936,80115,231821
b7452a88c2bd7e86933d0d36872d09b4,126,104,306607,92072,214535,143,124,372672,98930,273742
42c11354f5eb5ce4783873f9979b548c,126,113,432858,94982,337876,137,122,404646,69839,334807
5ac5593afdfb9fa9fec890c9c2f162d0,200,143,782097,149199,632898,174,123,589826,123007,466819
45b9caf2f19b07efcf83679a9a6d1cb6,147,86,329987,100227,229760,124,72,312037,78659,233378
7d4bf9a7cffe6aee041fcd69f19b1d0e,136,112,563141,133863,429278,186,120,680004,104587,575417
ef26783c7313332993e46ab4881de6ca,66,55,99203,43844,55359,72,67,131751,46122,85629
80e16a31da652839444759ad62885229,198,137,1024651,160106,864545,201,150,817916,203933,613983
96ee62cefab107d3083584df786c19e0,159,122,319352,75443,243909,148,113,301036,81019,220017
12c3b42e446da5b535bb8b416b3c241c,222,153,580023,105234,474789,134,102,430572,124701,305871
c729ee0e6d8fe4942e1bc259b8609bc7,157,115,521369,123763,397606,166,109,502937,120284,382653
3c8a995aa9661e35fcb64fec782286e7,39,34,39215,16825,22390,49,41,59862,15031,44831
5bf6f31733f7dc890c5ac7a789a222d4,119,99,470910,76628,394282,161,136,446229,95171,351058
df648c86461975db9eb3899350f06447,51,48,109390,36891,72499,64,45,130352,31078,99274
0db7a937a7c2da2d0e890d7675f73776,56,56,89202,49054,40148,101,79,158264,46414,111850
8dcabfb5e7bc7346368ceae89d4dfcfe,24,16,5403,2324,3079,24,19,6095,3654,2441
17082addbac1c9140ddb674005aa5145,20,12,5360,2175,3185,17,12,4256,2137,2119
2d94773e7ab7e11c715788724783e7b2,69,37,142705,20994,121711,91,54,162220,36239,125981
e8fda648bca443eb6641ff7da4e59e2a,100,82,203447,35222,168225,67,63,104801,32750,72051
516d56cba2b73f63ea85006ed6e11566,124,73,305429,78205,227224,160,136,492316,104445,387871
53044117695a2b5bf8c95c70ed632616,122,92,228452,44413,184039,85,72,116219,56893,59326
6f833e73e10840d2a1ebbbf096c04de0,100,82,180418,30826,149592,104,95,167065,44591,122474
058c2b5e120c47387e5604bfeabc5312,97,90,141732,46247,95485,100,87,187908,37834,150074
33fd8ed4f572dead362d40ad32e62bfc,150,116,420787,82468,338319,190,103,482647,71397,411250
1f9544d5b7deb65f64aa9365e05601a4,152,110,515303,110240,405063,223,155,614743,81913,532830
b14c0db3002d201733555ef9d737b90f,138,103,422825,106218,316607,142,108,384341,75740,308601
621613862c5eb1ba71136b036fe28a56,101,80,308618,76484,232134,150,110,374389,77172,297217
6e3870197250ef4869650eb6839885f5,47,28,45438,11709,33729,42,33,41333,12134,29199
a1302b11c7824a7bc22a4c5533d7e15a,74,49,75569,22712,52857,55,40,59167,29664,29503
ca8c64a2dc40e1d8eb3fc8bbe5840a14,216,140,549298,71892,477406,128,117,384788,90821,293967
5f0fb37a0a96ae9c8ff68f5408123d56,153,131,529523,135493,394030,171,134,491153,120441,370712
811e21105f6c3a155094ecaf5de90fdd,152,120,349482,72216,277266,134,111,356431,76368,280063
6ebc05041699ce07c418625ac345a6ad,115,104,307750,85908,221842,137,107,378426,87121,291305
8b78ac30b4c3491fea7d8af3f263cf82,74,55,127223,25617,101606,84,74,133644,32639,101005
0cb9147480738190e74e6020102336db,124,86,233320,26873,206447,87,62,114748,36744,78004
94cb15613bedcbe6d775e43ad7d8ecc9,157,117,535092,113038,422054,167,121,404406,136540,267866
85141154cfe195bf6db6466a6d03b54a,100,90,207397,51845,155552,87,80,177963,37079,140884
ac3314d9f13a97399d0b04b5d151d0dc,104,90,288865,63836,225029,93,86,165978,80781,85197
b3349fba42dd9d87c357840c41787c1b,131,112,418183,149667,268516,175,131,565153,101291,463862
881b4dc1ba90166ae4daf4771aac7aab,4,0,205,0,205,0,0,0,0,0
3e7f210d5cea4f45b8ce77d29d75769e,208,164,757197,165469,591728,203,127,621386,167624,453762
a723b62898d35ea59bead22a89f0ae7f,37,27,27447,8442,19005,32,25,20715,7259,13456
7640cd83734cc2a04b922bab13f240d5,162,119,641010,122946,518064,157,104,573160,97451,475709
3a2ee9ee0501c301c4a6e5fc9af385e4,44,35,29727,11934,17793,34,29,33903,8978,24925
a1d31e74f798f9001da7078dbe084ac8,28,23,18183,6314,11869,34,34,27950,9534,18416
952a0734fe1dd4c16f7a55492963259e,85,71,120790,27839,92951,75,53,86121,27305,58816
eec315cbab22145bd0db28d177106fae,100,80,258779,63700,195079,118,93,307763,69298,238465
85e359f18a5b103e9693174ccce3f28b,109,84,216746,58058,158688,75,72,169475,46122,123353
a7e7fedf28306b0a3ee56626daf4028e,77,49,99129,20364,78765,91,78,123646,30223,93423
903b55a4f31ea3088d30bcd1d145a63b,159,110,385988,106228,279760,118,85,271388,97184,174204
e0c7de62066b2aafb716f5c9f2f5fe1c,114,71,202811,51302,151509,88,76,167552,70002,97550
ac3aa5dc9377002fd15f03d949662098,121,81,289788,52391,237397,94,63,198153,58024,140129
aa258c492b34d09361d5042593c8e3e7,53,41,43948,12026,31922,35,28,36318,17784,18534
5b0cba9c31eab12c83f337af05d07e84,16,13,3054,1717,1337,20,11,2509,1152,1357
d8b93707187533e43c196097bb75ced3,66,59,83214,23636,59578,71,52,95519,19414,76105
ad177896bfc2417006f364b2173a9988,155,99,446647,101187,345460,113,91,406181,110786,295395
ba01b6fadcd36974baa3dc0aab0c9766,50,24,57455,11508,45947,38,32,43788,18127,25661
424c5a2b61e88992f61ac9fccb8dad5e,35,24,15652,6509,9143,29,22,15369,6231,9138
e3732acc8d1cf43602ad0b635d3bdbec,84,58,103266,23622,79644,57,42,58275,22137,36138
7812952a106811db6586ffd802fab5b4,20,12,3348,1711,1637,15,11,2829,2300,529
447ec9ebf6a46b60ae8bbc2716799e21,115,92,316148,62990,253158,187,126,382380,91104,291276
9ca8f962d721bc416b506719ed991bbf,26,23,31843,9417,22426,34,23,27766,7547,20219
568ac2f79108bfee31e39ecd9e99aeb5,43,28,40510,11623,28887,31,24,21511,9283,12228
c01e80b8d1843ae88e2aaa060fa4ba9e,39,26,34942,17474,17468,33,27,42960,11936,31024
08f7a000bfca0a4ea822bf2b27e95fa6,86,48,122619,25324,97295,101,90,150015,42936,107079
01e623d224ea9da87514e3fc8604c29f,118,89,348059,108354,239705,137,106,474436,71009,403427
1f1a2fb279c11a494f21df1271bf5b4e,143,98,340075,128283,211792,144,84,258724,101951,156773
a799e0d323955c9d3708ec58b0689e7c,95,83,220357,56159,164198,95,75,213664,45894,167770
1dfc82e7f55fbfd8213080080aaea35b,140,109,355911,102224,253687,101,85,276425,62416,214009
810edafb0a965e9ed1f1d907a5a14c7b,175,148,442033,122913,319120,164,123,459975,101886,358089
4ad20fc2d395d8e9611a5df95cce4e00,82,78,198422,54403,144019,83,71,162324,51407,110917
8876fd8e509bb35317ae7bd5fc7dd72f,10,11,1268,982,286,12,6,1710,460,1250
350c2e8faa71df47b3dcaf1c518623a0,129,91,311059,76349,234710,116,96,278220,88009,190211
60a5ca6fe833735fbe637cd7393dd278,135,101,237057,71151,165906,97,80,158670,58728,99942
408c9d622c61f4eec826f5603f624bef,43,30,60543,12463,48080,25,19,18417,11332,7085
1d38061b82af4ae434de5def8cccc039,160,122,388271,90062,298209,139,120,333553,112959,220594
7e348745c192a7d100a3176f0fe981a2,45,37,51263,19268,31995,52,47,72058,20744,51314
5c0cfe6bb066743747acb28f019ab58a,6,6,501,517,-16,8,5,664,413,251
9eb5576c784ba70f87b81b2765698fae,20,20,12288,7304,4984,26,18,14308,7246,7062
4de806cec8fdc80dac6cb333523e564b,32,27,42119,11195,30924,38,30,40310,16833,23477
1b073310cdc59f42eec8db2b338d7186,98,59,114746,29639,85107,108,74,181545,23629,157916
bf5abbda5ace2f01be0ee8661155b71c,94,74,171154,43369,127785,98,69,179735,55170,124565
22cec8fc93f29d20c026cf00b6dd4fd3,34,26,23957,7552,16405,31,30,20949,10449,10500
6b1bf2a474c9c161d3591c74bc7d5c0a,199,159,994460,174066,820394,186,152,962019,216252,745767
fb3497a5ed14273dc80cb613580a8544,25,23,11806,3903,7903,28,19,8141,4203,3938
f82f72be6767e7e22a9dc85c62fda798,115,85,220107,28882,191225,98,83,146037,52096,93941
4a205ee2e15a9d3bde7ded421cfa911a,65,57,103796,44825,58971,71,59,120157,33954,86203
0c832562729ea0e97c158bef5632288a,69,52,108836,37279,71557,95,80,182574,46818,135756
e411b917124308d1f717dcb018199e95,82,75,103934,27701,76233,63,54,84971,26720,58251
20b133f06ee66b424e05845e4b0d9c5c,91,62,175329,40204,135125,104,93,197561,45548,152013
3a52bb75ad36c11e1e727e24dec61d7a,93,67,194055,61526,132529,109,77,199102,61433,137669
03e47ead9330bbd684c3254ebd68e024,21,19,6274,3716,2558,20,18,6515,3408,3107
5e9601f79034e15b072c4df438a61f1c,120,90,297969,82257,215712,130,97,269402,102685,166717
f60e6f7c4d904f4f8e89c0c397087a6f,20,14,4550,2837,1713,23,19,5753,2657,3096
e2c3520735a2c9321d33729ed2b9cf47,43,41,30585,13853,16732,40,29,32069,11911,20158
748cc6658420b143bd28577e73ed88d3,77,47,82454,24329,58125,82,64,116241,25898,90343
6931bc6d06e52b08f98c05935d95c6e6,75,60,157036,96375,60661,152,117,324418,93955,230463
7900752302315b25b627cd726c4eccb9,61,50,78398,20740,57658,65,46,68341,25825,42516
7e4768242a38c60aafe531f3cf541153,21,20,6471,3028,3443,21,17,7542,3666,3876
fff6f197c92f013bb5078115ddf7fde4,67,43,146600,48596,98004,101,69,198252,45740,152512
24f143fa25a43e78f5787b90bbc655b8,105,84,253751,81545,172206,189,109,381740,63057,318683
6e0034f2eb124e53eba786e8c6b9981e,83,76,232388,48922,183466,117,100,257791,45593,212198
ee1b1132d8fadb6e922e79eeb009df4e,165,114,425628,68595,357033,157,135,377059,84575,292484
63a361bc0de75301587ec16f4b8eac81,62,50,82302,23324,58978,48,46,50023,19785,30238
5abf0b1081ba9b9f2736aff84ced39eb,73,40,114519,20715,93804,60,45,57441,21753,35688
0d63c7fafca22db7f626815815593991,102,90,185565,34041,151524,95,74,161397,39025,122372
dca1da1bf98168857edf5d9c38d2a9b7,181,122,451343,57701,393642,138,107,309984,88359,221625
6ae1fc73d0a6505fd9d7c501437adbbc,77,65,126064,41562,84502,106,94,196318,41247,155071
95e0f482d2bcf91671887664e46051a7,0,0,0,0,0,0,0,0,0,0
b2cfa6fdd7b26cd3c99610f8ca05bc0c,44,36,36769,13721,23048,44,29,36320,10045,26275
20bef15d5fad232050e13ada9a844736,50,46,54395,15761,38634,63,35,87822,14925,72897
c3d815e52131df839e90868abed3c4f9,126,102,399947,102740,297207,145,101,455760,63156,392604
f86610b14466bac04b73aeec5ca770aa,216,140,847035,137622,709413,223,153,732161,119387,612774
7078754061efd6fe6298749eec31f771,199,135,616458,104377,512081,149,112,505362,104678,400684
c9ba86abdb07f5fb006042a499919c2a,44,30,40003,15382,24621,50,42,49199,15683,33516
3232e6541b0d203786b01f0bbdae3637,51,58,44477,18143,26334,49,35,45676,11362,34314
f7ee0feb15f449ccaf2ad819720fdbe3,36,28,29225,13382,15843,32,30,30242,14336,15906
485cd709fd64c3325e3dfcf835b9db23,25,19,6923,4448,2475,27,21,7671,4372,3299
00286e08e2575779a46c8478699a240c,144,99,475795,74775,401020,199,146,540791,82791,458000
c397dc5304a9e62f64a50011c7d0db1b,30,23,27507,14499,13008,33,24,34669,10124,24545
05c6e1c88e6123b7e6fc5802d0ba132c,13,17,2326,2137,189,19,8,3039,928,2111
4047b408d4994ad174994cec75ab0846,94,81,110220,29952,80268,76,61,101516,26347,75169
eff153e9be087bf95e167258ca05528b,111,85,188742,45583,143159,113,78,231491,36436,195055
608b9a0c208eff1f7c2dc82bd0e944e9,70,53,87653,23536,64117,66,56,78402,26482,51920
bb84f8923521471e78b4a866c7b4fd3a,68,48,90293,14694,75599,45,38,59157,14828,44329
9540b115e0c8bf4f7bb74c9780e609df,162,131,559234,119978,439256,209,159,652600,121578,531022
8e50fbc9f99c7560f46a0084268a2491,156,117,445586,61521,384065,137,115,333011,66196,266815
bc96f79e4f63882c9c151dfff57d4a0f,120,83,215388,40561,174827,131,102,257021,50034,206987
95b1d8279bcfac4b8257ec5f2bf336e5,107,86,278427,90387,188040,105,66,234409,83394,151015
01cce240a2b6967191867e0c7dd14d8d,19,17,9713,3345,6368,23,22,9472,4759,4713
bfdc4a98c8aa3a71131daa777cdef3c1,88,63,171368,59452,111916,92,72,212709,50101,162608
3fd754712f72838a391dc3ae400f1623,56,43,67138,36897,30241,57,50,89663,20922,68741
5266dafb25988fd62fe8fd63181be5b1,153,130,549291,74234,475057,150,113,350039,62118,287921
f0535c94875a4fe2c0fd446d506fc464,31,27,22760,7530,15230,38,28,20455,7591,12864
1687f97f09a5cca26dca3f28779ca7f0,28,24,19540,7576,11964,26,17,22180,7007,15173
b50de387d5e4d76b926df116f9f28327,61,52,79368,29092,50276,73,53,82056,28156,53900
8e1750435c9d7324df28abfbf566739c,189,113,856884,154212,702672,146,130,722657,178158,544499
d9621c05a002a246aba30f59acff08ef,181,135,405005,66098,338907,122,93,324243,69882,254361
d5a2a8e0528e54b3f1d90f5768fcebd2,45,40,44845,20124,24721,68,50,106180,18921,87259
dffeb98deb9550313f617d0afc953338,106,90,298268,92304,205964,163,131,438211,82886,355325
6cbb6e8f2aec516e3859e5a423fa5fab,60,54,62181,28813,33368,90,70,129101,31757,97344
82d1c00fdfc45c97791a6f16a5920e29,108,92,306772,69314,237458,129,108,273512,64357,209155
44a294f615c5d0d2ca4504a5f4e07b77,31,23,14597,5287,9310,33,26,15494,6531,8963
ad4032bc272ec196d86d39177efd756a,47,37,41318,19340,21978,43,36,59111,16516,42595
922fe84f0bd04f1f5eb8d4788939dd3e,41,34,18440,8467,9973,36,30,17462,7550,9912
4484bcd54012745fd7549f2def56e950,4,2,529,321,208,2,4,321,529,-208
3c76ed271422bf04ecb291b8801c2bfc,108,74,245560,55284,190276,115,80,256363,70809,185554
22b931972585959733889e98c9a93f6b,102,85,161348,28199,133149,89,69,161940,25457,136483
d1ce41539f5f745aa5f4d56db69df7da,56,50,126729,29550,97179,43,36,60395,30611,29784
d100f95a1f40260104ba214679a6fd47,193,119,492848,115297,377551,152,108,393054,93637,299417
0d69127d3e517ddee0790a821ab424e1,62,45,83420,24397,59023,65,54,81579,25471,56108
60c4f4b828eee8285a3801e2703133f7,84,55,116209,33062,83147,77,52,126397,34906,91491
d7f990636b3c846aa992efed396a62a7,135,111,383869,91082,292787,133,85,350266,71379,278887
fe16f684f94d9cee3420f34b4144c9af,107,89,291788,79776,212012,140,95,282899,77800,205099
b1ad2a5839f01971611b5aaabf6c60ae,103,91,242820,66318,176502,90,72,228986,55385,173601
9be74c471d9dc648af395ca72cefc00b,31,24,17019,6289,10730,33,22,23331,6555,16776
7189036084689fbb8fd20191d1ad34e6,35,32,29915,12563,17352,46,27,34753,11167,23586
acdcfd390caeb7d54b6f79462b57f040,34,27,33187,11870,21317,36,25,25714,13197,12517
ec503c6265c1d18287dcb61b97e803a2,51,42,74691,29024,45667,68,58,101827,35599,66228
1c6a4a46f33e627607526e1c04ede055,30,21,18111,6082,12029,37,27,34721,7757,26964
13a9ffbc4f0c2b4357995b380a113497,137,99,377352,104411,272941,136,109,345728,145006,200722
815f1d619aa2b3eb9af6db23a4931561,65,47,98864,50201,48663,96,74,181667,42920,138747
3e0a6e3c326e51cb28f1e40d9a45454e,108,69,231610,47309,184301,100,75,213135,43271,169864
ec8b3e25c25c223f460b3b0f7fe36d26,71,47,87162,17958,69204,48,33,55412,22155,33257
7f08f02c2ce3cee91b7c876650c8ec5f,107,84,286036,61640,224396,94,85,191159,67161,123998
9e9e217ff1dc11c5a565187f9f20ec8d,71,70,163905,38541,125364,58,45,79777,30181,49596
71aa99608372cc0980ec859adbd0018b,123,111,246079,55516,190563,143,114,277545,54577,222968
b6cd536574cde701099b51702390ea0f,139,106,306034,54991,251043,146,119,296033,73569,222464
56de2f3a967fecccd3c88bbd29d9bd8f,128,103,221491,36584,184907,131,102,249786,48081,201705
561a8abbb4e8b37b90ac7d5ef1267842,6,4,559,332,227,6,10,3358,805,2553
a24a580c509e53d39501a30792dfc005,73,49,136381,36207,100174,90,83,191056,38412,152644
00b845f066750a390c6046ea1c3739bd,135,77,281314,57271,224043,156,124,412969,95317,317652
c62e62e972d9ed6bcdc98b46595ef50e,25,20,10450,7039,3411,31,17,17602,4292,13310
7e9b1a8e03a53f7541aa3ee5eff1da47,110,95,224603,70311,154292,94,86,192054,48962,143092
94cb806c062078d192508adefb6b0b2e,165,140,507532,112583,394949,136,109,427102,79694,347408
8ffd58c750c618548ee405c88c7adb1d,11,12,2943,1172,1771,14,14,3262,1449,1813
f40f2a54183c1084ca6751833d45ea3b,222,151,890788,199915,690873,196,166,1264863,260287,1004576
a7faff6de33917b0e53d87acb2222dfa,32,31,37280,19139,18141,43,39,50997,14775,36222
b1a4c61cb200720b61cae1a7aaecfae1,124,84,316174,85422,230752,140,110,390354,80485,309869
908fc63cfe1bde9b7b0df42137bbf565,158,113,333021,49185,283836,120,101,291451,84941,206510
bd0c14552315bcea7a7dc218d407e1e8,151,120,591030,184491,406539,179,109,660463,132561,527902
3d1c056bb1f130173931c047a074ae71,135,97,301008,68498,232510,138,115,339962,74929,265033
34bed6f6044b3a87a99dff223db3346a,168,136,524743,99436,425307,122,82,335093,75033,260060
30fd96589529881388aa1e6c2c3c6db1,29,19,14640,4477,10163,27,15,10913,4555,6358
8af88f270b117834da00851dca383373,140,130,538063,165527,372536,166,131,506702,169665,337037
7fb3b0d5cda46e55d02c7de9f98fcd78,100,84,212546,64755,147791,157,140,419698,78113,341585
b69e1ad51f2e1b4e58136b727b148d62,142,121,461987,143974,318013,179,137,678924,113360,565564
88a3d4c7e625c06cbb8ed1adb495714b,47,36,58455,12566,45889,64,48,63512,16930,46582
ed1ac680c8fa20c77a203844f9ae23da,76,64,139605,42832,96773,102,81,140425,47857,92568
a469c88dca768edec902eafc7b09cb83,28,24,18226,8758,9468,32,28,21713,11001,10712
643f12e45866637bf558b5266e1432cb,63,54,97543,22810,74733,64,59,51636,23497,28139
5fecf94ff1e2fc4268d09f889c0a0d0d,45,38,56794,26470,30324,70,56,120952,24225,96727
29edcd4781e14ed4c2a33997ed319e52,108,90,260431,44629,215802,134,102,333598,60901,272697
0c39b70529954c10f92be54b756d5f18,144,103,418411,79302,339109,118,97,309662,90025,219637
9ecf4f796a68e94d4735d789e435da13,61,44,73005,17759,55246,77,54,94627,21750,72877
20cac67fe06a341eb597729950606dd1,59,42,73777,16918,56859,78,54,106514,14015,92499
a206e581b2855a29acc490298d1ba06a,202,135,1074447,163569,910878,207,142,1362290,217350,1144940
08d70102a32b879d6a2c5d229a5a6b1b,216,131,592090,89538,502552,192,131,676851,85905,590946
b426dc4a5bcf2b2a2f13fa5de65d4428,11,7,1244,404,840,12,8,1792,312,1480
bf54a9f14a3cd67bc894aa0b26eec620,121,68,222931,49469,173462,103,79,191881,68198,123683
07ba44d2487a8e8cacf81da71216f422,45,29,55684,13395,42289,40,31,44553,18622,25931
89e2374a170a9e79cf099d8a1ce5a16d,71,45,81389,23508,57881,98,82,119976,27453,92523
2c18aa48409e75984884f5ed31f28f49,25,20,19467,8469,10998,34,31,29605,8706,20899
a143d626490aff9b3c19ff8eb6955d17,15,14,4341,2014,2327,21,13,3772,1946,1826
32ee59c2c385cc6eecd57e50af40d222,26,21,15932,5221,10711,36,26,22402,6344,16058
f1c74a361a59baf2c32a4ef793ce983e,79,63,195386,50767,144619,73,62,139458,57416,82042
7a2974863fd26961564b2560198c37ea,157,126,369434,93975,275459,158,123,417390,66223,351167
6f47d0ebde42d7cc7db0f199a2d0ba1f,120,90,197786,69791,127995,119,107,234945,91360,143585
8822d07a3e3b82fbebbd26b387b8da29,153,103,271923,64484,207439,140,94,347147,72364,274783
6a870cc03fa7676932aaabd8cac13799,113,87,318543,111999,206544,139,123,413983,100780,313203
c41ebb08f861fb55ee51565128dc7dac,125,98,335803,53728,282075,137,105,309485,54255,255230
742118b623beb9ad18d81b3bac5d0fd8,79,55,96741,25612,71129,95,65,148957,20007,128950
035ed768b82f8de2b4816db2f2bd1e73,63,49,92683,22065,70618,55,35,62715,20402,42313
9c0c8e32ed42f533664baf0b9b556341,111,86,223261,75937,147324,119,92,271299,71510,199789
af04a04998c9774c10c486b9f523bac0,133,107,408652,92363,316289,192,119,479685,110599,369086
68c9433cb6e937d1f75db50489b606f6,96,80,251023,59518,191505,123,85,233559,59861,173698
64993b73ec3d88628c0c99f624b7c2df,65,61,94966,24283,70683,78,64,77656,34956,42700
a4ce05809c94db0eb5a3264e7ddb6574,112,76,215829,43823,172006,93,86,142488,41791,100697
9d42e796f621387e942be126dcf49f50,28,22,17624,9001,8623,28,22,19484,7082,12402
36d38c2e0aaad73229aa47c7d5debb22,172,142,788144,139276,648868,150,123,561871,156125,405746
675b77ac18034d5cafe88492c9131281,145,114,291850,82958,208892,102,79,209614,88251,121363
135dbe3484d23e03d601f9a37ca0b9bc,30,28,21228,5518,15710,30,27,10990,7246,3744
18af616191574814a5884dfbaac77c94,22,25,12525,8052,4473,24,21,14308,7351,6957
a16558d87d76fb346e8f4b703bf864f2,83,49,112253,26368,85885,72,58,87746,32204,55542
ef63e963ae32917d242d9dc9c630e4dc,40,28,72197,13163,59034,29,29,26560,20978,5582
4c58776896a04e9e7cea3a2a0f9c9694,104,72,169919,50618,119301,110,72,253051,51994,201057
06d3984d70dc514f20d5a8c478ad8f10,44,42,45077,31067,14010,68,44,86848,30678,56170
b77ccce62d2a42998cc17a1ed2c0418f,73,53,107432,30773,76659,78,67,105121,44857,60264
4753fc2aebe39c0c90c4f1d243013e37,101,83,295378,94251,201127,117,102,377983,86648,291335
f947660380bfec0c127aa87439df7ddc,142,101,525385,86218,439167,194,150,626659,120457,506202
e0936873bf34bc7c5ca0108b8db374de,149,102,515089,74973,440116,180,139,599323,115620,483703
4d4171942bab16e0a2d09e2c9b7566b0,70,48,106722,58949,47773,85,68,174930,56595,118335
c752e54f83958e362e305d0d75a3ed08,136,115,411160,111220,299940,116,88,381698,121966,259732
e7dc33e893d366325b497d0b57c1d413,28,22,13289,6471,6818,26,26,18615,7036,11579
2eee69e4e3ec9b2aa5e25a81d03f566b,193,157,732872,139972,592900,181,158,700980,145969,555011
6748a53729e50c89057887999542f24f,54,42,70385,23519,46866,53,42,62097,25169,36928
eee17f29400c00e01f58a3837eb15c84,60,46,107250,21485,85765,53,42,55377,19992,35385
0b49f805365e6204997805e8e49a2960,64,57,81230,29115,52115,83,69,129279,32109,97170
c98f06ed766f5211b3d051602991c5c4,215,142,1149440,224060,925380,158,144,1116422,243645,872777
7e5d304b1565ed1c32df7620830a351e,148,64,215884,38019,177865,89,72,116168,50952,65216
cf1e0a98f7356ec2dfb7b35e4dd86bed,136,103,429526,140344,289182,159,128,455735,145803,309932
b65246dbf3a6ab715bce57e1c2b370a5,45,36,47734,11610,36124,42,30,26343,8629,17714
a1990a3abe5b2d786e7aaae3cb78c7ea,32,24,37145,9438,27707,34,21,29756,11069,18687
48221ea6ccd76c5cb36f0dea0b891ddc,5,3,335,389,-54,4,6,421,367,54
30cc610fa62305b1df9085435861c05e,160,94,508741,129122,379619,165,130,615225,124341,490884
96220d6fa55ba1ec64113dc5bb11fbad,122,103,244418,35794,208624,93,70,182966,44928,138038
5ef9aea281d6601433946ff275dfc92d,128,92,255609,69347,186262,147,110,425060,62661,362399
e1ba14b286a667cef25485a41e20c3a2,86,72,148877,33987,114890,89,67,130884,29554,101330
4a48b300de6df7fd5f82ef54b601eade,3,2,142,310,-168,2,3,310,142,168
dd703c50ce8d0b73111192ba4752dd62,83,70,168367,51255,117112,67,55,104216,44269,59947
f48f9daccaba23738bbac0e9307adf01,74,40,82724,15734,66990,63,34,67994,14118,53876
b6d283ecddd4f783a9b81d4569e98700,43,43,73220,25836,47384,42,36,74098,22886,51212
28bc590d4599e25dceac33bec5a83fc2,180,134,719673,110502,609171,166,132,527697,123567,404130
ad446daed34ce944efb59ac103fba9ab,1,3,300,443,-143,2,0,143,0,143
0c0983f0aecea3bb3e368fba631246fe,126,104,400740,141160,259580,183,146,571818,125587,446231
d8cd9943da364e78d4aaf7f2a1590511,87,81,172437,34225,138212,86,76,137720,33870,103850
1d8baf5b6af8fb8a6ac933fb56a56e86,20,19,5375,2308,3067,19,16,4338,2315,2023
4651ea5e39a8454d56360f4c6c269b18,28,18,18767,6060,12707,28,21,14515,9219,5296
cc492edbb84dde5184fd6def752e0070,23,23,4971,2438,2533,25,23,5599,4086,1513
1ac1e172db3fe210ae9b39d13cf875ff,69,54,100618,28609,72009,67,63,100551,36069,64482
36f2857b922fbaecd00f0e1fa12498aa,70,66,143346,55523,87823,81,73,160619,45324,115295
1763c6ea8c3d4f1b7974244eb7e024bd,46,48,43800,15722,28078,41,30,38482,15662,22820
402fca3a3d6f6565f136af76069e225c,201,142,672000,151816,520184,181,132,848792,149283,699509
71364e7f7b94940b6ef0143cf2faded9,85,70,166620,46505,120115,80,69,171788,45664,126124
2e686433cdf548cea144da2e52360895,72,61,107952,25677,82275,90,53,151698,22993,128705
b8e68fc94e196cd1f971f8872dcbb0ed,115,85,236070,64953,171117,143,90,336573,51703,284870
e1ec0b24d07ae207af3612346e6f8c88,134,105,377771,69990,307781,150,105,308879,65084,243795
dcdf181aada108da0e36afc15ab04d05,122,103,263445,65462,197983,123,95,201806,64329,137477
0e61b93914074f6f5d6324d2e618e4c6,69,41,82417,19124,63293,59,34,64517,14992,49525
82cedd8f8890d4c4436cce1506fa075d,193,136,959417,195834,763583,199,152,901484,227968,673516
f560d7515c589bcec8f23b488c5d51a0,152,113,379754,108510,271244,120,86,368029,71731,296298
92343f40facac35b50f5f9429fa9dfd3,92,82,170685,39783,130902,99,82,188771,39056,149715
d7abf3907bb25c51f185389a8f0f495b,28,21,20536,7342,13194,31,21,27225,7643,19582
d322c5625e151ab702c3de0a5c7ebb65,118,84,250126,61607,188519,137,84,295878,41386,254492
33a37dac55c14a81ac7614190e31161e,161,131,538451,97027,441424,165,109,588006,95224,492782
a72c67c0f23bde57fe313ffe8fe04633,46,34,36787,8800,27987,43,37,41762,8483,33279
d5e8e11cb7964ce4246a29a1ba9bfb6d,126,102,318660,62877,255783,128,99,263501,70907,192594
dbc39c6f85ddb5fa035f5669c6a7c03b,32,21,23339,7209,16130,32,24,22177,8678,13499
0e4d4206e6a1078d636994662ff6112a,9,7,1696,993,703,11,12,1295,1476,-181
969782fffff8defa684ecc76bca3d0a1,25,19,7363,4731,2632,23,23,8484,3729,4755
8330d5f7f3bc0dd7041e6ca70e2dfc6c,26,21,10505,3668,6837,23,17,9946,3368,6578
ac3c50ae700cbd0ae18889b1ed6785b6,55,44,53419,18842,34577,58,39,66509,17207,49302
26cea31a4f11eee841f81c5f2a8d08f4,189,135,482336,91325,391011,136,101,390617,84296,306321
52e6fceac0187872532709eaa5568cb8,64,50,77381,25996,51385,62,51,81607,26122,55485
2fc2b1241918b5898445d5b479e627da,79,62,125594,36542,89052,79,71,107363,47276,60087
43cf4d10abb423a812f40ef6ffcf49e3,63,52,60375,21971,38404,67,39,110762,15456,95306
43a0cd9af6a6c7f03e5f24a90e5fba45,128,98,294956,88080,206876,139,116,385812,87773,298039
157ed9d0c18276dad168667f12bc5a18,35,26,34909,12074,22835,47,30,39377,12501,26876
8b5b3bc2af7f37e54ebe73db5bbab458,26,16,6199,3253,2946,20,15,4248,2319,1929
4cd2470b149f64eef1913b9dc9e48e17,100,72,216173,44431,171742,132,86,331397,45518,285879
64f2779fe1e02727829f8969184898ab,46,30,39499,11248,28251,37,33,29313,13465,15848
9857ace0558215230038ecc76cedaaa1,165,142,777714,149376,628338,172,111,454812,134894,319918
43eb4e939b35f971a9aebb3ab0ed403e,5,5,834,455,379,4,4,380,759,-379
a1955c1f61fd52fd7e2891d82c501535,48,33,41034,11139,29895,57,49,54926,15295,39631
83f9be84ec73bcd516d5df98dd37797a,218,141,812519,165934,646585,213,144,1128836,199784,929052
2d769bf07c1e21581a989bcb5aeb42f8,20,17,4222,3402,820,20,18,5325,1722,3603
487b87441d8e1f4e57796cd49013123b,57,44,88642,37462,51180,67,46,105552,34676,70876
a829fab48ac79ff3c25f8e6494a1feb9,141,115,444917,84879,360038,131,107,358185,80434,277751
013e716b1e3898c9e1bf06e967d088d2,150,123,442738,97556,345182,132,101,449400,83109,366291
5eaaa2bb322fe52ee929d87383d9e73d,109,95,183098,42604,140494,81,65,128143,38938,89205
a1a2bdd0a6720ea89e471e8ae7de3a7d,19,16,9219,4131,5088,22,16,12203,3206,8997
439355edeea0ed43b86dffbd3f5fb51b,105,66,349421,82463,266958,128,74,281372,79404,201968
d893408ef394d10f1d2fb0979b529022,50,39,46008,20536,25472,54,33,67859,20061,47798
f38f175dc078daf460cca8ec100906ca,30,18,30723,8560,22163,30,24,19095,12571,6524
56a3ef35fc43f3ab650420ab83a5ef59,36,29,30108,9920,20188,35,24,28557,10173,18384
5b67769a2e0eb02849fe11e55b0c9cae,116,94,230307,40729,189578,91,80,142847,41350,101497
c99d10fcf20ccdc99e619d829e51938b,146,123,491740,123330,368410,130,105,520448,88457,431991
611422c99e75d250ba446d4230bc9349,173,139,705302,96236,609066,136,107,468144,105196,362948
eaa62699b1ec16c461a974f0bd22a7bb,35,27,45645,13538,32107,39,26,36971,14894,22077
b5bc48749599b0757e8ecf08c558e442,130,86,348756,81959,266797,106,90,297790,92023,205767
759b11f22d6208f62a094911d73ed463,59,42,73592,39738,33854,90,67,142673,36877,105796
3a70d1f4a518099d097a550d66781bb7,107,86,163911,38111,125800,88,70,132629,35262,97367
f8efe430091fe9f0568c94222abe7878,60,46,67744,19406,48338,51,38,61405,21594,39811
d428994665fbfd7f3e8efad7468b4f00,83,76,126353,36495,89858,123,76,165933,27017,138916
d9466134bb4d56d5de46f95e41c4dcc8,192,135,760792,118899,641893,168,125,494299,111914,382385
a1df5a9719cb1580dfd21741ee98e706,116,95,222189,43458,178731,77,50,117205,47165,70040
8226dc431cee8ea06eea0a780be55ae3,11,5,1714,646,1068,11,9,927,1301,-374
04608c380a15644584755bed5327f6b1,192,129,836716,171582,665134,220,148,1004159,118214,885945
1799c9542ecbe2ce1eb466cc17b6f6c6,26,23,30036,7398,22638,31,21,20569,10012,10557
960cf7014b506c168e8898e52ed7ad6c,40,31,74787,14036,60751,72,47,79658,25870,53788
1f5cc74dea03480034cc59f66a6a434f,132,106,251997,52176,199821,121,103,252064,63744,188320
f2b254847c14358f78e09cad550dd49d,14,8,1268,665,603,14,9,1452,685,767
eaab613e5b1e2287721e049fe4180b93,13,10,4931,1695,3236,20,8,6509,1144,5365
91a60b4414c9669efc5486c597ef4f7e,27,25,15328,4333,10995,20,14,6932,2035,4897
e9e48ebc05511c172551c576b531e701,91,66,186063,59301,126762,147,122,269204,58369,210835
5489d640c87b5c6117042429fe9a4c3b,159,118,551166,132520,418646,142,118,474096,151992,322104
1954a8a467a085da8e437c1746a8165a,44,27,33798,9240,24558,39,27,26020,12537,13483
9d57055e53f9710635f25f975a230a1c,33,20,14799,6178,8621,35,25,27268,6800,20468
ece6bba998b87a734e78ee51a8151792,159,114,357468,60658,296810,93,70,201759,72436,129323
1ec75d2de0bb198ae89b0ef7b28a0e23,114,103,233588,39666,193922,108,86,201086,49232,151854
67290cdde1dc87a15f6499a029f63d4a,29,26,10662,8601,2061,29,27,17612,7091,10521
3ab6e928b2910f45638da81de386e3b3,84,54,90958,23416,67542,75,57,88137,30202,57935
9200dd2e00a922ae5e31148972a829a0,154,119,396094,60321,335773,126,101,298317,69746,228571
1b64f660d0cd708e667d74d17b9d8bfa,82,60,91288,30882,60406,67,48,82900,22773,60127
de099a1f6244331d6b278253ba6477eb,128,96,297958,39126,258832,108,100,267805,61496,206309
be7d4589d9b00a5fb0c778ec7993d347,39,35,32200,21246,10954,43,30,54985,19549,35436
ed8a8f65c9e5cbdb528476bfd3d0305f,68,55,113150,34808,78342,57,39,83367,24905,58462
ff4b2f2edc22b8916ab96936e85a9a5f,156,107,531195,105409,425786,167,121,643208,101158,542050
1c9bb942bbdc21a17ed0c37e66b88927,189,131,579418,88888,490530,141,106,372967,95249,277718
47c3499ae80addb67d1be87d8340f076,11,9,1667,885,782,8,7,1037,751,286
3430c89b8c670761db5f57c8fce70037,201,154,1041658,115965,925693,208,148,788442,120929,667513
6735556b9fb1a266d91a6c850d465cc8,46,43,43893,20184,23709,46,42,47920,19605,28315
4b65df619f5aa9255c796d8399586d7b,58,45,61942,26601,35341,50,40,71631,29167,42464
2e1d6e86a1c1708b9fcb456d2dcf95ce,106,68,189351,31504,157847,70,54,113031,33219,79812
55d706a39b00ebc2cddff575b1abe11d,190,112,584863,108078,476785,212,147,622780,117851,504929
177201c9ae355a714271bba435e35251,92,73,167013,37222,129791,74,51,95331,34962,60369
216b48e9c00a22d6cbcde56b4d74a5a0,43,33,31162,9952,21210,40,28,33052,10060,22992
81a9ac3be565121d14e80e6edba7c7b2,168,125,404844,58533,346311,147,111,430230,65562,364668
22a82dbe8468ed515b1a77f6d77781f9,39,33,38771,16364,22407,66,57,81706,19631,62075
121b18720f518ab0095fc902aecebc18,45,28,46777,11373,35404,61,53,61809,18114,43695
105335e2a44b576fdf22713b412ddd34,213,145,577022,110345,466677,189,125,537346,118158,419188
02626d24bf7f81197e0c99376c8d7807,33,31,20277,9609,10668,26,24,21321,6777,14544
f7117c17889dc51cd513fbe70929b608,150,116,383687,96752,286935,134,95,370124,80393,289731
1d7c88301e00b36ce190383e16aea9f4,215,134,649653,100153,549500,165,123,550341,150082,400259
9ca7df74edfbd31df8ee73bb96899f44,78,67,126884,43651,83233,63,56,95333,45018,50315
942822795a61768f3e9a3bbc5beaa233,23,19,11553,5042,6511,22,17,10075,3674,6401
58e10c3db48471b6cf780d5eac7b34bb,30,24,17685,8238,9447,28,20,21659,5741,15918
46dfe3f40363571954d74c4dfe437569,25,20,7513,4004,3509,23,20,7769,2839,4930
ca375d292781ccb9b24611879bbbefe5,103,89,249753,65676,184077,136,110,405412,50511,354901
c26ddd5f4634df5051db1cc87aadbb7a,38,30,29643,7857,21786,29,33,27701,9937,17764
9616f031645c607e725b4f4710e39803,137,105,315310,82947,232363,140,112,467746,62973,404773
6c64917a9f102642360ab6203bdff674,153,116,374296,61199,313097,139,102,300239,57862,242377
956359bfafd40de79b16fe49aab8444c,127,103,229273,44146,185127,127,109,274804,52815,221989
15cc4a1580629462885b0f2192d6c4fd,167,125,486092,72713,413379,186,147,591193,105716,485477
00e46b48be1aaf49870b7c7a3a644cf5,136,85,494512,105872,388640,119,85,304195,137183,167012
c3d15f5307935a951c80592ddac00796,21,24,10363,4994,5369,23,18,9053,3727,5326
1b0e0db2554e34249d2c8cc035a77255,72,39,60336,22286,38050,79,58,100609,25746,74863
233dd25d506d1203a5191a5834920041,102,87,174310,36609,137701,102,87,147596,47023,100573
ddcc58b502a8d9be13eaff2473f63e09,52,40,46310,14407,31903,39,27,34619,9015,25604
3461a855e064f2ab7ee5e02721be5050,79,65,86211,19698,66513,72,60,76699,17632,59067
43f95d859f77c8ee5da703797762438f,40,24,28417,11717,16700,37,25,35498,10013,25485
9c884467b3bb3b97608f3142a6735e14,79,68,118900,30086,88814,76,71,115694,42884,72810
5a25184fa5698f2154e50509f1fd5243,144,122,336750,80060,256690,112,98,301757,47063,254694
41a0dbc1714f00a76cb7e62ae79a33a8,155,97,987903,129746,858157,183,147,637995,182915,455080
a66bb29d8b3436c2e73357e24ae9df06,95,76,270041,74104,195937,152,121,388170,82794,305376
9dfaaec983850a6ba2050f08c6f5aae5,40,37,33878,10850,23028,45,34,31384,8679,22705
1435a8c39937ce3574055ebe122caa46,77,62,146792,32461,114331,95,88,117852,46338,71514
bb0a606a8f8fe6481abf567191bc3148,46,34,52307,13092,39215,56,37,69160,15523,53637
5da87e8dcf4a30f3a828b76993df65c3,173,121,483007,97224,385783,164,117,460147,139758,320389
15ea9b503d4eef5d3082c86f95df1a37,75,52,81937,39765,42172,97,75,147721,29756,117965
6c0f87ff4e80088ba0cdbb3018458983,31,23,30042,10831,19211,29,24,19998,10663,9335
75f757d9f858621d48467521d90218fe,24,27,14339,6040,8299,28,24,10091,5949,4142
866c7420fbed1d1da83563356437dad8,92,68,157368,49128,108240,86,62,156941,47376,109565
35b18034121abac225d65c64dae84954,116,90,242929,80196,162733,124,102,324413,84698,239715
2c394418d535124881cb2021614fa811,104,94,299534,66713,232821,123,104,283526,61148,222378
3c78f35fe03350b2df5035111e8940ad,22,19,6010,3295,2715,25,16,8347,2445,5902
59f24c1eb790256c084877d8bde8a0bb,132,94,425384,83105,342279,154,127,411510,104377,307133
bebf02500e98665e6f285865bfd2f8ff,75,64,198680,39948,158732,93,79,127684,50143,77541
17e4f9e3ddfebbdfa6540e154542dec1,167,135,747967,168680,579287,196,137,663645,163659,499986
b86be3dcbdc89eadf46b7f27a67e087c,44,32,71562,19266,52296,54,39,89483,16779,72704
fb7ff9514eae3917c2cc22ce8b1066bc,33,31,25532,10042,15490,35,22,27424,9107,18317
7b58e1951740c9b949ec0fabbebb26e2,112,77,203050,39806,163244,66,59,111595,53840,57755
222ffd6e2b915a5414e9221421ea47a1,78,68,149428,36485,112943,86,58,119993,32550,87443
958ad638f11d3c085bf31fd8767057e1,148,119,413474,125421,288053,135,111,488897,101966,386931
b52f78debb0cada13b97d0ac8e5385b8,77,77,145957,59833,86124,146,98,284295,70266,214029
291f5290b6104e0ed4267c4c893a12fd,44,33,39387,14165,25222,42,30,32477,15582,16895
3765c412dabd76c677064d9bc4782700,160,119,1168006,161950,1006056,172,123,895006,202929,692077
501030dbe8bc162c3614ece6e6aaf34e,96,81,349975,104756,245219,177,141,486990,81747,405243
f5f2597a63e20469b04298af23eb62b5,118,101,279871,99398,180473,100,85,208806,85529,123277
31e7030249e3be44069f3d70059abd44,49,39,48795,18114,30681,42,31,36542,18163,18379
4924f9b251bed4b016f25e60686903d7,117,87,238620,48079,190541,127,112,244780,65016,179764
7b44aa81c09bebe0c8e06515a779ec25,72,65,127336,31718,95618,67,58,90944,30634,60310
7e58167b1b5c6841b35925c84f490390,21,18,12313,5361,6952,34,22,21422,5270,16152
0a030c29114457448564e015522e30d8,103,89,266252,66031,200221,112,94,222141,43964,178177
d60673e9d4ee919702c73bad85c8951d,109,84,182876,70299,112577,157,107,313495,53528,259967
e1c094f4e30d82f97a8c03c5227f5f54,134,103,322737,103537,219200,179,109,451594,104624,346970
f8c491146f8d3e5e317eec7ca9773025,58,41,71842,21856,49986,50,38,47566,18103,29463
acb1b273a0be4a2aecc0d06ea9822736,147,116,443679,86607,357072,126,82,289652,83139,206513
79dd9c11275ea12aba50a43447dadd46,171,116,594250,101242,493008,176,149,705435,147340,558095
54eddf7511cf3d58242a50b42abb5206,56,52,73832,29934,43898,52,42,42176,30742,11434
410f73b0f0bfc03cce288a03bb34d731,111,87,256909,69163,187746,112,90,312001,59902,252099
b1c0d19c914d1b945b1814c476fce5cb,161,113,370187,80773,289414,202,139,543321,81734,461587
1ac9284a2ab51e1a802aa01738117295,149,118,301808,57611,244197,126,91,220702,82698,138004
7bb287f154c2ce056264743000af5484,120,99,220642,62730,157912,153,125,295407,66936,228471
98cc06281bdf4baeca283a78697b5062,111,88,224148,56705,167443,70,54,120111,48519,71592
c422a04e57bcf8195758db2e9311897b,39,33,34418,13147,21271,35,31,35795,12956,22839
3d1ecbcbc00c49ce529f3c9fff1516d1,106,70,205357,27920,177437,84,59,154272,32825,121447
77bc450e24e68f3d14615b023ee527d8,120,92,249494,56836,192658,81,53,128444,70895,57549
aff3cabd2e916e23520aa4b68afbf600,7,9,839,860,-21,12,6,1299,726,573
33ee312f3dc778f8e071535286a15886,113,99,318526,78096,240430,88,77,237838,79945,157893
c71b25faa41d0d89eddc7c78b46a585e,49,45,85080,30150,54930,83,73,124808,36328,88480
29ef85b1e14aac401e3ed2cedb09368d,40,35,35598,14194,21404,66,50,61160,22164,38996
08ab8278f5a76e271d171a8a5f1c4913,36,25,22163,10828,11335,29,23,23054,9186,13868
9f6175d2b17fc070a86466d7e47399af,78,60,111748,44646,67102,52,46,87351,34329,53022
9c8f4028bcf4505a3377b627b54ecfad,99,68,175835,44407,131428,76,69,124023,57432,66591
f1468ba81731934842cdde4f84bc275f,66,51,118809,40109,78700,82,68,117090,44732,72358
ecfc1d7021c2ecdb5dc21140ddf1253a,35,24,19896,6847,13049,35,26,18426,8375,10051
97cdb7c23b81796e910e2b34d4c5c71b,121,86,225745,51411,174334,106,87,163386,79007,84379
5588ee88fb166168e0a8b21557c0bb19,31,31,26477,9781,16696,40,33,24604,12903,11701
bac8166c262efabd82d7ac2d04f46413,57,41,107322,25847,81475,50,40,101711,36130,65581
7c03bb01f5a39b5d59bd0a72f863ce6f,156,132,547597,151969,395628,103,80,373454,113948,259506
5581a9a9f7796c85d8ba93b22aa38d2c,105,85,247299,48920,198379,111,71,207572,46888,160684
36d3ab77eab3b68e611c904c60510e19,36,31,57000,19077,37923,46,37,36573,25879,10694
1215c980dd507626531523240d44e97a,10,8,1829,946,883,8,12,1755,1144,611
b13289fbce6ad5ff8df19e270552eadf,153,122,335463,80160,255303,142,123,391220,109780,281440
262a2920fdd177297b773f43626dd02c,139,97,294967,62288,232679,96,76,186042,67512,118530
bc64d3542f5fd00b28c657177e157bf3,103,82,276836,117789,159047,132,93,412231,116029,296202
be7266f449841d6d507db7d0d0174675,45,36,56379,21222,35157,61,37,73037,19840,53197
a31a65934b2d269acb18af2ae7b33e4f,48,36,50753,11571,39182,34,28,42251,9642,32609
1391a2594b86c1e69a9fb765dd849887,153,114,595491,138914,456577,173,147,698722,109171,589551
b10b53ca9c4b87a715b97ddfd8e4041f,110,88,257161,40946,216215,94,77,174734,58851,115883
7d909ea17852b282610064c595290ec3,26,16,10607,4203,6404,21,17,12313,3130,9183
03e95d0a4404f99f9fddbbb924f6ecd6,149,109,392107,91460,300647,169,142,528018,97196,430822
0a9440c20433245b8f71dc8f61e34af5,148,110,369539,66887,302652,152,115,408014,73823,334191
d4fb8ab28e93a1330774807c4a27dc10,49,44,51991,25849,26142,62,44,74955,21347,53608
6c027a00c9ab692243aa48828362b61c,44,35,47678,17401,30277,46,30,48578,11422,37156
943bdedd3c61290c4cf6ea3698681bde,108,81,203422,49289,154133,110,74,254545,48564,205981
1efe16d93aafb019017e844dd258494c,11,10,1053,789,264,11,11,1231,401,830
f24eeb613c0319801682b7d7ac7fefe7,50,38,62540,17049,45491,52,33,49346,14308,35038
071acfaaf99475acbd5cd28bba193364,33,27,26085,10755,15330,37,25,28768,8901,19867
bbe6c38253b6d7b8bc5f1e490e17b2f2,57,43,93333,29268,64065,59,44,90513,28188,62325
b6e2f5fcde499634c1e80f57930617b1,106,97,212294,79770,132524,144,96,268092,64579,203513
0508e29b8a762da62f8788db06158d3e,145,99,287771,74965,212806,148,113,395166,72485,322681
52c1a8dd45f8da9312f6560362464a59,64,51,70278,17120,53158,43,33,33583,19387,14196
6c07fd259e431dcd8f37338114f7d173,77,56,137689,42157,95532,98,70,138357,52733,85624
73c42f9872b78f011ea44d2e594091b1,67,49,74739,22152,52587,40,36,43869,16086,27783
a787aefb5e5beacec0ab4b9d6fee11c0,20,16,4792,2660,2132,18,12,5290,1317,3973
712daaab48a1f10ae6017004b82d6998,121,95,397378,100316,297062,161,117,460657,107543,353114
99fc68fe6d3540c334c0c5f32c221572,88,68,156926,38161,118765,69,60,142950,40103,102847
22c0209e82d186500e87d78c33884e56,71,49,85135,29874,55261,56,53,96021,26797,69224
0984c0b4d7407b50d0736a6265735052,65,52,77886,29637,48249,72,60,103874,24530,79344
c908e521429ffe16ca127d80dd3830f4,29,29,19616,8296,11320,33,28,20117,6819,13298
f372eb0bc903c6e3e9ed8cf39da7d295,86,73,163839,41330,122509,78,65,196995,48744,148251
b043be88f2735e228f37c3fe9bfb62ac,183,117,568653,89873,478780,190,126,605556,96673,508883
3327d99d200dd24a966d1dd453d60d7c,166,107,554522,127424,427098,208,126,630308,132846,497462
b34dbc56858c2ffeb726c35a71c47a8a,32,28,31024,13486,17538,36,28,40411,16206,24205
ae1cd4f79408d09819226f4aef2701ac,35,27,41485,18778,22707,36,26,52370,17169,35201
e600160187cdbf1053cc8f29b97c98d7,63,56,170449,71664,98785,71,58,184508,72964,111544
5d626f4484b917cf1ab24e141232c19b,132,102,267354,48686,218668,141,94,275534,50097,225437
7a3876ea15787f946b32c894153754bd,83,61,104349,26304,78045,79,64,92435,34686,57749
486f8b1fe115500dda4586aa7aa0f4c5,143,108,390535,61828,328707,160,126,434743,96303,338440
9e62399726a5f5c0bc99083cea17735b,77,65,132452,50896,81556,88,65,201006,42182,158824
9ca2be8db41f1c9ff32c37407b3e6cb8,120,79,379786,87849,291937,149,104,378554,90651,287903
7e32549f91640aae9bbf8598b955fdc9,168,108,413893,90948,322945,151,119,357691,97055,260636
1dbde10f6d7c313d6360eaa5a67fa683,58,45,85440,40005,45435,57,34,102548,30093,72455
4eea2d7faebf9305339997757dffabfb,64,55,110708,31169,79539,53,39,85208,27785,57423
8e4ce5b0db649653ebcd993fcce8235d,127,116,282291,55589,226702,121,108,242853,68541,174312
bb7cae307bed6a621bb9dd5f8a9909fa,61,53,98750,44675,54075,107,91,237480,38798,198682
e743b296acd9d28d2f63f0c97b704c4d,119,101,428847,128393,300454,164,129,485746,96479,389267
b6d6dd92973160dfd55572de35790fd4,149,98,387830,74508,313322,160,119,365920,53394,312526
f12f6854fe7da568cf4a6f7ed8eaaf8d,70,53,112223,30885,81338,83,64,130829,44920,85909
8d698c46c86e07cf5c0dd518128cb1ff,152,107,335056,104518,230538,100,70,187281,113612,73669
0988a507f5345b4173d0acadaf505cf9,168,133,530242,105154,425088,155,116,489395,126636,362759
601fbca9ec264a2848e8bbea124ef182,60,48,107630,42731,64899,72,63,97939,38402,59537
e67867f5321412c24e9b51900e19c77d,24,21,17728,9363,8365,25,19,17453,6358,11095
9a62953f2b4a95b4d55f2026c586248b,171,133,545545,141297,404248,177,115,468559,128674,339885
cb44f34ee9c3e043627817d14c0dd807,44,37,38394,15209,23185,44,32,43090,17257,25833
e81242818aa8115afb449fc7e444b999,47,32,55018,12382,42636,56,41,51067,16469,34598
d15d9f466efe96593cf43890627d6d71,59,39,64723,26988,37735,60,52,74465,29245,45220
beb5217e5d63af77ec42174a0cb1005c,39,29,22309,9339,12970,48,32,48094,11038,37056
1b4f2ca07b65f6227714ffcea04ceb0f,132,97,459184,118043,341141,178,133,591225,89827,501398
9fd1f9b720df9617320c2b61161964f7,113,90,246409,88925,157484,108,70,240784,65121,175663
1b7aaca7d5d326cb3303724a9bac611d,77,56,114692,22935,91757,46,37,72467,23646,48821
eb8f832c1e5cbb4224dd376f3a200f1b,68,61,111336,26775,84561,95,68,126470,26772,99698
523b55799385df4b068cfb539f7d86ab,153,108,366175,54853,311322,108,77,222092,64900,157192
fc9f50a09e8d9e02c5b824751d1a46a4,81,57,98860,32132,66728,75,62,90193,30850,59343
dd522deea3e19d4bbad7d9369cec0f8b,187,141,840264,110610,729654,192,152,614107,153109,460998
d9467ef42be0e57cc1779b1b1045e3bd,131,106,336788,101540,235248,139,91,451889,98066,353823
730d0c512c29a5dbf624be292c30b1a2,187,140,1072882,128277,944605,190,149,811735,121814,689921
2bb2acd8f8b81ec8001d311e5ea62b2b,106,96,312561,77001,235560,97,81,235289,74479,160810
35ed5f6f563bc82933d712aa5a8c1641,150,100,249938,53811,196127,101,81,182885,75803,107082
81dd97309dfca6386dc2453388b723da,92,71,138355,49032,89323,93,83,153194,43535,109659
312bbaf43e1332637ef8c16e16294120,42,27,32545,8689,23856,46,40,40542,11461,29081
53c0ab9840a77d312a1d2262031e75a6,179,154,661553,136405,525148,210,127,591266,111564,479702
791970274131bd889f22ae9749137292,160,128,442824,83954,358870,146,95,383149,77035,306114
fa698bc2af4dcfe059f774f4982e6e49,208,160,1109628,173570,936058,205,157,878892,206529,672363
ad410d6e5a0acb21a15438a426253e8c,114,92,314166,52015,262151,154,124,333459,57715,275744
b4bb1f9fb59d758ca6ca05f84a17efa7,90,72,203516,53871,149645,159,141,336206,72799,263407
efb37d0f6d1ef7b662b82705d0118c86,38,40,38625,14575,24050,55,40,40676,15576,25100
aec1045cfdf57a93b03acc7b86bac6c8,142,116,378105,123721,254384,65,62,278302,87043,191259
74208840db3e47752968ba96e15614fc,115,99,245994,73680,172314,154,120,388704,76786,311918
6d28fbc457ab1342d4c9b776c3b0609c,140,111,319050,89935,229115,104,87,258140,102316,155824
26856014d88ea8d2e0d7f64130521cd0,43,37,44329,19423,24906,38,29,40529,15223,25306
71405e8b7105c65fbf3dbd39fb0318c8,63,54,58957,23568,35389,71,50,82369,20483,61886
8cb0aca0117b02220e88ed91231e2536,82,66,253959,69658,184301,137,98,331934,62903,269031
9b93c49310c4d47f1e435e6a3ae7852f,11,15,3026,1872,1154,24,12,4769,1072,3697
d1dc27c4f6a0297b3508b583d5524f98,30,24,25878,7772,18106,31,28,17827,11804,6023
4fa30d13ac4674bfa680eb9d89e1d8ef,178,120,388286,78795,309491,117,93,251170,79100,172070
1b2dd80f0d5560e03eeec3fb5e1ee4c8,138,98,320038,54061,265977,106,77,229659,69938,159721
043c007bd03f9b51473d47e768213b5e,46,35,21672,9543,12129,38,34,27057,9028,18029
fbb0dce3cb36572a3ccafc167eeb2092,37,27,24018,10368,13650,31,26,16152,10052,6100
cfc96ca311ac596046e7ef5a67158ff0,86,85,136175,55366,80809,103,84,191864,35480,156384
f95e44dda68ce62f368ea90c645ac948,70,54,170457,60232,110225,176,133,452532,56478,396054
c0fb04d45e1a68719ba36a2b0c6a1a4e,111,97,287910,123237,164673,125,108,355558,104328,251230
de6de82ddba8279a5f99e128ed3fc816,14,11,2252,2408,-156,16,11,3164,1876,1288
3fd509781cdfb34f48dc42e5b793ff02,102,85,258183,85433,172750,159,119,388847,55950,332897
3eb4dce3979601a81b8c8c43e7fee05f,35,32,35717,10821,24896,30,25,28892,10483,18409
a8ee2b530060817b57d9bcf323265a3e,89,78,198171,72990,125181,106,75,233489,63533,169956
eb69a10e9a880a0c78482a848455f1b6,59,59,97706,29548,68158,49,37,60031,19220,40811
c7125a2b55c070a0cd8d65c5cb1645ac,158,121,449019,86071,362948,95,75,237529,80853,156676
54b2fdec0563cbf7b4242768b85cfe06,89,67,196076,46081,149995,129,108,257866,61512,196354
5429d2d5bbd4b96d37e0533147b86942,164,102,472998,68286,404712,127,97,287698,95440,192258
1b95a2cf7d2dda8df37f4f61143c9c84,42,39,26147,14129,12018,45,33,40099,9762,30337
ec6e168034ddcccc6554d53179fc59a9,106,69,247201,73720,173481,96,85,244068,66170,177898
b7a5ff195c33ac96a5152d8063569be8,44,33,60172,15621,44551,31,23,27719,18136,9583
65f75d6e5aaa9a1e20f007167956c5f8,52,38,31457,7249,24208,37,39,24728,13043,11685
97bbae4cfb71284b6c6c3a1ab6eed51f,110,76,330049,79646,250403,152,131,502796,120501,382295
b238aa8ed553c405730d9c96d1f2e05d,32,25,53638,22355,31283,31,26,61897,21329,40568
3aa7c43912c23c09632aa9f1a77c2f06,85,70,150351,60872,89479,94,75,225990,54263,171727
187265ea7ca3c073f8ea8a12484fc015,99,84,197654,71008,126646,95,75,172062,63870,108192
716c831c6799b1c8d227d3e69964cd4e,114,95,252334,97641,154693,162,139,375400,73224,302176
a44e44413eb5ee1c635a011c96495334,100,83,173844,45436,128408,96,84,207480,36838,170642
dbe751e035753362cfb6378f8b1b9ba1,75,54,137516,53652,83864,91,74,193971,42345,151626
9ee3b3a4bdb50de338e9f8c3c2c87113,35,28,36172,6215,29957,32,23,24111,7362,16749
6b70be203e9c922513c12d7a0b2b2d56,133,93,257819,65911,191908,150,90,283744,79084,204660
5a825adad80f0afd065f3b3f27c5dd1e,150,126,518771,113007,405764,133,106,375789,90970,284819
3333f3449cacd1c321c1b603bbdc870c,72,57,133961,26552,107409,91,74,177320,29801,147519
1d738de50fa9bb777dd3190437575fe1,66,67,125483,45986,79497,86,54,123211,37592,85619
99019cafbb4a0da8bdc1d43923cdfa56,37,25,26413,7771,18642,44,32,30324,9418,20906
e8e3f2d3da63a4e2eeb52b7965ca00e0,30,26,20517,6535,13982,31,27,19534,6953,12581
33db283f2e244416ae8b6fa81726c8e0,146,121,416240,136259,279981,132,99,453885,106952,346933
82caa74e3df1dd716e86acd41300b0bd,85,63,189017,77244,111773,111,90,315946,57789,258157
a3eb41cd4478665f6492e1c12e5df833,76,62,136508,49916,86592,100,88,202568,58764,143804
ec0648b01fa6b0ca27fb85511d3c6cb8,104,91,290026,79306,210720,154,123,413928,70116,343812
061089b50f73a7b16a89a49b32a47ad6,29,22,14257,5496,8761,26,22,10127,4916,5211
869a72eaaeee5eb5f12e2cb8f98e9423,24,20,8889,5281,3608,24,18,14437,4620,9817
89f5e466b2aaf5d1eb90c1bd0e791fb4,152,96,358305,88723,269582,152,115,448330,89778,358552
03f1c78f091fb32fe6ac3fdcb3e4dd80,25,22,16718,11713,5005,41,23,35688,7673,28015
29be3b237d3ef691b157a645f5ff6ac3,32,26,17345,6590,10755,38,33,22483,7602,14881
e559d8f9c291727584df06615c81b9e5,105,85,239507,60628,178879,96,66,219784,41873,177911
3180cbf347a1930cc6f0db30b2912721,70,48,87074,32424,54650,77,63,120457,38290,82167
2e93ee81dbd7e5c8655600c9600b88cc,163,120,445696,88104,357592,169,122,384326,84621,299705
5e82ef5e2ac6b6325fd9dddba0a42793,103,86,255783,48764,207019,106,75,172580,38504,134076
6eeb24751ef5830694696933c9a7dd28,108,94,211829,60135,151694,157,125,374797,58522,316275
f0092b7c8df8705c286a0cbcd83d2393,28,17,8764,2663,6101,17,19,9195,2047,7148
27dde819f20d23f14baf8e902ee73c54,147,110,338243,71716,266527,142,111,413482,79644,333838
86444f08c9388ba33695ef0cd73641d0,152,125,331053,43638,287415,105,81,245558,50523,195035
0336ad21a5f6c22cf24c918f1d8165c7,59,47,80801,28303,52498,89,67,114421,29136,85285
e6b360be84b42a1740f96b74d708a115,136,100,368382,80816,287566,113,98,258584,86854,171730
692f3e8a92100ebcf8f370429e5cb241,81,71,142184,37989,104195,69,57,86009,42185,43824
4a2d163005fb7ebdde652422d3911aff,44,34,51310,9865,41445,38,26,26521,12883,13638
107345e3764d8609bce728ea2787b407,33,24,29599,8237,21362,31,21,22423,9347,13076
51935e6a7ebc00bcfe6b8d082d5d232b,151,119,485450,115513,369937,126,101,386652,105256,281396
2bc91d6b06bdc6e584f2655d61680fbc,24,20,9100,3494,5606,22,18,5040,3485,1555
fa0c0a83ccb6181f5ca72e597d89042f,98,65,183495,38034,145461,84,42,116703,31028,85675
842afc7c3ee5f8031c6df0adf68ea9d1,24,21,10313,5014,5299,36,29,18524,8182,10342
d2d18e0a3287f5367ae9aa3f5812f65a,164,120,420936,50977,369959,142,100,298151,71624,226527
4119f584359367cfd833a1264a12a2c1,30,22,16601,6534,10067,30,20,17188,5943,11245
4e8f40f88941e24d4d32f80612218b89,53,36,92344,13573,78771,44,41,43756,25370,18386
d58f95640a580dfce0bbe7a68981b2fa,110,101,256674,70202,186472,119,95,220514,65303,155211
4f21905e96ecae7daf7b4487da3ef786,141,101,288037,62068,225969,118,88,339565,73316,266249
476b717ed7e885cf47d74846ab1e66bf,138,98,450438,106088,344350,137,109,481652,138580,343072
105b45693aae5ae298b5d25e434707cc,122,109,190230,66692,123538,130,101,281172,51312,229860
d0824b6950efbf0143003ecda1319a0b,171,121,674411,110794,563617,188,165,622648,138513,484135
7a78373dc03004d5fc6446ce335c8317,137,118,427359,107141,320218,126,90,298016,96443,201573
8f183222de43f30e84c165bd8cdbaa7a,16,11,3809,1027,2782,18,10,4248,1485,2763
80312e8700d61930a37e465c3df5ac4f,132,111,386945,80990,305955,126,103,399882,96358,303524
08a5df1a68ba75fcb1a466341fc770b1,161,136,625400,168093,457307,220,171,845344,159899,685445
2f8c1a17d50ef5227f2a65c99b782096,24,22,14990,8817,6173,27,22,18382,6404,11978
6f2d5b7909c7a39113fa9017449bf697,123,93,195751,78232,117519,186,120,410315,54094,356221
85845d3c5d51098fa536a89ff60745b8,79,59,110238,40433,69805,78,61,163788,41329,122459
5b13e31a406b01ebd6bb0ccda321278d,64,48,132493,52471,80022,99,74,225278,40762,184516
ecfe6585b5132c4100ba0119565c279e,110,90,262309,49800,212509,85,75,202179,54452,147727
aae41483b0280b7e42f09b3ab3e49990,114,92,244149,57581,186568,108,90,227810,55328,172482
33acef76dfe8307c16aecd1d69da634c,140,103,505698,85079,420619,182,154,644135,136059,508076
9ad88dcd7a8cc53d84ef3ab58ff84f87,137,115,484014,157176,326838,157,109,533853,87041,446812
ef6f7ff79e0a9370cd5afd6d8d170e10,87,71,151513,36711,114802,97,82,178166,43496,134670
ef0981850ff7ccf969083bf4f116c844,98,83,251450,58576,192874,117,101,319872,62230,257642
2495f30ebd2f4a36d800579b5a613ea3,98,69,160870,35448,125422,66,55,116059,36081,79978
06ee5117fab61bb17fec4f170a7e07a5,92,77,177374,55571,121803,129,115,300652,76239,224413
78b59b2669a9c2b56e43a793b02b154b,79,61,177319,49378,127941,103,73,230006,63972,166034
ae6d918dd43ae0715f74cd53be612483,99,80,128375,38262,90113,72,62,105371,40886,64485
88f69675d269a411364119e1646d6fe1,74,62,151861,52998,98863,121,93,303717,52485,251232
7c7dbc9343b188266cdb0adfb06a1901,23,12,6093,2344,3749,20,14,4557,3298,1259
485901311d25b83379c6ddb1a75eb3f2,74,54,105078,22208,82870,69,54,106495,32687,73808
e36677b15e4deec3900b8b1e369bea23,156,121,486699,116974,369725,202,125,492751,132217,360534
b31653c39641358dff34709c4bfb76d7,155,122,350768,50614,300154,148,123,401540,67173,334367
d8eb0442ddfe1e14328a7f07f5342f14,132,93,297315,73694,223621,119,91,241489,84036,157453
9cdf326163a85ac0fda8208039d3daf1,157,112,426197,100334,325863,130,113,350701,137273,213428
bef65436afcfe611d50342d506ed3303,93,71,142144,56105,86039,86,66,170167,51188,118979
26cc3cc3262f4f317a406dac06770a79,23,19,6462,3226,3236,23,19,5133,3322,1811
413a4e5e1b190f12cddfca34dc2250dc,89,57,86722,24257,62465,72,57,81380,24659,56721
9aba9bbddb988579e59459156d7f1c56,51,42,37236,18886,18350,58,39,63354,10369,52985
f0e82279613cf839b4e7c503dcbd42f3,65,52,119532,26488,93044,48,38,85356,30908,54448
1689352c1557275e0fdabca4f4593e20,191,149,491960,134272,357688,112,81,312461,145273,167188
e877b5a791724d578022e981710c55ae,84,68,150641,45329,105312,108,80,177631,33851,143780
9af5cc1582670a79357c5297bb1682ef,100,81,169527,72083,97444,105,85,206885,37065,169820
79ee26ff927743fcf3c351caaf479c89,82,75,144077,43826,100251,64,55,108456,28858,79598
707264da4ca417b12c6cdce215bf1a6b,100,84,330052,61391,268661,114,85,246907,66804,180103
438560893782925805f12a5019b8b007,107,83,225514,90798,134716,110,94,253789,70115,183674
33afbdf1c86a79a90b16ae77f0628b55,99,86,203303,57512,145791,125,100,243125,58482,184643
445293ff896c180dfe4427b925b0491c,37,35,106630,26306,80324,61,39,98834,26904,71930
924bc204bec1861439938525eae3853e,104,80,165295,45555,119740,102,73,149147,37143,112004
a9a0559b9636c58d878489fe19b62c4a,179,122,611417,94812,516605,156,114,499953,87913,412040
9f50ad5f0edf8c38f013260599f045ea,139,110,307860,66631,241229,133,113,322295,82238,240057
208908469dfd3be89e07202905637cf9,45,43,67456,13934,53522,41,28,36251,18776,17475
24878e183233cf5413b2c8538a4a4eab,29,27,36439,14898,21541,40,28,52283,17661,34622
456eef5d429d7298253283c57d1c5a82,50,38,57912,18090,39822,42,30,43339,14553,28786
089077dd4d725e5236251f62f6df5b35,61,44,62879,16171,46708,57,39,38706,16233,22473
40f8318e4242470f788d05fcab5d70c9,143,115,490866,93514,397352,179,145,442800,107574,335226
44f64ee425abb7bd1f8ec5eec194a0a1,23,18,5902,2644,3258,24,16,8747,3455,5292
8503e7f0dabdd7b689fe21e967a646d9,27,23,18047,4695,13352,35,24,12770,6769,6001
3c2643bd071820a1289cac4f815a2d35,32,21,15167,8528,6639,29,23,20091,8314,11777
71d316bb60a378e5a060c813507f249a,37,33,26784,7225,19559,41,32,27259,11222,16037
e9a437d056c38ea8445e9ccf1ed520db,136,114,215799,32887,182912,84,75,108391,35714,72677
1020bcf2fe6c4e9f34b3fd9be6570342,168,98,537076,82255,454821,138,105,406089,114857,291232
cdb9d763c3e60f8c6b0d6ed9f54b1fac,111,81,194938,51605,143333,124,97,262644,49846,212798
e03b019f810eeb7900baff10829b410b,44,34,75608,13600,62008,50,39,49903,23267,26636
a45efb66bad44c56130c24a76ef8967d,192,130,490104,108662,381442,207,149,504993,86693,418300
6222bc5ad661403fe19af5d8639b3bc5,178,97,498140,86050,412090,129,92,372510,102909,269601
3c07ec87e0535ac7e9d172ff0e868271,81,61,162320,54370,107950,83,75,167361,62344,105017
53627fdf89d2768e5b4738c69982c3ad,82,66,106419,34834,71585,84,55,116204,27006,89198
571ae8dff8ea2de337db1ede93de03ed,52,33,45449,24340,21109,54,63,83669,29300,54369
f96061d3e4d13fc4b3b9cb3a108fdcea,64,47,68723,29098,39625,66,45,107796,27068,80728
11a080c8a6084ea10fc02aa40a49ed54,81,59,127093,25243,101850,93,65,153537,23274,130263
45ff5725b34bd5d78b8c85734fdba3f2,167,114,454876,72633,382243,152,101,361976,76365,285611
a33507bf599cda249bf20f65eb6d6a46,52,33,79853,25683,54170,69,56,128588,26556,102032
5d6c0243a02f59a84589a44dfd375d75,220,133,971832,148099,823733,181,129,981355,130411,850944
020893da5ec5c15d51eecb27d6c4187b,192,131,867224,156761,710463,171,130,756239,153244,602995
0a60c3667e94fbc86dda37fa914745c5,153,126,566168,107569,458599,140,107,501226,97997,403229
169b6cab774fefabb5a910a17d8319ba,28,26,19820,5384,14436,33,25,15694,6158,9536
b2926e21d23dc0602d773cb3081d8291,146,109,315851,73391,242460,130,92,273001,67656,205345
f8e1d40026aac3968c422b68d29f614f,119,93,304082,89781,214301,126,114,322760,79824,242936
44a0e840ed8aecfda3594d28a18e4818,137,83,282233,86941,195292,143,97,355132,97710,257422
6d44d4d4ea5de2d4b07d7eb7649e65cf,175,140,932932,216702,716230,186,134,739756,270978,468778
4452495cd290f6d406423a777eb14f4a,186,126,452441,102209,350232,147,124,581609,145480,436129
3998c538e3bfdacc1f3d357275e8a97c,18,17,3119,2875,244,18,13,4705,1921,2784
d32c8f7ca64986249296c9482f94d8df,39,26,24223,8785,15438,34,23,25171,11358,13813
8cf5596fae422b7dc4010c7a47891e5c,156,119,665224,176788,488436,168,122,698133,130123,568010
83666fc3197157c76f684175e7f22fc1,87,77,147137,30108,117029,68,61,82935,32316,50619
9ceb2fb9c34749aee93f6e2d384294fe,103,81,221108,43622,177486,113,98,198569,57624,140945
937426404ac1a4aa0e1e9515cc8afa4d,86,49,76162,24204,51958,75,56,76379,20475,55904
a4b2eab69888aa495067e182002bdcee,60,45,79487,25156,54331,60,35,46526,19794,26732
62490c1eee4cce98b8c8376ee211a0df,44,40,78078,30444,47634,51,40,67464,29254,38210
62a2f2d4f6361f7854da702a63856505,78,48,113784,18801,94983,54,36,60091,19897,40194
56f0eeb4999ab2bc5ca00d23004ff197,126,86,354523,68321,286202,169,141,603640,107619,496021
1feead8fea22484b0c4740d62f9ec0a1,31,24,17776,4857,12919,26,31,21218,8597,12621
6a9e69bab098833d537b3d0df4472e04,94,65,206712,67531,139181,112,88,345009,64325,280684
675342ebe79dc87b020c3d3d0c9184d4,55,43,72949,24421,48528,53,41,44991,18624,26367
da2290c0dfca771321a0ada34cd4ca15,88,65,147204,42063,105141,94,72,164184,34466,129718
c4adaa0fd7ef7a3a3135cf12ca420ae0,20,16,10714,3559,7155,21,16,7584,4091,3493
85fdfb6c2d2f50f55d1f94b53a54bb8d,77,58,166063,51452,114611,116,72,244223,34093,210130
e8d4417cc9cefbe8df668b4981fb181c,69,63,98172,39597,58575,104,92,196361,44307,152054
f72ecf4e12c4891a2107fed4fd455cc2,70,51,99745,21984,77761,55,41,64076,26933,37143
4595e1e4c208982830345e82eea48c28,145,113,333781,73904,259877,95,67,218164,74702,143462
e92cf8f90234fb9365483d15382f3dd3,136,111,393167,61560,331607,138,112,415815,68826,346989
4d3bd547eb742d5f4efac85c8f904f8f,85,72,149239,42115,107124,59,49,99386,43316,56070
477cedaacadb48a1399a08dd6fab0489,35,24,26972,10004,16968,39,27,29902,11387,18515
6a20c51663a45712e008d8af68d97884,64,58,98031,34033,63998,72,58,94312,20791,73521
d841e1f7d4410a8e741e16623cb005f5,112,85,188728,39163,149565,92,77,157367,42891,114476
7802aa6fbbb422c043322d94ea4a9c48,214,164,776319,259651,516668,175,115,1050920,171832,879088
5f49115b764d1184a1bc34878d52ae9c,134,92,286759,78878,207881,126,89,361761,74772,286989
4e23e6998f25bac2defef9817309b13a,57,44,68802,19381,49421,45,37,53613,20639,32974
b30381bc685abd154356dabb521e6bf9,79,56,96879,41941,54938,70,47,124580,29948,94632
2c317c501578a78ba4f07aa19b1189cb,159,86,423105,79551,343554,163,142,477189,114332,362857
520f7b70ad0d8ac5dfe77d2857505c4b,129,119,395413,83684,311729,121,96,243906,79150,164756
76f0a427d8606cb9451c852d596b2a80,86,78,158166,50992,107174,88,74,156134,45936,110198
c6bf76861fe28818c483c7279d4a5bca,161,114,405564,74498,331066,115,96,349868,102488,247380
5b6fed97169d7010d0f876289b169484,83,64,170397,35271,135126,110,81,205532,32982,172550
ede15f5837122dfb9a2fe0e139f7e243,64,42,78176,29819,48357,86,74,133172,28276,104896
81f51091001c87a921d0debefcce5459,65,64,116659,39744,76915,73,57,118795,33066,85729
c1095ef84f60ad01fd043f98a280aa09,182,124,596189,98351,497838,146,84,501357,88079,413278
76fa9d43e5ef248724c2c8106f7b4d4c,148,99,347235,55610,291625,117,96,293934,48243,245691
98b8985c789cfb0452f2cf78a0b0e087,66,58,133795,42925,90870,54,46,97727,54236,43491
aa52a8bfe988d7500ee523d6b8094d51,91,71,176684,46299,130385,106,78,139378,42029,97349
2762a56cdc4ce41b497ae58f7b5217c3,30,25,16975,10198,6777,30,28,24436,9682,14754
ff72a5cfa79b28b1460f8d41929caf2f,77,60,104420,29639,74781,69,61,84274,32077,52197
0943590b2993d4af15cc9609e8d64252,69,64,96050,32944,63106,92,76,130659,34336,96323
714aff93fb5b3ba21a451ded56389bf7,54,52,69668,28625,41043,64,41,76289,25664,50625
7a091e861bd369ebc1e951a612841051,34,26,23210,7055,16155,26,18,17646,6264,11382
0e194c455f21b803584b6d4102592d12,126,96,334954,68967,265987,100,73,262241,48339,213902
d3a25894067ad667cf35c3dba2d66c2d,122,101,369172,70769,298403,137,115,403345,79415,323930
9d71cfa3ea5629a8851f38016845080a,24,21,16209,5877,10332,22,17,12656,5392,7264
063efdfd1b3cccf9d82fa4ea761f8bfc,100,86,220270,76415,143855,127,101,308388,75614,232774
bfe6380402d9c20a1ccef321cae7e0ea,57,42,76541,30081,46460,74,54,118162,24071,94091
0e94760d9e2ad5fb3d68d99fee630057,97,77,190114,50815,139299,87,65,153459,42846,110613
39dc77484fa3e676ad532ec785e57591,33,20,30479,6628,23851,23,19,16789,9350,7439
40e8bd0dd20ed3959bf9fa8797928c4a,122,81,335820,104372,231448,157,107,446844,93020,353824
89817b2fd326c53a0e8853590dfc0db5,166,123,816060,125916,690144,188,163,724717,141431,583286
c09e7b62ce9f0e47b48b7583e46e6909,101,86,245706,63137,182569,116,93,271294,44746,226548
cb6112c8cb027bb33ce3f4ea053695d1,41,36,23249,12036,11213,43,33,26160,10130,16030
056e066bab701eab068027a3971128b1,48,35,41182,16773,24409,41,28,48665,11496,37169
170f91b9f76bde33674331f248b55d0d,138,123,278891,82932,195959,116,100,261334,60584,200750
bc65a08ef502ef870822b00062b7d2ae,115,83,240333,43089,197244,135,109,264231,45785,218446
93bd484fa945946be3bb5eb6a0aac04f,45,40,69406,19668,49738,41,33,65122,24360,40762
7ebed96b46e44e36f1c463d4b27d112f,112,97,255146,61627,193519,88,76,189947,56036,133911
bb098291ca401e2b8b74f27be58e6a0a,144,123,345627,73300,272327,138,109,373996,91848,282148
123ae748abf3a7c114cea6b819448871,196,131,600516,91427,509089,159,120,521300,97527,423773
0d9834af2d5bf01bee6a225bf3d5603f,33,27,23026,8554,14472,28,24,30651,9486,21165
f3660498edf6a076a06235c76c4a4991,155,117,613562,164648,448914,163,116,530339,130338,400001
3450cc3d48c4f7579481454507d76513,136,101,380483,103596,276887,117,82,328697,85846,242851
4cf0f13a68cb4c36f8fd314fb3cfea7a,66,50,80184,27644,52540,63,64,108212,25881,82331
cef120005fa63773586f5f65c1909ad0,210,141,951005,95326,855679,152,109,497669,87841,409828
e9adce6b79bca7e81470994cd370511c,73,49,125347,23241,102106,69,45,86495,29905,56590
ed58ca887497d5ab356c8520a9cb8328,96,74,203976,54206,149770,122,108,249380,68548,180832
70edf8d57e793871f12c6765cc3bb24a,111,86,281357,41219,240138,89,80,151985,57729,94256
9207083a30400306d9039c1483498b60,30,23,19739,6559,13180,25,21,14532,6265,8267
508e26c0223691f3fbd0f0c08d5bc2f0,101,87,237770,65301,172469,90,72,206892,68811,138081
bd627ecb03db80a433f6c9a4c7f48a62,209,151,1309720,185443,1124277,196,149,929361,157697,771664
bdf44c96171f4c2779185d90688649d3,119,94,296756,92786,203970,143,119,361898,79043,282855
d86ae0bef6301070efedba1dc6a9bec3,24,20,14189,8188,6001,28,23,18472,6705,11767
09e6ff0d10ac15efcd6dc6059396f1d3,135,120,328888,104341,224547,100,77,209917,84491,125426
308c597b9429c17b5010e118cea1112a,63,47,66574,53367,13207,102,70,215286,49287,165999
43fa8a221be025857ed571b2ea5e23e9,64,58,75841,40392,35449,77,58,115146,33589,81557
e015551883c3f199a84e6b179ed8b4a1,185,156,639138,173312,465826,219,176,738144,147009,591135
e40605ed6b3ffc4b13ea97b54a4a4ed9,67,48,82688,25514,57174,47,42,42632,26858,15774
c25275feec4d9874e6003f11fbe77f98,99,58,151154,25656,125498,63,52,72853,22923,49930
45bb466463f07d2b531683a296a89383,178,148,720071,185709,534362,162,122,676961,135251,541710
50b7d4a5d3548933ca52ca6bf8bd13c3,96,87,243558,64684,178874,113,91,268243,74276,193967
1072c7720c4d275a0c36554c2e171837,107,64,183014,35742,147272,125,79,193202,40906,152296
416c4ffccea4ed090cb33bfe766d9320,67,54,144821,30052,114769,73,53,103823,28284,75539
091c34b11b15a6e3bf8c45858e1295e7,53,43,82863,37478,45385,75,52,103724,22322,81402
41a032323883d94ae47e4f0839a11b9d,28,21,12185,6378,5807,29,26,13852,5825,8027
33b9232e4510f5129f6365e4f8ba0354,118,101,255120,61353,193767,120,96,256339,51826,204513
3c44a08da316514d4ddfb1a78d95ae66,35,29,23756,12496,11260,35,30,33287,11445,21842
c1bd827c75df7893bc54c70b89028611,30,24,25765,7093,18672,33,30,19142,8742,10400
353a0551a43168c898a81d6f34bf67c2,25,22,10848,4514,6334,23,17,8558,6192,2366
3da630cb592000558a2a965b23ae01ca,144,121,387519,80447,307072,126,93,314742,68903,245839
c544aded61f01a54e60981c15322de60,19,19,3819,2358,1461,22,14,6018,1818,4200
def5cede9b85f032fa3c24775ecb8b1f,94,86,196777,70446,126331,177,125,359429,78634,280795
b761d1611edb4babd4dc7937ee133db5,159,128,1273880,201668,1072212,228,140,1496134,219687,1276447
c6184bdb0109afc947d104b9a549e9c2,151,123,541384,127029,414355,154,124,620726,121406,499320
7f432c7ee9838ad642ac707e35039213,41,39,45030,29840,15190,55,37,108149,22729,85420
f043aa305d490c0aafe3bdb1b04cf26a,145,126,258840,42742,216098,91,76,153722,64561,89161
d259d59e1479a99808fea89604dbc6a2,51,35,51925,23999,27926,58,40,56571,18861,37710
b04d8cc30ff03564b1aa5e77baf5f388,33,27,26761,14659,12102,40,33,42314,12725,29589
3f9012ae88e0eda092acc3d37d69a0f2,139,95,311714,49212,262502,155,133,349334,77343,271991
335e16b05d8094f6d11d6b9eee24ad60,134,107,343261,72484,270777,115,98,232526,68713,163813
e9086af6e8a273429dd764e1315a7b19,103,84,149580,54716,94864,78,67,177585,45139,132446
0ed180bd307145ab1f6387e42ff3aed9,47,38,45612,9515,36097,40,30,26005,7976,18029
78b5915664a8d7c55979599ee0ea2f84,195,150,754491,114530,639961,227,166,903577,87594,815983
e82f0561ae27d8a8ae58d56830553fc3,158,115,364981,88724,276257,131,83,267796,91119,176677
838092a75a186c8ea59d4665e3b449c2,13,13,3163,1739,1424,15,11,3920,1426,2494
c9314726a09789ab74ca4e072eb9dad8,133,107,418036,97471,320565,153,133,483912,95647,388265
515c5f10f4108393c7dbfb8bb8e7647f,174,115,464492,81533,382959,192,123,497958,106786,391172
40ee70dccead64467df4ad59851f9fcb,34,28,34605,27289,7316,52,30,74433,17237,57196
9f274d795efb3460dff40205774da3e2,26,25,16285,8468,7817,28,19,16384,5595,10789
fd4965e5cfb126f7ce09f7d30f19aae7,236,159,2310891,279164,2031727,251,185,1636589,417549,1219040
8cb2cfbbb2b29aedac53ac51e994639f,128,84,336014,89917,246097,113,88,274290,85230,189060
d8aa857dae078c79721bef8c79f8a6d0,133,99,255440,37097,218343,114,82,184965,49419,135546
540f1429eefc86944f67d4b4eb92f111,79,72,123089,35896,87193,63,54,103525,25293,78232
a8a3961644b382b0f436ef7d1e28cee6,96,70,216642,47243,169399,121,87,232003,56107,175896
9df63cbb68f4a3f0bc985d0998b43bb5,218,164,1066699,272009,794690,218,145,1135279,166744,968535
5267b7cae8bef08f3be5fb0b03793efb,47,36,44405,14767,29638,44,36,39926,17295,22631
557af23f8b7f09ffe44e9a5aaf3b3157,116,77,304506,75737,228769,103,92,298618,80946,217672
9a146c8a9a3fcce262def91b69780bee,92,74,124938,39063,85875,54,51,84505,42046,42459
92a4380c5a0c10d004e5d09157e52830,33,26,34054,15013,19041,34,27,29540,13435,16105
88277bdf48830cae3ba813fae1369c0d,150,128,458405,92054,366351,131,119,517689,72353,445336
5f9333b3f19e079fa2dea08bbd4415c5,141,115,640366,165152,475214,148,105,598240,159594,438646
e6beff492a4c989cec9a086de5f35e25,44,31,32646,13275,19371,50,28,53314,14035,39279
58985158479b027b7d838bf6f4531501,63,43,104795,39298,65497,56,46,116479,36482,79997
3d1319c155b17cb69a91ee019323e144,38,29,37980,16257,21723,41,38,52000,20383,31617
6bd1a620fb8520fb63aba3becddd9d1f,223,159,839273,160660,678613,173,120,916930,162355,754575
9967a278c51a87a9b35252701792c2a3,114,78,159607,32837,126770,110,87,153596,34823,118773
f8347eacf66ff01a2ba9128588ef42b4,47,37,64967,13001,51966,36,30,28902,19368,9534
66ae43231c2391255e2625d743b99543,31,23,24375,7549,16826,44,36,43244,11217,32027
053b74fa669c09c8cc0ac31d48a7eacb,35,26,54637,15984,38653,33,27,39155,15574,23581
69a2c92f322ac0ee15e81fb2dfd35810,83,73,210780,72901,137879,106,95,257604,56131,201473
3ce48e97ca9c9171b2e58523458fa7f2,18,10,4511,745,3766,17,16,3125,1627,1498
7d89ac3819dc7c7afaff07e78b9655d0,27,21,12015,6387,5628,25,25,13985,5874,8111
e6c7a0274c83d9acb65134049145b757,80,70,103679,41337,62342,105,89,158357,33007,125350
c8af26e0089873c7fd301c42913ec9f3,66,57,67157,25546,41611,43,49,60990,24204,36786
3a891cdaee6d8f3a4c744a2271dd3d0a,108,92,240050,42537,197513,102,89,260925,43473,217452
e308350f92d5529bee64fea9b8b12c9f,124,95,283970,48945,235025,147,123,300783,61163,239620
381539b8fbbff47304e8ccb01b3624cb,97,70,122105,28411,93694,71,54,86912,33172,53740
fd9db0c4fc1355d0d211dfc90107e3a4,91,87,106440,42082,64358,80,61,108184,31399,76785
f3f26500240db68da4ec1c2b2f0eeefb,156,123,423885,90039,333846,151,118,432764,94099,338665
9655a6eeb7e759f7993b1a47f14fe926,48,41,49703,17200,32503,44,41,52904,20188,32716
2a4acfb98682fcc5b580faad8ccd9fe0,64,54,122870,34034,88836,80,61,113160,28259,84901
b21615aa0bb0f1e14280840fd788183e,84,72,147051,35895,111156,84,68,99048,26920,72128
84bbec329e5613085fcd07c36c5d8a52,47,30,42644,14479,28165,38,28,50375,10658,39717
45e05580e4e2c2b7d7241b96b7f8bb36,1,2,48,585,-537,2,3,585,269,316
cc750e4243fd3af8e424125099ce31eb,86,68,156943,46487,110456,64,53,95021,38312,56709
5e0bb64a8463136b0669c60eb85fd72e,72,65,87716,30654,57062,74,64,96820,27264,69556
c486920d2ad7a3cd7f72bbe9fc37a83c,28,22,20617,8058,12559,21,21,14804,10347,4457
8d2416572418417e2cca4bc30d27676c,44,33,27961,11201,16760,45,41,36800,10092,26708
af6b30eb7caba8b98454f59aed000791,169,121,408168,74921,333247,115,98,210709,83098,127611
744f272455503b1289d8397c247d00d6,55,37,97693,26266,71427,61,52,106129,29872,76257
32332196e154650facd7b81f150d861c,74,64,126586,58303,68283,122,99,254837,47395,207442
6816b429bdeb59b4979c2b65b4d61d44,77,53,134232,41310,92922,118,93,264804,51704,213100
b924bc4e1e89de2fccb07653d55269b6,48,47,62211,27158,35053,67,55,97786,26915,70871
92ef7aa8b452f08f41c1339b5df0dc87,35,28,20067,10089,9978,25,27,19392,8047,11345
6d02910c22269a6d3141a9a7a7be7316,10,15,1626,1174,452,17,13,2313,1029,1284
a9edd6dfdec927d8b0c8c77f60cf7e30,137,111,403159,65377,337782,106,88,312699,103786,208913
5342b71336933f58370c31b393fb3042,103,75,200613,54988,145625,120,80,256484,44958,211526
2d565bb81fab9f44cab1a509421321b1,87,74,130571,34387,96184,92,78,104495,35552,68943
ad6ee938812afe077404305557973d62,34,15,23463,4324,19139,31,23,30059,8754,21305
9ff79d77dc0c7342b9d6cbbe12d83bd4,131,103,366093,53774,312319,109,82,325612,55924,269688
f6430efe7aca4f71e4f456641fe93567,37,30,35018,14806,20212,37,27,27815,10012,17803
6f870bdbd7afc9bd5559fed847cd1cab,22,19,10652,3418,7234,22,15,9302,2530,6772
ab76577e8209d5c45e14dc428fa5eb56,136,106,350172,113609,236563,151,112,496042,95213,400829
82a46ab1262b4faf38bda5e945865751,21,14,6011,2837,3174,15,14,7651,2863,4788
107ad291a258f4cad60ef8af9c951876,36,32,35007,10166,24841,31,21,19903,9025,10878
e858da778cf280c397ffc5b5394b86e8,48,38,48731,11717,37014,36,28,24783,11572,13211
35ec87cf3bd0bbf8d7b6bcc8dbafe9df,59,48,133139,24667,108472,59,45,119153,28295,90858
878f5ff4546e557b8a5981dd0bfb2786,88,58,153509,31819,121690,93,81,164496,35950,128546
73554ea746eeb23a5192d474a705b463,84,66,125053,19724,105329,48,41,54258,21163,33095
1bd067c018665e2c862f90c90f937ddd,20,17,3445,1288,2157,21,11,3147,1215,1932
851881b2c7aceaadcc73a0e032db503f,24,21,11844,3702,8142,22,20,10286,2884,7402
f9d342f040413779c58d655edcc03735,126,95,281920,72440,209480,152,119,406897,75724,331173
f55a2d384ddbeabe084d53fd17590ba0,146,115,553925,142083,411842,186,127,813236,111645,701591
29f5914f8ba2ef35cd73d5531aa1a702,122,82,315089,120270,194819,158,103,449584,96039,353545
1b104d701c89d67c367b43a2b46653ca,141,101,351802,143125,208677,180,133,526217,95967,430250
1ef712a1601c320eef52199fa64ad185,65,42,71239,21747,49492,68,49,82067,19443,62624
eedf744bd4808aead252c43b686162bc,176,145,557236,96430,460806,186,150,565556,82289,483267
ea3d4035b854b1fb39f7b9798b0bde6b,32,26,25074,12380,12694,37,23,32303,8504,23799
306e022527a7e4032116020588ba2b89,142,91,169513,61572,107941,100,69,148784,51590,97194
d5bc5143c0dae8f715abcefaebc606d4,44,32,45485,13311,32174,41,33,30780,15898,14882
33d57d4c4205266444eddfae53dec81d,43,33,41252,12668,28584,54,41,64419,16777,47642
b784a64c3d3bc8d7f75c89ef4eba2a45,99,64,158394,46999,111395,138,107,264551,56645,207906
a8177fde2b198e09f5d2789ae1b9e931,146,104,369210,76776,292434,131,107,350847,79962,270885
b54889f912f5a4e03f7d5289680ea55b,97,77,192081,40603,151478,88,77,152054,30953,121101
4b8a8cecaaf0f201cd26387c69e4e4e1,60,41,74225,22184,52041,68,61,90127,29587,60540
3fd80352f8a0d9574bd5dee7d8dce104,116,83,211966,58596,153370,142,110,370525,61672,308853
d9ed6f2a38af49588cee7fe46ba4979b,168,130,364547,60327,304220,142,122,320034,57731,262303
06c7afe45b20e3f49e74755902afd699,161,122,407051,94761,312290,171,119,402459,87007,315452
c00691863904a86d1a14a6c48626219a,112,91,309795,47592,262203,116,92,237120,45819,191301
058f293db2b8045366d0312ad802c6b1,92,61,153543,54223,99320,106,78,158063,37991,120072
ef016c34896990520ff5c71becf0cea3,123,85,263771,51653,212118,104,78,197832,46223,151609
9ded58ced36d8b214f20bd343be395b2,78,61,144028,30705,113323,90,63,133069,19644,113425
7bd98ef98f81af86baef9f7d92577a15,212,155,1008480,205402,803078,152,120,924478,181615,742863
07e5ada7f355adcb1beae6ab4e571e08,28,23,14253,5459,8794,29,23,14604,6649,7955
66185e1386aeb2b648c0a8667fc1580f,200,136,1110108,249143,860965,214,146,1228113,276679,951434
3ed646dfbdb3cf3fd688781621bc65c7,42,45,49116,9164,39952,48,41,35436,14560,20876
4cda03f5e337052bd7d2441966455175,20,14,5162,2091,3071,17,16,3928,2894,1034
00cc0aa4d2186798b3030accf2540a98,80,67,108989,36352,72637,79,60,125693,38558,87135
ee06990ae90a91d4d42429df72d31903,28,28,23252,6440,16812,28,22,20775,4418,16357
556d6b0927a53f214098b07cae2f08a9,79,66,129879,48372,81507,129,115,289179,69200,219979
5255170a25d9111dc39b7762c6769d89,82,62,182282,60864,121418,150,123,358932,70858,288074
fc3d372bea73a914229c9d0c176ea773,49,45,50877,19792,31085,56,48,70658,22370,48288
bf97ce2a17e275a102bdeb51b87ae8eb,128,99,415726,91211,324515,178,145,509595,83726,425869
0643ab8682851e384eb6d60e04fd3558,171,117,1004061,219291,784770,210,153,1276060,223706,1052354
3f4d674ec2765f9734f947009206bb0d,103,77,179451,55884,123567,116,88,246286,44824,201462
7e370683eadcdf788c578228969d8e6a,44,40,44315,12101,32214,32,23,31712,12180,19532
8bac0433708264eba13ed67f6eae9731,99,67,167519,36445,131074,87,86,177032,52052,124980
88ce2a1a258991c5aea5eecd512be5f0,47,36,51599,25624,25975,65,51,81820,27853,53967
8dd21d3317066dbf49db58e7a9a8d4aa,137,108,365884,67888,297996,155,123,412471,63185,349286
04a0cc273c241b44c239da38865f3842,15,18,3955,2943,1012,24,16,7792,1288,6504
a8460b8a28cf5328288f7381a3a6cf12,201,130,673613,133253,540360,161,106,595807,103937,491870
96c3424d34f6c4e834f23e8328604e09,54,40,65624,15735,49889,52,50,57308,13217,44091
fc6341bcb451a584c892661adbbaad13,89,55,129360,31822,97538,85,74,128836,45420,83416
b7e4ecd9873fb16adeaa3a417a8a0cf9,146,118,304393,61351,243042,97,70,187914,68228,119686
3102033c13ec8c5ba7d6ee1db3190f51,28,22,15560,5757,9803,34,31,23027,9063,13964
48e744772d36bf0b6abdff6693208b56,65,51,70346,27535,42811,78,51,80401,25582,54819
c75b9a73488630e81002a9e01b3cb111,185,115,437854,95040,342814,151,96,409227,73970,335257
d42df3dfd84400b53c235e19a394e28f,78,72,133575,38256,95319,61,50,90980,23511,67469
e173d5283b82b0b4c8071cb3e8f7cb3e,166,107,469934,90712,379222,189,137,493933,83669,410264
4b69339d0804d18bc5cf95f59b0f4b31,79,59,106782,45413,61369,118,87,208804,46431,162373
4d17426b4d86655af1f9202080014f30,137,104,406678,67585,339093,154,130,440707,73345,367362
66fc02525e6e340d1474f21146b0b5be,45,44,53725,22790,30935,58,39,86221,15171,71050
2614fe81aa1008186849a09969e73f5e,16,17,3817,2210,1607,24,13,5129,1595,3534
41a10ea7aac03ba5ca9d82c709793ac2,34,25,39153,12725,26428,44,38,64451,12058,52393
cd8560e74e76b859e72474a7be29de6c,68,52,126312,38559,87753,73,58,118531,36031,82500
6cc6a0ab3de88c2261f0a06ab124fb93,176,138,450873,110311,340562,138,100,382818,84044,298774
07b3a717b56cf82e7af66db0445ef1b0,39,31,27951,8659,19292,32,32,20371,9907,10464
97c8d9cd4784cf33280d1249a20a09e1,1,0,33,0,33,0,1,0,33,-33
07798a9d9208facd0384c490816d3754,9,8,1821,1128,693,11,8,1256,1443,-187
6e1e2ab2936ce5e176f1359e95340f20,167,139,452121,84011,368110,110,83,253814,92600,161214
2a4c06954539d38acb368eb12b2a6a7a,78,61,113844,21462,92382,79,60,111783,23587,88196
3342cc3fa3a4a958aadb7d702d6cf160,53,44,71260,19355,51905,76,65,59255,26086,33169
c0e2012c2b4e5a61e0d8d4ec1f70fac4,35,25,32149,13426,18723,37,22,23302,12792,10510
8fd942663fc48ad205d4eca4ae3f976f,138,109,324220,58198,266022,157,109,291788,65781,226007
5a44b032e7c5eb3882bd6d3f73e160ba,92,79,150697,57570,93127,80,64,138202,43694,94508
bca5dc2ef34c61517acdfc7c65bd80bc,104,78,211178,101472,109706,151,101,359192,75687,283505
54a77766f84c768dc8d524dfd821f5dc,92,78,225398,81427,143971,143,120,310352,59352,251000
4b942ed1712120af9f6d4da677a001b1,100,72,225647,53834,171813,98,67,193991,52438,141553
27e6841d6c815cec714566646b507a64,12,14,1499,1027,472,17,11,2287,502,1785
bf13495e6d0e3d01ea9f1d4a7b04bf6e,189,129,411515,61423,350092,138,108,351730,66414,285316
e3226a8ba570622100010ab802c88ef1,61,56,77138,27879,49259,60,49,75687,17446,58241
e72b5d17997655fad632763f7d3a8e35,47,33,96372,28764,67608,53,43,84172,26613,57559
fc647b1db53d71abf967570429136e35,80,61,99263,19125,80138,58,46,67740,18393,49347
b1a7b9f0e36af479690f50b3cb7d0fb3,156,83,250413,32700,217713,132,99,251495,48935,202560
4b63f3b28173b0159666f1b1ab38e0a5,157,110,399372,77417,321955,135,109,378908,84264,294644
d48c032216c103764976d1440fe3b0c7,56,35,78594,16608,61986,51,40,64471,14891,49580
d0426300ffbc0c2466b26b2972871d06,126,95,393410,118904,274506,139,113,419623,112082,307541
c391e2daf2776dc117bfc1a69271920e,52,36,48022,15878,32144,52,43,46075,20100,25975
0d46e263ff3b70d397f9d98e8927c62d,115,73,274101,112338,161763,78,67,248035,95744,152291
b08b2b5e920b2ae02518608b57bc313e,44,31,52054,17475,34579,54,48,60489,23184,37305
e1d19307874bea1273e0e55aaa3cf05d,139,101,398223,138965,259258,167,145,516822,98219,418603
ebd7b2c8a47f093f785b8f8cd8a1f64d,23,21,13779,5848,7931,28,20,16851,6774,10077
44b06e0b0466b1023d0b421b90dc3e8e,17,16,7649,2151,5498,20,13,4641,2773,1868
e8a0c520a4a58655f8e418168e82ead7,58,45,65787,21340,44447,51,36,52339,16167,36172
dfa3a024f9a852f13c37facafb8ad8c5,44,37,79120,17416,61704,36,32,39528,19818,19710
363fa14298ae09b799c3b7d7bf179ff2,24,20,9994,4776,5218,25,21,9347,4843,4504
4cd75473afabefc78fbf1d1c72663cc2,141,107,312803,57250,255553,145,99,336085,53486,282599
678b43fc0bf94bd56113129efc35adb7,87,68,171458,55209,116249,88,66,200295,37874,162421
9e3391464212362945848a82247e6e46,59,46,91635,36705,54930,75,62,103995,30918,73077
9217e71ecfa6fc65e28ce5577463b6f1,135,93,294856,47531,247325,105,87,182807,72171,110636
91468b958eefed04f3236e43f37318da,92,62,137458,57182,80276,129,95,322079,58617,263462
c56b683d3d663b26cc2ec6f6c7930d4d,28,24,17719,8520,9199,30,23,16265,5321,10944
46b61ee27562f7e5bde44b8d057dfdf7,36,32,26297,6936,19361,24,20,16878,6578,10300
ac682d0a1ba5335dcd0b96228295b46e,44,36,89473,26545,62928,31,33,56199,30014,26185
87410223ac17042257bbaa2aff60b403,27,20,15406,5495,9911,24,18,11979,6921,5058
7cc0230bf641244dd9d891032f06fb94,32,22,27112,8644,18468,25,27,24616,10652,13964
0f2a38c606e8cbc978a503d3f3cc8b0a,105,85,277688,56734,220954,80,58,176300,48596,127704
48fb466a05fe8b78b9606cc42413b7a2,98,73,142877,40656,102221,97,50,126966,36815,90151
1132b17cc911bf16b2a850171ae81658,1,3,33,544,-511,4,2,772,261,511
7729c88114741fe0fd9ec59df255b44e,85,76,167952,72606,95346,99,75,244239,43911,200328
ba335f8f7e282f1344e91116d3b07320,89,75,125071,41393,83678,71,55,138976,33585,105391
8e52cdc8da5c0f1f5cae130a3bc67635,15,12,2208,1759,449,13,9,2246,1144,1102
8691032051d6f7701a45c6c8d638b052,103,82,176117,53371,122746,119,87,168672,45733,122939
0bae278ec585c5f70dde0ea21a397a1e,32,23,18672,7353,11319,30,24,19915,6400,13515
61b1697bd70f6d2b406fcfc624eb6500,75,53,120474,31719,88755,80,63,128963,32197,96766
3133f69af142bce221e6b997995c6baf,90,76,186888,35620,151268,77,57,130796,31414,99382
c882ac9bb1b158257c2c11f8a8c02f47,31,28,15305,10204,5101,34,27,21673,9694,11979
c1b87946705a18c58c8a0c389e712617,45,34,72811,29790,43021,43,37,63936,26881,37055
892b8d8fcc3753c46cd1fc1e5c87c5c8,162,128,350772,64914,285858,126,107,280767,95188,185579
58a1874a27a9663445c91775211a8bfe,43,38,31198,16006,15192,44,39,29874,15481,14393
fd2ef6064ea0232e82fe99d72e3b1fe8,161,139,434249,91610,342639,117,87,229187,80120,149067
cc689512a77cb87930f62720bb7867b1,178,132,580077,130797,449280,185,141,545365,115359,430006
9dd91b864242a59887c90bf57b7e25ae,32,29,11972,5754,6218,29,20,9223,5310,3913
e41a92e9b0d27a3c505dc92249e6561d,13,7,2410,377,2033,11,8,1223,1059,164
5d6a8ea8f8d32f7acc2dcd5151c72bbd,132,100,312368,65045,247323,146,131,325868,74732,251136
bed6935acc26be1d5b88f2b13c8cf069,107,82,229155,62385,166770,146,123,288008,58927,229081
bfeb03cefa9815b98c9c2d8c58cb9155,23,18,11925,6107,5818,25,21,18095,5604,12491
fa1c94315d2622a235c927b186b237e3,169,97,430911,99271,331640,189,140,612684,108717,503967
1482e7b1d52e6160ca24eaa74b09d972,59,44,109427,30104,79323,41,32,66749,16240,50509
fc1318b4a958fbb20ee4193b3da1cd79,189,154,737232,115006,622226,180,128,478490,112471,366019
0e352bfe577e6eb12fa79fea96e7c248,31,25,20143,8587,11556,33,24,22314,8007,14307
fc295f11f66005f0c0ca74d3b961cad2,79,64,77625,24159,53466,78,60,95014,23758,71256
4216273d2b7d46c1d0c8558f00e96320,113,97,211118,78303,132815,113,97,251435,68192,183243
d840966be0acb73b4a547e9eed1379f7,143,112,368262,87897,280365,133,98,382721,71731,310990
69d7407bd3cf6ea4205f785401bae35f,59,52,90682,33621,57061,85,63,108418,35193,73225
e6154584b00df098a1bf71604716217a,31,28,13497,8489,5008,29,20,15471,3706,11765
81e17c774bcdcf6e9b365b1e000b9611,157,117,400272,102831,297441,137,111,445213,109503,335710
7910411f38fe381978c3b2aff8a164c3,178,130,365826,69499,296327,136,108,297579,88303,209276
23b8c1694cce061c516c52ef4200b1df,53,34,42997,18807,24190,41,39,51705,18443,33262
c520f53e64420e952406f51dc060cbe1,61,51,116301,49012,67289,106,67,180162,32280,147882
5df68557dbda3a405795d7865d026570,104,83,150357,28758,121599,91,77,110101,35154,74947
79b8d809d8a2b3b1ec822ff50259dc57,45,33,35510,11530,23980,64,51,42288,16254,26034
b4bf43125c473a9be6e033a492fc505d,38,27,26768,13216,13552,36,32,44751,10802,33949
4cbacec860be7e520861978b1899e7e4,103,75,142083,66145,75938,109,86,189913,51389,138524
517d5ae4ae2cbe91bb0b1b2005322a44,31,17,8048,2085,5963,16,19,5631,3461,2170
3208568866bb8ac74c66c85e43470e54,21,12,5771,1816,3955,18,17,3975,2809,1166
eb21dd49a20de8ba9c1da3502938ed63,174,143,934513,228918,705595,190,142,749702,152406,597296
c0d5b28313ca3c7626a1524b9832b71a,54,46,81650,33273,48377,63,40,107732,23534,84198
6f6872c5310559616fa345482ed89ea4,108,84,271812,73738,198074,114,91,367888,73248,294640
8ef4bac89725cc21ddcf686694831bc8,42,32,29810,8689,21121,33,24,26818,4227,22591
e95f223b39f051e2fcff90006423e887,166,134,467803,84325,383478,173,130,591734,82340,509394
3dca4aaf812cc5b46d7aa0972720ed63,0,0,0,0,0,0,0,0,0,0
3428bed77abd557cd21432443370ea12,66,43,68594,21947,46647,51,45,77179,19458,57721
af4f3940ce02d1e17f9f22846ed6b594,0,0,0,0,0,0,0,0,0,0
3752a475467280eb5b82481953fb6b61,23,23,17659,5585,12074,21,19,14449,6181,8268
2cdc870215b514b6d6034143096dbea9,106,88,218502,75861,142641,102,85,172227,50906,121321
39300bf35c0e352ad0f26c750398d89d,51,38,76214,25145,51069,54,44,74831,29200,45631
6478aa820e8e99fe0d3f34d73d2b9499,30,27,11650,8950,2700,27,27,15927,7062,8865
61d20a13b773aa41b287257c12da0039,19,12,4755,2338,2417,18,20,3517,3281,236
064398f7582ccab36788db76c79d25c2,62,46,66533,14470,52063,48,29,40737,10150,30587
375b2240c61c601bc34e2b713bd5e3bb,119,98,277101,72633,204468,112,97,287721,61364,226357
7a763d792e5b06b8fe140d657d853c07,90,69,134719,25797,108922,87,74,111366,28523,82843
e89273e4c17450c63d7238890835db00,73,52,124133,43176,80957,89,63,167759,39853,127906
b6c40a5a8e972df8e5a37a72cbbb5aaf,35,32,26231,12541,13690,42,28,25080,8541,16539
4b09ad473d5e3509f0a0609fc90cf7d5,165,105,510255,71263,438992,191,125,625793,103220,522573
8d14d442c338e270fada705ec763d9d0,61,54,62264,22376,39888,49,36,60615,25063,35552
ae5dd9c150b3de97ed5d1a7675fd0d98,35,32,47311,13221,34090,30,22,26257,11563,14694
06a1e6a32a53a64b16f036f7c2e836be,15,13,2799,2102,697,16,10,5505,1268,4237
4ddb3a44c275dc036f1c13c19680a04a,48,32,49186,16008,33178,45,44,56684,21576,35108
589730a896604cf84ff82a21348eeced,74,56,78281,20971,57310,71,63,74637,26562,48075
0c5b0e4df670c337e3213d598b5bcc6a,20,14,6849,2101,4748,17,11,4764,657,4107
d01c4b66c1a89d8269636e9dd136adf6,55,41,105479,24682,80797,94,76,135398,43524,91874
99218731100498ae7dea2a0e12190819,21,17,5231,2217,3014,22,14,4660,1892,2768
2cc542f37ac84aa03dff0f1a39a7b77f,145,113,267533,64397,203136,136,92,328858,50708,278150
4c3fba7bfbec0a57c84c4006233555cb,21,24,14768,8024,6744,26,18,18332,5727,12605
5a62719bc6a604138c3735667e4dc989,129,85,292199,110778,181421,169,121,566047,106786,459261
550eceeebe030300212268aeb57427a5,64,48,75764,22766,52998,39,36,46068,23696,22372
44255d80ca48b0f4a78c4bc6c797630e,142,92,408311,76941,331370,117,93,386720,85662,301058
d35eab9ec7fca51ef0a397a8c78b0b4f,41,39,35215,21023,14192,52,36,58975,16878,42097
5218cba71436bb33833d6fcf236f8b9a,102,82,186501,30543,155958,79,62,115744,38703,77041
f5be13ee3c0faa7854fc7f2ba447b589,96,70,121514,36430,85084,70,47,75635,22510,53125
f4f99cb8855c21792b159e4aba97256b,136,109,302132,67093,235039,121,88,223585,82297,141288
a3dd8e4f4cd76c8a5392b01e522dd14d,127,93,227514,73130,154384,158,114,332116,52804,279312
32e3fb4965b35bc1d77cb08f15942bf6,153,119,348418,75670,272748,143,109,325644,51788,273856
44515bcc5b0c878f5be4a16b8869a3d8,81,59,255399,80071,175328,147,114,492188,93914,398274
a828d1c9e58c6e016437df6676826c81,41,31,26717,15155,11562,42,29,29369,12302,17067
eb77b76a8aa5c472b2e9e292cabb0292,90,80,143035,70100,72935,95,75,218486,48583,169903
8f2b1fd817f8608e44fe2a09cf79c11e,155,118,373841,77991,295850,135,95,228463,53643,174820
6d2bd16604def51eb5e671fb143e5017,26,23,10964,3740,7224,23,16,7089,4936,2153
c74122c70fd844b096e2ee1af13d7745,27,21,22537,9996,12541,29,22,25241,8509,16732
372b4ecb0e651bdb9d7810ba4f369e4f,94,84,153401,40025,113376,61,56,113626,40099,73527
7af30ae28d036fde3ac3099bd6d99c5b,121,80,202891,43035,159856,87,69,131391,39694,91697
8687e3f9912c21cae00b866a431e8244,159,122,362117,106816,255301,141,116,356466,92115,264351
f580cdf1c4156570bfed48f3eebcdaf9,41,28,25422,11334,14088,44,31,37723,11452,26271
6f5453db74027d4c1ce85f37530797ac,142,122,347580,82850,264730,103,83,254089,84376,169713
e374371a6581b48b29a6caf1a0b93b4a,123,99,347790,75734,272056,128,73,310203,73982,236221
10e571d84a4312cd634e26f7206835ca,34,25,25196,7620,17576,27,17,13212,6605,6607
8a27111a8f3558b739d3bba66fb9cff5,30,22,14278,6505,7773,32,25,17739,5683,12056
702de550c5aca809cbdfe3a906601143,107,72,278430,72008,206422,111,79,239563,97879,141684
e68da5ecce210c7ddf996190ef7cc0ea,20,20,8288,2861,5427,22,17,6129,3132,2997
78069271cfbefd83e56812d57bbfa54c,79,61,163799,35439,128360,99,85,199323,45984,153339
2cff0403772b61d34dcd622c5d42e74c,23,23,10533,5060,5473,25,17,12777,3375,9402
575b320d87a62f454963471fcd696620,60,47,94178,29451,64727,51,45,76378,28849,47529
6a3a9217988095ba40d0dbc7161f35ce,131,93,237243,53949,183294,96,81,218744,48671,170073
d003a6cc72462eb8657eacdde6c08071,156,134,512229,97405,414824,140,119,426565,92916,333649
a9d2eb2ff47bff50295bd41456e05ba3,33,29,39069,17575,21494,35,22,46907,13367,33540
17bd54dfba5e8dcdfc83d4db0b339586,65,45,86840,31457,55383,64,52,77734,35833,41901
c1253fbe414f52b005c1a7ebfdf97331,138,98,353328,77822,275506,102,71,191878,69321,122557
e6d9f034c5397b95b78b31423fde1599,52,36,61861,28341,33520,79,68,109978,27817,82161
603a0eb9638fc7d781c4882e4f305fde,64,53,98459,16948,81511,56,35,55523,8955,46568
72f75e7bffaa0a5c22b952dcbc81a7b2,43,33,55054,17072,37982,42,38,43307,22909,20398
72840c4664ff29a3d11c91bdbe6fb437,143,124,460576,93411,367165,133,118,430089,82141,347948
4db2fb062b8150ef098cbf8a627e2f51,104,69,227647,66269,161378,108,84,240196,68520,171676
f3c58ef577aed1fc70f424dbb621b784,78,63,145621,63177,82444,127,119,246221,57463,188758
a659aca1c47885bf91e44b25bcf2501a,103,85,187212,47754,139458,109,84,222348,42327,180021
378300ebe2ef507e6c578d8d8c09e822,119,100,303670,69461,234209,136,92,308670,61076,247594
219507be2a3d7382287972df5ebeedc2,123,112,238844,60139,178705,127,88,255080,48240,206840
128f85be6383d3237d5abaec3416fd1a,141,98,305294,88486,216808,150,105,393527,93522,300005
27da0aff8db7e6a4586bf21f62293752,25,16,5822,2123,3699,24,20,10617,2851,7766
e8515f649e8f6d0ff3adec7f296abefd,21,14,10243,2736,7507,18,15,5053,3137,1916
f8b9b0c1fb653f6090d001096bae972e,60,48,88979,19299,69680,35,30,36745,17779,18966
7e22199e916de30dae999cd0d55dbe1d,43,32,37490,9900,27590,27,23,18962,11079,7883
5a792e441a2b4da3449f89204f189b47,133,90,310455,67052,243403,143,110,333938,63864,270074
1bdd16c3aa4cafb44e8b50c3d322882b,42,35,27458,12790,14668,51,40,49235,10345,38890
dcdea25b0a5c229ed352cb56396659f0,47,34,41818,13113,28705,40,30,28962,13571,15391
39f0ad9713041a4e4aec13de5f2153b2,144,113,322704,84491,238213,148,81,312335,89726,222609
4d3591ef16e449c5c808fbcd7c1fe579,65,42,88831,21152,67679,74,57,113322,24595,88727
6e8f2191b1d0700d7c7947fad35271ab,94,81,171449,45146,126303,65,47,101298,43155,58143
0d247949300e9ae254937f933e27bb12,118,93,357271,84569,272702,171,146,468792,100437,368355
bb295daebc8ff1eda2802829945e5993,97,76,189814,42560,147254,104,86,179726,46169,133557
2ab76ef1ad2982c16b7da779d3546bc9,105,81,192077,103740,88337,126,100,343290,120549,222741
216347b9b6a4db1c9c5ad898514912e8,30,23,19646,7080,12566,30,25,17551,7699,9852
8cea3cd1d9a97ad57eeb80b6da067f0a,169,132,640392,145359,495033,153,125,711668,113834,597834
1ad16f3d551a8685138a30bd46e12fd9,162,107,355675,70942,284733,108,82,209942,64389,145553
26b9ff8d8a344e9c24c842d62edcb18e,19,15,4032,1756,2276,16,13,2614,1490,1124
88ff395cd6f31bfffe03ed051dc15166,57,50,67319,27114,40205,70,51,67312,26752,40560
8ebaa46b883f2d2d3d8b57d96256ab0f,14,7,2926,1046,1880,11,11,1947,1620,327
38a5cf3e42e2f6b6366138a3b7b07633,204,131,630823,145193,485630,184,137,592292,138518,453774
579f8ff80490a775f12e34b7f82bf895,48,37,58936,18359,40577,36,25,44042,16563,27479
791e1157c581ce28f2267a955a433cda,155,104,455834,83260,372574,148,122,469780,107353,362427
3e63e8a300f7661dadfa0931b0423f11,19,17,6852,4726,2126,25,21,9274,5241,4033
315d4e12cc5fe6063c207c95d9143bfb,2,5,182,486,-304,4,3,435,194,241
a4d93212d131162179df1ab65db98c18,18,16,5291,1252,4039,25,17,6226,2063,4163
e098ed2305ddbf2e15fa632436bb16bf,53,48,61980,36507,25473,73,60,120151,27532,92619
dad9b9d34a5c10d230fb09750a355c14,143,121,319296,74189,245107,74,64,157861,63878,93983
f6911dadd25e921063c1aa90229efb01,91,93,153809,45139,108670,73,63,82458,47807,34651
eeda645ee2b2e7237f6be194316b7df0,38,34,49812,14895,34917,36,25,50854,13449,37405
906dc2577077429d6bb94fa6a46ff671,104,73,151519,36934,114585,134,76,236627,27270,209357
f365556b28dd5b3e8aba814692543d3a,96,85,250014,83263,166751,79,50,199083,56963,142120
13406ba4534a9c755cb01d512ecf6974,61,58,134067,39359,94708,69,50,123086,42494,80592
fec1abf4f609221d588b2412a16b92f8,19,18,5326,3343,1983,23,19,4986,3262,1724
5ba7702a4f1f3d6b196c44055a725f22,123,114,370079,74882,295197,124,98,293612,94734,198878
4da3a90a6e601a3e58acd1e252afce4f,35,32,38770,13106,25664,30,23,32963,11575,21388
9a96e1554a9f9235345f8be7cfd8b3a8,174,127,575660,120347,455313,146,96,607368,90636,516732
3c4db7b4d4f45e4011fb77a2472939f4,137,100,446430,149846,296584,197,136,598584,142285,456299
4b7506b562fe1911f6ea0723c93aa246,163,113,761964,188942,573022,195,131,1090405,169563,920842
e7f0bbfa7ce2fd95df277a0922b3733c,155,116,489242,54873,434369,125,98,357657,89030,268627
99de01467607bb24067832d218219b39,15,12,1764,2228,-464,17,14,3284,1217,2067
20f29526ad1477a4322325d529e05585,91,75,213184,45190,167994,137,119,256785,63076,193709
1e93981c4fcbb90a588d71605fe9adfc,161,123,634324,120221,514103,182,146,911902,128541,783361
12e276382ac99b36d60736d93588d2f0,27,24,11936,4811,7125,30,23,13249,5455,7794
76429d101fe334931cfc3427214d4aa2,46,34,55424,13890,41534,53,36,46190,11538,34652
d87f4b65952eeb70479569041ad2f4b2,112,98,287892,87246,200646,121,103,398167,115987,282180
e3e1928b6b3e9cc4a97c2f8ff1134691,122,100,281262,82582,198680,146,114,371157,93449,277708
82edd7d79eced1d8ec2b7056a813c683,152,114,421862,96972,324890,135,107,341517,74157,267360
888e5c557b204c9a21ec3bd073930460,32,28,26516,14602,11914,34,32,33677,13537,20140
3a2d093ca141882504e8cd5d671d3a57,38,27,19618,9992,9626,43,32,44357,12438,31919
22394b28143b1fe2950ffde123830d3e,136,114,290618,100119,190499,117,103,261867,90236,171631
f6e06a96e2c70b359190b01771e33df0,165,131,623616,217950,405666,211,162,791998,183294,608704
67d68606008b915ffaa0b8ed632e9185,20,17,7376,3005,4371,25,21,8153,4872,3281
c14ea87e53955d17a0c6d5895985c2ae,179,119,1071304,150256,921048,240,170,1251641,149197,1102444
43c65c69dc046a583830e6bde34edad6,47,30,54445,14063,40382,34,33,26946,13767,13179
ff0c60d15c9ee208a11053ea5bb24bda,77,56,141063,32578,108485,102,83,191518,36540,154978
4e1b667467d73a19c13a1454895f5359,102,85,225172,104865,120307,128,93,239807,88526,151281
3736dcf96476cf1be93f5b34abcfbb8c,81,64,140594,46315,94279,84,62,111444,53042,58402
5474947a67b0cd955ebaa9d49b493901,23,21,16029,5963,10066,29,26,20934,6092,14842
22667de195dbfab0795a54863397d619,129,92,275613,69583,206030,154,108,391016,60982,330034
668509aad50d52e447e1e94f7654eb70,68,58,123606,39066,84540,49,46,77935,44416,33519
71f705a29b3fe2f575060fbc16350028,23,18,7347,4423,2924,25,20,12661,3729,8932
10883d6fee2dd3abaf250d99074ad971,40,31,40137,12336,27801,45,38,52439,16363,36076
fc957d0771b49c93c6c9a1e80c74cf8a,76,56,117571,29172,88399,77,55,113750,32609,81141
e401921484a1e4765f3fbd9455361633,52,48,55349,16278,39071,58,51,63793,16884,46909
a6b4c277103a827e50c22125ab041137,113,94,268780,68094,200686,111,95,202964,53296,149668
69a5053a0fbcfeb29283de8e9b887769,114,82,388975,90741,298234,151,105,440033,109304,330729
a7555a5fdd9d747fe0ddeeeac798941e,25,20,10770,3394,7376,15,14,6585,2771,3814
61202e405f5e36ea094ed8812ff7c16c,78,64,91976,36968,55008,98,92,169111,50343,118768
6ea50ee8591b88df38c8d613f4b78666,113,76,232522,71315,161207,110,84,243780,62750,181030
d99204d6dacfc31eb5093fadc2983525,162,122,477396,124389,353007,185,127,639006,126481,512525
17ca0f84475500f3f58c3488887c4d89,87,67,233431,78224,155207,99,75,273276,77919,195357
918937070a9de7c164ddc5b4afaf99a4,139,105,346866,104844,242022,139,126,411502,91884,319618
f75e2350d9c3a65478f17acaa83c4aa5,192,143,732833,159458,573375,193,173,722088,242466,479622
aba6c1d8bdfdc8a31fee79cff679a103,26,21,9301,4193,5108,28,21,11720,3135,8585
3f8c5c0a791425833be6840dfd291daf,66,49,152038,22092,129946,73,50,112740,26852,85888
d308a8ff5211a94fdd61ee68c9ac3ac7,173,127,738136,123859,614277,177,133,851361,142791,708570
57cf071820b0119fbac9102545004375,32,20,13946,4809,9137,25,22,7713,6471,1242
43d337562822d170038ba92781bda35d,160,123,375696,109593,266103,90,66,278181,85904,192277
9fc0eccabf4c0248d6cc78647342601f,235,153,891405,149688,741717,176,125,818555,105646,712909
ca7595eb6640c59e9ca8e4fa72e68abb,99,88,302759,102425,200334,140,102,424236,88876,335360
1c66890c442a878d53dddb399cbd4300,95,79,212043,93718,118325,118,86,310566,61457,249109
19f2713faafec95b5e748c888d8e74ec,117,80,413398,94255,319143,171,112,452126,90539,361587
79567dfa27532d631a2b6b0c1dc0fc6b,102,82,217422,64578,152844,154,126,366659,78149,288510
356446b6e1de5d5c6eb437cdf02c165f,170,112,343450,106673,236777,116,100,316564,89057,227507
cbae191ff887289d202e882a7dacc07c,23,20,7052,4213,2839,22,18,9958,3408,6550
7852197d87776daace9b3b9a79b1214d,150,85,534498,115290,419208,195,170,781479,129940,651539
b4b4d008c1ff61c2f97b2333b1c014aa,122,108,287633,55940,231693,148,119,390446,47712,342734
34a6c4328d9611ba334d87b28da27c14,42,31,34114,15569,18545,47,37,52926,15899,37027
b62533832efdd2d7e3d7e4e65b5c23a7,31,21,17535,5343,12192,40,37,27769,9668,18101
d15da6ff175d8663d0eb489777d8ea6f,60,51,77390,19676,57714,51,43,60697,19675,41022
a1ef4e5cbdd8cfbd30d1147e97edd334,91,76,112312,32202,80110,69,48,67486,29530,37956
75c38f7da270708838c08b475e9270f7,156,137,337910,130263,207647,115,88,345815,78566,267249
da2a7146f4dea078bf3d6ecbf219f14f,52,41,46632,11839,34793,34,33,39394,15057,24337
fc1373e2b3f51ec8cab6a0c74c183c90,156,116,395535,94457,301078,183,130,543275,85324,457951
d3781d83b2c150bce1f141294557da73,127,99,446757,102048,344709,131,113,381029,121290,259739
eef24809cc965c02143d2c4a7a491daf,95,71,214072,63680,150392,110,80,213776,56660,157116
4705ec712c9dea6040f95f19d1f890df,128,94,258764,47343,211421,95,71,195616,38992,156624
57b48b97c54bd370328d17f7f4b1356d,118,92,378673,61705,316968,139,116,398015,62488,335527
2a167b93f1222dd716fda50fd12277b3,43,39,52073,20629,31444,43,34,39774,20356,19418
c6b61f0d186627b680b9871b1a18e1b4,151,112,480126,72641,407485,136,108,469038,104756,364282
75acad1c4e51ea95491b97da6fe61c51,32,24,19914,11280,8634,40,27,29313,11246,18067
b679a26fc3a8199ba4cd91539d6553c4,100,69,150587,33255,117332,81,68,99851,35198,64653
f35da41910b180708c9575f5e8cd5d83,81,62,171051,31721,139330,94,83,149178,55507,93671
0b897b58b520f84cb23d62c136a735af,150,106,321887,95088,226799,130,96,377200,59704,317496
bfc124c4ad899134ad63a0b92c88591a,27,23,14530,5072,9458,35,27,19750,8272,11478
73a7bd4d2e269f0d7be9a8596faf98ab,54,39,61282,14095,47187,42,32,38168,11341,26827
77b1dd5eb6ec388c7acc60e7af4c3aed,125,103,337760,62104,275656,123,107,344665,70183,274482
f70f64a0a402f54d4e52aaf6e6bdaa19,21,15,7239,4046,3193,16,16,9206,4036,5170
c2e83e9ea9458e3d741f8641fcf22986,31,24,18159,5871,12288,30,20,13381,5617,7764
e0513d85dcf258a83dc55c409a5849eb,121,91,227952,47671,180281,94,73,168273,47969,120304
1cda5796e2ad8e0ceda9284a593b2bd2,118,88,223604,39601,184003,84,84,191349,55721,135628
f6ee370f2292042af29789f9a3c42ee2,92,74,143808,36843,106965,82,63,127911,39036,88875
04deb1a2c5ad8e8b84ffb2a00a313654,26,19,17858,6326,11532,22,19,11065,8044,3021
9c2658f51f4719f10434ca9733776779,43,34,62262,17437,44825,37,31,46168,15555,30613
1baa0d950df1ced4279b18c922c72479,96,70,166141,44156,121985,83,84,128611,42242,86369
b8d200d6c177fe70cf56e21a3f136c50,174,137,523613,93257,430356,160,114,415109,78244,336865
16aa60b4d3aa3afb0b6fdd4e60700f68,82,55,162010,34779,127231,95,82,167844,34870,132974
a5b0cbb6499caf38df558529c6598843,31,21,9828,4879,4949,31,20,13023,3906,9117
ad59864c8a4108808de032c1b6703654,31,21,11375,4756,6619,27,23,8378,5058,3320
f9459dfee42cbcc46db087a45c0a2beb,87,70,113629,46492,67137,96,86,182094,42125,139969
47ccb5d4ee579ddff40e280d7563d0e2,91,68,176834,42743,134091,120,101,192121,41800,150321
b82155c1fca1972598ca2464e48e87f4,114,98,228749,57790,170959,109,76,253494,80820,172674
9df6db21e9678aac2ce867d5ecf62f6f,123,89,317057,47276,269781,109,82,214574,56128,158446
dde110f89428a61c427c83f1570ff1f7,132,87,326652,76424,250228,148,125,403928,117035,286893
f0ad53925b5747d0ac75091fb188ae5c,19,11,4530,1136,3394,18,14,5019,1539,3480
5683e0ab9baea3a573264b0a61cd7166,86,61,172035,54199,117836,84,75,129542,43306,86236
4090599e24389d1a9c4a8fba113c0e2a,30,24,15119,4534,10585,37,33,15473,6047,9426
b2a99e8237770da3999585d26e3053d6,29,24,11240,5868,5372,28,22,15339,5977,9362
4b69f5b1a60afa11e8a59668b2997358,49,34,39430,14623,24807,39,31,39747,12755,26992
784746c9ee671d15452397a66eae55bd,228,147,591388,95450,495938,131,98,411717,126641,285076
294af21c50a46ae851d7dd29c50b7a5d,144,101,314701,52534,262167,98,66,188564,55664,132900
230708168e6fe8cd67511c0a67e93361,85,57,199113,48704,150409,101,64,167745,64042,103703
0c74c11c89e241bee91982689a35a4b9,94,85,157385,50031,107354,83,71,141244,38116,103128
3a667006b65acb7dd68a4ca608f6e3d0,15,9,3514,387,3127,15,13,3106,843,2263
e99f09c7beb89edf55bd9d6cc5539b0a,134,107,328416,59089,269327,162,108,335011,67586,267425
d73a05999272a42cb5fb84fe7adc940e,7,2,827,204,623,2,7,204,827,-623
20f26997fcee5afdcb5dc21457d3d9a6,94,69,149123,54415,94708,70,60,130204,49770,80434
f6d40f071b8eb0db8c7276fdf03e2b47,57,50,112060,35036,77024,81,73,122029,45850,76179
b6ea41d2ed2bc973d54a6a52fbd5430f,44,37,32277,10460,21817,30,24,26096,6239,19857
d9f02a7592a35fd96192a33b3e695de1,135,75,393246,104180,289066,161,127,562414,114267,448147
a57a1dfd5d0a4e89b749cdfbfd620cad,64,51,82881,50453,32428,67,54,97708,34302,63406
86506fd54c1c04356e2bc9195a51ca42,91,76,193625,59272,134353,92,78,198989,83030,115959
76830dc2a36362d945c09a282af050ec,105,87,411033,102305,308728,168,115,437922,96089,341833
f2e1331b8cdf3780eb8b829a3737e751,145,95,285988,88075,197913,148,116,303969,64363,239606
ff171d035c5c007d19a8e06f048e1b1c,128,101,289784,74254,215530,145,100,277460,69264,208196
666f2e5e38b1378fde839a734a8b8375,36,19,20829,7032,13797,31,20,21946,4882,17064
53a48bccf3430ab5af04ecce4131ad33,133,91,265968,55367,210601,113,73,161018,57280,103738
c84cc060fb7756e5319c71051fa73009,95,78,174495,77862,96633,188,138,428116,77747,350369
a2445687e2be931d112a1f5513959db5,178,141,873662,158307,715355,192,130,769297,142011,627286
49347fcba592d307f110eb5b44025980,56,44,86340,29032,57308,86,64,127877,28560,99317
00fe43d48188f37b1c2cb29822aa3f50,35,26,31202,11022,20180,49,35,42107,11236,30871
0adeecbb25370d470c36eb8c2f24771e,69,47,73025,16412,56613,46,41,61346,21806,39540
15ce81392b13905c594810cbd1c16247,158,118,367782,75033,292749,122,91,305179,62068,243111
8f9ab126d51621e652860d85d2ae5679,80,61,153917,28183,125734,49,42,58255,36856,21399
696ee231ec4722ba1d6b2830768a5294,84,67,113580,25977,87603,64,41,103889,23021,80868
99706843a309e3134adb45f77e15f73f,46,49,38826,17410,21416,49,32,36853,12815,24038
3fef762f63fba63767cfef26ea84bbcf,1,1,141,115,26,1,2,115,212,-97
5d943cbb3c11eb7306d9a8f25ef868ea,69,55,95760,16734,79026,45,33,44520,16468,28052
13d1f98a9a166e293734fe78ae1e3d1a,53,37,44935,12053,32882,61,51,35763,14213,21550
ba1d91bec23600998ad7c236ec13837a,67,51,114480,26329,88151,80,71,149461,40518,108943
534f25b256430aaad5f2c2be3347ffd1,95,71,136062,42238,93824,81,67,129780,39417,90363
01297fbcf38d40b45e422bd273a609d5,158,139,462785,76224,386561,110,82,255845,61875,193970
12baad93bc918273915d6e05d9ef4c8d,145,128,600423,135066,465357,208,147,759324,111797,647527
c3c471ec8207c2cf4f2765c91417c22d,87,65,171938,27364,144574,110,104,208702,55409,153293
a03b86407ffa23a00973eae1775d5c78,138,114,446784,92743,354041,154,132,349351,128289,221062
c8ec2699ab91b26a75e1687491df72ce,11,14,2047,1708,339,18,10,2077,1058,1019
f387255789e8aafab323462d5be0151d,150,116,302957,80687,222270,118,86,240400,65905,174495
0cf7fc5936c3a538ed0d5e803879c622,125,100,299577,67357,232220,123,99,300904,61249,239655
f1c78cf3e870baa6a49474fa0ecbca43,63,52,89735,29016,60719,47,33,97885,20862,77023
33f0b92fd12d49160ab0737e6d1404c8,49,35,50283,17050,33233,39,29,46425,17162,29263
fd164ab018319df37e1ea476f409536b,138,108,314747,99802,214945,145,106,422247,100721,321526
2e23529becc78084eb3c04f2effac9a2,95,72,187630,66701,120929,163,106,316431,60879,255552
338966f2b16233e8444da4cb8585c239,141,116,399457,130810,268647,152,111,337178,124577,212601
8e4724036af05849390555e1d6a7fb74,85,73,164174,58380,105794,79,66,164075,56483,107592
ddaf551dfcdc8784c12a32123f9b6561,36,35,28747,16732,12015,45,38,44875,13022,31853
27b0af848aef72844f10104f11e72c70,161,119,412631,83116,329515,175,139,382439,96358,286081
d31aa34fca0d97feeaf20831d7dc3a71,133,101,383605,85781,297824,126,86,261014,65675,195339
77f43ac9f1084acd596e1a073d98215a,24,20,10028,4055,5973,27,20,11017,4567,6450
68ad717fc57637ac0efffc4c45f630e0,47,37,59997,16160,43837,39,35,31234,15848,15386
5c9528e4c2ad27725cf442006f9aac80,150,127,686368,231924,454444,172,127,746548,163544,583004
de66a3dc04c02f19d340ab12ec2a8f18,165,136,677228,147613,529615,178,122,566154,133769,432385
05ffc2991bf70816d26eb4d5e41bbc88,86,62,122966,15968,106998,58,55,54877,26523,28354
7a91320f040b6adfe70a665a64295f2c,62,43,108364,39081,69283,107,87,167301,40789,126512
8c6ab9e537ec40c2e7c5c56e88a5c87d,144,112,484656,112555,372101,122,98,430742,99990,330752
c83ab1b6761bf6733dccda8db3f742d8,175,117,766824,161785,605039,210,143,738255,161222,577033
ecff9569165eb7cbf8c234ef787847e0,98,83,145899,36588,109311,89,77,123188,42996,80192
279dfed00c9044759849367b1b1eb2ab,20,14,3908,1899,2009,17,15,3529,1469,2060
d4c3b7cfe527e79335ea464e70639b25,218,175,785782,154946,630836,152,138,824674,184946,639728
16f4d006117e97d2f1b686b1886ef7fa,85,59,149487,40062,109425,78,59,121081,37129,83952
e718d6f8baf8deeb31850fb9ca883384,91,70,107921,37726,70195,106,82,167586,39216,128370
65e5767b2c36a65639469d601b276a49,40,32,50908,15714,35194,36,20,45457,15281,30176
713d60855d31dc4909564f67fa3a77bd,65,55,127743,40349,87394,141,119,282007,60528,221479
b090379c60894612cd9c62b9f1f1a699,30,24,10745,7936,2809,27,23,18543,5462,13081
4f799d65c18c9a4a15536f3f58398db2,54,37,65805,24731,41074,53,41,62973,29231,33742
4efb72f4507c91975bb2e6d0d0e996d1,151,126,454878,85334,369544,128,112,310468,124418,186050
b12e8083d00984464426881486d163db,44,41,35040,20688,14352,49,43,56517,18257,38260
ae57ec078b1a7d751b27cb97607f6a41,138,106,348940,65258,283682,148,102,383331,46532,336799
4c686380782bb538be29608a422d4077,44,41,51109,38509,12600,65,41,102885,36310,66575
10378a2a16292ef0e95372224b5c0e2f,51,37,44192,10730,33462,34,24,23720,12233,11487
1232d865d14c39e9ca4dc6f3fc139c80,42,35,45564,13555,32009,53,43,46076,12973,33103
c213b3e1cd77fdacc249de8bb35e19da,25,25,24061,10592,13469,21,17,17262,11638,5624
0a3fc1a2e95a297055da3f17bb55271f,29,20,16935,6672,10263,29,20,15886,4013,11873
b51a181728384adc2c945d2c13443362,102,75,182256,46378,135878,97,76,165019,46655,118364
1ffe2d4678b766cc07787c311937147b,98,86,293098,102441,190657,144,108,367373,120973,246400
5217f5338da05949c5201e49542162d5,77,54,72781,31445,41336,70,57,91892,26163,65729
b9b1ed45fe45a552403a035afa5f47bb,44,29,53026,11037,41989,37,33,29928,19617,10311
80ba637636aecfae1b4b382365c68b8e,25,18,8447,5435,3012,28,22,12431,4144,8287
a4c56ed32b411fe89ddd5af8fd02a4a8,50,33,49590,14532,35058,39,37,43460,18264,25196
b5cbdadee1dbe03b33b32d1a61979029,152,110,691687,147085,544602,165,97,535531,152729,382802
6fb531905c91c6cfb22ffa1b5ae54881,86,62,130992,34720,96272,70,58,120636,37199,83437
08b097a6668eeca93a2d22613bd12a51,31,24,25446,9484,15962,28,24,16962,9410,7552
f292e5fdd10259692f11e172b1ad4271,58,40,87766,28537,59229,57,50,80724,34615,46109
6d695f786d0968143f1b32925cbe0cae,117,81,256187,73696,182491,74,62,155135,71434,83701
cc7c7dea676ef0f7af1e6671d67ea1fc,13,11,1811,921,890,19,16,2940,1416,1524
71cb863ef1b1032ba9b6a0679d26bd6a,194,149,655761,92735,563026,208,164,556280,106733,449547
1a7dafd98d90bb9b2a3cfae0d22577a9,124,97,290281,65709,224572,107,87,241825,48268,193557
ccf47002aca73b94839091aa53930e2d,50,37,64589,21103,43486,47,36,53009,23686,29323
e2cecf47da19d77445d6a8636b5e5c0a,56,54,47161,17520,29641,47,44,57487,12152,45335
3b882fec93731de06041308ac599f3cd,25,25,15499,5144,10355,27,18,16788,3781,13007
1e48a710b738fbb8685da705f0154478,114,96,207062,56938,150124,131,107,300432,69562,230870
8b19130588c748d1249d8fdeaccd9418,65,44,100233,34558,65675,69,50,96331,35299,61032
b8e22f6711c23b82c64284c1a1a51310,143,90,298269,72290,225979,157,138,448735,87491,361244
d8d75d10fbe0c0f929eeacc9bac8d933,162,109,474514,87829,386685,135,103,432058,103176,328882
d537ca047f5fcc9669a36de2ae12ba3c,35,24,35307,14298,21009,36,25,40039,10035,30004
657dd76e7a08ba996f8f4f704af4deb9,134,97,307725,58134,249591,129,109,312686,68229,244457
6e8b9ee0503c74bff046b4c9c2bc7a4a,69,62,98655,35802,62853,75,53,107490,26516,80974
44327e721487a16350810c076442d9de,86,63,133726,35027,98699,58,48,101722,37934,63788
086330d62cdfe0bd8217b79baa6119cf,58,51,91371,30628,60743,72,51,81179,27502,53677
3bddb0ab07a5ebc5f5881c36817ae8a9,15,14,3772,999,2773,23,16,3881,2237,1644
b3e6280d30e5dfbe4f58d4fa7f7d1e58,112,99,377129,95355,281774,132,121,434392,89865,344527
e8f7b0b07a2c16b983edd3c2a0b058e4,83,70,119022,39271,79751,92,76,135172,32151,103021
802df43cc41afe6bc1025a5f8f7c989c,118,95,236171,65783,170388,126,88,233123,64201,168922
ead631b88163927e88300a83ddd69942,114,88,202955,59617,143338,84,46,146583,47376,99207
143053dd4e48d80d4a327451975f2847,62,54,126310,41343,84967,118,78,158665,49063,109602
c1c2191eb98df29986b1ce84a5b4f3c2,105,91,223863,50869,172994,114,86,239108,61234,177874
611dfb121d57c12d58baa2f1cf554794,140,109,336369,36240,300129,87,78,135936,56749,79187
37173e7d175922e8ba7784d8146516da,61,45,69888,20627,49261,49,37,59109,17634,41475
8437af62a6fa5becd679f12407cae81c,94,74,219834,53130,166704,102,75,221429,46190,175239
dd2b25a74c6e81401abde39a84155085,74,58,93425,22673,70752,58,40,67530,27139,40391
b1feb8cba3536549254efced40573be7,132,99,212683,33819,178864,83,79,147624,44968,102656
049e7a493ceb935af94b4b660330c9a0,65,47,112931,23246,89685,97,70,119530,34738,84792
14fd7a69289ba855338181a72112e8da,109,96,229468,70459,159009,115,88,253464,72575,180889
7e76f1e0a2f62ccda227e0e2bd4d1a38,83,68,105564,28938,76626,95,66,116161,28745,87416
e0df848d4aa28bc990142d7609c91734,183,130,506094,94725,411369,143,107,383465,80067,303398
e3b24383cd822f26f0fb0899250afaeb,33,27,27464,14805,12659,49,30,56860,12417,44443
333b290b7935e2565e34e67f2260bf68,110,85,264366,45597,218769,92,78,189306,46829,142477
1377233818bfedba21801df4ed9b03b2,99,75,180698,41475,139223,87,74,128479,41403,87076
9f9aac8af8365c07080d0f6fa6cb2366,16,13,2297,1280,1017,15,13,2275,963,1312
6861d8ffedf4dba6aea95519ecfd8b37,111,74,291147,47257,243890,108,79,210448,55569,154879
395d95002e55a372dded7fa903d640d1,75,69,107390,42131,65259,53,43,103150,43074,60076
80b2d94ecbbbd4a1740da4d060e83fb4,125,100,221337,48721,172616,120,81,208893,51947,156946
121d5656826af7191854317cb70b8d4e,97,79,184171,34309,149862,81,72,161015,48533,112482
e4c4d5b8ef370c3c02fffac5ca55ac03,97,83,268428,47838,220590,100,76,192354,32460,159894
b0e2431afc88f0673c671b6d7892529b,86,59,131066,30093,100973,121,90,190268,44004,146264
248563623ead648bcf524e94d67c1c84,179,127,575079,171146,403933,233,158,919137,132329,786808
9ed522ae1f6d5b2138fbd99f175ae898,75,51,97481,25078,72403,48,35,76929,23246,53683
542e9fcb27497897e879b0f7b98521af,90,71,154186,34322,119864,74,60,70783,37254,33529
e0b9d794779c67e79edadcb0b7b008db,44,34,55020,15507,39513,47,35,42198,22211,19987
d320770124b4a2b3d8f028ab27a9a01f,90,65,170501,32696,137805,78,63,120777,51649,69128
7f3886d19741ff4f5894fc87aef45e42,129,105,278950,60861,218089,124,105,250600,58706,191894
75a3e355f27e00d006be612cf6a64e16,39,28,30482,15839,14643,35,30,33188,14343,18845
809a4ba62481d0124b99faf48c00e13a,150,106,372320,100745,271575,129,101,562576,77276,485300
852a2f0e90c7ac9f0347f2c0eb23d130,179,151,895942,174073,721869,158,126,1033998,168726,865272
0e58294e78e03fccb3a21cfa05137d8a,104,79,146158,29598,116560,93,63,121543,24768,96775
081a23b62ce3ddffedef1956ab4c2a62,173,134,703488,132102,571386,127,108,458122,149965,308157
baf8d6d55e0df56bd292abdf606400d5,139,110,402639,104513,298126,182,138,551725,96418,455307
de16b5cd99d9318ac6a673c97bc4ce2c,47,38,74867,24104,50763,70,49,104910,29349,75561
c4aa30fb914bc7ed72a68009d0c02bc1,122,103,277852,77148,200704,103,85,234894,63458,171436
028aac266f7322325a1e476b102ace25,31,24,33951,11953,21998,33,26,34660,13676,20984
c9059aa2d453e87aa72c90713c91ede2,65,46,142990,28832,114158,96,69,186229,41314,144915
0dc3a1262a2b7099734c61e6128c687d,28,24,13990,4178,9812,36,26,7945,5662,2283
d5567f5faa2da778da8a47ec18e27fbc,44,28,35075,13176,21899,46,33,42265,10515,31750
b04e8366149be8ef915e8c5f500a77c7,36,25,26247,12234,14013,38,31,38714,10987,27727
0ce30f9ddea202b528c41afa1618ee33,120,87,252953,82667,170286,101,79,225337,68581,156756
3b4d87752ac65103180ffa0bb818d8d1,98,71,108390,30096,78294,110,82,148656,33933,114723
e4c2a2f1a5ec8a57c11c285cd4f9b4fe,21,15,8511,2124,6387,17,9,5289,1498,3791
0804a8ba6611079ab37c096a6dbda2aa,47,32,49945,16644,33301,39,37,48880,17387,31493
3358628eebdea346db0bbd94b696da9b,174,115,631869,123859,508010,169,126,511010,156602,354408
2bc930ee5e0ef4e25231f62331bdeac6,97,82,234480,62035,172445,110,85,245592,68874,176718
8a6414b545cf05ae19c9b7c0363dbbd4,128,110,393913,55076,338837,114,92,266545,50808,215737
77d4cf5a9f7e1cafc3dd32f95f7c7205,179,109,518280,82600,435680,127,98,349992,88317,261675
79e8bb6e6c16e8fcfa038f1b7ebcb79e,127,95,304841,39709,265132,118,104,289391,57781,231610
d20ec056b4ad493fe146d67c35178c01,88,55,126810,30376,96434,113,79,185763,35891,149872
5fd3d4d6fb973cbeb731667e7e17fd4a,26,23,14231,6782,7449,31,26,18015,6743,11272
1840acf770ba324a0431d1b604864cf7,46,28,44418,14509,29909,65,46,78709,21755,56954
28e31a261d8b86fb8c7d6daff80534a1,157,90,352991,68932,284059,128,101,244507,68889,175618
152885d754ae2b52a94ea3eb6bd2df63,51,40,117899,29599,88300,52,50,100941,46086,54855
963fa60bab9ff1c149e59ec1b1020921,89,75,218526,63992,154534,107,97,241702,61879,179823
9aeb37f23f60c41d5c91fec7b3713e9c,26,20,8609,3661,4948,22,18,7171,4470,2701
3c325e2455429aa9a26bf8229fc92791,207,142,718579,184343,534236,219,161,863654,125134,738520
5180242662b713d227387572f1521e26,53,48,70010,29492,40518,52,35,76244,21279,54965
2ca89259b6dd6b40034be707aaca7f6b,196,137,704587,154766,549821,193,139,644728,144057,500671
eb5726efa2131c2f15c79e1354a6198e,45,41,60672,24606,36066,59,55,86508,24593,61915
69be5001180cdb1a10538e7e7e2e99de,93,75,158608,54483,104125,87,62,154219,41244,112975
641595ade101ae525ce941bcc4cbe671,20,15,9260,3893,5367,19,20,9118,5155,3963
ef9b69c41f1efe7faf4faa6ae2dd0e30,146,101,206474,39841,166633,104,77,160607,35421,125186
f2bbfa9a2660e4f6b5d363496af8f4a3,88,79,173467,32868,140599,72,55,122029,37265,84764
4692ed27ca31d1d95809cb0e63bf38a7,30,24,23207,8798,14409,31,26,15801,7801,8000
bcc1c3413551d0591c4b9e61de1eb393,135,89,365453,64659,300794,122,102,269217,81835,187382
55cff52e65b08ac1726d9dbb38ad6eb3,91,71,228728,46873,181855,126,104,264311,41188,223123
5ab2a06f861815f7a8087d7fbf945fe9,58,46,84089,20540,63549,76,63,112512,27462,85050
4d26ecb3247b75122976078e40eb9b62,38,29,33583,12895,20688,31,25,24692,11166,13526
76539efdd5988bebf65a4ed25cc36479,58,48,52219,15809,36410,39,32,30584,12993,17591
0cd6d716e4c579c0ab4a61a078a9b005,31,26,24321,9806,14515,44,37,37751,13722,24029
ab606df4ab64e621679d22209fc70af2,38,27,24716,11779,12937,30,28,24871,12400,12471
7fd10c15dd28fdfef1db58801be979c3,122,98,263102,74002,189100,133,107,304389,51632,252757
3a44a2e4de6e284091d6138bb894b402,43,30,48714,10431,38283,42,38,45584,19304,26280
47ddf03a87269aa72106e39eafc44676,28,22,12009,3758,8251,20,20,8747,4432,4315
8e63bc40b30a814c46233f3e421b45c2,34,27,35467,15353,20114,48,37,56523,11530,44993
cabe3dfe23f8623ccfcf0b8e10b0c92e,53,41,88766,39551,49215,82,75,153793,43697,110096
e848a7d9b3f6c65196b6a891c225de79,71,54,75886,18356,57530,60,48,46982,27455,19527
489cfff02ee8c8d3cec203f5fe729366,73,67,164745,41141,123604,73,68,100950,56354,44596
5b57648fb2cc62695aa9db3ff404b802,75,62,94241,31650,62591,84,64,105036,33777,71259
59e6fed5df147fae16c6186720076fb6,69,56,90820,27939,62881,69,58,114257,27036,87221
ed895b6fdb644437ae7e6c2eba7c7358,101,87,210570,56105,154465,128,109,308313,54558,253755
26b3333eb1652c26b713d564255f205a,134,100,282720,54037,228683,151,129,317235,67060,250175
89d9e4b92029a40b9af823d770799ac0,28,19,21091,6867,14224,28,24,21137,5379,15758
75462b2b4bf66d184ffc419c80a77f02,1,1,45,234,-189,1,1,234,45,189
e5a0a1a0d3a595a74edff0af9fe2d922,121,100,247727,83091,164636,99,80,232904,52628,180276
2c954c4f2106e777ccf4d743abc8865c,7,9,783,1110,-327,8,6,1101,708,393
df8e75fc19dc4060cc3720d1cfcdd1ca,58,55,105647,34597,71050,74,56,89702,33398,56304
a37f5975575dc55db5ba4f9ae4d1d1df,53,41,96778,32669,64109,67,53,106140,35093,71047
c4e5a1215bafee2ab3c41bff95747f99,128,94,370323,73028,297295,126,86,283529,58952,224577
285a3dbbd453c8568dac0190671b1928,79,73,108258,36583,71675,99,66,169419,32531,136888
440174a2e0112d0e5482b81b2b08e131,25,19,7985,3058,4927,26,25,5512,4207,1305
76118958ed07e5bc001371509afe488b,144,110,372889,122730,250159,181,129,409996,82399,327597
fd504e47fe467b9b0bbb787059cfe68a,11,5,1232,227,1005,6,5,355,222,133
dd59f5c293e294e9c50bfef980ad88c7,42,30,47361,18397,28964,58,45,72114,18377,53737
6630a8f98da288fdb4906a83e89b50a6,62,44,62574,22570,40004,63,56,75975,16669,59306
0e0991012f810e3d2ea77db64dc533fd,72,53,139088,20166,118922,61,56,86732,25226,61506
bfa3d2d2b1593318a5e91fa5a2811fe4,121,101,307914,83605,224309,117,77,292226,57021,235205
03f364d04b15fc3aec0411667d1dc1f9,170,122,674751,130249,544502,112,97,391883,189797,202086
2e01ce75a201d41c1ae24d6922d8c5d6,139,102,351194,87318,263876,129,114,315670,70324,245346
f641a93e4f9d5d117043e463bcbaf388,84,56,139647,39036,100611,55,39,51069,26980,24089
8ce56650faa451a8683a962fffddd32e,30,27,38229,9581,28648,31,24,32027,12658,19369
b51323c6904ac1774859f7f5b9c63eff,109,100,209578,46685,162893,80,63,92435,30538,61897
e782dac4f7b0fdd00525c5c78a687c44,164,128,497992,118616,379376,145,108,405532,105345,300187
8a3d08494022c7838ecd806abf05daa3,101,66,298211,78366,219845,163,108,321453,84469,236984
faa95feae3cf71b5aeacc9bd2d52c672,81,67,126760,30463,96297,89,49,107611,25057,82554
4170efc096459f27e1f73a9bebe50555,80,57,127191,26811,100380,63,49,95877,27481,68396
a02324bf804ef725eb14cb154274cfd2,41,34,33080,15379,17701,38,30,30043,9876,20167
e65b2d7daa26e7386246738edfb77fab,125,97,248232,67048,181184,122,96,275454,57774,217680
09fce74b0341ec6ee1cab2d41eb71b90,42,29,38140,15642,22498,34,25,31974,15350,16624
7fdc92f8fe3d808aabbb7703f7ed7686,95,57,181271,67304,113967,112,70,198517,55281,143236
b7c15bbedc2b7349a6c842c3b615df1f,83,61,105062,26582,78480,75,62,88177,34974,53203
9bf0bdd213df1553b9914f46c77f1075,41,35,57501,17886,39615,53,42,58374,26777,31597
daaecb9438fe455ee6291074fdb8cc8f,57,45,68359,25395,42964,50,37,51574,26098,25476
927a700542ec6314c7f4aee8633bd4d2,130,109,275776,74184,201592,154,107,352469,84650,267819
772f8a73f73007ac09f0df6c51a0b0d2,50,38,39637,21704,17933,45,40,29441,21204,8237
7818f49b8a5ebe822a9dbecb96649b90,110,87,209803,59519,150284,74,69,155632,59470,96162
50aec74530b11e0ce08ac24e3f151ee1,158,122,464207,96041,368166,120,110,349526,89877,259649
cfb7b17e5ed595d1221e689a097d1472,54,37,79054,25699,53355,60,46,89334,29140,60194
9da5021e0df5b7ab06cbdee6fdfce2a6,49,38,76700,14931,61769,41,29,60882,16652,44230
4b29a9d89a312262e579758e3a5b2e96,140,118,462078,113587,348491,188,132,622607,106415,516192
365d615f7c28eefaa5271dd9ca203055,153,107,308370,104288,204082,135,107,313350,85769,227581
e8be4b608f2addb036b9827b129aab5f,51,45,51979,15327,36652,44,36,41856,17254,24602
2a5e4ad9a3a72ddd6a6a973b0bfa6f83,120,103,223879,58206,165673,119,85,288423,40448,247975
84043c160a071d1e31547451beb0a337,91,78,130490,34518,95972,84,66,122357,37809,84548
ff75b379ce0330b80dbb35e1377a259c,110,83,194801,35562,159239,117,92,216544,42285,174259
2ab980e7fc61ada85e3bfdd579c68b51,115,83,329594,54452,275142,142,111,323341,66153,257188
cf4a25e888694f5ad16a51ec1fa30d82,73,58,107132,23317,83815,58,53,76373,26461,49912
0748b22801f4dea5c5da9d91939ac7df,139,116,385608,67386,318222,131,106,331468,67846,263622
9a15d2f6580fd5621395ad126cf56ff7,52,51,71320,30420,40900,55,45,102024,29629,72395
a1bf164f6aff92e6b145218ddd4a6e47,28,22,15910,4341,11569,26,19,10071,3978,6093
5599d275b796115c30f4b74e1075528b,54,32,80618,19105,61513,72,51,105398,16805,88593
d10eb803c5e5594e8ab5881aea3fd7f8,43,34,64604,19494,45110,41,32,51636,21609,30027
39a90548fab81c6f8c81fb9a59c0edeb,31,23,25520,10081,15439,21,20,21507,8758,12749
0876c6dd7be192ce1effdda26e0c1d6a,214,141,1340532,147487,1193045,197,150,900306,151604,748702
5b25a0f15a9cda2a8ebeeaebbfc24c8f,160,127,483894,85913,397981,102,76,362672,87658,275014
75e5cb9b937de12cce28ba30b40104a4,34,21,25710,8005,17705,36,28,19661,7645,12016
43efc8e0846a295fa4bf2360f408f6a3,156,120,384171,95162,289009,172,101,367682,81072,286610
232d4dded94c10563ae48a07a5d3e348,23,15,4909,2562,2347,15,15,4736,2905,1831
3dfc539e4a7f886e81722519799e74e8,50,41,64110,28250,35860,55,40,69594,22434,47160
94291cfe14f911d0e6c223287c6b7851,36,24,50504,12917,37587,56,45,81471,20306,61165
6b51960d3a95c54bd3c06edc48568b80,238,155,1141672,232970,908702,197,133,742150,222741,519409
7d4345bd366abc7cd370ab840601c217,145,114,464176,120582,343594,151,112,455322,127084,328238
af8f7713e96cbe41f85d11b3d6ce47bc,98,75,214150,41705,172445,77,61,88672,34424,54248
3bb5c604668fda0204e1edde266722e8,64,43,78895,24407,54488,36,30,37879,24454,13425
23352c29c36c854a8915d735ce76c3fc,136,107,297504,57827,239677,124,93,277894,63921,213973
4c0800dba0648d5165ee513b1f6cde2f,3,1,258,19,239,5,1,351,68,283
5421c7cb5ac14ee7d8c626d150889265,56,42,62288,16737,45551,42,32,49856,13800,36056
e2f85099ddfd6961b064e4235ce5a804,170,132,385935,71737,314198,149,115,431018,100763,330255
3aa0a93377fca041d34a94862824d233,57,44,96255,23847,72408,68,56,87279,27170,60109
935b101d3de6ca994d0402142ec4844f,56,53,82374,23339,59035,75,64,84041,29823,54218
b41225779f4512afd98d01b97cb0e81b,115,78,265642,44326,221316,133,101,377130,46298,330832
ae2e3e868ca9498602c3fb77654788a5,60,50,74011,24158,49853,60,45,59341,17086,42255
bb6d048b928a91e50b2ec585c1ef888f,38,32,72688,14178,58510,31,28,21515,18295,3220
10d55b7341f115c350b6577cccbfd312,80,67,161304,34563,126741,81,64,98340,28682,69658
3ae66ea57bc5c1895e5790eec944709f,230,175,1052500,194535,857965,181,139,947694,205635,742059
46b73571522eb97f124a10c8b09a7334,29,29,17646,7833,9813,29,23,17730,9300,8430
173502ed0bfe6827056be17a830fc69f,13,8,1322,336,986,11,12,749,852,-103
35ad41b3b481d14aa0f3cfa9fc5e2ca3,116,96,281319,66839,214480,161,124,467691,61303,406388
54b18c88c3e1cc5e6d36e9e69d7d51e0,81,66,149749,38177,111572,91,73,115901,49745,66156
4be873bb2100b7297204e06bc97d5f28,85,65,97614,34694,62920,102,67,133491,19272,114219
b34e698206f45e3c2c0ce61bf9272c72,52,47,124355,35612,88743,90,75,179368,49126,130242
205e85408fa923b744523db4655f7cf7,36,31,19277,9296,9981,32,28,21044,7725,13319
ad43ff03e0dc708a3b621f436fe9feeb,48,31,57664,20558,37106,52,49,56110,20974,35136
bb867856e1d3d43d2897de781c8e7fc5,37,31,42442,12837,29605,42,36,42904,12359,30545
1bf8b8c74d10bbabd9bb4bd76e769f9b,108,92,336384,72372,264012,163,145,410108,75983,334125
10049dd78dd9b0ac4911179b0b72e2ae,171,137,384694,89925,294769,138,115,301776,83303,218473
ed32e33a96d13d09cf57cb60e2aa0a84,70,57,102534,48518,54016,85,70,155563,49282,106281
c549959ca4086058892376bfbc9ab14f,170,131,424522,83278,341244,122,92,284512,74661,209851
f2492634af4ece94cff7b23556364933,17,16,2464,1046,1418,11,10,1152,913,239
d9192f149cdea95ce1684e87b8492bf5,60,44,80503,21476,59027,66,48,72863,20701,52162
71c1cf055eaaee9f84aec53325c058f9,151,129,460510,106628,353882,180,150,518263,104128,414135
2f2a35599fa7f86687c7c42de44baaae,156,133,700586,142837,557749,202,147,665568,151024,514544
625a81743faf832e34676308e7aa3882,158,105,310702,71255,239447,129,105,239997,93164,146833
9cd1e75404e05ba406a6af84cbbac6aa,137,101,254691,49362,205329,85,72,170295,76077,94218
11a0af745cf4d6a8366d76a3e81f21f3,74,42,105151,21150,84001,56,45,72908,29631,43277
b62f4a1305075533ee64b2a812afbbae,64,44,115111,32332,82779,71,62,105844,37369,68475
2b039ff7633a4a85f65bd9d20cfe6a1c,12,11,2986,1433,1553,13,8,2313,1259,1054
d264c49a54e4e863af6679acce1c8c09,154,129,474161,97965,376196,206,152,600811,98265,502546
c0aa2527cf59a97609dc0aa6dc5cdcaf,63,49,110709,55506,55203,74,69,161530,42473,119057
bfd3ae0ff7cb6a7d9d2c366a51d2f533,133,81,221343,40448,180895,100,67,198753,34127,164626
f24df18dc0b44fd03965d1c87a5d9b1a,99,86,260855,52689,208166,113,104,276293,58751,217542
d56e264493d98ad679bff153c3d29140,129,100,234056,43614,190442,104,68,243523,42750,200773
6716b516ad49b4af4c6598ec619c4ce2,166,125,474174,99816,374358,179,140,555650,165102,390548
f2aa4d7bf5d7d18f8c1375c3c28d7d80,14,9,3339,1082,2257,11,9,1885,1151,734
ee5bd697c279c4bb4c6c11dd4fa1de5a,30,24,32543,13493,19050,47,28,48507,10558,37949
e6f6aaaeb3eb2ed182fc7ac6157fe0bc,85,52,159605,35133,124472,139,102,317448,55056,262392
c028a77060fc849f7c46b0146868535a,119,88,388535,82085,306450,111,74,305606,112877,192729
b7b7bdc874f0d02b76b6f5c811c165ca,22,26,15638,9199,6439,30,21,18106,8857,9249
24a3f1740d43e0470f75643bd7bf65f0,1,2,109,155,-46,3,2,170,124,46
84cb9d4797997677e1541798a39aa5a2,44,32,52096,16047,36049,52,43,62664,22230,40434
9e206bc7555f429edd96a78b665b5133,116,83,238674,54652,184022,98,69,178513,85376,93137
cd5c5c106f194eeee0cceb34f1343475,30,19,7656,3446,4210,24,18,8104,2611,5493
a69e334d479ae21d3c82fb2ab22160f1,42,34,100377,42407,57970,62,58,135160,48873,86287
fb88359b90e6605dd76018eaa40fb962,55,40,93871,25239,68632,48,41,69744,29629,40115
37e4951b7c24fc5acff97605360769d5,177,119,490718,83805,406913,112,89,292079,99066,193013
1fc063794bf36958fe6c7dfd9a487b69,54,50,106927,27682,79245,49,38,79779,23796,55983
052ae696323c37f7b7d634241e324dd7,117,103,289567,73852,215715,132,112,315243,62181,253062
851385cb5b46c34f87c2efeaa87fa350,34,24,20949,5286,15663,41,29,21289,8837,12452
c0732cd134ff3cbc48ed24c2f891bdd8,42,34,40769,16958,23811,46,36,63295,15708,47587
b26b0abe3893b073105500a7863ca8ff,23,18,5287,3422,1865,20,17,4469,2957,1512
62f8401a97d647ba51f38c7e4ef601d9,117,78,327854,71916,255938,198,140,652051,58866,593185
028c892e5bef45554bff66baefe9d25e,49,40,65574,21940,43634,64,52,71543,22864,48679
7f9ac34f547fcac943662456267c89e9,116,102,412946,93698,319248,120,92,310456,76506,233950
db3e2f5e81c8239fa8d53fb5c1d951be,85,77,174185,55210,118975,84,79,161368,40867,120501
2c8ef548223f72bcd180d84ec92b1dff,31,22,23623,5284,18339,29,28,17936,7259,10677
f427f0ce25bc6bdfee132122b19d31a9,147,117,427850,79866,347984,128,99,378029,83077,294952
dfc29aec080a29c995f19490b9a167f1,4,4,1026,1212,-186,4,4,1212,1026,186
9481006efaf3045f3e8e556d8150dfa0,140,100,357181,81132,276049,190,135,562884,96894,465990
6e2967cbea6054f137b942241522d271,49,38,65926,18566,47360,54,34,62893,18060,44833
c67b52b74ea114c55c7b6333b5606451,31,22,18822,10013,8809,28,21,17407,8611,8796
1084d8ac4b6ed518cf0a78dda56e1be8,25,25,12897,5066,7831,24,20,14598,6279,8319
964f38b3de4a8c8bb411488ef00993f8,0,2,0,408,-408,2,2,408,42,366
4606fad933429b204fea54a7d8f355db,38,32,32191,9545,22646,33,25,19591,9920,9671
42eac2f826b9f0f984ef4fcac218c966,75,52,83152,25433,57719,68,50,101146,29573,71573
fa4a87e80c5a44220b2ee8cee1ef3b16,209,140,739604,163631,575973,176,130,663547,188114,475433
274adf503b32a02e2ddcbafb93b9ecee,115,101,285884,61999,223885,124,90,310248,38789,271459
3e958c1feeffb1b16e8ebc694f414f33,62,37,88061,18534,69527,59,55,76515,18177,58338
e5c11afa56a2f49faf997dba4cc3c9e6,120,86,459578,117717,341861,161,122,452990,126055,326935
edf840512a2a08202c8f01fee5800866,80,58,96601,37042,59559,82,70,101078,33969,67109
31b3a8781db4cebf4f938022c87a9473,18,18,3938,3144,794,23,15,5231,2543,2688
5a8e0d8e33607c1071190a42b1f9208f,90,87,191445,79275,112170,83,75,186697,53560,133137
e32dcba633678e40296e4d68dbc1bac8,48,33,77592,28393,49199,52,44,84917,35103,49814
8cb750f3853f038071aba027bd0ea11e,89,82,137228,39676,97552,103,93,183380,40656,142724
1ce266969717502bd999a68e61bc70a2,59,47,81695,28905,52790,59,51,80015,28155,51860
88016c0a51f858aaf7ad18fd65527b7a,46,37,36619,11142,25477,34,29,27011,13604,13407
783a7af829d40e86a1897a510fd16186,58,45,66071,29215,36856,74,55,82709,31257,51452
189b30007f5e58ab17c4fbefaf0603fd,93,66,188434,28975,159459,77,60,122553,45619,76934
68820dcbdb784f4485a3e8b1a3ac6b60,87,70,108807,44496,64311,61,47,113671,39113,74558
9aea6e36dc93b62faf6058ebd8dd3702,115,93,159127,32283,126844,67,57,88976,32530,56446
419335a68078d6def4bc22d6358abe84,174,134,453278,73304,379974,134,90,243990,86477,157513
0ebb0e162478be285b7d0fbb86b038d8,158,122,701661,109555,592106,181,146,694017,130972,563045
974f609f79929c7847f81d13f3c427bc,112,92,253522,58864,194658,133,108,254961,45144,209817
d93966e734f6b615d53880a4baf6c3f9,36,28,28329,8092,20237,34,21,18450,7571,10879
3dca390ca43324fb32b68717116c10e8,30,29,20938,8934,12004,35,28,19984,8359,11625
d2ebcf36e6285c49ceec831d4e5def78,82,67,137553,53684,83869,108,85,224504,42902,181602
4d2b580dd083147823789b326a1cf81b,27,21,11709,3756,7953,25,18,12651,5353,7298
311428da764534f376fdaa3785a704cd,98,61,266210,59166,207044,150,113,450323,65578,384745
4ddcb7a6d7e5d8eaa9f2cffd3436ed71,22,20,6732,4590,2142,24,18,12561,3907,8654
0694aca7c62591079157999f54dd401a,186,142,845258,210079,635179,179,136,807644,186074,621570
6d21c1bf5c4e1077c41d3964df7b920c,157,126,438487,86221,352266,160,112,385432,80094,305338
232b76ca5dc9590e78a3ff150b14abfb,92,65,219716,54764,164952,122,92,243640,62086,181554
57c94f374e1f69b8e50582805a6be970,122,90,254593,73731,180862,112,88,195900,81304,114596
b7629f0810d1553376d8d3b6199cd094,68,58,106820,25472,81348,76,59,107020,31018,76002
5e88ec928ab251e37ede3a37d06c9946,10,9,1237,670,567,16,7,1398,215,1183
313aa198f08f80b8186f1c670e29c1ee,19,17,8296,3304,4992,20,18,9200,3638,5562
bfb1a2ba38ffa3bf281d9472616dd27e,10,8,1191,251,940,10,6,626,271,355
79943baf5475d4dc06178e1479b8af5d,53,37,69100,26897,42203,51,34,82288,32896,49392
1de966494f714202db5453366a1b575c,143,104,263191,60091,203100,129,107,287280,57205,230075
5913bc2f772b16364ad6d8a6a4727444,40,33,31789,6502,25287,37,29,16755,6014,10741
c830215ed7bfe7d878c301f5506eb340,169,124,473200,91654,381546,143,133,427974,94094,333880
72003a2ca5002c5ff2bc03ccc1b20aab,151,124,679017,178888,500129,172,124,577217,98842,478375
7fad412e30ad8f34288e14ce3ba8ad7c,155,109,616491,127456,489035,198,170,914136,141143,772993
da0f5647375ad13bb563001d59af8ec6,21,22,9832,3688,6144,17,11,4800,1922,2878
9bd4892e521559db4c5cb258e0fb64f6,91,61,185227,54326,130901,137,114,313680,78026,235654
e58e09f36ee75c9df4a6385627f550de,84,63,91628,29048,62580,75,71,72559,24981,47578
8c32628748becf5dbb1fd5583e3206ca,91,66,145425,40824,104601,99,69,138352,33101,105251
f74014a2a787cb12397431998352891f,156,113,363882,53165,310717,129,117,330518,58200,272318
520517111d6f1ba12ec7365f8d904ca6,13,17,3290,2906,384,20,14,4454,1949,2505
f3d4aca5f359ef3b5ef508ff21611573,2,3,486,327,159,3,2,327,486,-159
c143931a6a8b3fb55a8ef6b9f30c6933,133,100,400174,79555,320619,119,115,359187,100000,259187
26b68ea3e9b94e5ab507ed25bc971fd9,42,32,41610,16490,25120,62,44,69489,18784,50705
09407a00b0ad1016c94a3d2b4f857f51,24,22,12195,7229,4966,26,19,13573,5724,7849
c264ae7c248e14d461332ee43d8662cb,39,29,51900,14523,37377,58,50,71842,17997,53845
a99cc13942e2bb549dd10eba4692591a,64,42,85621,28459,57162,46,38,57586,16401,41185
1c653af72043f919670e2be481d0e3b4,49,37,60956,20199,40757,62,41,93002,21921,71081
3005e9f3a40b5a26c5fdadc90a9de721,176,143,649342,132174,517168,166,124,467746,112308,355438
a358e1bcc8b71cf74b2445c0b6e8879b,30,22,14455,8447,6008,30,25,19151,6021,13130
952b79b410b2910024f77f4b4393be7b,141,116,527182,74222,452960,141,112,454555,83386,371169
6c2d463c667ddf69e69fef310e5b6307,20,15,4843,1542,3301,16,10,3070,2006,1064
42d1435606980c78b3806a6fef5a1665,23,18,13040,6264,6776,27,25,15737,6361,9376
9a1e8b2ac22071760ecdfeb27744298e,86,67,158878,35748,123130,87,84,127866,35342,92524
5e4b93765f3c5dfe8627b89776898c5c,23,19,8167,4548,3619,21,20,7106,4574,2532
2fa780dce9c7c7093db0181ef0c397d6,113,85,219548,78397,141151,124,104,312247,72336,239911
6bf92312284ddaf1aa5fac5b27bda7b9,43,38,71041,20919,50122,44,33,66793,18116,48677
9c8251dca49dc96f33742882d93f5795,107,79,376854,95226,281628,164,132,495868,125093,370775
23a6898d87cbf7d3bc6c3c99c7eaaddb,96,73,203359,36072,167287,71,57,94492,34289,60203
d33da77502925211006169b0e0cbc06f,23,20,10270,4945,5325,20,20,10799,5655,5144
14a384309459630c185dc86596e4a19f,79,43,85598,19924,65674,64,57,57970,28477,29493
77127a95cc233c8753ec12679fc0a7cc,24,22,7915,3704,4211,26,22,9249,3695,5554
fb9b332df0d42d609968cc5553948865,136,95,406021,38727,367294,127,96,242206,55277,186929
2f834937ecba61f55584b2a018409339,54,46,44564,16806,27758,57,47,73376,17925,55451
c7ef613540ea142b410fafadb9e2b240,76,67,136180,58513,77667,106,80,201112,38118,162994
82ce7fdc6c26c0a23274f8d8ca84a335,50,42,79382,33213,46169,48,45,80571,29387,51184
00ed5add107a1704e8e01d9a8d316268,131,117,424303,115231,309072,163,125,575536,111743,463793
f15c4363e6e1200dbd52aab9ad497a9d,136,101,264870,129744,135126,163,103,371471,75724,295747
ee63169d2ffaba16c0134f9306a80a0f,179,110,627712,125028,502684,170,130,673965,146178,527787
6fe622ade32aa00e08876a92000d11fb,137,91,342411,71250,271161,122,91,286867,102796,184071
ece6c89ce5e90ad7d4f84e499d6a86ee,30,23,20338,7096,13242,27,22,15164,8447,6717
094f9d806b6a49b1835c8a8de1a585af,45,38,52915,15434,37481,40,31,37155,17620,19535
73326b5ebbf3ac52a09c5ec242e7f207,92,63,207569,41692,165877,123,89,189542,58657,130885
0de80f539855b714d3c0febb0013a958,13,5,4065,2044,2021,10,4,4286,1828,2458
7647447e71098870c2377587b7e1c520,10,4,1849,508,1341,3,8,208,1495,-1287
49384a84c35b4eb0d59eb10c1eb38962,50,39,54792,24003,30789,46,37,56354,30106,26248
74862c087c5aa19cabcd02da05c64c8c,33,28,33437,10974,22463,33,22,27402,11236,16166
fb713df6fa939d4fba91d9bff240048d,121,102,233078,65371,167707,118,90,235859,45639,190220
bd9965c7b431d2541bbd7ba1ac222aa5,189,136,599510,103527,495983,135,105,408238,103693,304545
53444a6522c40c50d04e383c935300c1,75,54,114229,34380,79849,77,56,146855,32796,114059
d31e8e8faef6ae63d53fd33b7a1fac13,140,104,288115,64265,223850,117,92,221929,57703,164226
81922ec868b073cad3cb86add0b1ed01,41,28,36170,8647,27523,30,25,19515,8320,11195
b9ec052e99809a04f960d382cd32c499,45,37,38921,18949,19972,41,38,45721,14228,31493
650732f6f50fac23d344b07c406c6d59,17,16,5528,2769,2759,17,10,4328,1996,2332
09423be374a33ddf807c058963e5fecf,179,129,589446,105359,484087,175,141,738467,130710,607757
f9ea143b37533666cd1e6cebcbaba288,37,27,38562,15991,22571,50,44,55957,16471,39486
3fd7e2de6b9d997ff3212ac7b620df2d,38,26,34444,7288,27156,32,23,23759,8823,14936
a56ece0b8d57f0302f89de5eaa35760d,104,69,165844,31966,133878,126,106,263747,44748,218999
c5640e860b315ea2896b4712e99f77fc,63,53,71562,28716,42846,61,43,67943,25618,42325
51ae21dd8e7c86b30be27fe0c1db11c2,32,21,21477,4164,17313,23,24,13908,7819,6089
7c4d149fc8443c22ca453210abd4c082,92,80,163194,48857,114337,107,92,286893,57345,229548
911c62cd2c201c32851d83591792bfbd,43,27,38781,15575,23206,61,40,65120,14583,50537
7ff0efcd7c4bb85874fdc70d3ce1f4bb,26,19,7923,4827,3096,27,23,14953,5871,9082
5a916ab683b0d9b0e12280b30ee91bdc,73,52,97520,31435,66085,44,40,72696,35222,37474
4b2297b7e666213c8ba2840380f8c5e4,38,33,46955,21648,25307,54,43,64605,19927,44678
297d29c0db77d393ea91a969679ae71e,20,17,8558,2983,5575,19,18,6527,2423,4104
5a08c16886d72be070915c1026e8197d,48,34,86585,24112,62473,46,34,77655,23135,54520
6ba1a469cf89e9510545ba119289742c,76,51,163561,33736,129825,95,75,204862,35710,169152
e7934e7d139a96b1bbc5bb3e3fcd895a,77,61,152943,32936,120007,103,76,152337,30766,121571
04b423865c74ffe2a1fe048f10410b4d,136,92,303747,45080,258667,109,98,282767,60218,222549
f0182f6d9cd798df0544c5ddd288e80e,112,88,329678,66547,263131,163,141,470544,103201,367343
1f3bfee38954d802ec5c54bcfb71d072,69,42,88290,31176,57114,86,58,102777,25922,76855
d58d3058fa21569cd88b14ed1facf800,58,48,71161,25853,45308,53,45,66742,29733,37009
006cb7f1ef27aa82bfb50665d57351d2,60,50,84426,31983,52443,65,47,65896,31968,33928
417836fd4b449382c88bc3ba301dab86,29,20,23350,7234,16116,35,28,40868,9262,31606
94580aa6ee404dd1268ee41527be18d6,67,49,103420,23064,80356,73,50,98752,27902,70850
8c8161a1087891494b05a6b754d740d5,49,40,58522,15326,43196,44,35,37878,20373,17505
4009ad99e206449157743b196781c117,17,11,4306,2170,2136,16,14,4237,1450,2787
9ad358b097acb7c40a68a3197534a7ed,30,25,23118,8292,14826,27,23,10756,5720,5036
28e61c6dbf2258630c941f9028f6ca87,92,79,250770,61279,189491,95,91,185754,54945,130809
a1dc63abd8ee55a7d25abb021bcb093a,51,35,59980,33875,26105,66,55,95875,39957,55918
9f7eb3d379f9445648e3c97ef21bc93a,37,32,58352,13764,44588,24,23,27237,13844,13393
c47f58a842ba3ee4aa5da1c190487d39,39,33,21324,9747,11577,35,27,24745,9276,15469
2c98eb122b16e3d2ce8d90f42da2cfa6,54,47,72745,30319,42426,78,51,97562,27818,69744
fb777f02ae6a9dffaf3ba049e1d032fb,26,22,15289,6751,8538,22,22,14403,7821,6582
d4205b1c7c630ead9fecc2c225ecc5dc,28,23,27298,9723,17575,35,31,35201,11780,23421
871510190c56efd692545042134c33ad,124,100,348015,116123,231892,188,154,452985,172656,280329
98934c6b00da7e209a06db844cb23add,49,36,52468,11362,41106,41,26,28920,10855,18065
273d6965146558e71814543a4e8760b1,31,22,26122,10540,15582,29,24,23657,8990,14667
437e2b7f32b5013a0cac9b55a02a3b57,130,104,477995,84362,393633,169,147,640962,102921,538041
ce0980b1e4e161f1f99cf496b701311a,235,136,897979,177281,720698,189,140,797089,207614,589475
5fa5765db2c9edd949dc3f2aa8ecfd37,117,84,304726,53292,251434,162,131,310661,71704,238957
f860a4db6d40bdd6b0fd821229f257c9,75,59,113692,47732,65960,68,56,154082,41269,112813
ab5506b18e09696b96b7736782010351,96,79,218697,53932,164765,68,59,106372,63104,43268
098e4114acbfa0258f5c5645ef76bb02,26,21,22868,5208,17660,27,27,20845,10692,10153
86c3974c391907171bda9c6cccd73d15,89,57,132451,31329,101122,62,45,81004,25513,55491
418df64738b4833c74cf7381467a5bbc,94,71,178485,59305,119180,100,76,203832,54420,149412
fe6fd3299b0f9f801f27715237e5ecbe,15,16,2409,2807,-398,24,16,4786,1727,3059
aab58672d82129ad17c5a56eeb298123,95,84,153554,34798,118756,91,64,150244,25247,124997
39d7cda86c5527a0f5c14b8de746bc9b,196,119,502394,161923,340471,173,140,669790,159810,509980
80897dfffc9bc51cce049a47b4fafba7,133,97,318010,61299,256711,150,94,351541,60387,291154
3cc1ca3eac1a45027659ee27952dee68,119,102,305018,82795,222223,156,127,475844,79539,396305
513cdee6871e8e8141fefe454b497320,34,26,35752,14225,21527,37,35,45979,15568,30411
51cabf218b5dd881619164c16e2d1169,56,47,126352,40538,85814,52,41,106411,39073,67338
920980e1bc0c19f0eb30eef85812db91,86,65,123523,39960,83563,78,69,108272,40383,67889
62ae99079da11695341682a01ce8df34,106,79,144942,40587,104355,84,70,123567,34333,89234
366c53a4bd253f869ef897284a67de95,50,42,111004,45089,65915,48,37,94980,43311,51669
bd5022736f279ee8a63cbcee8c333374,51,43,61074,21586,39488,65,51,98007,25076,72931
c95edf122e0312a0ba4d29d03809b009,35,26,26788,18227,8561,35,32,42079,13318,28761
e6e38e8ee5109932b865db64d29bd033,105,73,217212,35694,181518,105,89,186739,59402,127337
af55af02a98b7f921b02f63eb3890c62,173,125,476701,76385,400316,155,114,356953,78001,278952
15a46fea7661bf52502f9c1314a51977,94,84,227480,40570,186910,114,101,192611,63726,128885
301b547d6c2abe4749d4f3fd04ed48b8,167,138,701772,173895,527877,157,126,674318,183693,490625
1b5a786f011d73a2631c900aa5ace033,71,62,132458,33601,98857,91,71,95720,42606,53114
e4f49ad5d8acb3f049cf6a72aa16845b,135,112,314315,61556,252759,123,81,276241,51209,225032
a73a6dcf15567db0051ac6c1605b7049,126,126,448355,198206,250149,179,127,659519,155726,503793
fffa8934ed88175d862a1cf5b66600ad,35,29,27596,8009,19587,34,28,15020,9838,5182
748d30477930fe8ccfe06f0551040e87,133,86,287565,67632,219933,133,92,248679,56701,191978
23fa16a3001ec9ff6231f2b161511d3b,63,45,110847,39921,70926,70,57,125139,40851,84288
bd9bc33e62c4bd23e5567935e8b5ace2,171,112,589735,95689,494046,161,119,460961,107269,353692
4045a9a2cf603d04d11870a33e506ea6,23,21,8452,5778,2674,30,21,11344,4357,6987
08c875f6a1a718d810ce0cb47428aeb7,31,25,20575,8217,12358,32,25,21886,8182,13704
efcfd3ee6bbb2d8cf8198c770563e49c,107,92,287639,63815,223824,162,140,382150,72065,310085
071f08d5378b844f4cc1e125d982934e,166,104,402274,76578,325696,152,106,416934,69489,347445
cf15b3467d7242814f0693f6ca5bbe7d,185,116,547743,109701,438042,162,122,593078,134333,458745
30fda8b9b714b98996869ffe07f3c43a,101,74,177431,57612,119819,126,105,224484,65824,158660
4c35f919e0bec77724cd3d64c3dbd725,114,92,204285,51829,152456,96,80,188633,42876,145757
8ee601982f74b7099b1dd2a41086c93a,188,128,696278,107609,588669,204,166,774238,101501,672737
0ac97af95fda80bfd28d22429a0f7d2b,99,57,134041,32705,101336,84,63,159842,30290,129552
c5617cd4a159991ebe713ac8d372fcb8,49,28,33305,8297,25008,50,34,31908,8867,23041
3dd2a96cbe2d8dce22f3ce31a99e7d22,77,54,101927,34317,67610,103,81,178576,35177,143399
e2f348470d96c08b49d7c034649f48e1,48,41,87645,39480,48165,89,71,172735,49896,122839
c3b37bbcba2eb3ce89bdcbabd65a39d2,17,20,3531,2962,569,17,16,4332,2660,1672
5669ba0b88164edcbf9949c4573966de,46,31,67686,27982,39704,49,44,87183,29311,57872
8146bf1f3876e1f5cdab83a066d89630,28,21,17221,8358,8863,29,23,17547,6868,10679
954d4e3191905d9df0f9106de2de0ab5,24,24,12183,4557,7626,28,18,10292,4180,6112
8fa427bdcd5fd5f2793b3319763c5a5c,173,115,566549,163923,402626,135,106,370667,142000,228667
c7f5c0f67eb543e544ec2aca1e089ac2,39,30,37885,12831,25054,42,31,50017,11080,38937
7a4e3aae7e77359205804582431536cb,88,70,266563,53498,213065,118,98,267154,71731,195423
2c94b5c3d273e97e864958ebf387a4a5,131,102,362507,61830,300677,139,94,353650,45650,308000
4d05c583e7ae0d8ec9a8a248980c6174,64,44,56311,25482,30829,76,53,96326,27545,68781
533a415f22d34f065d9d8acf1f8abfae,84,72,117979,38194,79785,66,48,76242,33812,42430
d8061d0cae2fcd498218d14ba46ae212,77,59,110859,33480,77379,115,90,151323,30657,120666
bc4a45823b6c6913af3d7aa552af0330,167,112,607303,144031,463272,194,143,656397,140035,516362
0a4a8f7da7bcae42561771896072e47d,115,105,243457,63189,180268,111,90,258975,62772,196203
f3edc6d7c84b04c386c66701a86fb40e,102,75,240879,40523,200356,88,79,138783,62640,76143
049c359fe0fd39d8ef206ee48e1e8da9,179,142,556408,210046,346362,183,102,502370,111088,391282
fb790bad60ff97783e357e682ad679f9,114,87,315380,85000,230380,128,115,347047,102979,244068
cfb509ec3aa03356c56410664a84045b,32,25,17622,5874,11748,26,23,13405,4226,9179
2b76ab7331442a85636a2c525ad44342,60,38,86284,19174,67110,34,32,32469,26886,5583
62a9a8f89775887ce493f36f4cc67060,142,118,362761,50480,312281,109,87,209071,58700,150371
426a8ae34341101db99baedfd2253658,77,51,100603,26151,74452,41,37,42026,18020,24006
577272367af973f5731c8276f128d79b,128,97,325728,60010,265718,93,78,218451,56698,161753
477cc88ba2f849352ac99a23de0d4b38,42,32,34985,16498,18487,59,54,75540,16547,58993
26df2b38726fafd4fbdc8a7b2952df61,3,4,838,1445,-607,4,3,1080,838,242
3b852447371bd06b0b7134e02dc071dc,58,42,72764,22788,49976,65,51,73267,27522,45745
c114f608d2229921db8d8e99721ec87f,20,20,6771,3519,3252,25,24,5820,4556,1264
a91b31777191e9a4b7e299a6fd4fb670,29,24,22950,6791,16159,29,19,21121,6586,14535
962a465a3134d55ae8f3711f54fa6279,121,72,427382,89878,337504,175,114,504737,90441,414296
408c80912217dc13941f5870298e9773,44,34,81432,16617,64815,53,37,60671,22240,38431
1aa0677d5c6dca6839a201a8a04eef7d,59,53,85408,29824,55584,65,41,104105,20737,83368
7df1b9c057c8ffd5890679301a84f4e5,55,41,49943,13274,36669,42,33,32171,10394,21777
ce5f8f67e2fb663c822db16ca7586750,173,145,491386,117597,373789,164,120,469891,104541,365350
3ef79d7a249f3b9c462a8634de464d79,36,26,55867,13097,42770,35,29,40447,18007,22440
c291b69f2f10f2cb59fc3cd83c19046d,79,54,128115,23546,104569,78,71,82954,30864,52090
de56ff474694763df9723ded59d16dcb,124,83,359224,64965,294259,153,128,384178,93725,290453
0733369d266c6a9f21e3f710717998ad,87,76,152321,51695,100626,85,77,153385,48039,105346
b606c3efd6073a70df480f9620096762,45,40,54163,17292,36871,46,36,56687,16591,40096
babd45a3396fad1f458ddeb6737f9092,31,27,23391,8853,14538,43,25,38366,8668,29698
2e05f16bf89d037008465b38a830b16e,156,107,347667,49889,297778,103,71,219646,59583,160063
e15d0a6029729e534e71847edc6e4251,98,76,161434,38917,122517,111,91,239468,44366,195102
4a3d595f5b2ffd5b31a97819a02297da,67,37,63611,21435,42176,64,48,79543,24560,54983
8e71573c7219ff358c4ca78255fa2527,27,20,6004,3538,2466,25,20,6766,3577,3189
6c12c28b34bb60ffdb298bedce39a70e,60,42,96407,25885,70522,87,55,152140,29629,122511
0d63dda544c6b1fbeac3b73074eb67c7,153,119,375514,112254,263260,114,96,227760,88268,139492
8185571c8bf46ff5b70d8a6a1afe8f45,25,21,17170,5793,11377,26,21,15423,6216,9207
72961eab4f14f6b4f270fa911af11c98,54,42,85646,18599,67047,45,32,34755,16960,17795
92525c4993b315ab41fcde3b42dd96d5,45,39,62886,35154,27732,66,54,118090,29180,88910
092915f847a8d84031b65573c7fcd6ba,14,9,2397,619,1778,11,8,1111,1278,-167
f4f85d317cbda13447b372e6a61c8eb5,19,16,13609,4457,9152,20,14,10767,3780,6987
12461b7cb58323f9adda32da77e33670,50,35,35053,11298,23755,43,29,34431,16539,17892
5d8f577be08496230c6afee54b15c416,155,116,505257,162248,343009,172,114,514102,102862,411240
c1e0469e3ec1971bc82a360c2c4de785,77,54,57450,19191,38259,56,49,37895,20387,17508
f94650cae5c2a3d80ef30459c399ac20,163,103,420819,108855,311964,116,91,306393,103397,202996
3260153d7978a0ac40e1621f3db47578,150,105,424231,92166,332065,213,161,663867,107773,556094
67ff24f6f529fb95c45f6dc4f6e1f381,15,9,1866,1588,278,12,8,2259,882,1377
fcab9d19b1235863bf7a212c224722b8,4,6,233,679,-446,5,3,635,189,446
4d33c07416ddac972ffc9d3db2e5e260,129,91,324316,75146,249170,138,78,260989,66448,194541
46ee22dd010daa1250afee066cd93bad,71,61,157490,45986,111504,46,39,92107,51349,40758
f413315f95d0dde6258d3b829cda4c9b,36,29,36196,22168,14028,43,24,64514,12987,51527
7204d641a9b249486f9798e60f949ca9,127,101,260458,47944,212514,87,75,231420,49144,182276
4bebc9c47fa08412515477438c077113,114,91,349934,91267,258667,156,140,495761,127503,368258
199594541100a1620031ac658bdb9f07,36,29,31552,9691,21861,35,23,29839,12425,17414
40a63380847158c7faf96dcde4499d90,46,39,51920,8247,43673,39,31,32949,11063,21886
cd71292b58aafa2fb8191baca4404392,61,51,67934,24442,43492,52,44,78982,28138,50844
6739c90b2901a4663c7b50bcf25008a2,117,90,326378,91982,234396,135,112,417911,103759,314152
12c6afb8c373653593eb8d1398244c80,105,73,201443,54648,146795,125,91,275167,54415,220752
35e9da19a811002090adeff4db8d2a69,114,85,239730,56989,182741,120,90,265253,60389,204864
2b5b9e2765f265504affb020bcee37d6,106,77,209552,44307,165245,92,82,205567,42802,162765
e5a495f72e7e944507377da03b7fc42c,104,53,112077,15912,96165,47,47,72748,16966,55782
64ffc36954d8ace8adef2fd1405f914d,60,39,74475,32395,42080,56,48,102781,32779,70002
35d5a6d5b3b7c9705320242455237a3b,192,118,685142,187614,497528,124,91,513285,218230,295055
629624fa260f6c10f59b25168a7cd663,48,42,34777,18832,15945,57,40,52918,13592,39326
c852839324ea7019a40c0c6f4eba229b,75,59,119877,36734,83143,78,65,124516,40750,83766
f05e8797176cdbe0e19b38f96a080e5e,37,33,26982,14273,12709,43,30,39454,11448,28006
7837245e2ae90f75fa1e3c697471cc71,69,52,81738,29356,52382,64,45,106724,25947,80777
82679587c25a09e9ca629fe06b59d614,82,57,83020,27009,56011,77,71,97764,25980,71784
e92093c1d3c9a86f0ca4421a7f527654,100,78,158998,42200,116798,109,91,211159,48998,162161
fdcd6c947baa8808ef4b3cef7848158b,142,111,297183,67572,229611,129,107,288545,54528,234017
5117f44d8a32424ce16f4495d40bbfc6,96,74,130966,41963,89003,81,69,116574,38645,77929
cc30e49a071644f603c7836297f87ea8,63,46,73355,24347,49008,84,70,102548,27051,75497
68b87385fa39f7f2a36f44f70fc519a9,27,23,14413,5542,8871,26,20,9536,4758,4778
36d482ae7f2e3a75c49f03d19cbc57fb,23,17,4555,2848,1707,20,16,5096,2417,2679
fb567d2dfe961505ad553a4e0805f545,46,28,34772,9125,25647,46,31,42742,11829,30913
d52599219285e80367af779dc9edf6fe,42,31,29814,10651,19163,46,35,39902,13484,26418
808b658e1b097d116514042423e10155,13,7,2538,1416,1122,9,9,1657,1350,307
fc07c7a11ee4537ddf00cf6b988f3f87,108,79,159297,32677,126620,90,86,148594,50606,97988
bf2f59d62c7bacb4b42df261277977ab,78,67,163292,45231,118061,81,63,126297,47151,79146
d46cfc47b32538681366548b708c67d7,24,23,14158,6693,7465,28,28,20755,6096,14659
1b65426cb6b56599a835113b3a34a3b1,71,63,132346,45458,86888,60,40,94356,42906,51450
4d5e5aaa6704f5fe539291d6215b184b,128,90,374437,108564,265873,150,106,310726,96110,214616
927227d0fde5a9717e5997d69151c16d,112,77,203900,56311,147589,132,102,263715,53073,210642
bbe2b3cf44766d0d52cbe9cc08cb3866,146,95,304788,54322,250466,115,92,223145,72308,150837
ab2ce7d9d18f79e5e92146a1bbc6b323,171,110,459898,99016,360882,115,82,325367,88236,237131
496957ca64c5c137d32fa4b833329a0c,109,96,299575,79278,220297,111,82,363636,70149,293487
4e63f2fd109cc38a8d5b0ccb8412be88,113,83,245112,61631,183481,112,100,277333,64148,213185
edb6009eaf447ccfa721583a24de8adb,120,67,303525,69826,233699,121,98,255173,71212,183961
8ec2d2c0adf243662998b068136dd518,148,106,576615,113743,462872,166,122,560442,102872,457570
c9435e023107955c40d7be20f09be6b4,116,80,288930,80717,208213,125,103,296913,81553,215360
2baa697b6605587b8b735524f23b2105,125,96,332731,62218,270513,132,113,320407,69784,250623
369d54babb53c00f17bef30bb7abe2dd,53,41,41098,18777,22321,43,37,54589,16855,37734
50abea9e1b9012bde4504a4e13b86b91,90,75,168987,49478,119509,112,84,196020,58697,137323
7cf56298bde7e590dbea3ce2d75767d9,58,49,70519,25054,45465,58,39,54551,23813,30738
5951721f56ce6de003aa42f9b0cc284c,3,2,750,411,339,1,3,398,750,-352
8bd65c69b02130c6391fa1309de8d65f,132,106,394202,81146,313056,151,118,432425,100526,331899
1d49b1f1f82806cbfc38577574f853b1,23,18,10641,2999,7642,28,23,13165,5918,7247
4044ce0a0f5abd139cc28e16b28de67c,40,29,30716,13090,17626,38,28,33506,12964,20542
605f8e559bc05d0cd7b72ff6d2416fe8,150,110,413137,63713,349424,138,100,438445,68247,370198
da32622f8837b83067d6157d6753ad4d,159,118,517301,68105,449196,136,111,383005,93979,289026
0d38a39ab59313f2b4aeb3dbd0ae8c5a,114,99,201097,50683,150414,118,104,271111,55073,216038
ec5240d226d8b587d48d8de1662b576b,237,169,856045,134162,721883,228,166,968072,163233,804839
199956ccacb470a7cc9fbe59e312f38f,133,98,378287,67719,310568,157,101,435860,75794,360066
b7408f556d6ec13c5979703a4cd7840e,35,26,18748,7399,11349,24,25,16180,9376,6804
bdfea552a0e1d6ce255ec5f3791576d4,28,26,14948,6497,8451,25,17,14640,4104,10536
32ce8e18f1416cc1f094ed38860f9fda,212,155,794095,131903,662192,166,124,519781,163938,355843
d9cd7be6b67e5c57ada56b8a97c694e0,52,33,55555,12545,43010,47,33,42730,10358,32372
8bcd6ef962502e8ab4b314cfbdcf93f0,102,78,171813,51264,120549,99,78,174064,46110,127954
3397b98ba7203c803bddd8571418f974,125,94,202881,36755,166126,105,88,177813,40454,137359
09374702731190fd7eee9bf100bdd0a5,28,21,21140,6501,14639,25,22,13390,8431,4959
4df452667f6bda9320bdd68187cbd0b5,143,108,433261,50503,382758,153,109,415350,60828,354522
ee15a8232f44c74c97453f5aba41fc17,194,151,1291219,150931,1140288,210,159,870669,130726,739943
4ebaed94591ea3a43653958f7b4df4b5,116,89,312965,38932,274033,100,63,165195,39096,126099
a4e3ef656b66024ef192c76a069d5afa,82,50,90284,24066,66218,75,67,110040,30332,79708
e2079ef582e860369371702f36261208,105,79,205506,49174,156332,147,133,342193,94439,247754
0d081a8587ed60b675aa3389d321fc62,74,57,136720,51552,85168,92,65,157100,48255,108845
52760dfa125221c31e99f4552336d938,156,111,556001,110215,445786,174,137,690852,130199,560653
b2db6f115e96993d550c223d70435685,75,61,70029,26117,43912,50,35,46087,26479,19608
2ceca95e3ed3b758bda07e7990533a2b,26,20,10208,3030,7178,24,20,7353,3650,3703
a9046f850141873e2327cca47534a8c3,33,26,24748,9516,15232,34,31,21940,10207,11733
15f5cc5b9244f5178505b4dab9b17860,172,136,665473,158664,506809,176,135,661086,182502,478584
2539f178c893715c597f0f26b4b93221,118,85,280846,88191,192655,170,123,423601,90479,333122
3ca7c4cd4ca8fbee06c6b1cd46b02e88,60,38,76395,13674,62721,65,53,69450,22990,46460
f3b5228da3be02ccf91703163e5981c1,62,44,105250,30911,74339,60,50,99036,38327,60709
f385e13f0ff30d9f1b9dafb3dd3d9978,13,13,5098,2590,2508,17,8,2789,1127,1662
bd4b3b39f9fd375071b0f37d433cdcf1,50,42,78618,27799,50819,44,36,84530,20434,64096
6de3b5c97b5f597689f70ceba2f99a2e,82,65,158259,53840,104419,131,113,266896,63495,203401
a4e1f17d7f0c8fb3a43c2407428f47ec,162,127,554673,132712,421961,171,113,472783,89683,383100
b43af63c8c0d83dfa6e299b3ba28f69b,23,19,12730,2809,9921,22,20,13374,4336,9038
e5866d9f5bf7fd6bd4a4dafc91440498,40,31,27633,14663,12970,40,36,31953,12697,19256
0a12aca852394b6b423dd6246d6fdf50,127,87,388864,75600,313264,124,112,330587,64104,266483
ed014d4c63f4ed523b7ed9afa751afc0,151,105,372894,60322,312572,138,90,289176,73176,216000
85bac526578af106086b88d42ad1438a,155,98,318494,41562,276932,128,96,360208,53702,306506
a495fef3bf88ab7f8b7363630e8f0767,30,22,18941,5173,13768,33,20,18414,7317,11097
b5aa92613e1e59231f753271249fd06a,43,27,39068,10344,28724,24,25,21747,12784,8963
cbb488df942cd1e386f52f9a4c3e2dd0,4,3,452,387,65,3,4,387,452,-65
c1f8edff7d1652b9fa5b8acd2ba5e961,116,81,265092,84460,180632,115,83,280512,74696,205816
32cf32dead495182c78d8d6b3c82cbd8,35,30,28418,8028,20390,34,23,28785,6205,22580
a957ad01e1829ccceb8559c376766898,166,121,662531,155260,507271,166,143,620821,142532,478289
eb8393b9fdbec2c7f8b60acd8e1ca812,70,60,122451,46375,76076,102,64,182105,39577,142528
f17dc89045ed2b60f326437d12318660,36,31,20508,7250,13258,42,30,17588,8239,9349
56238e07fcfdf5f3e66f65a719b25372,79,69,153120,33897,119223,70,46,100122,31924,68198
3540d4080c539f9901aa3c3cf8c74cbb,35,25,23303,6791,16512,40,28,26222,11406,14816
ef004ea65f7aec9773f267982ebe6f76,139,112,510677,110756,399921,152,126,483567,89585,393982
ddd144b7aee477a4184d82a75111ad19,44,29,30159,10979,19180,43,32,29778,15107,14671
ed41996a4190308b660de1d059a7f82f,80,62,168163,37327,130836,105,87,227360,53351,174009
a4e249c6e217d531446a98d49a9a4443,19,19,4879,3044,1835,27,14,6689,3078,3611
9bcccd7afc5c1e03e5885b3be0762d4b,81,70,133046,40051,92995,76,72,134746,67997,66749
a916dfe7ad5667c40aac3383305b5b61,45,34,38237,10684,27553,29,23,20665,9394,11271
d12c84fb4fb4d2c122b7a3c0c606430d,140,109,403458,87712,315746,172,133,424749,78415,346334
4270749f792d771b3871acc83db406e3,38,33,37352,11239,26113,56,36,37677,12448,25229
8d0a06f8b665aaac27b355c4d6fe1627,58,42,61166,14528,46638,66,59,57348,26877,30471
45363171180aa898ec7fdc0383022fdf,30,21,15490,7302,8188,27,21,13953,4867,9086
c0ad630c9eb65ae96ff0eeb0e3ce3cda,73,59,128795,30484,98311,73,54,63475,30133,33342
a4badbba838a3daa0a25e42be6dad8d5,114,85,162334,46915,115419,84,58,116827,26144,90683
4b5547e357290793dc4ee0fb5c3d7a67,30,23,12118,6168,5950,32,30,15304,7284,8020
c6e143da5c8c6a5bb430d2a84793d3f0,128,85,235604,54104,181500,146,118,272672,62584,210088
24fc642d802d9e3aa234a7676ca42700,29,24,15601,6915,8686,30,27,12416,9480,2936
5d995c5dead8919a6e00fbb731c3f1ab,42,31,28126,8151,19975,43,33,43026,10209,32817
05e24bb879690dca2de28360c81fecfb,185,120,580364,112134,468230,144,83,380761,90370,290391
0bb623a63e028900296fd16670c548f0,27,21,18881,8713,10168,31,25,19046,8382,10664
d9f09cd16b681b687b5e52174dd34b1c,38,30,32119,10071,22048,38,35,38935,6356,32579
4ab28652be148fd8eb22e4695097c938,131,78,215318,78944,136374,146,111,306844,87030,219814
805ea551e9c1f4bc0375726c57ed006c,125,96,202465,44950,157515,95,78,173450,35610,137840
c86eb000c81da3677d62736409ba8be0,113,78,203824,48984,154840,80,72,167846,52925,114921
ddd3200a13b97ea1ee1e3fd059173e7a,157,124,608897,128999,479898,145,115,486225,97916,388309
921fb09ae80beb5ae0f3c75cdf018275,149,108,425402,76068,349334,118,97,264983,91138,173845
cbdd198924f2b4f1c4adc1d6bf0359bb,35,25,20227,8517,11710,32,24,32263,7484,24779
b10d62260c68a2a98f9cf0c15fd83e81,242,142,789869,144599,645270,189,146,645068,115607,529461
6d8994020781a626290221e248e6837e,124,100,248136,64055,184081,144,119,420506,63487,357019
eaa5be2d2cf54f003187c43b19d9b66e,201,167,1068024,158016,910008,201,156,1083701,131097,952604
ae5abae1722d5bbe0a971263a2346157,1,1,108,84,24,1,1,84,108,-24
016e254ed7fc74a3d099680f77c9e0e3,124,98,288178,88199,199979,191,142,440777,74141,366636
35a32a3a45c9e4871d71ca154c8e4202,210,119,469211,123897,345314,150,93,415278,111232,304046
5ba03f2c8a69538e0f208035ea1ff2f8,51,39,61398,20262,41136,41,36,47175,21126,26049
c2ec13c0e9f008cd2ef845e4177073c4,101,84,213356,51603,161753,129,101,282416,56937,225479
1fba40c2106f17c22451f4385d064855,104,82,239142,61137,178005,153,103,300704,57645,243059
6aa6fa740b0fe135508d4b9417c960e5,35,24,41117,11154,29963,52,36,62808,15750,47058
ca210d47ff46cb821e8574632b7193c9,16,11,4286,952,3334,16,13,2098,1297,801
00bac05a83f8441dc11ff52b88e3926e,104,85,274113,93110,181003,109,80,290391,61582,228809
7c93f6c5b04679f12b8931892d652733,84,68,122616,35032,87584,61,45,100945,25172,75773
5bf8a31704a98d1a7599d943de27123f,99,79,136599,45603,90996,113,85,188961,38582,150379
51616f2b97f29bbb16c7fc0d9c9a7109,81,61,148047,41699,106348,100,80,172343,43102,129241
2684f65bdb5dde96f59348c08fc70c32,73,67,142801,34949,107852,88,62,159750,33307,126443
158e597e861121e6263ad3ae6aad54ea,40,28,39738,10113,29625,39,28,29071,6721,22350
305199aa17dcd6ef2488572aa9d3bcd0,129,93,349813,77806,272007,186,154,526328,117164,409164
b87eb86c2bb764e8b2397ca6d0fe3622,58,42,103146,31471,71675,67,52,89097,44100,44997
9335a3dcb3003519db90b5f984672748,49,38,49480,29982,19498,92,60,190300,39849,150451
01f5179c20b166aabce3662f32231d41,95,63,221921,27461,194460,89,63,174367,40687,133680
b8fb16e2bb34b8d18c46a6b90fbbc336,214,138,472109,88779,383330,150,119,396852,86607,310245
6b543f8174292b06ff1eb904459f0a30,27,25,13745,8977,4768,25,20,16490,4599,11891
2358299ad85e1ded3995aa53d51bafd9,114,85,220319,51254,169065,110,93,251091,79899,171192
cac5f915c62c189388307922497ca1e4,64,39,43926,17747,26179,41,31,42844,10248,32596
310e5b9524eed8164c1bdf218c39312c,62,47,77273,17521,59752,46,33,50230,22201,28029
5d68db4d837dd2ccca7ca6eaeb677c9c,108,71,219961,41722,178239,99,53,132879,48900,83979
711c97808aee4e7a96ef60254205fec4,167,106,512802,152518,360284,133,88,447982,134790,313192
5c13c5ab18bd10943258ff2dfc535d89,121,90,217042,46045,170997,132,95,322582,57797,264785
d616b5654f6269d91a5acee798c8693b,163,114,953285,144178,809107,204,153,1101868,204537,897331
824a51bb37408e845b26e81d47fd73fc,28,23,20173,7244,12929,36,29,20311,8766,11545
22ca8a2b23350bef3d2032e7f663cdfb,72,48,79578,20701,58877,78,62,92270,23226,69044
141f6d070385a10bf764a10c200063d5,50,44,27434,10769,16665,36,30,27752,9274,18478
c88170b2764ec679a81c0f87320f9400,25,17,14815,2636,12179,26,19,14215,4043,10172
6dd9d2f594d36ee3a11263ed0f3b91ae,26,23,21382,6513,14869,29,23,15835,8386,7449
a7ebe05d5a14931598323fa463176326,233,172,1117963,162277,955686,160,124,973393,167777,805616
20860b6778c7ccb4ddbbab2f816e1edf,73,56,88936,31541,57395,86,62,109025,36025,73000
30c373a598d341658b5ebc4b030545c6,0,0,0,0,0,0,0,0,0,0
2c256f43d6816239cb072d81fc14287b,122,96,382326,104073,278253,126,108,310952,98280,212672
0dbb899180a06a9e4f9edcae2e53fd2d,50,35,44873,17096,27777,45,40,36950,20823,16127
7b235a43f3df71479c43c7c3f6cfdfaf,117,94,355613,84807,270806,144,120,324391,95409,228982
0b718bbceb4cf4d3a8246eea68c919d1,24,20,8183,5308,2875,23,18,9478,3452,6026
90af094545bd742dc926ed5b782d8b8a,20,13,3683,1618,2065,20,13,4862,2267,2595
4d4e238f9a9fb5362a300470400bb891,42,38,63314,35074,28240,44,35,66368,27976,38392
666f3d6743ffa4d96d748a3b87d5c85d,48,28,36620,8881,27739,43,33,52937,15091,37846
828073779ad8f26549dafa381c5d4e03,83,68,133186,46141,87045,92,84,164758,54016,110742
ed612d2b1a9ee88e8b6aaeedf81349c1,41,28,38583,12027,26556,62,60,67487,20706,46781
2422980a58035fb7e86c953e71bd2eca,53,43,61659,21069,40590,54,40,64502,18663,45839
dfd3f6427fbd896fee011d0d0d15e1c6,79,54,99590,34361,65229,55,42,120858,30028,90830
0ef4fcf5fd3384280f176cf5915c1b8c,75,61,139270,33125,106145,106,90,156526,50357,106169
de37f1d78d84dd64c1c78e5ddf420b84,132,104,532631,117199,415432,159,144,583417,93835,489582
50d45815e56b4e7120433c087d629d59,53,50,108253,33205,75048,86,83,162195,41705,120490
c32eabe273f2ba436dbd1c98d81e7084,127,96,328655,58336,270319,106,89,292361,80494,211867
d6ea5886412121f2b24e801a5fc02ecc,138,102,283722,70921,212801,145,97,244006,50409,193597
d49f02ae07b961f7a4143be6fc3adb2a,146,114,391600,79884,311716,167,123,594303,105883,488420
78cc958e73bc55a25061ab4bf7a30d8b,25,18,10657,5258,5399,25,20,10071,7107,2964
f8abb4926f83dda8681de9321666b2c8,74,58,105196,26652,78544,95,65,108707,29866,78841
ce1f685827ad4b2a1d017453a7a4c394,64,41,109149,33199,75950,46,45,76095,33536,42559
a4e9e1c334d90d18b49685ad839f47d8,59,39,85053,18171,66882,39,38,45512,19643,25869
00bf2d0e661b8634865ae4f3fd778ac4,36,26,29579,9077,20502,33,26,21084,8689,12395
181cb4e95106ccfc13ca0fd054734310,170,120,431512,96994,334518,141,111,305956,98157,207799
aa7e133d35d5a154206149f70fb6c20b,153,125,369856,110001,259855,184,142,459884,110229,349655
9c11a4f1a9de442b6dae958129d3b328,169,103,701627,111782,589845,162,134,551874,120078,431796
0a938333b3dff553a03891ed99e99d4e,149,117,540894,150947,389947,183,138,754523,132604,621919
4e5f8cdaf0278f8fc5fca8bd1a77c0e4,129,92,283627,86054,197573,157,134,399617,69821,329796
901514894c823320827b09d43e7a4af4,44,37,40874,10577,30297,50,44,36471,14064,22407
dca2b0920c227e460a2f8e43040138aa,169,120,452598,63428,389170,188,119,398500,84588,313912
ffb5a065271b1324febc56c28f0813f2,188,145,675905,182344,493561,185,135,624329,164053,460276
cd08328911b787db73f8adeded5e5116,60,40,41146,18871,22275,59,37,55828,17400,38428
814d8902dac0b67f0a7964e4da6e92ad,54,44,76979,21210,55769,39,36,68863,23327,45536
182238a9c7e56a4aaac64b6ee608375e,161,140,688724,174073,514651,201,135,825103,209899,615204
32db1e416470eddb495445f90942392f,92,56,135587,31807,103780,94,60,171769,29755,142014
465a58312ff3b0783f23bc5354678956,112,86,172864,32707,140157,81,54,105041,33445,71596
402d6b76e503f145a630157c2d162891,82,71,131843,36255,95588,100,80,189518,36310,153208
831ab4cd6d0801dbfa0e83bfc9aca2c7,110,88,286940,62970,223970,136,96,373074,55209,317865
403eb69a44764914dbd2691d53b299e9,37,26,22616,9953,12663,30,27,25936,9184,16752
c1ddfd94ecd75853d21b3200406c4f7a,80,53,147699,42418,105281,87,56,160935,51200,109735
95f3f72dd19e528f9b4979fa71b9c418,18,8,3042,814,2228,11,13,1967,2115,-148
55e4bae541129f9cf657ae7d0f5fc3ca,124,77,352752,77433,275319,164,138,458325,100388,357937
3d3b990c6346180b0957e79cb42612dd,176,132,466908,132290,334618,128,99,373005,67731,305274
e40a48b0726f4ca7929b467c31b511f2,188,127,481316,80061,401255,165,146,550191,87540,462651
f404dffde0c04852cef7065e0e30b0db,62,50,104726,20820,83906,50,42,69814,30888,38926
0b72a54be74ab7763ce231bd0b03e271,54,53,87467,27590,59877,48,37,62372,29478,32894
e1ff8665449a6884cad3eef4c4a8f9bc,24,17,7462,3188,4274,28,18,11382,3609,7773
7d52e674f5f0816ddae55c58673aa785,182,126,488952,82371,406581,151,126,468346,86794,381552
2ac704bfd370a5b00089e84ec54e4ae3,89,77,211161,24765,186396,107,86,211802,58985,152817
d0705301a372577de51ddcbfdc0313c9,90,67,123008,29719,93289,106,91,148192,38038,110154
a331f680aeaf0273c79c7de784b9ee71,40,32,42021,10187,31834,35,34,29891,18517,11374
b5049fd1dd618ed18cc489befccbfce4,90,73,186483,60794,125689,115,86,189277,42472,146805
7e761db1a5252c8a23dbc787007df440,168,125,414926,97426,317500,155,127,502672,90611,412061
25a53ce8f0197bcbf80cfda97b20611c,153,107,437742,152579,285163,194,135,535843,115429,420414
b7caabafda9968fddab39f17ff3faf93,48,40,86694,28691,58003,73,62,146723,35500,111223
3f3ea459b681ad0ef16718af5f4cf739,152,97,480035,128080,351955,147,117,571968,134970,436998
668b7e208cf9187039241112291771ee,74,55,129714,21229,108485,78,64,107763,30649,77114
968dc9102495657aeeaa27e26382a800,94,60,120458,33744,86714,120,73,173539,32844,140695
43c011c47e799b565399af03c7073f6f,112,96,264338,56847,207491,134,113,331873,74317,257556
ff7f0627e9a21ff0ef4d6e21a9a38af4,165,134,483944,106989,376955,141,98,348743,105517,243226
1c0db007486823d789c413f77c36058d,33,25,27299,8720,18579,34,26,40608,10798,29810
8d152c44f806309153a23648e671e15a,27,20,27238,7616,19622,33,25,29000,8435,20565
669706208a0c9d48b5c51091220fab05,86,62,182175,47936,134239,82,64,258109,53256,204853
bd376edfbfb4ef7eb8b638fa85f84b92,43,33,36931,14935,21996,36,26,36058,13001,23057
14ad94c80cac9d1b3f66b1a12b4bdc2c,72,57,76864,26431,50433,56,54,82954,26458,56496
6f4eddd6c1d2a88ec0639adce4b68500,204,155,881033,219530,661503,205,162,1245281,227185,1018096
0f9e0f4523bc3487251f5781907436a9,29,20,7182,5999,1183,29,25,12318,3955,8363
17835c5ddc0547a26681dc7468f300d0,133,115,297052,76373,220679,96,69,246445,64682,181763
91220ceb3b93aa2df556bf4d0576cf9a,21,12,9594,1788,7806,12,18,3873,3439,434
dfe9d349722efe5b8a8e9cb360edb222,161,117,422578,69844,352734,137,101,329858,75181,254677
fcbc6fb081b5245ba3239ca21375f314,41,33,23309,7702,15607,36,29,18234,8508,9726
7bb114df85ba83a38029ef6443b8447c,101,80,197647,61251,136396,99,74,208625,42224,166401
b067143c11d464ba93c91cfe4b57f790,116,91,205726,67232,138494,89,77,176708,63712,112996
1707dcad46fa23da41cff1da364ab175,32,19,20406,5072,15334,25,24,24285,7222,17063
b44aa221cf9f076f66d261aec8e3e661,145,121,374294,51095,323199,112,91,266561,63680,202881
c063a25801d52a547698abd9b9cc64ab,90,73,210398,66175,144223,133,110,310283,68983,241300
18f8ad9ce415fea86f78f36fdd50cf88,139,115,640507,183624,456883,150,122,561098,136005,425093
075494e3bcc3a4cd0b7aa67d88b22dd4,52,37,37292,12873,24419,47,33,37952,10374,27578
662cdbb3340de571fc8cddd1a5ccfafd,139,108,240711,120089,120622,168,125,447349,112316,335033
810abb0f5f96194b9f2bde9f73964fa8,132,90,352408,62743,289665,111,79,242649,77851,164798
52c331f5b67b72d8fd0afae742885de6,86,64,135396,46663,88733,88,67,148642,38328,110314
3700c3d4073efa2c93d6b2b8afa7b2fb,56,39,64544,22859,41685,61,40,66377,26266,40111
9ced18083c7fd13c2db95a1b10ac5646,143,95,295266,64388,230878,119,104,239572,76673,162899
e59f32e2055a5494755df755f76b1630,107,70,194628,91663,102965,139,107,381632,98348,283284
7d03e88431d18a8b4596ce43f7e35064,41,28,27123,10070,17053,47,30,30516,6354,24162
6d4d5b2b9ff9804c0034a09b3c071c91,75,52,108151,31995,76156,54,42,108529,31180,77349
1f88f8d0147ecadea83ea812bdf569ca,28,19,7561,1903,5658,21,24,6965,3586,3379
1002a806bb7bf6055ff3578967480eeb,135,100,868786,118844,749942,172,117,541746,147341,394405
3a35dc25dbf8b1f2283bba50b89fae7e,0,0,0,0,0,0,0,0,0,0
52ade35f695978d7f868682f5f3a3171,90,72,161790,36281,125509,77,58,115221,32879,82342
6882fccef9ab986535fd107b012e9dc3,42,32,30183,11307,18876,49,36,34743,12207,22536
9b55341907660f94873e449586e44855,116,90,249355,56454,192901,129,90,236299,56251,180048
a2ca87fff52aaa01079a573f1b0db2aa,92,66,179601,50005,129596,109,101,213281,43548,169733
a30fe62b9b0d4455bba881b57f47593b,117,98,292057,67394,224663,98,84,256555,97847,158708
44266ed02a5afdfe1ca28026b8f5882a,117,89,277436,59752,217684,121,98,299398,76321,223077
e441696ce5a75a24794ae5f1595c302d,89,67,158031,39214,118817,105,87,213465,56220,157245
f25d0837834ac3f25799994dfaf08095,186,128,1074830,161111,913719,237,169,680014,230248,449766
45664792b78a85a65ca214fb35346d3b,109,89,239747,59682,180065,153,128,296517,53615,242902
c0f7a02b0e5a9566220050c390f7acc5,26,19,13210,7587,5623,26,27,19227,7359,11868
03654237ab5443defa675c2baaaa92cf,107,90,184226,46434,137792,123,87,233708,38121,195587
98edc56994e805b3c653a8576f1849c1,21,18,5248,2418,2830,20,14,3878,2480,1398
c1209613846a107a38ab4a23cd28b2d5,92,81,166231,38306,127925,84,60,130059,38545,91514
a2e642bc9e1cba8a8bcc743b89946f68,131,92,226630,49510,177120,109,93,162072,54217,107855
2d0b3a880f3714d08a73c95f8a71943f,172,113,622804,129803,493001,182,139,574663,118331,456332
9758bc94fcb3d10d5c79c8723289e42d,118,94,267075,76861,190214,135,111,302895,79185,223710
13d595d7d29e643f4ef5efafe9012138,102,66,205159,32911,172248,56,48,64861,32188,32673
2204342a358518672a89554d5d994f4e,78,58,74049,31751,42298,69,49,109092,24114,84978
faec9c149c53018df463479ee90a9764,130,105,316680,94754,221926,133,102,312758,57492,255266
de8eb0291749245d80cd83522080244b,116,88,207867,60577,147290,101,91,206889,59646,147243
5599736ec33053b63211b49017e8d655,63,55,75537,30174,45363,74,57,94644,24718,69926
e67f39895462400a54ad709d44de4f2c,127,63,439518,90171,349347,172,124,577008,156186,420822
66781b15cb06f21de28b12e3aba7c16e,33,25,33087,17797,15290,34,26,35969,15751,20218
528b142acfd630b85253681a4df2c467,35,28,25687,13590,12097,40,32,38593,11510,27083
b3cf214871381622c0a3cfb840f0a913,118,111,258700,44877,213823,89,77,235611,41980,193631
c882edf571a13a5bace0e18237c4ae4b,79,61,86754,21305,65449,74,49,74721,23501,51220
47f588fc4cfe4324201dd4abc03f5ba4,167,134,579608,117935,461673,184,147,715939,92743,623196
51efb80661a750b960f51369afd0ca36,48,36,43064,11775,31289,49,32,52684,10778,41906
79035701d48084a03d69a4f473620241,22,15,10272,2346,7926,24,22,11177,3991,7186
a3eb3dc5c0c0662116c2a82d3228871f,34,23,26971,6552,20419,39,26,22298,10566,11732
98cb82ed25394d562c9372e04f5bf078,87,74,130091,40925,89166,84,65,134773,45870,88903
884fb5dc3991703e4f58d1f0b8290673,169,109,387986,78912,309074,111,74,234520,70671,163849
a56ec60c5f26b11385b9ae2e68092f4d,85,62,136208,27259,108949,71,43,81553,26142,55411
1b0febb33f40a1d4a2d2f111d3be59e1,102,70,167704,56965,110739,107,74,213908,73602,140306
506fe954647b1be08166467c55d60e5c,115,93,304151,91631,212520,143,118,405526,74667,330859
e677152c7581bdd9b466776bfbe3166e,73,64,115466,40286,75180,79,57,87544,29724,57820
2e15203923fd62452bbad57f28dd34d1,91,77,173711,37525,136186,93,78,153108,39665,113443
629fcfed9323c66da60942cd5e9195de,22,19,6553,3584,2969,26,12,12591,2238,10353
7e7be848dbec3e366562540d13b27d2d,34,27,21000,11609,9391,39,30,29544,9431,20113
bd86b4e25fe9f7c5d70260d3be075bf8,113,85,193013,36821,156192,135,93,226963,38660,188303
05050f8c599c6e32a45e7dca279beba4,109,81,157590,38589,119001,91,75,140479,46921,93558
830dd47df074cd7b9813daea0cb5c4a8,70,56,126269,30205,96064,93,67,147755,31896,115859
6d1828decfae35cd370a182f86c32d2d,74,64,111689,32635,79054,89,78,152049,36160,115889
3e427605a9108a8a18b37b2d64ee6a32,134,98,360739,75328,285411,145,96,344938,68463,276475
1e689a866d3c5d1f8455156533cde35b,64,42,139759,20044,119715,56,49,78198,29282,48916
be848f82a737574a22a2e53fd4635e10,22,20,9189,3498,5691,23,17,8542,2798,5744
140e74df951312d7fc2a8cf36752b251,24,22,7909,3093,4816,22,17,6030,3070,2960
729537488e0723254286b35f9453267e,7,3,874,503,371,9,4,1024,660,364
47f9a1229f60f1ecba889422afaec0fc,60,44,65126,25884,39242,59,53,83894,24162,59732
79f3d2956524754403d4800307af308a,23,18,6726,3119,3607,25,19,11893,3447,8446
ee6df2b53d9d8f2c9793677fbf64de20,110,88,213677,56458,157219,121,98,231383,44056,187327
8debca0a0b2eaae05090f2673542d319,18,22,10961,4293,6668,23,17,7160,3240,3920
71aafc05cd3a0ff92710baa5b291d09d,47,37,65813,19939,45874,48,39,50007,22092,27915
0d3e35a9e8a0cc1dc89823d22a67d91c,88,70,110626,28215,82411,102,81,149077,41087,107990
3cd7c57ded2f475a6bc3b9cd686fe774,89,68,100559,26072,74487,69,48,80337,13166,67171
293a0c280ed3310d3cf2cc431bf7e6fa,115,89,269895,47889,222006,107,94,200993,53229,147764
0129f82684ae34eb50a01073c16900a6,158,118,533403,77196,456207,91,61,201662,67939,133723
c682f18f0dc9085d170ccfabd93917ab,51,38,62354,26780,35574,54,47,85253,21961,63292
25c8dafe351c6fce930e0a42974cf5c8,122,86,243645,70285,173360,131,99,334829,53399,281430
79012fad8984bc9d2221826195aaa5bf,42,27,31699,11556,20143,47,32,38580,13006,25574
9cb9a45712fe0d0b0e3b3ccc4e14ca57,98,77,168962,57133,111829,136,111,254703,62933,191770
804e78ad41e14ce9a63f3b4f49338745,134,111,380910,73533,307377,137,105,362027,91904,270123
75fa2c002861caf3115aa91ac1be25f7,132,108,313718,50304,263414,127,113,320239,58831,261408
461221fde68741eab0b2657c9fc98410,63,52,99548,19754,79794,71,67,72753,31188,41565
e9f26d625ef8a0ddbfc26f23cc9eb327,86,71,158050,54848,103202,86,72,141546,45454,96092
efad05b0f466bcc06c4868fbda80ba70,143,108,274621,52135,222486,116,105,316236,70545,245691
84f532f83514ea9ee52031b535ca6213,59,51,97744,36727,61017,96,82,163725,32675,131050
4788ffdbe5e21fd9b0cf00a312d50760,31,27,18410,12657,5753,28,23,22453,10469,11984
61633f6080efa6c0614ed6ad42e245cb,171,147,679837,186581,493256,157,109,575363,100172,475191
b24c2b51608ff6cbaf21f9fe442c5e60,61,41,100057,23774,76283,54,43,86366,28387,57979
17c76c85d3c505822f7a15643c5d2d43,87,63,160441,50515,109926,97,75,150074,46731,103343
9d2208036648d087963ed0d8bb2d2bab,50,40,55987,24947,31040,58,49,79834,27242,52592
410f17460373330b82c4f3344add52c9,165,135,438355,76627,361728,136,109,299784,60813,238971
af7bb6bc9f564b6f2e00c4d5cfd0df89,131,108,478990,90361,388629,124,104,465034,125683,339351
91c4c4bd8e354034e53cf12113b80895,99,69,432559,127201,305358,177,133,548274,148297,399977
14f344de6837b1f152a3fa124673d8da,237,175,1255701,190678,1065023,201,153,927698,207717,719981
72bf170ea76b9d05b81256e708b95422,95,76,208782,50279,158503,86,70,169122,63578,105544
4fc0a20473039871e833f7cb728a0ebf,41,34,33909,15083,18826,33,28,29430,13444,15986
9bf9a9a0991bbc8c22b7099802c10b27,41,32,51253,18503,32750,38,26,42813,17880,24933
565ed3a419064f43542877e61a23a07a,70,46,103364,26928,76436,97,79,127479,38369,89110
40785a5b12271e859f696dfbb6397f56,36,18,28673,9969,18704,35,32,35194,12642,22552
03445ec86a53d391aa82215c2cdb0c33,113,96,301678,72304,229374,120,97,332564,64522,268042
0a696b574d03fc104792c7e421e08eaf,158,117,375220,86726,288494,159,127,374130,89503,284627
bdee12ed1a57bda4da9e3a5f171c5400,59,44,64099,16823,47276,56,47,45473,22124,23349
e38983f1c74dce687284274e14454875,55,46,74634,27071,47563,56,47,45501,23521,21980
c1c0b1f505ba84d1f936828edb02ca0d,48,45,44544,14498,30046,55,44,55335,10335,45000
9f946b23323fd9b2e303e473a752e3ad,56,47,110380,37363,73017,66,52,120114,31466,88648
ea92a428d787433528297f58d82bf6f1,12,11,2861,2022,839,18,12,5011,927,4084
8597aa8def177baa628b402ead05d626,40,29,18747,8022,10725,27,23,25485,5922,19563
0195eaa38597ab5c6042853accc59aec,56,46,102572,33451,69121,62,49,105183,23076,82107
d9c7e44530995134ae437ebe2d862724,57,38,55680,9893,45787,43,35,39969,14021,25948
dc25298a24a30780b8de6059f5db6c02,91,78,154816,42311,112505,102,76,167759,29525,138234
f393fb14560518fdd056ccd53d03340e,38,32,30908,12538,18370,35,27,25048,15251,9797
3abfbaaba7c665981a59bace78e3e685,14,12,1858,1231,627,11,13,1937,997,940
57514f45f8eb5f707b7c36eb3d3e47e2,16,10,4524,554,3970,15,9,2729,1217,1512
8d83c45b2a104c50d44480ffe495e9e9,190,147,743077,103949,639128,107,92,404613,131380,273233
66995b87df2cd3f3f9bc841f92fa317b,94,70,133391,37134,96257,106,86,210269,47391,162878
4d8ef6f5056cc2a6e52bc1ca70be6772,80,61,209220,71267,137953,131,95,317952,90566,227386
261b251f7798486db6d649f09b32c674,130,105,332121,56522,275599,147,132,343570,82976,260594
e945acd9094db169c723a8aac212564f,122,101,265296,68510,196786,80,65,184715,64325,120390
3e321b278c9967a86ea15ef6a3b6659b,180,147,836605,174312,662293,164,144,900990,163533,737457
91917f6039bf6174d9dcb4bc72d85abb,9,7,1704,360,1344,15,9,1538,480,1058
f68848c1860136a1de0dc20517148165,38,31,38564,8917,29647,42,32,37112,9602,27510
84be878380daf32461c0a1d22ed913a3,105,82,259555,96351,163204,83,71,178519,74461,104058
792d64026bd0fceed8db5ebe2e9de7bf,206,136,623912,113470,510442,168,113,636027,142439,493588
17adf5bf51b3055c887d8e10c66ee767,100,82,198144,54884,143260,89,78,169657,50262,119395
6ade099c8c5ef6baf517bba75c97f168,16,11,2118,796,1322,13,9,1691,1070,621
33c69b6c3698e9759650f7848fb353b5,80,61,98579,28167,70412,72,45,67735,25555,42180
13e455c666d9783cfd016e5e3b7e8008,139,95,467419,100664,366755,117,79,337676,110800,226876
cac35fed917fa66398744b9d9a62e009,27,22,14699,5438,9261,28,19,13341,5538,7803
b27be0be08408174a677fbc226630acd,102,71,237501,57263,180238,138,102,313007,71751,241256
949bd3e1eed446168b015c838719b9b1,21,16,21026,3855,17171,16,16,8384,2854,5530
c6a0466affa21597e8a34d3c36dd450d,28,20,13980,7919,6061,23,17,16785,4598,12187
e715c6e26bea3ca16a972c67474d8e89,77,58,136034,34498,101536,60,52,85422,52098,33324
bd11570a1f1fce46d2b5862627ec172d,0,0,0,0,0,0,0,0,0,0
a6fab6928e2353d8f5fcb5d9b78f3407,103,78,172545,42247,130298,95,67,130863,41166,89697
6ed5026c0829e0eb54cff1d9cfb0261c,122,102,285817,68766,217051,118,90,313081,84979,228102
5508fd91a60be4bc39ed233b440cc937,102,80,186767,47430,139337,93,63,157656,38107,119549
3cccf83ac37cf7f4f7ecf933128081e9,50,44,90683,29293,61390,61,52,97647,32143,65504
b761ca86ac2bd32de95ba20cc9a8c9ea,57,42,92609,31102,61507,47,38,79294,20222,59072
d4eb36a19d7521869015b775986ad9f0,87,69,141310,28176,113134,59,43,54353,19521,34832
0126660f593db9ddf5782d640b06f54b,52,41,61282,21791,39491,77,69,119895,21627,98268
b069272ea61c43fa9ab43e8c09bb228e,136,110,382332,90071,292261,158,95,309579,87419,222160
0d609498687f361d1e5d49f1dcdca83c,186,147,735411,153792,581619,178,130,606419,94367,512052
2fd7092169d0f7ccc4eba148535c50ab,25,22,7001,2615,4386,20,20,5842,3337,2505
0dadb710f00fd125d4b54fc4fb2ce287,92,75,172812,77513,95299,159,112,350927,56086,294841
cde6b5a6044d3a5987c015bc4bbf1824,83,70,123421,44966,78455,85,66,153153,37848,115305
3edbb155d3788699ff2311e06a86ecd2,70,62,99537,34555,64982,80,74,137940,38245,99695
7e05e2dc795ac10fbddbd0404e36ec60,118,89,193830,42939,150891,96,73,142642,35458,107184
6ee1681ede6c2be99f38f9621ee5711c,166,115,754706,111394,643312,165,114,485140,132899,352241
dd6c78899f211da801c3b141d8169742,116,98,279206,76318,202888,124,95,316672,78264,238408
013d2a3d8ca6821fe0edd22da288efcc,35,26,18010,8287,9723,21,22,12898,6843,6055
6e328cd6b94940e00c7bae5985f8b3b1,55,42,65382,19449,45933,69,47,94077,22550,71527
52b8cc48d95e7bbeb762766f7665486a,114,80,205330,48239,157091,149,114,269328,52098,217230
a563e0fa05359febab6c17be4b5f4658,43,43,40458,18871,21587,39,31,49062,13604,35458
b2874a6557a8c7917f4a6c8fdf74e8b4,28,19,7737,4366,3371,22,19,9205,3983,5222
c35dce78ddf57bf46a23f464683aeabf,33,22,23905,4229,19676,31,25,15376,7191,8185
4afd351e177b262abb644bd530549ce3,26,19,8863,4739,4124,24,21,8826,3690,5136
d942b9eca3efaf2870b4f82c17b16548,166,136,670535,147816,522719,199,169,753917,127623,626294
08b9540b5a302f066bc6cd3827b98282,118,91,233464,56372,177092,144,123,350513,78977,271536
4484a8665deeeaa1addb8820464aee77,37,29,20196,8155,12041,30,27,17707,9116,8591
1a41303079c23751d658f48c65a0ade4,109,91,251197,84228,166969,154,136,424620,68765,355855
1bf7b56aa1c80af08037fabbec5a5c4a,110,101,353027,100418,252609,140,112,310532,57226,253306
45126b79f01fba69a0d6ae8e856c1d33,31,21,31637,8500,23137,33,20,20329,12151,8178
b54caedcc09b57feb0c150dc57e919e0,81,63,136878,53875,83003,169,129,328506,75208,253298
5547bd1a7832245d3286f84d363c86fd,89,59,143998,22183,121815,56,53,59009,34833,24176
bb3d1432ac40112b70c99bd2daf57f89,76,64,97297,27506,69791,82,75,102754,29592,73162
2f3eda247c4a45bcbf11ef915c8e4b13,33,26,43724,11758,31966,31,24,33761,14865,18896
f0d701c42706c55394c83c147553ab84,3,4,794,275,519,10,5,1582,305,1277
33291b36fab91bfff228d7a3c1f28798,101,80,210224,47237,162987,139,94,243030,64797,178233
26bb7c5570c1e0dfab9174a92015d4b7,47,35,60657,14720,45937,46,40,34389,21538,12851
a4c9509f6230185abefbc574b34f2954,56,50,70927,22364,48563,58,45,60258,20978,39280
7039cd15335f53226d7b3a09771a4403,25,20,18162,4835,13327,24,17,11134,5287,5847
d33b50b2c699725ff8f4cb91aa9491ab,105,68,164418,41471,122947,123,90,208557,41607,166950
228f37b31b9956a2752fdda5309e2dd5,101,92,153981,50321,103660,116,104,197400,40231,157169
74c2e5fc505e13a6a20a6f887be8a90a,71,57,135776,35864,99912,112,88,250418,34912,215506
0ff52f1dff1074eb10410851b44f1e65,143,111,358646,85193,273453,115,80,391291,74389,316902
8d1890f753b42d3f0cf1ea32e87f2387,66,57,118542,27960,90582,39,27,68083,31950,36133
98514dda0980b248a48bd84ceee94ee2,130,103,292052,50720,241332,162,122,346769,59437,287332
7943788f083a4f29e66fe1363b5ce48e,73,61,101501,25531,75970,103,90,115397,26157,89240
ef4f4c8359bc0efe75cca052e5a48351,95,77,143844,37900,105944,102,68,154356,28907,125449
20af14779fd7f5a80f32375e4aa6335d,35,27,38916,15176,23740,48,42,49385,16149,33236
0c173375e225002844b0897329fbc73d,63,44,79761,22505,57256,61,46,77478,21403,56075
63323de8f997757cf1db142061f432d4,99,80,200572,55500,145072,103,70,217310,55190,162120
6a70aae35a802fe011891e5f8f38420c,24,17,5223,1570,3653,20,9,5947,1046,4901
39784d2af7f9fcb68d6d79882b95dfc6,14,10,1881,720,1161,13,8,1415,1074,341
91a3e23335ebf9e0807d69252ec486f3,166,121,556970,88413,468557,133,106,455189,96727,358462
895016900a1b5b1a3e585bb6a99489be,86,79,137207,35416,101791,72,67,91076,30987,60089
145641c78f663bf4a8683e8a95c0b2a3,43,35,59536,22515,37021,37,35,40280,22005,18275
550a81c6a551aab2cdf0b8d7a464476d,61,44,47658,28575,19083,55,44,60286,21625,38661
20fff437c81fc9926a42655b0ee061e5,45,41,64487,27689,36798,80,77,144535,32792,111743
99d0af3b9fee05fd8b65c496280d1202,130,96,343411,59952,283459,122,98,263010,64693,198317
60ee26f327adb1ee2066d728c4a4051a,164,140,832032,177320,654712,203,174,942538,151257,791281
3a0c226531229b69ba71af0d9ec81e7b,34,21,35910,10218,25692,32,25,35087,12244,22843
3aff4e5284ffaa92c6648b103184bc15,50,42,61737,24085,37652,76,58,103077,24470,78607
9a90d16bc0549c8720d0a118f5dbc183,116,99,218461,46756,171705,128,108,279262,68079,211183
082bc3a5888a30e862e997dce3ebbb25,232,151,1574661,199457,1375204,224,158,1046466,253655,792811
86e1603298cfa834fbc704477910a521,136,100,416704,112107,304597,186,134,651583,120327,531256
b97f77fc72587e22476bcdbbf456f035,82,61,147568,40839,106729,58,52,94906,44776,50130
1510d5594b1ca29bb28cfca3ba590280,191,140,506559,115818,390741,114,93,326063,103036,223027
963687c6ccd52de3ef09b0f15fd10d10,141,100,349216,73458,275758,147,124,373372,93176,280196
210b1bcee8047503b1310822c22ebfb6,41,32,46053,16746,29307,46,36,40129,19509,20620
b727f1d31d39ea39e535b20e02d608eb,178,112,581299,119776,461523,148,116,513585,104035,409550
c96f5da5695745cf1c65363f68a0bd7a,20,17,9758,3756,6002,23,17,12523,4057,8466
dbe5dd22fdbde9ae3f2233ad2f6fae5f,53,46,67162,18521,48641,39,27,37202,12827,24375
80a8abc9b77f24d4945ef02103366e58,90,58,110194,28719,81475,68,50,74643,30420,44223
44b038a9965ca3589aa83aa5f3fe5456,125,86,344721,78229,266492,131,106,437557,71573,365984
9045f8d5cbc61d453c42d9849ddecee2,110,90,265336,66819,198517,100,75,228640,77133,151507
35c3c7995e5bc224c6e56581f51306be,101,76,201564,64020,137544,139,117,336518,107590,228928
af8a4f7520f3fc8a032fc28f2bfb6992,106,70,157205,44336,112869,120,99,222236,46923,175313
1d4aefba325420b779dc755bf230d1b9,24,19,12064,6711,5353,25,19,12405,5749,6656
cdbcab98b0c4b3ca0cae93526387be2e,71,62,152646,49469,103177,76,61,93108,54527,38581
eb55fdf40c8104606073535e849d20db,132,110,345021,81369,263652,127,113,321967,87542,234425
0d2a1244808b515c85d2d06033b8f680,126,100,254218,47517,206701,123,98,203839,44122,159717
3fac00dc68db575b0cff376c346542e9,90,49,128387,23213,105174,85,62,150513,24821,125692
fd06fbc36f4e494b2b31c2ee941f4287,17,12,6218,2135,4083,17,15,4484,2297,2187
102ffe270a89303c295c775e7eb44bb0,54,51,65156,29913,35243,73,53,103957,33802,70155
d57400598ba3bd261af21a1920912621,24,19,15882,5741,10141,23,23,16248,5508,10740
de111a4548c48ba25db3d73fcee573df,47,39,41561,15691,25870,53,55,48305,16155,32150
65d4cc6d6f0ad946883d369701e9c031,126,76,207623,45961,161662,121,78,199340,51351,147989
cb9ebc2f394ae02a1e370e05963b451f,37,25,43138,10116,33022,34,26,36442,17913,18529
2aab39515c501a650b21a2fbbc027708,135,110,291953,68773,223180,167,122,345197,68891,276306
d263100e61d05ca2514c806a9eef4f45,121,95,371030,107468,263562,171,140,492219,84333,407886
e58628f4bc48801a806cf492848e3d9d,125,86,240788,57430,183358,132,101,315534,46949,268585
1b8a5132daff2262c99cf4d9af091b30,95,70,226816,32487,194329,90,70,165023,38877,126146
e8347ebc986378ff55137611b34fad60,149,100,469708,168347,301361,139,115,533264,170568,362696
33b1531fb8c0c3a23a46e557d3f817c9,155,125,404838,66430,338408,155,112,337453,73096,264357
783448092b2ed3bb96164566e5814837,5,3,1131,527,604,2,4,355,959,-604
b7472d14bcd3239a776c31e6d54c1051,32,27,26907,11273,15634,54,34,48673,12750,35923
47b8b1edb1c66cff772ed6e53ae97c3a,93,63,122687,29104,93583,76,52,98191,29420,68771
c65a65fa7862ec5b9812ff98690b50cf,82,68,144005,33745,110260,56,46,71031,27640,43391
b8791ec45755e8d1789a7b22a7e88b6e,45,43,47832,21212,26620,50,45,54134,14151,39983
e3d55262d19a22e523b08cc4eeeffeb5,141,97,360670,97390,263280,162,130,548304,81665,466639
24240c5d7b7836374333fa7872e15d2c,25,17,5882,3225,2657,18,18,4494,3346,1148
bf1843e0627a8a51ca232ba056967e8a,52,40,52682,17103,35579,47,42,45566,20514,25052
48aa02245e3d96409284b6a969f21bf7,113,90,251168,63705,187463,125,89,230247,39734,190513
8893ee340dde95e155cbbe260ebeec29,156,126,308614,86465,222149,151,99,406348,44384,361964
e1ae33061208ca3347d7fc6c0ec295e0,114,96,182471,51835,130636,111,80,186212,57334,128878
f81e1a1cde8e9a84e48d144f3d68c496,91,67,189119,31790,157329,89,79,125671,53093,72578
d92041c96fe565959ee591c014c1e2a6,28,23,23321,12740,10581,46,38,45852,10327,35525
7790c750fae2f11d611f099120c30213,159,101,327787,61252,266535,148,105,421814,85521,336293
6ec706737c885f8b5dea1ca9736d41fc,37,27,26720,16664,10056,38,32,34427,11617,22810
1a4f506ea9b7aa91128d04e74aea5db6,33,28,28537,7939,20598,31,21,17755,11881,5874
83cdcc66c78d96460eee0107508a17bb,43,27,34757,7734,27023,52,42,54129,11924,42205
8be1748ac49678d69b041281f4762765,88,77,157579,61081,96498,89,76,171583,41814,129769
c43c3295f613b6c6361379166021b877,151,120,373199,67648,305551,137,121,312146,69155,242991
b1eadb28a77aa16e44fa04b3205af10c,33,25,38324,10010,28314,40,35,36807,15211,21596
05697d1dac72afe525166ae5a6f31294,219,140,640086,89680,550406,162,130,582127,105666,476461
50beb562d4c01c64c50fc63eece71e77,154,113,281027,47093,233934,134,104,295755,44834,250921
0bc8a0165cea27ac2062ea01f7597c88,41,31,27678,12278,15400,38,30,33378,10427,22951
7f57b4ac2755629a56dc09b83b35254f,100,75,167963,59480,108483,90,77,222422,50950,171472
73f75dc8913b914c2a60f3d2fe3a37f8,160,116,934656,193561,741095,168,124,676179,251124,425055
6067295bd8bad0479a57be7b79fb4628,91,73,196988,62831,134157,72,54,120431,73016,47415
a397add796b9bb027fa9d85fdd6d5d21,136,98,347419,42418,305001,112,87,287752,58843,228909
f5d347ba0b45a6be2e8f520d407f63ed,2,1,91,234,-143,2,2,284,64,220
ed433fc6b624125c9fbd7e2e2b8dd111,104,81,219358,38711,180647,85,69,181932,44231,137701
842082125f263c2efac9475b320b427a,116,86,145243,27183,118060,89,67,151459,30627,120832
50c145d475716feaa4c0b1eacde13778,84,63,135777,25678,110099,82,52,123321,35928,87393
40ca813288a2cf7f3b787f8197875094,72,56,96029,22291,73738,100,75,110895,27239,83656
c58a884dbbcfb104516bb7b56afb6672,44,34,74004,17653,56351,37,25,62106,19029,43077
77f6843b9dfc3f4409d4b775750e1c7f,88,77,183139,49340,133799,89,71,208361,65099,143262
1d5040d525f1aef9ffe74ffd1ca1bfa6,114,100,253440,64632,188808,146,103,265861,47190,218671
afb31c21e6e4a4a9e9ee85c339b890f6,117,83,276568,91880,184688,157,107,385553,89310,296243
1ec164eeaca0529b3a23c30f63cdc945,48,35,55793,19017,36776,42,31,38511,16662,21849
47e36c7acf31c0f90a55cb87545bff8a,173,133,844134,143196,700938,193,159,836419,181947,654472
d0174508bb70812b3f1bbdb0c816386a,27,20,10858,3095,7763,28,24,15769,4998,10771
9970dc6ad56094ecb7512cee174ee8b4,134,109,242983,61575,181408,154,131,333346,53988,279358
a237317b41c56ee067585c46844f61ee,85,67,173040,65549,107491,81,59,173574,64983,108591
eff8d4a6a17699854e9db4bafc7fbd03,174,133,639881,94349,545532,187,138,708565,102407,606158
774ca0a7f29622bc28f68ef40280c431,6,3,563,625,-62,2,5,595,533,62
f9bab2a6c7233cff66595e0099adac17,112,72,210191,50605,159586,139,95,316269,63580,252689
7dcac7afd017ba926fb96e03195a6248,44,32,43013,18259,24754,53,43,75481,20493,54988
a0d14dcf508d45f4c6d1b573ef3e126e,132,104,362713,56576,306137,126,91,258722,41060,217662
035caed6a80c947b6b515f8703e6d0aa,66,50,122249,43177,79072,83,57,125674,50529,75145
6bfc3e579743c1ae8bf733dc216be483,113,72,272852,69978,202874,133,113,352081,73729,278352
43cac67cc1dcb7058b477e1d2b0c9a18,20,19,3982,2941,1041,22,17,5732,2195,3537
716e0ea1bf1ab47a3c5d1156ec239c2a,135,94,281824,72165,209659,157,111,429986,77241,352745
c88b68a3d2c26d391615c39b9eb1b9d3,48,40,45359,18285,27074,39,29,44408,16012,28396
9a52139804d06059bdebaa73940add64,206,145,791287,120808,670479,166,111,668068,112655,555413
16786f5850592111f9f14b08842a77b5,143,117,462696,101159,361537,153,122,463789,98291,365498
0501f050f5144e7600e9de5dcb7d16f4,111,95,184324,31444,152880,88,67,128696,23955,104741
cfb1e2342f9f7208e62446ee2edc5fc3,178,127,494655,98665,395990,159,132,480111,93742,386369
1eee82c86be3758149905a67abcef76b,204,143,1032366,178045,854321,195,136,1046014,157299,888715
a6273e5578082dae5aae5514b5bf643e,1,1,120,120,0,0,0,0,0,0
a819d422a5b871f17c789558619bf3da,19,21,11940,8299,3641,26,24,16391,7767,8624
3d0e33f409c5355ec956117def9b3b78,36,32,29225,15958,13267,34,26,32090,11953,20137
3d02fae5f939ce5cd88a93f21e2f5fc6,45,32,45817,17103,28714,40,30,40539,15217,25322
9b8ad701271944f2a09ce7a41336b0ee,27,21,12834,4510,8324,27,23,15987,6016,9971
46c21db439e9b0b117d29b05d05146bc,156,128,444533,127072,317461,149,113,562473,120929,441544
adf0a002b1d8c9844df913e8df2ffc49,79,70,168824,70504,98320,83,71,210163,50407,159756
c0e9e8ab2ec919be062b86fa92eb575f,76,63,114445,37299,77146,78,63,104824,46690,58134
ff7d8f736905be13ddc7da6ccf253b26,32,27,23189,7648,15541,26,21,18215,9384,8831
12904863de40cc0925fea3ec8321535e,154,121,471681,80925,390756,153,94,425959,66174,359785
260d7b853dc44555895f04145e92db86,80,66,155315,52993,102322,97,79,237706,48247,189459
33206d8992a82ccc096117bdd75b55a1,112,74,203982,57195,146787,107,82,204700,42970,161730
e750d4f0235d4f9da97afc455fe49ea3,163,104,371912,56035,315877,176,105,450157,95083,355074
95d2ab91803e909d455d8b98e973a82e,112,92,291123,70873,220250,83,69,195550,49988,145562
734b57a06d0bdda919de7e21c4f98d75,184,145,829206,206699,622507,212,164,836901,194030,642871
e3ec8631c63d51cb6e631816d6f924cf,114,84,288948,93135,195813,156,129,490101,90422,399679
d819d4e49583860a30ed0855c5df27a6,138,90,241355,48566,192789,94,78,174275,53619,120656
13c49e782cac1c56dc216e859a203aa3,223,127,1133019,234869,898150,230,160,1474264,301441,1172823
a0381fc85d7d582046026d810dda36ee,80,65,101282,36306,64976,57,48,92901,25767,67134
5ef18e1eba379f6ce7a6d241b28977eb,46,34,50539,21512,29027,56,45,64997,22434,42563
d56d5dd3667508619020e55f5d27bbc8,146,104,372319,96901,275418,154,126,472167,81335,390832
344c8494b1b1173d9fb3066eb5b640e4,57,39,74218,28892,45326,60,53,125085,27144,97941
75f6a8091c4e58160d37984b76999512,2,4,175,745,-570,4,2,745,175,570
07675461def7fa4eb6640612099760c9,34,37,27724,10324,17400,37,26,25501,12953,12548
a28ca1a7bceb09e805d9e8b53738ce69,64,55,80653,44536,36117,87,68,162486,31411,131075
9f4b943346c1ff5c2e6b2a82d5ae2d72,79,57,145353,27055,118298,71,64,117986,40324,77662
74ed8ff520f9915bffcc2d54bc60f2e3,73,59,95298,18679,76619,43,37,41911,23493,18418
3cc5cc089b4e1769c673ae3e2f323617,51,40,50170,13585,36585,44,30,47624,12515,35109
de3108605bad02ddf9fcfb46c0408eba,54,36,57819,20988,36831,43,39,50101,20536,29565
c9104130eb36597efd952c2e694ad4e3,85,73,139490,32262,107228,86,72,162356,40764,121592
92d6bbb9aeb64e2e5a6115a696032999,136,121,398994,92819,306175,135,113,301371,106127,195244
415179db62bfa0ff14a3c4bc71860a4f,198,166,1298202,259273,1038929,194,147,886500,189502,696998
a9f6b562062d1776cc34d9a82ba041d0,120,89,242404,65375,177029,90,76,213725,71539,142186
add32c3d7d089910907fafe3180b5314,62,54,121603,56296,65307,58,48,116595,40131,76464
bf0c40ec198f966c61a1f35aee8e9c34,96,64,175888,46657,129231,105,94,217907,61223,156684
c46ebb64ba29544fa27cd54abd9c6a77,136,91,291376,51701,239675,106,101,243516,73591,169925
e457220af41cb5b4c33a5e477e4e0ffe,27,20,7200,3393,3807,26,19,7576,3368,4208
f5bc9703f26723c3deb6683ef7445b5f,31,26,21014,6033,14981,33,30,12872,10112,2760
6873524c61c9362bb9923c37ce7f6bc4,141,118,462498,122823,339675,147,124,501283,106740,394543
d33053f7a2d1697495102d4f7786b84d,175,121,394685,76045,318640,120,97,276375,79899,196476
20c050adfc150b4e975ed5aecbcb5983,12,7,1294,727,567,9,8,2000,660,1340
4eb0e1df6263518c070afd90a6b72ad3,63,42,58768,18380,40388,71,62,69627,14766,54861
70dcb4899429f01a69e28f1ff4dffe1c,199,156,802103,171317,630786,166,111,782313,145542,636771
5ce4127738b70518a55af2fe3035331e,157,129,545685,98560,447125,114,92,338038,108144,229894
07e3a4dd6569299b15bbfb1fd9e7e9ed,78,62,97750,29791,67959,91,79,153585,28884,124701
f4cd73305d8e5b9f9fcc19c76d1fd6d6,110,93,200243,58344,141899,111,93,248192,68713,179479
a1c11ace3edb64d3d09a41bec96cf7cf,37,26,26582,12638,13944,28,22,23182,13745,9437
00595d84ccb70acb5eaa0c516903ca38,51,31,52205,22536,29669,58,36,53642,17462,36180
73c9c45bf5a14b3f95f804a54b55ce5b,148,105,448394,69430,378964,136,104,405580,83251,322329
b71b3c29e25dd720f47301e9b0a24c8c,188,127,566235,154189,412046,225,174,1089198,145051,944147
9fe92b9b1f9c536e2480ee747a35ca85,25,22,13909,6526,7383,27,25,18450,6794,11656
02f94a6a446976c2fb88187b8201a4b1,149,115,747126,97801,649325,195,139,801811,97507,704304
5fdbcd70eb3788f47212d5c0dfc48105,150,115,376877,62859,314018,128,89,278807,70658,208149
6268d32cd4a247c1191d412085bf7517,71,54,121440,39720,81720,85,65,124519,42281,82238
664c980c17e1586cc17d7e5b8ee09622,165,132,563505,183467,380038,173,135,700215,112755,587460
3dbbb226a51b0bf60e47f5967499d2a5,41,27,36703,14851,21852,46,37,47698,11506,36192
0dd63fdc2fb957fa6ac7a6cc0a622d8c,145,112,500855,69118,431737,143,118,364224,93866,270358
5539793b72ef3f95ead020b417467bf1,142,88,214205,36273,177932,106,87,146751,42483,104268
11b30dd0452ab0c5ef48f9abcfae2097,111,99,275252,77291,197961,180,146,321906,67672,254234
06f293d35d3aff5c333a2f7d96628379,24,18,12731,4842,7889,29,19,17845,4031,13814
69477ad4dad05992604f3b96339f9763,90,70,186742,30053,156689,90,78,165734,38838,126896
4dc95e448388c775fe153f0a2a7b1498,72,44,114841,22518,92323,46,43,57551,23842,33709
f8f47d0e1d24904942a66cf497eeeb7a,80,60,163586,26244,137342,82,51,131108,23744,107364
765fc5a7cefdb694f35ab703db3864cd,21,11,8863,933,7930,19,12,2769,1043,1726
f6b244c91d1592991726b63d1aa6fd9d,201,163,704782,128344,576438,170,135,564958,131878,433080
f98fdaf47e37572eebfa3052b33fbb96,200,148,848931,181403,667528,179,113,780382,172102,608280
5961a1cd3bcaf5963fb77246588d5591,148,105,322483,81257,241226,117,95,248265,79768,168497
4b140d80875b9c726c3dacc6dcb13d93,29,25,20849,11527,9322,38,25,21642,9862,11780
deda915c97c6a2bea3fbd89b9ddcec2c,188,122,634637,96610,538027,185,122,518564,141133,377431
fe46589702a8c09b9d6ef99dc0e9e2db,94,83,128930,39262,89668,60,49,84371,28055,56316
ece8a6fff48543bc6efeb7a8ce34a6c1,25,21,15214,6447,8767,27,21,15748,7317,8431
968bc401afd31b43e4fc48ae644f88ae,18,11,1921,1072,849,16,11,2153,667,1486
019cd08b285de70190eba0832ca6e447,185,135,611039,114156,496883,170,101,558531,84705,473826
c750d4935eaa8005e02166247eda2dff,109,74,278588,60742,217846,101,95,241051,79733,161318
ce3b68f2b230cfd70d8c1cd493966e58,50,38,111469,34042,77427,59,45,128437,43574,84863
349dd044ab3bf1e99dbce607dca61e02,48,34,46362,19668,26694,67,62,112654,21835,90819
6d9215462cf0a1b31f7cbbeaae2312fe,74,54,126337,41508,84829,70,63,145014,41683,103331
def4648751e065e8dcfbebbe801e8815,119,105,336430,82155,254275,120,102,254540,82446,172094
e3f3b3d34577dc00e35952e9bf4bac09,19,19,9717,5510,4207,25,22,9268,5442,3826
b0b4dc39309a62c17e8e3efb1027ca0e,69,54,89267,16377,72890,62,48,47314,17379,29935
6c8b32a513ab287ae197b9067c63438f,119,91,262169,32433,229736,117,86,150496,48986,101510
bd8ed6b7ea70ee5fa96c111bbaa9d045,33,22,31068,8947,22121,29,25,19465,11987,7478
8143d00d6092aa2a73c608d2bab0821d,123,86,238619,57418,181201,107,80,207202,36936,170266
6708a8df31f87c0e561a3a63a1b8284f,172,107,356654,102675,253979,201,144,566201,131417,434784
c4d81b4042c5ef68ad53ae52e2c12c6a,130,103,382702,104283,278419,155,103,453296,85280,368016
e11862e6301b9c5860eecdcac7ccefeb,118,105,283955,115727,168228,153,125,530406,84189,446217
1e7dbc6577a889dd30da45cb75c6e8ab,41,25,29908,10012,19896,34,27,22508,10954,11554
bc958cdb52a7bfac0e9734034f540489,78,68,133301,24929,108372,59,43,85419,25273,60146
a983f30b7e979226760e4ebfed10478b,111,83,179813,36071,143742,114,89,218637,41303,177334
832290085734289094fb6a805db6702e,57,50,80866,25362,55504,69,48,68417,26067,42350
682bc70157b39a7bfc970ee56f8bd6ec,154,128,382857,153453,229404,147,94,394801,138308,256493
51b094c758e88ed4b4147ce1adf2b422,133,117,420380,107885,312495,163,131,582142,127637,454505
7550e21b92a0d93de82c8f72d5bdae41,133,105,292772,89185,203587,138,103,300504,77802,222702
edf37903de6597318d301f0a79d77a4f,178,128,619986,147476,472510,136,118,640746,177810,462936
a475470d42dc59aef6acd563dfae8b17,58,41,67904,18017,49887,45,37,37406,19629,17777
bba930c527133a324e39c31a875d6323,25,21,12840,3178,9662,18,18,5172,5570,-398
ac8930b09f482ebfae2425a2a77eb169,129,105,328460,105197,223263,131,93,278728,75448,203280
2d7e49b37b502f53f9222247c368f310,78,58,127969,25694,102275,63,58,95920,29342,66578
49af0442e76aaec1080b53ee347c0b14,35,25,38064,14868,23196,38,33,39991,12594,27397
cd60d1f27a02185af67448b594bcf00e,0,0,0,0,0,0,0,0,0,0
648020a4bffb46d4e36264b3413afaed,56,34,58326,25379,32947,52,37,65918,24184,41734
58532377785f8d41bb413edd72ca5998,54,34,64808,18700,46108,63,58,71427,25047,46380
44c5fc50ef8173aaeccffc5a08decbbc,50,40,51046,24069,26977,60,43,81842,24600,57242
5c28d93ff03d6e6f85e03c2438a23d60,52,40,96365,23008,73357,69,54,70381,26101,44280
43f9d96d060c63b3d9b92e1a61fe4fb6,136,86,373265,87198,286067,142,90,311399,96223,215176
5a100b7b28205af3a75fd695b5026126,156,131,366898,50575,316323,87,69,179830,55927,123903
54fa0caa5ce4a6988003109e6a8b21e1,106,89,184496,61301,123195,121,76,202662,42259,160403
559074957f99b600da4b15af326fdd7c,47,34,34562,9485,25077,35,28,25151,11500,13651
b7dfd6f8faf28f24092cc27d969b22e9,50,34,60082,12585,47497,43,38,54264,11662,42602
a49e70a3c831437429f24f64d797ef0a,87,61,157125,47326,109799,84,64,104100,34745,69355
4b72b775051b9e62a108d072789f3b3c,122,98,293674,74243,219431,125,97,296281,105006,191275
63bf8064747d3d833053b1e52d8f1993,166,125,613520,115862,497658,150,133,648761,137048,511713
3ac11e149258624c4d63d4becd7abba3,9,10,1470,1379,91,10,8,1672,1325,347
0e81865fc668599c7b355976279795bb,127,87,451172,139452,311720,126,96,432696,137125,295571
7491505ccdc7467bda6be68dc03c7ae0,78,68,182796,41382,141414,103,80,219254,55392,163862
58741afd300c8c6be0cc9eadd93ba6f4,23,16,3681,1318,2363,17,13,3928,1568,2360
00114f246df4abd6ed150dcccb8b656d,54,50,61706,21370,40336,84,70,134788,26312,108476
063926ec5efe720c069fb562556b4a84,106,99,237053,58491,178562,116,96,264538,52931,211607
a7408930c5e2315f93d203e564d5d12b,147,121,310154,91467,218687,80,67,195093,84426,110667
6e5f938f733ab83942a00c7dae22c458,69,51,89859,18552,71307,49,42,46529,21481,25048
4567fd6a66743923e58b04196918db1a,101,84,156409,45347,111062,89,71,165719,45004,120715
88f5cf93d3bd641f3cafb1423de0c2e5,17,7,2941,980,1961,18,10,3714,677,3037
d3bb78addfee66bf4bc2c7a3789a6721,103,74,233764,63134,170630,101,67,195406,54210,141196
add9c3e7b02b9df469ddd5a0f50a2ab3,118,84,253578,97894,155684,156,123,434951,77260,357691
7e524f0db139e5fcfc8cd88ca90f6fd0,46,34,78795,24273,54522,64,53,126449,28062,98387
3eb1c69a7294f9d735bc416d40350832,102,78,222381,68679,153702,70,56,132911,54365,78546
79fdbb2ec33c332cf579cf5745e3d015,118,81,277495,98425,179070,126,103,358301,72894,285407
a95666b2f5cdab09024f9850497abb0b,76,62,89351,28604,60747,98,82,127027,25625,101402
61b151030e9b8e7dc391243de24f9a07,66,47,75559,31719,43840,92,66,124046,28806,95240
37ace9240b550d1e4923c8af72867318,142,105,383339,61097,322242,147,119,326554,69368,257186
f844e40d00a291e67fd83329088ec2cd,16,13,2057,1164,893,14,17,1837,1254,583
839bdc232c834693e440322e8484703e,163,109,926136,231580,694556,220,153,1173511,216702,956809
ec4beca5e095af333f2f629fbff78a0a,30,31,29121,11342,17779,41,29,45937,13647,32290
ac26ca007377f4edbb79d1b24af846e1,66,53,91027,19284,71743,32,29,40007,17944,22063
ae54ae6e893a5a1e03ba2e702c472cfe,124,97,240573,55240,185333,140,119,293807,58038,235769
aec5480887d831c60fa8e692889b7e44,37,25,35205,12062,23143,35,25,31300,9630,21670
a756b985e1df323d9f2b25a09ddaec1d,99,75,168917,29372,139545,98,85,145665,42794,102871
6e1916185284d088b36dab6842ef2417,122,105,350285,96730,253555,139,111,444175,79168,365007
5b57e452cdb8571e877619ded46cab10,35,30,29384,20621,8763,38,33,44131,14244,29887
428ef06f1574721532e8a4392560bc25,41,30,45418,14580,30838,57,32,45208,15020,30188
c9e1bee97b269de32951b87048806053,63,44,100444,23060,77384,82,64,101887,26321,75566
ef4d34f2460c3fc7484c7f7d6eb34737,86,74,160595,59140,101455,121,86,257322,60487,196835
656511eabf2355fe4b773088882161ba,68,63,123092,32825,90267,84,73,163111,37424,125687
e9714443e4b7bba9504f905c711df8b1,38,26,30599,8408,22191,31,23,18970,9696,9274
ead3cc92ff77670b6e2f703857668665,140,107,265992,61592,204400,103,66,202538,41322,161216
2dfa6fe59c93c4ded0ec0cb8f8b9afce,140,116,352683,90061,262622,114,106,339274,123381,215893
4f5213d541e05572a3ea32a877619c45,42,39,41275,11366,29909,53,35,46035,12225,33810
6972995884558ddea7f42878c11812f7,144,111,368067,82692,285375,110,74,260769,72929,187840
a8ca29b8e13ff3dff2d87074fc10dc7e,46,26,25483,10585,14898,46,33,39314,11056,28258
89b64801d6ba392d45772ec7e6060b93,44,27,56508,16387,40121,55,49,64198,24555,39643
ce6a1edd08914a112ed34975e8937237,146,111,333669,58563,275106,127,105,290539,62092,228447
d8ac88378f2c2e55515eadc1c03a33e2,16,17,4705,3113,1592,19,14,8409,2352,6057
d416f7755e7ef9915735c804499678bc,42,34,55887,18777,37110,42,26,59727,21116,38611
f7b10f40cd768c096e821578e1f1086c,171,132,467857,82242,385615,199,148,599722,80051,519671
15b3c33568019d98ef35b638834ecfcd,138,90,668797,138456,530341,165,94,486055,177331,308724
efab07027da06b5d3f569da50b35d222,13,8,2128,1236,892,15,7,2584,815,1769
76523d325a143cc3d5ae671c2dbdfcfc,54,52,73882,27677,46205,58,44,85384,20342,65042
47f6c0c472ccb5cf4e4b82859a97fc72,120,97,270492,108018,162474,210,122,389333,116982,272351
2a6acaab4cb371cbf7f25c4a7dcff11f,50,36,45242,15146,30096,42,37,29331,14934,14397
ab260d0bc505de2939e82bde19d83bda,31,30,24192,9813,14379,44,33,41660,12124,29536
09c9871a51f166ffdc8ef78b1ecf7df9,43,30,37274,21985,15289,44,34,57554,17923,39631
ad891ca6b847348875fad52979c45161,109,75,220784,58704,162080,112,71,186387,43180,143207
189128eaf979303a107c0ab02c4ef981,130,80,238165,70781,167384,138,111,308179,71982,236197
79e339694d787c4332042948378fa207,193,162,741112,112888,628224,149,100,489560,72838,416722
6b42512f28123c547c1cb89493bc51a4,54,41,71147,23039,48108,70,63,84051,24741,59310
b0015cfa4dea9b39f2c705bc1da10b53,43,34,34397,8631,25766,31,28,22838,9339,13499
ed4f23b092c3317bb5b36140156f4150,166,136,456754,100634,356120,190,146,638111,113913,524198
911b3aaa972b0a6d5538fb02766a494c,32,22,32469,13393,19076,32,24,33765,11774,21991
d150095deb5feffced578ccb6dd2c363,34,29,28878,11485,17393,38,28,25983,8644,17339
e14d00c7014d2d5619478174dec7e006,55,49,79374,20672,58702,43,29,45358,17045,28313
78762b14a1c16bf96e360407165aafb0,111,75,163029,47964,115065,98,73,162116,46053,116063
524bae5671ddd12afb3002e36a747bc1,111,79,253370,62913,190457,121,89,244391,86218,158173
6daa6444d09c8e808265bd8ae53ad807,42,29,27871,10658,17213,32,21,29867,8722,21145
7891152ff63908ac233252d8c748d558,58,44,75892,25044,50848,73,56,125926,38436,87490
42c1f94bfd128f05808d32972708370a,114,93,290100,60182,229918,118,108,262054,84165,177889
cd75154faee9a061b482e9789bb1746c,50,42,68514,22838,45676,59,50,67410,19092,48318
812969200a1a30c27acc4b2d1717049b,138,113,413981,102904,311077,139,104,469154,110727,358427
8f7c22a42c5acd58d8953dbef728e076,71,63,142233,34922,107311,62,49,93509,25348,68161
b30643ab499a293956b7f7a35da60415,21,13,5621,2552,3069,21,23,15692,8488,7204
5d0233aca90821b051078d16cf797f2b,33,26,27042,15882,11160,35,25,42719,10396,32323
56e42d5d7aa99aa4abc69d542a8d6e89,37,18,23036,10732,12304,32,23,30264,11269,18995
184f9dd7cc17cee3a7e49bdd292c949e,36,29,35468,9975,25493,26,23,19261,8440,10821
a2d8b2cbd54911b0c8d514664dc5a290,87,63,109311,34911,74400,107,75,175852,34718,141134
f19fad9e5bcd9ea7b906456280ff6e35,70,52,109628,36654,72974,55,59,80738,51053,29685
6db927c2cc50d1ce67901dc423a4855c,89,60,144612,45470,99142,114,94,248251,54307,193944
51dfc8bffdfa58ce10a2f951fdf94617,100,89,187874,73422,114452,121,94,252424,49685,202739
4a986df559a5389ddb86274a6972995f,73,57,81486,23575,57911,69,50,92237,19341,72896
b595ef455b81df5e7e2240d6321b48f6,39,35,37342,11922,25420,47,42,50907,13889,37018
e72db9e6fa329feaf66fe4ae7f0934ba,16,16,8862,2326,6536,19,16,7611,4415,3196
883588147356909d38d4c4c32fc670e5,25,19,22570,8633,13937,38,29,34569,9343,25226
183f19dcb40166c2eaf9078fc1b8f0d7,109,107,232212,45416,186796,101,74,177130,50291,126839
3f9e13bc9abf54cbc58ea15bffbba170,25,14,11299,5598,5701,22,21,12243,7090,5153
1d98ed8c620e0a751b199f184e647917,39,34,57044,23732,33312,45,36,63547,21107,42440
bd856713b890541d44fd1975fb244d64,44,38,49216,11366,37850,30,26,26965,8446,18519
522942b0163a0d7c31bd4c0e5d33eb82,33,31,26068,18472,7596,44,37,56005,14473,41532
99c7521d8b3f1d6300db44844a11b0cc,142,106,434410,82392,352018,153,103,456407,90185,366222
100cce6fd3432d94caa2fba9ffbd63b3,95,72,118841,48050,70791,96,87,162947,46699,116248
01325dbdfae21fee34f8c35c8cfab870,52,41,76260,31171,45089,50,37,70952,31503,39449
efa082932ac87e74d5e07dcf2d4f631a,199,133,533925,153075,380850,162,135,523346,121807,401539
2743328d33fd816c0cf14d95dabfc23b,134,108,429637,107303,322334,138,109,448231,100231,348000
95895088e32c636b5f2735f8b283f46d,124,121,268694,66856,201838,142,95,234343,52139,182204
51c1d4c27d4474dbd3d6e6c9a82d1597,71,50,125467,41358,84109,61,48,91784,39274,52510
d0bf0dda091e228410c18441d9e38498,103,78,193774,48956,144818,80,53,119552,41689,77863
4ed9be62c064522307fc6f6d7a8443ab,55,49,78306,23362,54944,42,36,49169,23567,25602
b6619df83a4231c9719eaeb60a8947ec,164,136,392599,62007,330592,139,117,389747,77412,312335
afd7081fd2776afc09774a6651f057ed,52,44,43528,14024,29504,37,24,34509,12084,22425
d5b6547f92a474e88046dde663b88eab,53,45,90410,29036,61374,73,59,136155,32527,103628
dd03412b96b806989bb2b2019089f826,125,106,300770,50518,250252,153,120,332097,54796,277301
b7ebe8a267d553977247db720d66106a,103,78,196206,36927,159279,131,112,253838,60060,193778
99af84865bf0066a4f57607fd9167e41,91,62,175815,40593,135222,117,104,241820,51192,190628
1045099168b93b598e253bb72b405947,35,27,44325,12296,32029,31,27,30527,14649,15878
10733b68a846e70a76b36dd93537675c,88,73,185136,34380,150756,79,73,144565,51524,93041
0bce1e8c8420f88012303b8132dc64f4,85,71,146306,71856,74450,107,86,212454,57455,154999
1b84c9e89e19675c739ff9f10488b057,17,13,6675,1273,5402,16,15,6242,1300,4942
b6f6cc45aaccb52fa78bd63f797f9749,27,26,31322,10627,20695,39,27,37478,13236,24242
253a167f041413669effd3ad0d76039b,152,111,371390,94218,277172,164,116,399067,69847,329220
2391c3547b00d7e01c0b4cbcdb662d17,25,22,8459,3967,4492,28,16,10202,2938,7264
1f28bddac4674fe4dc22ae9f722046f3,142,101,268613,51065,217548,121,94,217590,50029,167561
a4e23bebe3f9a36151cb3988a0b2e739,62,50,55837,17338,38499,58,49,62373,24366,38007
35128a5b54b9b1f2d95eac3e8f6148df,67,58,90356,32039,58317,78,56,133978,23891,110087
d576d6070c9463d7cde4c7713d6dcf56,198,143,690952,144412,546540,200,147,813880,112471,701409
684e943233973f98e4076f9a24e5e36c,34,35,22863,8196,14667,36,31,25185,7769,17416
a4fcb77bed0576869e811abc407482ff,106,96,254844,70587,184257,112,96,258652,59522,199130
6c3f2da4f95ad4f01a943cbe7e6593bf,28,22,21022,7908,13114,36,27,35598,7847,27751
8efad8fc8550318cc6767959ff2a6d4f,14,13,2347,2207,140,16,13,3179,1955,1224
b95b922ebe6a68c94de358e337a90be2,201,145,496273,104768,391505,157,108,516532,83132,433400
c77050d61546a60418e8fd30ec03d348,22,14,4329,2335,1994,16,14,4212,1926,2286
71a52a75d394e6822d4dfdbdbc362dd3,22,21,8300,4995,3305,28,22,14119,5958,8161
015074a476c4abc225daefa9eff30ad4,134,115,487244,106160,381084,132,109,363947,102334,261613
7171d8546dc55483989c445d545e3b9f,146,86,289130,61695,227435,142,109,335716,104261,231455
4a0c07b52a033ccb18bdd8057ff0234e,28,21,16621,4675,11946,17,17,10263,5414,4849
15193000fd2687759f2fb005ecb39db4,196,143,545010,114490,430520,190,161,653739,117208,536531
3f4aac81190a4a4e6dae49d2ab529581,5,6,571,658,-87,8,6,2819,727,2092
479e5428e8da6f202ae63ac8ad48f424,138,107,387523,82720,304803,102,83,240474,96424,144050
d28d46b6f612cd3ea55a8c382d0fac7e,55,51,70687,32379,38308,63,49,85695,23875,61820
5162ef8ffa2545e08827a7896c5089fa,28,25,15666,5073,10593,26,21,10957,4706,6251
56fe6a6309341430361d6f37c0744fb6,68,52,100995,30695,70300,82,70,130558,38473,92085
909fba183fb648bfb1a520ae1c60a997,129,86,332289,44798,287491,133,107,278282,51097,227185
881c0ffbfa113c3c31768ef2e11055cc,23,18,7659,3700,3959,23,16,8698,3604,5094
86565bf3d14382a19ce62cf879cfe1c4,202,147,781586,144602,636984,166,129,1012291,172743,839548
b570ea6560f544f840a0bff7219f2d10,19,14,4440,1700,2740,16,15,3433,2201,1232
c669d0d740a3597104c2e08e21e0ace6,74,54,134174,36289,97885,81,71,123289,35601,87688
2dd8afe6bf6c0f3a8214edeafc6b1707,183,119,588349,109265,479084,144,92,503268,85928,417340
1cadb7830e09d8b2d1a4b28b06cc7d51,27,19,9721,4002,5719,23,21,10131,4005,6126
26e34dcde142ffaa773c3180f20b1640,133,100,375344,106213,269131,138,114,361987,98347,263640
b0aa8d33c5f414bf40b6aa0b7e419688,164,116,417686,98833,318853,171,125,422537,100712,321825
245c8d1010d2d20671ccc734581e199e,111,88,303613,97421,206192,137,97,400142,95916,304226
a2b6b1fbf74591fe7058c00f69647e1c,111,89,200906,44019,156887,122,93,214464,44340,170124
15a2eccdb3467f983dbf84e0dcc6dd44,172,132,611433,109916,501517,167,112,321472,106200,215272
5c5667a1c684c1e4217fd444b7c286cf,66,60,94004,36189,57815,70,55,86301,33634,52667
d1c797120387c65fa5caa6291639519a,106,79,271398,81274,190124,150,124,407085,89505,317580
2a8e79a8ccc0c4e768d8a8ab25fe5091,107,80,197502,49799,147703,133,106,242729,52884,189845
729d06c4b34cf6759b2527d73d40129d,111,91,206025,29501,176524,131,111,280587,39009,241578
d3f28426b8d47352a64a4622c6b5084c,172,132,585002,158568,426434,164,119,543269,100061,443208
015bffd9270736d9a0e1b07b8d55de4c,21,18,8103,3743,4360,22,14,6599,3213,3386
6a25205ab893931898a66250dfae0384,170,115,511525,109880,401645,164,98,450327,98025,352302
f60ea1e02ae8ea12c7f0084d0b1094aa,110,82,201612,42138,159474,116,86,195992,42988,153004
f17ac47988ec2187c59c65cf85e8f355,129,85,276930,43528,233402,136,93,363017,48135,314882
4907730e7ea481b94ad0113e8f5761cb,139,121,357391,90679,266712,146,104,380382,65952,314430
91dc2a201d38aed7fe0db150f41ed6ae,107,71,192141,59120,133021,119,75,172495,72552,99943
7787ebc62fe32f6c355e058e64947ee0,81,59,98939,29093,69846,70,61,98569,36829,61740
10a942096ebec7264a03ef2e024c1b08,158,81,203047,57285,145762,123,87,196534,57615,138919
ddbe48b40d43b72305ad6ac8a4365e9c,38,30,30926,13114,17812,39,30,39276,12418,26858
a7fe1a47aa19cfffbe45310ecd10a176,58,44,90206,23468,66738,53,38,56564,17247,39317
3e2718f6840487212f18b05e0330b9e3,46,31,46806,14406,32400,47,38,73593,14643,58950
de14f03171e3ccd958b7ce5358b4dffd,101,88,191726,58652,133074,106,89,245137,55729,189408
d1a811567538775f93854cf73e538778,124,84,347810,126979,220831,107,87,258124,105361,152763
6a1e48098b038710baa5fc10c9713723,18,15,4025,2112,1913,19,16,6175,2325,3850
d644a0fec04a82a6553e8e0cdcc994ee,1,2,36,96,-60,1,0,60,0,60
d0371d9b0a265cf7dddc25cca0493173,48,40,41504,16264,25240,42,28,37526,12833,24693
08c6fd71fdf35e1eb9dccc02f7a3e90d,24,15,6948,2254,4694,19,13,4634,3577,1057
36c878a000f1e99aa5c5b6d3d361da5e,164,109,661929,124293,537636,185,149,796980,127457,669523
18af9e4d8921e408d8c2384849cf7003,69,53,95033,25991,69042,68,61,71696,31685,40011
edf53fe4d4bd358eb6838400d698c65d,91,73,172378,41855,130523,117,90,212282,43775,168507
bbe8bbe82b4f559a0a08872f4552e07a,40,25,28264,8878,19386,31,27,21438,9550,11888
dc010b6d14835a84fc527b247c2c4001,175,128,804947,204148,600799,157,131,671818,169808,502010
b43bf0015d0b790aeed3111598c241cc,199,133,730131,112111,618020,162,124,471938,176635,295303
f4224631504c49c695556d51eefdc566,28,24,16050,9208,6842,29,30,21519,8269,13250
afec32f7a527b008e206bd47825b1dd2,149,98,240523,44897,195626,127,85,168995,44871,124124
e47e5ef864e7b3dc65be317f02d8ddee,70,54,94152,26497,67655,69,61,97095,26480,70615
0403e095d4fcb23d0a912b6606676ac5,135,100,428776,90864,337912,171,135,557282,114799,442483
12dd4cb27bc6b1a5ee0e2736a8578b30,70,55,140406,35880,104526,105,86,157586,44844,112742
546875b862fa66285f761c7ad67c6dd5,32,22,15669,7636,8033,28,28,13614,8187,5427
0faea3851cf90d6b5c052711137e31f6,44,42,35807,14229,21578,42,25,30065,10035,20030
f04a6dc31d01e347c05a2936e0fc4a8e,96,81,208520,48817,159703,99,74,191468,36025,155443
910d82ca3c967bc9ecb3e1cb1eca7c66,63,47,77658,23614,54044,70,60,80960,36610,44350
0715c6d3ade8504abb735ad153375ae0,89,66,144668,60296,84372,89,79,208657,74903,133754
f352a68849aeb814fc263bc62b660a31,93,81,218530,51484,167046,74,52,129579,69984,59595
6666081bcd223ddb139afcd907daf215,41,26,33887,7091,26796,50,37,38541,11551,26990
e567d34f45d66abfd3ddfc482e4dba63,88,75,134798,33317,101481,94,79,144443,37415,107028
4e3063a85933382b35cd4537995debfe,24,21,9718,3745,5973,27,19,9245,1960,7285
ded5a67c88bd668f1394880245cec813,26,21,19521,6178,13343,29,20,19208,7483,11725
83c72b294955286e5fc9cff7cd71e3bf,113,91,197874,56678,141196,112,76,207815,48244,159571
98f70f6d5a8a4812bd31d9a880533a25,34,26,15385,6809,8576,34,28,21062,5875,15187
6be39cc2addcb344b29dd4d63c139e41,178,135,592427,166739,425688,149,117,491208,168089,323119
081d5ceb945b52044b70ec4976f02230,57,38,80048,27859,52189,75,58,136059,30836,105223
8b9cb0866e167ea17fa9e056d4a418ed,132,117,344934,77695,267239,159,115,413519,59199,354320
0b1d76a5fb0c4fdf0d5e64aca45de57e,84,69,112816,36524,76292,70,59,130533,37733,92800
a7240df6153ae4cd70f4342417ff0a89,29,26,25288,7952,17336,27,22,17077,7440,9637
1a7c52cfaf4ce5ee3ea072608a570901,53,39,67719,20168,47551,65,60,79687,31251,48436
c7df941c443bcf518f9160da0544244f,54,45,71726,19257,52469,59,42,67647,18677,48970
771689f007d57c029f9f2e89281759a5,24,22,7808,4494,3314,28,23,16096,4865,11231
d0c572a9cf5d2393a2e4189a6ab58d7d,24,21,5671,3374,2297,26,22,8189,3213,4976
279505b3eb8166a077bf5df61cb33b09,119,98,195249,47155,148094,80,52,144882,28140,116742
4c2ed42b9a3761f54daa99a33110ba97,135,113,404771,84890,319881,150,130,400562,90867,309695
14dbd8fc94addd0ced59a3937b4f9a79,142,113,304102,53559,250543,116,92,247917,57267,190650
17097098d7cd71b520f0cfadfce05bc3,54,44,62399,23650,38749,53,50,66589,22485,44104
93504bbfd4a67ebff74d14b8d427bf16,45,29,50772,14093,36679,48,36,44844,16455,28389
b3f6d9d62dc8e879b634c8321f7d6365,24,15,7882,1973,5909,25,17,5352,3338,2014
7768cc7986d6932fda57bca0f5697b92,232,142,693641,117838,575803,178,133,700298,122017,578281
f728c7370d3916a5aae8565d24dabef2,43,36,32482,14415,18067,37,29,24269,11520,12749
e6c326de4096ba021165cd903e9c44b9,88,59,87563,36102,51461,92,66,99620,30708,68912
c6b534dc666ca4130129ddb5e891de62,96,70,174827,39925,134902,81,63,170496,32450,138046
d2dd4c0c44cdf312b3c4d2cdc511dfca,115,90,282558,66454,216104,170,128,452858,65123,387735
6dbf92b4f9d9bdcd9eed24c384985c3a,64,51,90830,45746,45084,114,87,220685,37244,183441
dc01299674157b73933f062ece5e77ad,171,133,499570,119603,379967,176,116,588359,89688,498671
715e8e4710fb6c1413b1ccfab3ab3838,71,51,110087,31854,78233,83,65,188183,27118,161065
0e47cfdebec3eec623579f6555a967a1,93,82,218347,58474,159873,150,99,271763,57250,214513
0e6476a900de528e8e62607da3c493e5,183,139,792793,161413,631380,192,149,676221,124281,551940
44f3456447ed7e9067df1a58c48e5c88,166,125,618998,116504,502494,166,116,394216,81620,312596
886195be41e4f085f865231dc62dd86f,67,52,114316,31878,82438,74,58,95330,29091,66239
aa37a6c6f65bff3a2e58933018a0ea73,32,25,33198,10724,22474,44,34,32125,11669,20456
be01057529e05c498040947a8e054d17,72,47,94929,41214,53715,101,78,167534,41958,125576
b1bf6e50ceb3de59591aee642dd65d2c,60,47,84290,18898,65392,42,29,44844,18108,26736
e5186e27a969403a52152ba696e4698a,59,50,107916,38235,69681,61,42,82608,29915,52693
e413c8697d022cf5e1e52ba7cbfbf86c,24,24,18510,10477,8033,31,20,27909,8065,19844
275066906fb926faa30d4d4fb54e3e08,128,101,289035,79639,209396,109,81,223657,83565,140092
9a0d4474c641936a70cfb78c82148ed4,62,53,83155,27266,55889,67,58,93646,25999,67647
bff2d692a2fe05bf54935a32d17115b9,31,23,19150,6251,12899,33,21,21714,4630,17084
d596b790e7a5ffba951960f3479916ed,104,74,248929,95478,153451,119,86,242472,75470,167002
c42f0c66facb2e462d60d18c0df22571,138,99,298186,70953,227233,131,100,291082,69113,221969
35e6ad48c166e5d09716761bd5bad4f8,26,19,20281,6372,13909,29,22,16239,8817,7422
797dfd7c4cc5236935b26736b12548b1,153,116,472918,114706,358212,170,116,513164,90006,423158
1312c14105cea94d1847a94d7614738d,139,112,552821,105878,446943,178,152,696568,129805,566763
18fcd6ce6a47cff342374585986e92e7,152,122,522877,110094,412783,153,116,418412,87492,330920
1c604a8dad7473b8df08a600ce8e4ecd,41,36,40250,18082,22168,57,34,54591,12765,41826
9e5a3b542d739a1a5b47663f482ef49d,60,51,91443,30745,60698,64,42,70320,22500,47820
834161724a6a111b9ae670be0f969a57,92,67,137661,40610,97051,91,73,138383,43950,94433
381590786aa8653474b3929c7935d966,71,60,97661,36177,61484,77,55,107760,23287,84473
91e5828b58e804b239ad398722146c76,84,63,98639,21126,77513,81,68,91356,22073,69283
09f278895406416e9cbfeead65d47665,194,131,464512,91472,373040,134,107,375205,76585,298620
c45206da41d5a613da7c7f922fec151b,211,176,1004908,224698,780210,184,126,875836,150096,725740
15b106bd6d60ff64cb6e67a9d3411cb2,141,96,438393,101500,336893,120,97,387013,102939,284074
0fbf82b878afad11d18a5125dea60be3,141,105,413844,71769,342075,160,118,403112,100062,303050
407497eb873eb2dd3ae62c6b3aafbe01,67,39,82319,21921,60398,45,39,51615,15612,36003
fe9370afc8dad6d4baa4d9c7ae0e792f,29,24,23597,8021,15576,29,24,21785,8227,13558
51edbf91aefdb53f0107d1d58e4464c3,30,21,19643,5078,14565,23,24,10369,5463,4906
0e1766de088212edbc5e0c2a33b994f6,117,100,275164,93593,181571,93,75,244569,68695,175874
2d18d2e3b96a1cfbdefecd1e6a0f5389,65,51,99210,24566,74644,59,42,62407,16436,45971
0bd6e1cf6280f3eefe9267440b2a4fca,24,21,12336,7961,4375,30,22,21370,7022,14348
552811105a2e2ae414b5ade9983033f8,171,137,712487,154821,557666,184,143,598586,117002,481584
5f132779230c32a804048768a07ee23e,70,55,113423,24619,88804,57,45,48973,25182,23791
bda21c74c38ff25edadee7601e766864,51,42,66560,21406,45154,47,39,51983,25427,26556
d3d4af0b77adc86aa635edd8d2bf4741,132,101,297717,58788,238929,107,92,258961,54632,204329
cde76f54faaf6903d4f143176a3ab80a,8,7,1189,1256,-67,7,4,1383,466,917
f2ac331e18f5e04b1a856a813acc74da,38,33,49920,17194,32726,47,39,49003,16283,32720
dab402dc42000858873f5571d11e0831,142,101,533800,116585,417215,183,151,615490,168305,447185
e503d590573ba2f8b8bbc77cd13be519,15,14,2985,2286,699,12,9,2680,1639,1041
8b1f1e6bf2ab344c40f45a171554f03e,114,91,274122,72492,201630,138,110,302822,67551,235271
7d56350ac234ac1c91b0a49608399ffa,130,95,281196,66997,214199,97,73,189295,61533,127762
5c11ca9132027ae3e8eb2687ae79776d,48,35,55376,21192,34184,40,32,45814,18269,27545
8bb7ff70eee8ca6e7c55b4f770d8e912,120,92,211765,34386,177379,108,94,234406,51289,183117
1f67d8c0e5f0ad93831b5520e3cec5ad,108,74,281875,75211,206664,147,77,301825,95897,205928
9e03b97126628a230a95d18b2442f4a6,57,48,101049,27970,73079,60,51,117616,25399,92217
ceb051865eaafeb188288497098c88a5,38,23,47866,16736,31130,38,35,48822,25215,23607
39d8f2aa42f802b1b423b8560d4347f6,156,121,579255,135299,443956,226,165,707516,157492,550024
d4048b1c5c6dab3e2e58211080e6bac8,20,18,10767,4317,6450,25,17,7472,4924,2548
9c69db820edd05e7e87bc7086d70ee8b,93,76,214174,65302,148872,116,91,250775,49850,200925
bafa06551a1a43082d823ea179e5ef48,109,88,232411,72287,160124,140,120,283500,76892,206608
ad07f9d3c92a40deb1c5fe8e076ddb06,159,126,549642,100627,449015,138,113,394269,79423,314846
89ebccdce824516204265ea2d50e3e1b,138,107,433229,123128,310101,148,104,455678,120171,335507
6cccb83c8efa536cba94487499ef596d,190,135,830586,139015,691571,141,94,642085,158318,483767
76a8bef805d43abc958a29e693854a2f,62,58,73385,31811,41574,54,35,96710,20903,75807
104c97afab9c9aa50145f17a73cee7c1,26,19,10977,3784,7193,24,29,14562,6183,8379
dcdb0cf951ca9601e3bfaca154e95e41,188,100,669600,113609,555991,180,119,637286,145443,491843
76af701b985487dd74407741b9c563f2,17,17,4863,5768,-905,22,18,7648,2227,5421
56aa46352e52c49ff580edd8faa2eb12,146,98,345658,157229,188429,201,132,573270,124213,449057
1fcc70676ff4d0415ef7c8739b950707,110,92,269112,53260,215852,87,80,224734,73222,151512
6b44e54429e684a5831909c0def40c4b,12,10,1945,635,1310,14,8,2036,573,1463
f6277633288cac669e049df3346e6f73,54,38,71066,20802,50264,39,24,47108,21658,25450
3104ef0c67ea0996048d63668f9f7d23,28,28,14586,5619,8967,33,27,15966,7599,8367
897f19eb5967070f470091ada841008e,110,97,236617,58054,178563,111,94,188070,67527,120543
dadbeec2d8b51763399ee57d17645ed7,45,36,43634,16999,26635,58,47,64888,17807,47081
420af473a72f13f998123c1f2bbdeb9d,121,100,302658,69522,233136,100,78,212590,66608,145982
1eeaac7a45fb1db3c65fe3c8a77d7046,6,4,425,88,337,4,5,108,249,-141
879c3199135229f845095f0a9841a282,72,67,202967,71551,131416,98,69,230442,49671,180771
102efec93d42f8e617ca231a8b596875,97,84,182397,37923,144474,101,81,189369,46227,143142
34b7d1a472e84cbc67af1b563367cbdc,179,124,597168,141546,455622,138,96,433383,121644,311739
8b824422efaa5f920a1eb632574f2af5,50,40,86459,26511,59948,68,44,102233,29412,72821
38d506c95b23314b991081508ef6f348,146,110,504202,129476,374726,172,114,605729,104322,501407
907fa25cbb309f64be4817bc1d0643de,41,28,33114,12092,21022,33,32,31103,14594,16509
cc5a06e56790a3a45172df90b2585670,81,66,96919,23529,73390,77,57,80630,19356,61274
f197bd087e10335b42a5b804e1df4fb2,90,75,213655,55522,158133,104,84,241794,66325,175469
d3fb2801db8774f716bd0b70ca4fb15f,61,52,63959,27312,36647,76,61,96964,29903,67061
d7fdfa911ad2f713614673376e42ce7c,44,35,50085,24143,25942,41,28,58724,18270,40454
4299e26db54b6122886fa001bf86cb07,31,21,11894,6018,5876,35,30,30051,6541,23510
37f3769ce22db0a0843887f411cfb1a0,74,62,168117,53907,114210,126,95,235701,54766,180935
e81b1e384bd1ae6e7287a86ae4f942cd,149,106,702136,185067,517069,227,157,1307177,277131,1030046
e9663efba2b5bd7d47b1f44275c3577b,19,20,10174,5027,5147,25,16,11153,4584,6569
02dafbaf6fa2481d9e8088dca230f75e,123,96,421446,77333,344113,164,130,435072,109572,325500
219af58f4fb3cd4226531753cea92a60,104,85,235047,45400,189647,72,68,108824,57793,51031
bb02e5df53105cb5cd604e3a998297ee,35,27,14572,7582,6990,33,30,21038,9611,11427
a492caf5a992171690376d2a1daca770,31,25,33673,14091,19582,35,26,38682,16033,22649
32f39a16052762e28ce2ca21ecc80a79,126,95,288060,96773,191287,134,107,274767,84773,189994
0653a9ac7ec32a2a1b37dc24cc1534c5,113,101,264264,76690,187574,100,85,238648,63418,175230
f40478b543a7441b0fa33f03d0a41995,97,70,144515,44288,100227,146,113,455990,47122,408868
d3c1c3644db80dff6fefa97826b771aa,25,19,9784,2420,7364,19,18,12545,3402,9143
f3b9b608e1f6f2aff657b2dcd7182b78,181,129,454451,60750,393701,131,103,398593,87114,311479
d39bfff272f6aa310f6afe3720136daf,103,75,195748,46238,149510,103,85,176967,42653,134314
7f1f0672c4aaf239a789e85ceb6b70bf,96,64,189263,32616,156647,79,54,122661,29500,93161
c9bc5d930a5f1bcf27cb6e36c0084790,62,39,117755,33821,83934,75,67,149054,42320,106734
88c36af2b2ffb64b1aca58d185bb5f7a,11,11,1817,1995,-178,14,10,2579,1382,1197
3017abe1261a91eee6fc901c232ae8e5,112,90,235818,71181,164637,149,139,456038,80583,375455
e500c81096b0db8665393306b91bd964,76,60,165910,59759,106151,124,91,244671,58808,185863
97c87070ef4478cc0586d65fa0e30f4f,115,92,319357,78372,240985,151,106,366934,75099,291835
67be1194a713cf31064ad5b48b885041,16,11,3118,1387,1731,16,17,3307,1519,1788
d6cc5b86dffb083bcbfb9a9ece463664,50,47,62036,17112,44924,62,56,43233,21939,21294
7b7385a5ed3f9410f9fb162a3fd2e6b4,126,114,241564,48329,193235,100,80,224745,42359,182386
ea69fd1dbb227463514ac5cca9473329,88,71,123266,32472,90794,64,54,86961,22429,64532
dcbd677029a86b92fdec4cd4452aad11,24,21,16036,7570,8466,29,21,13385,9009,4376
90d0b675a21598702bb5be5658a1e60a,131,106,255729,56757,198972,129,99,229802,67326,162476
b836e0f88bd943735576e2a327eb0a91,211,157,919825,152942,766883,203,147,774096,218165,555931
911e2fd7441c2226bae62306107692e3,47,37,57436,22386,35050,48,41,56651,20023,36628
fc9aa6a38f0db35342f74d06fb510730,78,63,174872,79332,95540,81,60,183287,74009,109278
90553e31067795dd1197d574aa5795f8,195,147,499780,142289,357491,176,119,555738,103018,452720
75b09682e8254c5fbe7cb0282b0db8bf,135,98,286603,66089,220514,162,123,417543,90371,327172
c112626ab62a70140273e69ad891f365,102,82,222748,77003,145745,139,108,301131,81065,220066
09ef0a894cdbcb1afc52795836401115,129,111,310543,94629,215914,156,117,372049,81322,290727
abc79d4448ed075a73b81e924403053e,99,81,255793,40570,215223,87,80,179060,53076,125984
0fd1b6f642061cce708fa54bef478b06,48,38,66066,25572,40494,47,35,79759,20211,59548
0c9efd9da7d7511824697bcd5d4df5c9,77,50,117012,38406,78606,111,81,161776,39582,122194
7943cc35ba6e195dbc3b78b98c11b7bb,44,33,43996,15673,28323,42,37,31041,17250,13791
bbb7ecd2befd1da1424770a2108d3f45,33,22,16543,7989,8554,21,17,13287,4080,9207
782b643b8a66d9e62e60cb11dd1cfecd,34,24,23789,8873,14916,32,28,24844,9634,15210
c4e5e640001908c3c2210ec71550d41e,67,49,106775,24179,82596,44,40,66111,20374,45737
debb41cf95e72aabfceb26863193dd28,27,19,9424,5354,4070,24,22,10656,4054,6602
00856603661f69453ca4977f2e6a79ec,151,131,355142,94443,260699,90,77,198091,84780,113311
3ef44708fddedf154e94b84586741971,80,68,154075,43594,110481,71,55,118359,37264,81095
a44bfca80d3c790083e8d1a86ce809c9,24,16,4715,3550,1165,22,16,5486,2479,3007
e39614668c9ed294fa35c474ce0bda58,8,13,1237,936,301,11,7,1118,726,392
d923dbc31905034c447d489783592f77,149,116,254054,85247,168807,94,77,221733,60217,161516
d6f317fc6992ac6c7c4fad1488dcdd3d,42,25,25881,12247,13634,44,29,37840,10631,27209
e032dfa3611a12b89ae866fb5b5b3229,35,29,26514,7876,18638,33,28,14526,10321,4205
13c210b504254354979299dc3ca8a69c,143,84,356567,81711,274856,174,127,549034,76149,472885
be2fe361d1d4daf94c136d6f8fa70f60,39,35,40655,17505,23150,49,34,50067,18428,31639
6942855a940ec56fbca56b7589e108ec,137,102,246859,51336,195523,119,100,209816,59239,150577
955211dd9c4125de8ab6dd942fe38677,107,81,202219,40920,161299,98,85,180139,42777,137362
aa312b1dec543dfc1a004bd621512e4e,54,41,88143,26517,61626,52,41,85802,22239,63563
ecd8791c6dafc370056f86f17d90d58e,182,125,620641,112449,508192,147,121,410233,116885,293348
e90fbc480f8d4007ec95cf3e2762b1cb,155,116,458107,126168,331939,217,138,650903,128560,522343
89b764303cf11e174837ce30d6c1ec92,49,36,63323,8626,54697,49,41,48710,14715,33995
1ed7a9e572ae6c36acb592e2d57f873b,27,23,26137,7217,18920,31,24,28833,7027,21806
4f8419b124b1b27f3661b6f7e0e7c31f,75,59,163359,40177,123182,89,71,161833,37393,124440
a4e30e2280da547efacec54de3f81996,28,28,22291,12260,10031,40,34,46906,9741,37165
aa7ff482ed712e3e1c8ec7216cb58ac5,50,45,59740,20692,39048,58,46,89206,23209,65997
cb6bef30b3fadf87006d7fc9b89a7281,34,24,29094,6383,22711,35,23,19716,7111,12605
817a5f6a5a7867a927b742be28df64a7,21,28,11000,5230,5770,23,17,8214,4109,4105
92a09715b87a2be6b2d574080099bf82,22,16,10506,4766,5740,23,17,10172,4097,6075
9fa393c4f98d5753a2b5c0533932a200,21,15,9205,3420,5785,25,19,5871,3694,2177
62795dca8f65f808c5207427355fc1f5,92,67,218390,40963,177427,69,57,118562,43457,75105
60bc696efd31109caa78e7a1ac2dc11d,112,81,381990,56228,325762,170,134,533109,84514,448595
013714ee62b17e40c767d7d416e6c44b,35,30,26958,4254,22704,32,20,10988,2479,8509
3d147aaa13c08630302b1a114738bea2,67,53,102429,17362,85067,72,59,92075,27782,64293
34dfe70be816444ce0af76480025c046,51,29,33805,13112,20693,53,45,41513,15327,26186
460cc4cdeba5a0cb2fb8d470ab514535,26,21,9473,5880,3593,25,16,8521,3940,4581
cb503bef347dfa059e833e90f85d3335,210,121,656448,96531,559917,234,147,784442,174405,610037
025c2e9160cba5cdb0a44c0921d547f3,66,53,80430,50946,29484,81,61,121388,45479,75909
27efd5ecbf4f7d4270fbb244c95778df,4,3,291,296,-5,4,5,328,323,5
7add4b70cb6c39ebcbcad0000d655cfc,57,35,61231,14896,46335,60,53,51261,18049,33212
ae543b5c3843cbf96edaab8b02a88296,133,123,506295,161910,344385,156,117,567414,95733,471681
c1d9c6db08e365ab856b9abf8d1b9a74,139,117,286117,68479,217638,136,104,311550,36695,274855
c0fd2603351a2edda329f5cd57c38a90,24,23,20429,6041,14388,34,22,20424,6503,13921
88b55c4f21f1f527dff28b270684cd72,78,68,152194,34156,118038,60,49,93424,37978,55446
3f9f9fec49cb4fabb70ead25d7226316,85,66,152765,28909,123856,66,59,107656,42778,64878
b078f7aeff513ecd7638aaac2151cac4,69,48,128792,22675,106117,59,43,54378,16719,37659
66960067d6906a97f281eceb316538ab,83,48,99126,21659,77467,71,60,132333,25202,107131
6b758f20d1e7f1dc64ac94292933c32c,56,43,55013,16034,38979,57,45,49132,15404,33728
ee38e476ecf7954a098d802bd015ea8e,142,124,431030,116943,314087,152,123,481838,103063,378775
401ff4142fb4171b9cf46a1072a9fa80,132,112,358893,108074,250819,156,137,509290,106469,402821
8e44cfb8c7a93c3f5a80c5b93d2eb8aa,99,82,174307,30498,143809,88,68,141618,28659,112959
eb7a9f26d11f1a09c0bf205b9cfc4790,147,122,355115,81232,273883,109,82,172958,62091,110867
28868ee627d75a2ded4b35773eea0a7d,43,31,54480,17115,37365,41,37,67756,19807,47949
0ed7c59efbde40ea89e36ab44ffb99be,157,116,327369,88059,239310,117,98,254189,89121,165068
b9e43a42dfaec545df0fe865c72104e6,104,70,250634,68525,182109,138,103,240583,80274,160309
88225aed8e6a44bb936be32d2d2cb4c3,119,96,290037,50439,239598,97,93,180596,65165,115431
a7aa629d3231777dbf35c2e3ad1afd24,92,75,310947,102245,208702,148,143,439267,128180,311087
5313b7a06230b97fa3cb6387c2205dc3,168,140,625063,192168,432895,176,126,648710,150721,497989
f82e323566da696717c24f11c642c111,103,86,186000,42423,143577,86,68,149639,41608,108031
c70f7e48af273af844d39de66430a627,142,113,399090,79405,319685,98,68,217399,83229,134170
2c633cf75891c61adfdf7793c01b0e4f,89,59,80995,32775,48220,100,74,113659,31048,82611
927d7e8386bdc22038305c3f784dcd66,32,25,19182,4224,14958,27,21,11779,5085,6694
e9d8f1378ad5bbff7460b8c4884482fb,36,20,34737,16847,17890,33,23,43487,13351,30136
dc255c58cff4b15dcaf787b5a46ceac4,154,102,430662,157615,273047,123,81,410301,208965,201336
a345ff23760d261a979ed5da0a1865da,8,7,1141,1499,-358,12,9,2082,898,1184
63682400cf4f3f70a02226b2d959d24b,111,91,211910,75658,136252,127,99,331621,103166,228455
811ea47aba3e911ee3d818c5b031e4d7,58,41,66846,16180,50666,63,52,69168,24684,44484
1b644238e1c1b3ccbc8e28a705f885cb,63,56,75734,21335,54399,66,48,77566,23830,53736
3be5192f0f543414c3247ed8ec6513ee,85,61,165804,28757,137047,52,49,95842,38703,57139
398ec9d18d80ec95103a8f4647e671d1,125,83,208522,61025,147497,125,92,277460,69565,207895
b2366468f8e54160abe11968048f8d19,74,61,100076,23966,76110,84,61,96955,20095,76860
716f93cc9e813adfc39b769e5d888591,56,43,61499,18109,43390,48,47,50280,19748,30532
d31d2ef407458981ac5400535ba0ed16,45,31,30976,14921,16055,45,43,42929,15891,27038
7ec439399a87f15d7d741dc939a21f55,72,51,99602,24997,74605,79,52,98994,26885,72109
768b6ba47ad56d8c2d21d3caa540e949,181,126,502851,88442,414409,179,144,470903,95066,375837
dbb82afe9eaed41f48def305b616baed,185,145,825752,148644,677108,197,166,826462,122074,704388
009e2ae968da4e191b56fe2d2d2d9e0b,39,31,37148,13325,23823,37,28,25294,13292,12002
5a01e3d726df2273d580a8fb02bc62e1,116,83,225181,32878,192303,109,81,184984,43605,141379
6ce8dc2bf5394c62d6c1e805f66a1827,69,45,115090,35801,79289,83,59,126993,25341,101652
08f152543228ef7a1fac3dc9c0e5000c,22,16,11277,3339,7938,19,15,10851,3236,7615
3dd4c6dfb3a943123222590576d0fd98,165,138,558726,113183,445543,167,114,502459,90467,411992
ff69de5af32083c2582688ece64e357e,191,132,769193,164032,605161,203,146,729321,192796,536525
5e684fc95a15f880b1dc21dd9f0b9679,148,112,433909,92155,341754,123,106,333870,82572,251298
a355fc54893554eb88e3a18d1a49da74,103,66,147555,31296,116259,87,69,158990,40932,118058
d6b7e58ad223cdbcbea31ecc8b2e958e,137,115,323786,84044,239742,145,108,449104,64921,384183
c175ef14590f9edd3ffcb4d63f18f496,181,118,515414,199294,316120,179,110,490137,153198,336939
0a968b04ba97fede4428569a5f553926,118,91,264236,75805,188431,143,96,332171,62149,270022
c4b41488eecdb9be31c221f78aa2af83,148,108,429532,106926,322606,141,118,453707,141933,311774
ade38912816f9cdb14c78baa34dd7ac3,86,68,124527,36923,87604,82,69,130284,29103,101181
fe2724e49a2333f836522ff7c41d614c,29,22,15060,5775,9285,30,21,10018,5226,4792
c408fbf72a88b228a558146797fe95f6,60,52,130844,40261,90583,110,95,228568,51039,177529
2621ac17ebecbac3375f7e1afdde04be,178,125,337105,59812,277293,171,122,333668,68568,265100
0e991c1b67c97ce2894e56216b14bb5a,80,70,181940,63635,118305,113,79,187775,61204,126571
aff71521cbe87faeadad29e61409001f,43,34,33259,16568,16691,48,34,41680,13670,28010
edb9c692b41783c5f96f44862772f7b7,143,85,325488,46579,278909,92,62,182208,60984,121224
5bf257779d04feef97230d6588f6a0d0,104,91,265327,57186,208141,106,80,206945,55541,151404
2b59f100d62eecd4537d46b18135d5dd,88,65,185559,38065,147494,98,71,169344,28363,140981
2b46548726f6599954674d4a405ad585,124,95,287479,59616,227863,112,90,242724,55352,187372
ff95250e63de26ea3bc9881a9009acb8,50,40,66382,18044,48338,47,42,66518,14359,52159
dbe8c29728ccc18b3d7600c94ca98eb2,25,20,10499,4789,5710,24,22,8162,4225,3937
a681557f28f846a07401342edcc42644,62,52,100573,33931,66642,64,55,84413,28339,56074
c9cfd080a4c130f56307d09653029611,177,136,695636,146615,549021,160,138,676326,183605,492721
ae455f405edd5ac91f27fda48d4ad152,23,17,5657,4310,1347,29,20,12806,4254,8552
334a02a0cac60414f1780bd5bef12a8d,189,154,836477,215176,621301,190,124,568361,204766,363595
14284970d98071781e219d7a949f8f61,9,3,867,148,719,4,7,539,725,-186
599a4cbbf607f2ab202d27e18d7eb4fa,98,76,192971,37178,155793,80,68,113519,43192,70327
4d6d76a649a8cb73c197830f5abc8741,66,48,71757,26575,45182,64,57,78983,27165,51818
d602a5907d3e29170fc38d948341bb0c,29,22,29116,6033,23083,29,25,23694,14179,9515
57c48e2a33128fa5c68e03efc98044d2,50,42,60983,22752,38231,46,51,63688,21912,41776
f954bdd4fe0f09865aa1d45db5210109,55,42,89738,14565,75173,36,28,31335,13885,17450
01a6a924c88d4fdf31233da276b83fd5,175,114,463628,84675,378953,157,104,405392,97730,307662
7981605d0c40486827a0e71e8592c49b,46,36,41886,12738,29148,44,30,41217,11928,29289
ad2e98083dd8b0d7907a41848898086d,78,64,110437,20633,89804,86,60,86731,25324,61407
d01d425f75bc0dedd6ce4e7434b08178,106,70,156106,43855,112251,74,61,137278,43929,93349
aea05de1afa3428133c7bee1658612fe,133,105,390441,83527,306914,145,105,401692,79583,322109
4adacc5fcb60e2a87c19e241a52945ed,57,49,77879,30840,47039,61,50,129284,25449,103835
278e20a312f9c6118358fc5d7ccd0a21,164,131,558340,112015,446325,158,108,538833,111421,427412
b61da54df0f78b89c6b8fdc95106da2d,107,87,278163,75914,202249,137,100,359045,62416,296629
a461e499f777626fd7e454b1c4eacaee,36,23,29991,6648,23343,29,24,22926,7142,15784
46ea021468d94f984a1ac0d72068cf49,59,43,85829,14258,71571,59,48,52104,19583,32521
44600820c10bf314eaac2234d863be97,134,104,280288,98052,182236,128,93,240919,82836,158083
7d79dcc946819e156e8aaee0982b8249,139,109,380668,103333,277335,139,116,394697,82675,312022
d431b83359f4621cab76eae0834bc897,21,18,5910,2417,3493,23,13,6631,2875,3756
6f264b47b8f62b2e69c6009db22ca190,91,68,223600,72363,151237,156,127,416895,97319,319576
db196e4e9b588ff606f7f4021c4c0315,83,81,142327,48276,94051,63,59,134380,40084,94296
9ffd5e9afe0ba665674f133cb30a7f71,121,89,290436,100940,189496,116,66,295080,76880,218200
322ecd3041e4d08d7473037417421061,34,24,18418,9974,8444,35,28,15789,9744,6045
eda52e3627feb6eabd62e8748932a925,16,10,2666,962,1704,14,13,3365,2451,914
5e16c92831ca4ac3a74cea53ffda7813,158,114,612910,96896,516014,184,134,611097,96079,515018
7f350b2ea1b5b5cd486fc9eff4026d0e,48,32,46010,9783,36227,35,21,20869,7312,13557
39cb17b1adddc8f8b4ca11a0c03feec1,155,112,378206,94431,283775,149,121,488948,137083,351865
be5cab6100c784767b109d71c131bf92,139,104,377229,74879,302350,118,101,306262,58852,247410
ba623fed671a1a9d8a06eb407d5250d8,25,22,10441,5793,4648,25,23,16785,6205,10580
bf254348a37b049346e3d7a1c6264e00,125,95,422229,50005,372224,148,112,426280,66737,359543
134e8ffbf6a041aedda2c86bca288e45,182,133,592890,122961,469929,161,125,837400,103898,733502
a5ec6b284bfae14394cac75394ac763a,179,139,716534,131347,585187,182,135,665737,150495,515242
7a2fa5dd88f56dcf2ae665d5ff037612,37,25,32364,6756,25608,22,19,11661,5074,6587
ca5da9bb4d3bd6e088793440dbbd82d5,111,94,210693,43951,166742,134,114,275987,54039,221948
dd0203a6d0b22d9680d250441960985d,129,88,298925,49826,249099,147,96,288660,47713,240947
e42ed3f42265a268638f06e319618039,174,148,700854,159126,541728,183,126,623958,116567,507391
82db7e899e519b0832bfafb63f2e8128,46,36,46380,31787,14593,62,49,101874,20284,81590
b076ba493fb8dd7faad8f07218e18416,93,67,158921,25627,133294,88,70,126402,26471,99931
5fd01e7aaf87940e19cddff0b834be8c,30,25,21310,6480,14830,31,27,11531,8020,3511
b838ee67aa9c6de36682b44eafee36d1,92,75,290848,64305,226543,95,79,280658,80634,200024
e6152b6d135d1fa00ac245decd2b9a20,146,96,492386,114804,377582,182,138,537123,193250,343873
22e6f23c5fcce55a8fc88dee42e5aaab,75,62,147466,34846,112620,56,49,58910,23947,34963
1bc9680c2a153239430a75d39eadaafb,109,83,152955,33594,119361,102,79,136330,28781,107549
3cd4e588fd8f530c77602e70fc1f5859,60,50,94934,19592,75342,58,43,68744,19654,49090
e3b8ad7aee32c08c89d5b4102e16c065,111,82,302531,67493,235038,101,69,269193,65818,203375
f5a5791e46e081adbab95d50dad325ef,148,112,642862,223495,419367,163,130,556843,206660,350183
974b764236b9f772a2bba735679f1194,46,32,39392,16619,22773,42,30,42701,16387,26314
0624d68f5795ee7983b9b693ae4e62e5,115,97,212641,61220,151421,101,78,181645,46305,135340
e8ff4e3bb695792e0bbe346cdca60b3e,38,26,45113,10706,34407,43,37,55527,17216,38311
f894bdfa00cec3bd03186e968e53b8d4,164,113,546892,129562,417330,238,135,664037,172971,491066
621dfb18037d5295d98a861f27bd1679,27,19,12193,3543,8650,24,22,9806,4546,5260
771daf613a62fdb7a3f16151e3d91da0,78,67,188081,47746,140335,139,99,234712,55176,179536
b92d9eadfa6b0be0c27577622debc3c3,13,11,2351,986,1365,14,6,3062,601,2461
4b224912dc8c0a2b31302fdb27206694,96,57,283655,64962,218693,160,123,456988,88211,368777
e0c442bd0437eb35a9cc9ba6f2ba3100,40,23,22677,7298,15379,27,26,19814,7423,12391
bc82ff161674144ea5f7ab1e9a21f24e,55,44,77699,28170,49529,70,60,91481,26901,64580
c26ffe090b5f7e6c9cd535eff15c4bd8,159,120,492758,168279,324479,179,120,507466,98779,408687
d3362bce1fa34b3fe37cb0716d020226,71,49,178418,67395,111023,151,122,412367,58326,354041
a6cc261d3eb05fb70f9b1c5f3e17abb9,135,94,302192,66967,235225,129,105,266093,84625,181468
60598c5996aebffe339e6c24e4cfe0de,47,43,65163,15730,49433,47,39,31449,15919,15530
3358c234a858c653c6b36cce0f644eb3,42,36,58835,17414,41421,41,28,51688,21213,30475
8d29cc0b940da1aabe752bca16a31a1b,195,142,522525,99364,423161,146,107,431168,80023,351145
671833f93f7674547e1e9e6b22ae51f2,89,76,201962,59498,142464,75,59,222593,51389,171204
61536e9e4bac2a3d5543fb57bf07376b,153,128,476744,72820,403924,110,93,351600,78419,273181
33a3dcba7559118ed99670c2cd49b03d,161,129,472730,115295,357435,153,125,474195,97753,376442
0d7947b3f0065699a27e06d3056e7427,28,24,15279,6735,8544,25,22,18430,5071,13359
a9011682506de15f16f76a5fef1ac9f4,120,89,245034,67223,177811,115,87,209533,44488,165045
fc2f70abc3cebff5110d91a81197ab43,145,110,318882,59219,259663,86,54,183997,65625,118372
124d1f0e5bb9e555ed96480d737081f5,34,34,22674,12429,10245,44,32,32039,9795,22244
7e0ad1a600867c9e192f3a3e1ef262f8,26,25,8717,4994,3723,25,20,8392,4159,4233
8e023bbe720cc89796c1e3812c3c7ca1,49,39,54370,18531,35839,40,27,65145,15518,49627
004e333ed93e6c494fb851be51def0d1,67,54,97519,26783,70736,87,66,119222,25836,93386
7afe696ef60daf757784840251a7a774,54,45,95785,38036,57749,125,101,282216,39340,242876
fbaf6198609571f7f24e36697bd39899,68,45,77548,19292,58256,75,49,83885,14382,69503
db09e2fa8138fd70648b0a1f54fd2fb0,49,31,62800,19122,43678,45,36,45900,20351,25549
14c0cfddcf1ed4a5ae9992c1506c3b78,47,36,58232,16215,42017,54,40,39754,16294,23460
f9148c45f682ce0f8bbde37e20cae356,93,77,241381,81242,160139,84,64,177680,67281,110399
e185f0cf4f8223b0575b4f8e99274747,33,25,22567,5794,16773,27,20,17553,5907,11646
b6d0d5f3773d2406338c79a3afef8cc5,81,71,143186,57309,85877,90,65,151210,51292,99918
58fcd526ebd6b3a2912a6894ff76e796,45,38,50972,21257,29715,42,38,45464,15995,29469
8d8804591331c33b65491f511c4d1931,90,66,126226,27437,98789,93,84,150826,36713,114113
9e340506c2a3700246b30d3e14ab8dae,30,22,29098,11858,17240,27,21,30135,10837,19298
2619d98a5ad4a727b32f7f1490561592,56,43,60325,14077,46248,36,32,40615,16389,24226
0da79df3125ac1bac2fcb29c46045c88,137,101,357061,81560,275501,159,104,347314,80807,266507
386eb3dc37641b5832c1e07d89820362,39,27,25504,10797,14707,42,30,20791,8794,11997
c3976882b5d51e83daedebf13a52804d,80,64,103117,53048,50069,79,59,155723,34812,120911
7a82f8cbb6f54cef792ec218a293ff72,12,10,1592,875,717,11,10,1662,707,955
8aea77137991ee636ed1828589f4cf76,46,34,42629,12009,30620,52,47,72561,15986,56575
f4e97e7cd4874eb19dc6331400299986,96,65,188775,34186,154589,68,49,94778,36751,58027
0f93af57e478cd72e7dbff21fa07940e,209,125,731036,107019,624017,191,118,682366,174090,508276
8be78dd6f8e347d86c29027a2dfdb1ff,64,58,95886,30707,65179,55,34,83784,29422,54362
4133f344e8a61f51626e1c8ce5691fea,148,89,350174,54533,295641,121,100,347581,82463,265118
b1ca128e5a8170bb60721f76933b0c80,158,123,405163,79332,325831,95,61,213842,60949,152893
21fab2af2fb6dcc42f1498003a769b62,132,99,329290,61619,267671,141,106,378963,59321,319642
90902bfba9ea319f7010ce8741c3d8e2,142,111,278375,38106,240269,129,101,287424,39645,247779
a8f7f566cb6870d846dcb2940a0f0c60,106,89,209803,51634,158169,93,64,148286,32120,116166
50205a288abfed1f151410a1d13d3dfe,65,47,137422,25442,111980,128,105,259765,48463,211302
60611344bba4576947dc1d3fa674f965,201,119,666435,83826,582609,171,132,715350,102543,612807
9778212f0e9143414cf0712778060935,23,17,9713,4536,5177,20,16,10792,2172,8620
8b55aa0d3d6a617128b6bbbcefe3bcd7,71,63,131895,31714,100181,79,60,129939,25066,104873
6cf3f584d59f063167f642c6924998ce,19,17,4777,3067,1710,25,19,7392,3203,4189
5d0c808fa2e815ae8c65e3019b68e891,2,2,423,319,104,2,2,319,423,-104
e2a8526d2d05fecc4960bfa1c0b96a98,107,85,220404,68020,152384,87,72,158481,95819,62662
963cd8220ee3efc4d42a219985a3dc72,165,126,631346,219213,412133,155,133,782688,160540,622148
2430b2fda3bff382b1338a1a58e811af,151,111,561751,176103,385648,188,132,602695,153518,449177
27ae9caf4360ebe2cd53335fbeda525e,38,33,26354,9376,16978,29,24,19442,6356,13086
e132a39e2306194e5eeeeae90b12484a,68,55,84554,18202,66352,49,34,60217,12481,47736
56cb6fe874258e9d1cd94eb65e2f870e,23,18,9533,3256,6277,26,17,8314,3123,5191
fec7a17ea86182273fa0a411fc1c2939,48,43,73220,34645,38575,60,50,106657,33830,72827
4cc005a15fd0d5360ed1957c006e7cbb,163,108,505503,79674,425829,173,140,480410,90430,389980
2fac0d574a6715574d4e64d60f5fedcd,217,168,932475,222456,710019,193,145,884525,147563,736962
4bf76a3bd9779a027c969ba10d0b8327,72,62,111830,29536,82294,81,64,116963,33123,83840
566be661e2e5321f77ea2edf53feb14f,127,94,297776,43737,254039,129,107,254180,45441,208739
9210e0bf911d4d377bbaa2043e64599c,74,59,108002,42214,65788,106,80,201819,38219,163600
061625486295b7cc49b761928367c9ea,17,11,3494,2031,1463,17,8,5580,1031,4549
6bddd4b810e71cf4702820b8dd570470,79,65,134254,39278,94976,86,81,146893,56735,90158
6492e86853c6beaa4fa6a9e7adeeac16,99,68,152111,37396,114715,96,88,181011,49544,131467
e7daa26f4f6b57f927e8ca44a37b31a4,93,83,160707,39110,121597,108,90,167079,44562,122517
96fbfc1c03c12a13ffc5d78288bd2dcc,29,21,23193,6781,16412,29,28,20753,10592,10161
42181d4cb2f8f333accaf2827f2a4d61,115,79,252127,71580,180547,99,73,232410,56360,176050
19f32940b96bfae9e58db3e3ba5e91af,82,58,144364,52069,92295,134,118,281158,45298,235860
0fdd5ae0fce00377f41b2384c825f158,69,63,75171,26740,48431,74,50,87308,26573,60735
b1e50460d0d31421c94882a9568359dd,162,90,351691,79361,272330,141,85,316046,98155,217891
df85f34d5583001546fa19b654cae415,145,90,323764,73648,250116,108,81,217072,96024,121048
f0e35e5e0ed802187e341104599dd23e,29,21,13034,5041,7993,31,25,16870,5188,11682
436af8fdf3d4f14fa879014a8d02ff03,107,84,216307,66689,149618,115,88,253687,47410,206277
fcaec9ef4328d94e34ca3257206ea364,135,112,467797,59590,408207,100,77,249272,52691,196581
8a2243278c02c191430f10c7525e63ca,95,81,180449,56632,123817,112,89,266209,50069,216140
56f0e76b7f638353d77c02bf60ce7d30,25,23,31518,8681,22837,28,24,18957,12027,6930
40825fd7f4c4a665a46f68f9246303cf,42,24,33399,12163,21236,57,48,86159,18581,67578
dc70063462c368ad36897eaf195e2f26,21,13,6587,2581,4006,17,15,6107,2722,3385
2fe2199ac6edc5219f1cb734691a3d94,38,32,46090,9093,36997,34,27,25814,13775,12039
4c7851b817b9ac12bc2f83300486b429,77,54,110549,35668,74881,91,76,183163,45903,137260
686abc2af41e6cdeecf4e8031a3fe52a,90,64,160758,33564,127194,91,68,146074,30003,116071
d00d7b48de9e8d6196b6df4d71021f6a,60,38,90255,25715,64540,53,45,81792,34737,47055
d6766aee67c6495e105cc372f1047133,170,125,513494,105226,408268,126,100,347838,138076,209762
73b0d24bac4d9fdb4a940b13c4b0de0c,107,66,224861,35387,189474,105,95,207410,47886,159524
eb74595c15e9573ba454a65597cca7cb,49,39,48570,13388,35182,36,29,34835,10968,23867
5de90cf62d67280b87b6a708e5b09caa,31,26,22737,8634,14103,36,25,19590,9656,9934
f13869c70e835e4d6c27c954bfee2050,33,24,25348,8737,16611,31,23,26065,10639,15426
2a686494dc04c683702e748cc36eaf5b,8,4,1227,478,749,4,7,478,1223,-745
3fe0881901b5e0f422b1299c79608f6d,43,44,46747,18120,28627,40,33,48549,17262,31287
ff386bd04d93da198cb15b3cce20b57a,141,102,330937,77484,253453,144,105,330237,68613,261624
a77fe1fe1e1f6129f5ef2f16a3ae4758,32,27,19736,6350,13386,31,21,19777,3675,16102
dedde6239f2b14b9312363759b24f341,188,139,872775,220216,652559,226,183,863620,193547,670073
a611f2198456eeeaa86008feffba7215,30,25,11369,7588,3781,26,16,13895,4302,9593
55167977f7fdd33d88358808d4a3cbec,127,103,319843,103402,216441,158,115,396767,78793,317974
b407cabd8d0dcbaa9823da965aa27502,34,27,30434,11639,18795,46,23,43672,8048,35624
74f1a32ae44a3f8ae4fdab07f5eaf96b,158,113,432303,67429,364874,148,126,441558,94562,346996
55b66faceca1767c860203dea6c03f23,75,70,353101,140096,213005,77,67,328000,144462,183538
f220f4bfa20aeed4a93a2a39f6035bfb,158,93,467188,143061,324127,167,102,605449,163416,442033
7d1495c7796aa490b8405b777e4e1fc4,119,83,301757,56080,245677,127,88,288327,54788,233539
8c8f3c224a4056cc5296090e20038c56,1,3,141,306,-165,3,1,306,141,165
546b701523c113df8fd4a9b12957e127,132,96,309964,81691,228273,139,115,374720,146368,228352
9db1f51f649ea550bb99445ea3c66353,102,85,212245,39661,172584,104,82,194129,45565,148564
d0b98cf77e10a164f3198e65706d7884,69,61,78224,29634,48590,58,46,70873,26874,43999
3a2a8006db59df5ade1901e43880176c,25,22,19184,7244,11940,27,20,13143,8555,4588
e826c1ab2e00eee51058adac1e5a79eb,92,86,171390,34576,136814,48,35,66027,19493,46534
308823beaa2b3a26ba6e1cb6cd128ec4,176,121,429349,131427,297922,117,86,342226,112890,229336
66ddcb5c4e6a4e86a0953a146959171d,48,36,55030,23662,31368,65,51,88954,21761,67193
9d830c666a126157752a8b5c38fcfa0d,79,67,119924,32373,87551,65,59,96579,26452,70127
12a14f4dc89f35f3aa561a0921990ca6,119,73,207411,36365,171046,98,89,183297,67950,115347
d06d53b5be2da2f8abb8f220a250c0c9,69,53,106340,33154,73186,58,48,110338,32964,77374
5415044cf759a2e0b00d44b7dd41dd9f,104,74,213959,41427,172532,115,87,219197,68175,151022
b1fb421f7324c1aaff7cae1966bf2d8b,129,101,410109,91195,318914,190,144,469424,89924,379500
8283a8a093ac79bc3dda52f5330f747e,111,79,310733,104196,206537,81,52,272701,79089,193612
d5e03d95c9526b73cc5441cf78e11ef9,144,107,327988,115566,212422,129,103,364546,110717,253829
2b8b90e866ec51851fda9c96e523fd5a,59,47,87529,25170,62359,67,54,64795,29147,35648
2db70ac24de3e2aa40701a3ac079a004,106,92,174090,50114,123976,76,52,119563,29850,89713
3355773977f19a758d7f4203cabe3a25,159,124,338362,71583,266779,133,107,345872,75837,270035
36862ccef3af8ab92521fce91d869ca4,112,96,229138,66884,162254,99,80,214689,57845,156844
7f4641b89c817e32f79a67574a0634d8,167,111,451067,76485,374582,202,151,580840,83851,496989
05e756b13f12cb543b98028aa565c674,30,25,27551,7945,19606,37,27,25554,9031,16523
d683f3c0b4702c701e1910e9c1c0c594,167,125,427536,66474,361062,131,104,245375,79437,165938
1e75e8aae49add1208f06e73b6bad11e,73,56,88199,35622,52577,116,67,142681,28058,114623
646da3ad18cfadc8e0e2587e3eef896e,70,58,150258,51489,98769,73,68,100287,49638,50649
002835ab346f081ee453ef90013acf30,58,37,85324,28566,56758,80,60,135357,30094,105263
f3f7a43b7e75f13a04716116b78fccff,147,115,451818,126716,325102,125,98,470445,89416,381029
f70543f08924b594aa0710fcad558938,32,23,22103,8353,13750,30,27,16763,11133,5630
3369aa82cd52b21962c14ed42dd8c37e,21,22,11031,3828,7203,20,18,7295,3816,3479
cda525e60eb038c4a0fb8b20851c362b,110,86,168207,51042,117165,105,79,180328,45390,134938
6acbbef740f02ef8853c69443fb3595e,165,118,587862,103643,484219,111,90,316046,131415,184631
a83be061347614da1f8dcb174b5acc8c,109,81,203103,41474,161629,131,94,237450,38274,199176
f598edbc3ac20c25fc4a4c68093fa133,143,107,466447,96530,369917,153,112,492076,71546,420530
7362aa34f927589733e2f4ad6f0344ae,26,19,13090,7307,5783,25,20,13987,6817,7170
46fe5a24b94218f6549e445979529b55,70,55,102784,27315,75469,63,57,86439,29146,57293
be1e29da88381ae5c32248c38709aea9,170,117,536007,79680,456327,142,127,484244,115542,368702
482ae0f2941a8c0abf791c310fb25109,106,75,244011,49941,194070,99,87,188802,53156,135646
1fd6bc361a52d0891ae40a3b92fae108,142,106,478176,97903,380273,132,113,412624,122284,290340
7c11ff31c986920ffba954fb196705af,93,74,126082,61097,64985,159,108,338119,39501,298618
a183278e20fbe680ca9da99437d91df7,126,80,237847,48790,189057,109,73,220462,49313,171149
65c459d9974f7f74e9479454678b4e8e,94,70,161230,50410,110820,92,84,111354,43419,67935
2d02c4eb02062a7491de8950172e88a1,5,5,947,1211,-264,6,5,1591,947,644
136480d9404d2666f643b7dbb46caa57,56,48,61153,27170,33983,57,42,91077,18105,72972
ef1b5837e7003213cc166a4561991fd3,36,23,23262,10498,12764,37,28,36112,8283,27829
fd39cbf50d122a0d04c2fb506d4a3609,84,69,128836,26824,102012,87,65,116495,34201,82294
cf4e0f6222c09e6cc0a9297647991bfd,51,44,51960,27448,24512,56,39,64005,22300,41705
6a2ff6471b3e868bf123b890357c7e8e,27,24,19023,9378,9645,39,30,27163,7296,19867
fc3a7ef7a8e4aa9407d58c805bfb7803,69,48,100541,43762,56779,73,57,115462,36658,78804
56ab471cb6cdaf33d535a4d0c60b2ff6,125,113,297014,82717,214297,153,112,343565,81798,261767
913029b5f9858e7f7b825ed27baff2c1,95,72,144298,39435,104863,125,96,221730,31263,190467
3f557fff99b24dbc775b06a6ba215ff3,35,28,31783,13370,18413,38,30,30806,11743,19063
15a9e5599df828b239ddb390355e021f,88,72,153021,38524,114497,101,61,153414,31394,122020
403db2224bee5c2bee73fe6faaf0d6ac,94,79,157311,46785,110526,90,78,192985,46138,146847
422482ad83eb310b90f91da20f0544d0,51,34,46721,13401,33320,48,37,48908,16966,31942
92c154668f47ffd34e67d083389184a9,35,29,27989,9983,18006,37,28,22228,11532,10696
0e6414bb6f96e179dffd8232b9bcbb78,178,138,664245,119870,544375,158,132,585615,98212,487403
62655a964207d5275057d7402a520a52,69,58,97363,36365,60998,96,70,133203,45610,87593
21f949ea557efb3e25061ff9764ced54,90,60,153519,27864,125655,80,57,131895,41271,90624
4ad4c38b9a04cc4664ed31ef36f35482,78,57,126793,41650,85143,93,83,166266,42968,123298
2b53a3f1ec16600f0b5eeab61d78c528,93,65,156144,53939,102205,137,94,224034,58308,165726
7beebf6d421157cb4054c71f10efe1d2,159,108,518416,97596,420820,149,116,562829,115135,447694
2f694b33a252ec5ed830fb9df8a100bc,102,82,335116,78315,256801,148,130,487442,96024,391418
e91de42a47d69687204e65046ce6f972,30,20,17927,8726,9201,30,19,22656,6400,16256
4e14b6f0f2c246b51aa261ce848bc84a,52,44,94309,35059,59250,53,42,97880,34154,63726
60241d25e1ca6ef2cb83637b7d8c465c,100,79,183301,54797,128504,152,117,242354,56985,185369
e0da775a648089a6d70fa28ae5b5ace7,49,49,65518,17617,47901,56,40,65844,15682,50162
575851622ac7ce009db7943c3155a200,73,71,83188,27098,56090,54,48,57574,13524,44050
25eadf5d0d71f6c861788478968c3916,105,81,383585,72531,311054,151,115,551357,93134,458223
9635c5c7277d55da2cf5deedf6f34589,34,29,21196,9731,11465,38,26,25258,10443,14815
3bcd5be0190350703b9cb0170162b768,0,0,0,0,0,0,0,0,0,0
dcd3e5316de9f0ae5f06a628b1f0901f,83,69,137715,48124,89591,74,66,105222,37445,67777
eff9700f2bc67fea7fd6f16b51b78726,83,63,162577,49361,113216,78,55,194545,39397,155148
162f18ea9ec8ca98c1ed809b3f1370fd,84,66,160491,30507,129984,98,63,142043,26632,115411
8be0944b2a2537168238f5c1efa2869b,58,47,79408,27194,52214,55,47,82115,25877,56238
aacb97adbee6b685522669380d53913e,64,47,82278,24711,57567,88,78,123359,31530,91829
c9a064b8af7f876542a9e058e6dbdf08,26,24,16546,5670,10876,20,19,10045,7564,2481
c1d6f711cead753497eec5822e57dfa8,75,64,111752,30580,81172,132,91,193116,34915,158201
b9b49e4667631d7b1d481b697ba6501c,72,40,115272,19350,95922,58,39,74022,24106,49916
2dfb84531b966b942f0b2cba4a2886b1,117,99,303450,63035,240415,151,93,333287,54026,279261
78ce5e8d47062f38b78b67f722c20f4e,89,70,203380,30879,172501,81,68,137765,42860,94905
8625e1dde19fb7017d03fe44c59110b4,73,61,84405,20826,63579,67,55,76730,20950,55780
7e6936bce41a2a378a89a2926729de5a,141,110,387042,47569,339473,134,88,237600,84367,153233
1653654a22a69336acd22d4635e5b953,69,54,204179,50657,153522,61,43,144499,57368,87131
1cd021479f08e5d1b936b64442b728fb,89,79,206114,46551,159563,85,72,173048,35390,137658
9f867dcaad0281db245569f785759dfb,52,39,61897,13622,48275,43,32,38137,10847,27290
3658409ea02a7e03737594171b15ef87,149,113,456632,99241,357391,160,134,517834,103641,414193
cfb2b6ca5f45b95738c53e2fe10b292d,36,31,48429,15551,32878,41,31,40845,14533,26312
d6f52ed63d454f8decbe90c7fc196a4a,142,112,407265,88546,318719,167,118,401740,76056,325684
9aa1c9ed44728832d450cee345eddeb1,114,96,259835,66363,193472,84,61,194217,61771,132446
3e2f92442e5bb1ebe35e3ea40aa30b93,39,32,27906,10268,17638,45,31,37305,11842,25463
eb1aea8ee558a7fed70b8ad38abb5712,67,53,94260,31846,62414,65,47,96800,22329,74471
d416e6d3b17ee3b1c461585b203dcbe2,136,106,493032,157497,335535,204,158,620983,119277,501706
6b378442a9970185761e4f5068f91828,36,28,29665,14019,15646,44,35,31416,14632,16784
46039eeb2fe83436bd2c8a0f091041ff,128,78,186548,43155,143393,174,142,375466,72440,303026
0517fbf28b93c7659e9fd00199d97a9b,23,13,4823,1363,3460,17,13,3260,1800,1460
36bfadfe18c2ea97633436cc8251955d,26,19,11468,5660,5808,23,23,14178,5090,9088
f46c0aa5b5fa196f35ea3cf3dcc70705,129,93,357946,147476,210470,120,92,370615,91883,278732
66195d2c8d5c75a45d19774b676d1c20,120,89,255491,55197,200294,108,85,199027,62429,136598
03d2b1f6751fd58708523d7bf538a7af,34,25,13588,5359,8229,22,18,10548,3031,7517
87055eb6d3a6a366e06a8f898520830a,34,32,41537,16521,25016,58,46,105018,25500,79518
067c9b8ef40b2751ce3b0b4ad2eef9cd,116,68,194127,47154,146973,121,75,184208,49207,135001
51203f1cb827a639c74a7a221927f3de,19,15,7032,2016,5016,19,16,4069,1318,2751
6f181eae983b577ec607b10866c7533a,71,54,158760,33977,124783,80,77,110206,38887,71319
6f5c7e298fce0053099e2d0aa620cb94,56,42,65697,23011,42686,83,76,99864,26155,73709
9dde0104a32d8767a9b92a6c3af38171,39,29,29743,11918,17825,32,24,29201,12251,16950
56dc78d04de48d4b86d9cc024814d212,42,35,58490,17814,40676,39,32,34906,13079,21827
566a1713f28a0b79a5352e72d9e8d9f1,49,33,54655,20032,34623,65,57,72199,30731,41468
97751f1c553da7279842bb19f0e2daab,120,88,240741,44960,195781,95,75,149257,48354,100903
7604d6691f1ee0b058e7a8a8b1c2b847,67,43,112751,22017,90734,65,50,79921,28156,51765
d3ba16db996c224320339f3c1a120607,13,8,5962,930,5032,19,19,6445,2359,4086
76e57fc3e6b530a4a724792acc3c01a6,121,99,282101,43797,238304,106,98,191135,62615,128520
918af000d0dfb1842ce83359f0f92fce,111,86,250840,48684,202156,90,75,221746,55703,166043
a152fb7a2cb2e8b33f9822dc240b7971,132,94,431464,108859,322605,229,152,804494,161241,643253
9f41bce58c14e2cfb6f3e59959c946f1,135,91,252276,64500,187776,167,108,342080,74196,267884
657d91f7ca4b45085200003ab12fdd75,140,110,508343,127454,380889,136,97,489239,96010,393229
df87007745528ca8836a9b5a9cd21a88,29,22,12430,9077,3353,30,23,15438,5403,10035
2e7e2f7ab501568c05fee2cc1e940de2,86,76,200142,79129,121013,106,83,233399,76531,156868
d0ca57951b5d270e053e6a2f5fccff24,146,116,383418,76741,306677,166,126,387851,56920,330931
b1f63ebf3417ca8057980a04b83da370,103,76,235051,66121,168930,125,80,251123,81298,169825
f5b36669c5750758c220d8d657faca0f,35,29,47730,14291,33439,46,32,64086,20288,43798
95ae6da0f843aa9d76e3c689813db4a6,125,91,367198,93695,273503,148,126,321856,124237,197619
5e688cabe3d243668ec29335b34974a5,127,104,301436,57859,243577,178,134,444978,66199,378779
3b04bbb2ebb6d4fe3e9b68735c6a7fa6,75,58,116584,42794,73790,113,88,178774,35759,143015
66dcac7d807fdabe63dd3c51d79b9789,82,61,130987,40003,90984,89,75,134962,39798,95164
d747ec86def235d8c149796ab2d5d909,75,56,131486,33846,97640,54,46,89116,23184,65932
8a725c1b587162f7e33259113ee1b71e,89,79,160246,47471,112775,86,74,141555,51377,90178
03dfd9cb1e7224524f2ed0c32f4717be,107,86,182941,32137,150804,104,73,128877,38367,90510
8047e0cd03a2acae231bc026fe3460fd,27,19,10280,4954,5326,23,23,10001,4780,5221
00904503c0938f3ad56924d9289c3512,37,29,35999,16685,19314,58,27,65709,16801,48908
3c4eb2fae99665d0a8b7e200fb9d0cc0,105,85,279487,52242,227245,140,111,322472,63313,259159
c58f4dbacb0c52248e90ce32702ec86a,143,112,369092,96474,272618,132,101,358833,75594,283239
9df95ee292b4327cb75b1c92893e2d70,145,121,338220,71986,266234,131,87,315520,49600,265920
35979cae17df132fc21df7769d2cad75,68,49,79763,19551,60212,45,34,43135,24269,18866
e6b5c5c31349e78f9b03953ad1bfa704,47,36,28529,16320,12209,53,36,71935,9876,62059
8976d25c14dd7d496502e6ca4fdcd626,74,58,94150,18899,75251,76,72,81263,28011,53252
c9d2fec450bc3e7720db66df5134ad83,22,23,22739,7086,15653,30,26,22253,8592,13661
7c053c3cf7fed0dd85ed5b048c185a3e,29,24,36911,14936,21975,36,31,44600,18199,26401
0c91ead7296a7ad2fb74a0249ffd8635,139,105,465486,139727,325759,146,80,416289,110561,305728
56fa6db13485d60e4eb89c12d0c411a8,11,12,6720,2786,3934,14,10,6267,1932,4335
43d30bcd39937e1d0e28fc7c59df2017,47,34,89390,19285,70105,45,34,66954,26809,40145
be29d33237b652ae1e1438f6536ca878,95,81,248430,89273,159157,119,89,314039,79806,234233
982c59b927054abf8f7a15ea34ac0e41,32,26,14296,4311,9985,21,18,11325,3170,8155
3c6042a0cf3ba83f34c963ef7575dffb,28,24,21626,7719,13907,34,27,19303,7558,11745
46141db530558a7802686cf8f8970a16,185,138,784526,182507,602019,172,141,1047022,142223,904799
3595618bbb9478167a51a87a098f3783,41,30,42992,8458,34534,40,39,37828,11290,26538
c9dd145b0d1f686e89891026bdd1bd5f,146,99,367287,63615,303672,173,128,342362,76402,265960
2867f1e97c8c2b375af97d2ff4ecd5ba,44,34,45620,12435,33185,39,39,24723,13197,11526
e22c9935b2b43a420ae650213bdf4605,76,59,123578,32892,90686,116,102,197931,40709,157222
68d594e76d6c48d5821b0a5719d9956d,150,111,556036,110738,445298,162,122,521410,144151,377259
e083586be55f91e277fdf240400dfa3f,40,29,26479,14855,11624,39,31,38447,11068,27379
5160a0f89e9469b60912da21f30d8fd5,214,151,928426,198220,730206,211,132,892914,260882,632032
7ab5907b05c1cdc063f46be148e66596,112,85,200165,38105,162060,105,87,220353,54099,166254
19b0e8a96299eaa57df6302c168a0bde,159,121,389556,89053,300503,110,93,312040,63752,248288
cbadc3fa18967a9b71ab492b09e06e0d,79,55,159870,34171,125699,96,70,189496,41517,147979
3c66db1916e3a0fd25e8ea6275add3fa,41,27,76506,19392,57114,61,51,70211,18968,51243
52d2d744149ee73aa7ea5fd502a6dd7b,25,20,12837,5158,7679,24,19,9442,4894,4548
6086782c051ad4da849f5a9e106c0c7e,45,36,63161,18711,44450,46,34,55064,25304,29760
f5c5e87d7efecc5ac3af1d495f81ee3c,162,114,367879,55312,312567,121,104,260897,77407,183490
09ab6c86ac5e892214a5245543f159f2,37,30,34397,12152,22245,34,26,29012,12296,16716
87905dada7cafcedeb018fbc7cc1e73a,103,85,187793,62120,125673,95,72,192508,59652,132856
c970915ecfc7b3be650eda8f1ae4f6ca,26,15,12115,3658,8457,20,22,9498,4016,5482
97e80a631fa87eb8b65e07eea8b679c9,72,53,116885,42692,74193,71,55,97969,54391,43578
1cdcf8e10a521c729ba1604b3f829c3a,96,78,241776,70202,171574,111,91,245001,55695,189306
3c4e0a74352117d0c0f371ed9a8b55dc,142,118,392382,74327,318055,136,104,365948,85321,280627
e25a7e8908ae2045b6725d381afc67b2,46,33,70307,25801,44506,52,43,96160,25071,71089
548c8ea381573402f1678e224fc88e20,222,158,953770,160652,793118,179,117,1103406,166429,936977
f5e67ca0e6e3cd617ce3c154c4529618,150,133,354861,99865,254996,171,135,394729,73827,320902
244a7dd41eea712ce6d7b1848ca36b6d,54,45,57208,17868,39340,45,33,46009,17855,28154
666ec086919b89c5de2d422385987f1a,89,61,139196,30234,108962,82,67,154298,43539,110759
9ef76f281805cef0cba2124d3df5bef4,56,36,66659,16180,50479,36,27,48774,13520,35254
5ffaa09bb446fb66dacd7e9fe5fc8d46,121,103,295912,65450,230462,131,95,296373,80361,216012
589b841d951fdd0cbed691fef130eea7,30,25,17469,7379,10090,31,25,19659,7613,12046
5eb8bc3940c27d8611c61b67aff4f1f6,25,22,19647,6870,12777,32,18,19472,6771,12701
3b13631e9f481ce42ec8f162a50f53b1,26,26,19352,7894,11458,30,24,12291,6440,5851
9a128ab841ade13ea6f470d051230d1c,92,65,207730,60312,147418,131,103,328432,78001,250431
d9d7413bd4df10ad218559b8b2ddd706,115,83,180529,46134,134395,115,81,170348,47070,123278
5abd0148a137c7a0b6e5fb13ebebf26f,44,33,34473,16585,17888,54,43,51832,18628,33204
aea25344a3b238eb7e4e11f82594b921,177,131,699782,107606,592176,155,128,502457,111640,390817
d486209f30eec77f3a878f8a72091489,54,46,75840,17271,58569,48,41,46524,19471,27053
ef94739a83f37e85692cc06282f8fd04,191,163,960963,220151,740812,176,128,669883,207650,462233
b06689ff4afc4912f60df17eede9893f,79,63,120834,38841,81993,104,82,170657,39893,130764
03ee3ddc2137b82f0e6f3d761e379a98,92,70,184840,76901,107939,121,83,276126,66049,210077
8399f20dc32a3965aa38c162a0629940,123,89,354907,75245,279662,139,128,300805,68316,232489
56e340442381b9faa88b691b8994eda9,43,34,35180,17345,17835,36,33,28383,13040,15343
c9dfcf21664645ba17112a91fe949b09,28,22,28081,10094,17987,28,19,20424,10701,9723
5fd6b3fe0fab6faf8426db826b5293d3,150,95,324045,68237,255808,147,110,298741,81609,217132
75b7c3ad9c868ee476e7d2bc263d1a86,137,93,436002,98482,337520,142,91,427476,86401,341075
35ce3b729a6be121625d11d15b831bd5,126,112,349679,97533,252146,106,75,315549,56559,258990
1fcaaa98fe76e6e7968729c7d80cafd0,105,82,166857,53862,112995,126,105,224623,53715,170908
d5f3834e83b653f960b0ec2455bf16fd,142,117,357038,77046,279992,118,80,275116,69602,205514
ac9eb60f2bbdcb71dc50e356bc9eb7ec,33,32,32660,16482,16178,35,32,37142,17739,19403
48ef1ffea20c18abb9139139bd40069f,24,15,8080,3234,4846,22,17,7658,3682,3976
c28be22c7dc38cae48981b77d8bad46b,62,54,59399,23937,35462,50,39,73365,23656,49709
f64d8c3956c27fc92bdff75709575435,80,58,93766,29049,64717,75,55,97296,22137,75159
021d2560303d49575b3d355597aaef7c,69,57,156905,40275,116630,71,54,140530,56729,83801
8433693c0e9952afc4876d90b3e14cae,160,127,319284,84684,234600,98,79,218215,84225,133990
fcbc59d820d4c8ade0959482d221d1c8,192,128,587405,100548,486857,178,127,549225,89608,459617
2c1413e34014e5f48d3c31ddce850b79,59,44,104063,26220,77843,59,58,65172,33449,31723
25a061d534046f7116df77ceb7357de1,124,89,256423,52064,204359,134,107,320356,57656,262700
021f3536beb55a2afc79989331e01434,130,105,272489,64701,207788,121,111,305948,56208,249740
ce7e9b087bb493eec57b359cd7965438,90,64,116683,42842,73841,105,66,193119,39773,153346
39e3e6a1d65cfc42e8fe67a19906e4c5,134,108,359896,107910,251986,132,107,320594,105586,215008
876893b26bd72e0a335ab40d9b2179b8,77,63,146401,35504,110897,77,54,107461,38320,69141
9a5348479a2acea31010a48d64b6eab8,90,65,138601,39266,99335,111,82,186352,31706,154646
da220ff5812da65be16044b5d076033b,28,22,14441,5805,8636,27,22,8009,7447,562
ba80794174c19b3498c26f3257b97645,74,57,98344,44816,53528,99,73,174755,40511,134244
5b40967c3cdebf212f66c26f19b62651,60,55,101136,37081,64055,58,45,101231,22322,78909
9c87c6dd02e4800fb90c426fd2237829,56,48,62661,18676,43985,53,42,53631,10930,42701
d48e926d1af876a333beb78ab5c169c5,101,78,211925,48518,163407,139,94,269671,42593,227078
b441e42998bba18c52f7d100be5c2ff6,61,50,64935,26639,38296,58,52,69143,34063,35080
e696d428e29f837e5a63864e717deb18,98,64,151734,44656,107078,74,64,116654,38483,78171
630bef217f0971ab725fab1885046e7c,31,23,19528,7590,11938,33,28,25870,7519,18351
a9d6712daf98483f72b8df126609b856,193,131,488821,75591,413230,125,92,256125,120376,135749
9c6b3103b1b96f6d2f7abedf034d3f05,77,54,96723,29140,67583,65,54,123558,34770,88788
e0df43753842b6cc0e8880827b6f224c,174,139,515554,78660,436894,120,86,377102,71121,305981
f74a0ae1ec0c4876328a580788b4b059,90,71,232746,63733,169013,89,77,146008,67739,78269
28abc8380c854884874f2926dfa6d404,52,41,37588,16866,20722,40,34,36598,10381,26217
7d0b2eddf50fbe44507449623ba21ef0,169,134,589476,136447,453029,137,126,522509,120690,401819
40b0fbdac1fb00393500f7401332bd04,119,93,250050,66348,183702,116,80,245623,77493,168130
ea215e11156d29d4cb083ee11f579d89,26,23,7457,3132,4325,21,18,5070,2153,2917
c436ba1a3e91f02ea89d7e92198f6f9b,77,69,98966,24313,74653,97,59,114791,24977,89814
bcd200e04c82a95214a4f366091886dd,34,26,23802,9272,14530,33,25,36467,8198,28269
7fb272cb1d0fd9787222cb4630610c38,5,3,454,302,152,6,5,652,483,169
a69b7d123c52b30b8f06ab77adca4850,168,130,516662,136875,379787,199,140,618526,147015,471511
f07260511c3ebdbe751457a73add9d9e,23,17,6833,4915,1918,18,19,7667,3303,4364
084d6483174612a6080469ba6b6b254d,26,17,12899,3512,9387,29,20,9286,4177,5109
187ec49466ba86a4ca0cc448983c28d5,89,71,151110,32956,118154,85,66,135695,30309,105386
7aad1e0e9e8d7860920935ffcd509497,68,53,157629,39960,117669,149,123,309038,49658,259380
880b05d7f541c2451234f6aa564ca148,27,20,7921,4037,3884,22,20,8505,2967,5538
a64e50104f83b83c293d2967d02a3459,71,57,94109,37738,56371,90,71,120673,35581,85092
1968c1d659caea0ef2f448f324ac6a88,84,66,123842,40233,83609,78,54,134059,44553,89506
bc2ec6fc70a63e3ada76c52157fca1ca,122,112,475101,159641,315460,168,122,575142,156762,418380
60c0f84a71cc3247e458b886f5ee23f5,63,59,98723,47494,51229,108,62,203490,45408,158082
929176a5c0513124d4f307444ec0e5da,174,131,913115,136448,776667,188,143,752448,161884,590564
35386ded2be1fbcae4c1ec56d56dad8d,84,66,134524,34162,100362,106,86,155612,38739,116873
944f93eb6d871d34f3b72f0d33bf9123,104,92,205245,46511,158734,107,86,202082,55435,146647
e5096c6100e52bf9b38a1dd228a5e749,135,112,366345,91954,274391,135,85,359228,94234,264994
f43eb1b3d95677dda24cfebc0bdb8cf5,141,122,373884,64248,309636,135,117,406568,73154,333414
8347a4a4df9d7f4e83f39c1b1fd25044,167,137,516363,94323,422040,162,112,403196,83506,319690
81b7c4a390799d335cb0d96701515e29,0,0,0,0,0,0,0,0,0,0
5509d79a4c8c2bf01d1138ee990a0177,24,15,6363,1451,4912,15,16,4499,2932,1567
48f507e818dca81ea7d7c2959c17147f,81,58,221606,45620,175986,91,69,191538,47166,144372
f6face920371fc99567f0d0a8b1f1812,89,72,157622,56875,100747,80,64,159381,39906,119475
333ebdfdc49c75fd1eef6113fb7be151,24,19,6068,4476,1592,20,17,7872,2160,5712
6667f959cf9a586b7451d40f9264fb54,29,31,17062,8915,8147,38,36,28388,8914,19474
8ef7f718660e98a53aeda86615ec13fc,48,33,47424,19123,28301,51,39,60245,19795,40450
12b64697578f9f73ee0cd85205cea7ac,45,33,70049,22035,48014,46,42,82521,25909,56612
1ba0842aaf5148ef62bfb69394f29b2e,35,33,55413,13165,42248,40,33,36577,16388,20189
eda3c2b8be2a85ab07d5d617bf12a3d2,61,52,110874,29571,81303,62,48,96420,21068,75352
e36003e506488be06ec8e59d4e84f943,95,82,143837,42618,101219,119,85,187846,44551,143295
6e1840fe28fc8987e74b64e5a970e2db,93,60,137622,41934,95688,82,69,144992,38685,106307
0c1dfebbc97220fc16ffa15e046729f8,83,55,125410,47650,77760,74,61,120360,45444,74916
806df3d3d7370134985ae325266e1bb8,100,72,123181,35112,88069,82,69,110414,41052,69362
ffd6e96ce125f2505502cf09ede9aa23,25,21,16023,6742,9281,24,18,14144,3852,10292
22d5173cb27e0b3cc3d76a485f91e74f,102,74,184403,47496,136907,97,61,175384,52993,122391
099f920b747d2ac4b1244c643adacaac,196,137,853887,185779,668108,176,147,764048,200959,563089
d92ddffca4706f0ce8c67542c1db3a08,121,93,240462,53261,187201,101,87,202742,62413,140329
45f04a32e511daf737045232b81581fa,82,73,168017,61163,106854,78,63,130842,53859,76983
1c09d98f4ad3396563ecbaefb97570ca,188,113,406804,150894,255910,213,128,724469,128519,595950
575f8c1282b0af9ab74a58d69eecafa9,83,76,138953,61704,77249,139,105,302466,45130,257336
eee1402e0c95545401d8657a52f2077f,193,137,762458,142723,619735,176,98,716356,101618,614738
ec6f5a9fa896715a750396920ee11867,34,25,30400,10931,19469,36,24,32734,8522,24212
6e79bc48a168eb754012698f33f58d6c,91,65,137113,71244,65869,86,54,169053,42244,126809
7a9c3aeba0ce60c29ef12155b119a98d,57,37,45402,16954,28448,59,45,54928,15676,39252
3b64e6c4c3ba250236aa1101e2fafb1a,54,39,85447,12806,72641,52,52,82279,21965,60314
af4306aa21ab83a4c0d564b4de2d5daf,213,144,1204416,173490,1030926,219,162,1197963,219014,978949
68568fc3eb51081feee93d7faab8fae5,88,71,153427,44637,108790,74,59,122983,41875,81108
7704a914cf25599c9618d387615fcbfd,29,22,23803,7160,16643,35,31,19595,8189,11406
be99952f407058a7e2c1c1e8c54efd8d,102,79,192498,37488,155010,99,89,228846,43178,185668
2ca02b64cd9247d1fe28b7a57b5b0e77,36,22,21062,6937,14125,31,26,28843,9044,19799
1c305fa31701ceac2aec1acbdc4fcaf8,85,76,100063,33678,66385,61,50,91483,24955,66528
0ce017c73a68171a826103d1a8e7da27,149,124,341376,76282,265094,135,122,310666,69584,241082
9119f6c2a5b54cf860d1ffcc0553bfb6,78,59,121981,32802,89179,90,72,189244,39292,149952
487f507b0774676c8b3f1c6d474b3fb3,119,86,279929,72593,207336,103,74,206673,51097,155576
84b403013b09a206423f2f2445d73fec,181,146,569002,124843,444159,157,113,511657,90200,421457
b3816a237a4ab69585cfc464194d0a39,106,75,314521,74591,239930,121,103,341835,76286,265549
3c1af840e6b8af7eecd1c0f81fb3c866,103,85,172123,37585,134538,87,71,114976,36922,78054
334da8c1df5783e2df035f942e305e43,150,114,537265,133519,403746,154,118,718549,100524,618025
a4d4c0d79313f23d71df29b8b97cc73e,75,41,134061,23012,111049,78,73,104847,36226,68621
353b41789e5941a1c2c33416f20fc9f7,54,39,30007,15257,14750,52,37,56386,15024,41362
1e4ccdd87262e2e1bd01d8538f1d7d3b,99,73,222758,57297,165461,123,93,273917,62817,211100
f679a36f1bb75bf794e1cb11cf22ce26,82,70,134032,34293,99739,78,56,92851,18595,74256
e63753b4f288e0d005ada7973ba2678d,36,24,16721,6327,10394,30,25,22789,6897,15892
dc6bffc435d3971aa36338829587a18c,108,102,210672,92077,118595,117,94,204468,59498,144970
c55f71ea0b91a9610afb80fc6fb631e1,47,34,58534,17716,40818,35,27,44371,16268,28103
676f0d3a2e2724336dabc96c78324a2f,183,134,620332,140979,479353,160,132,586162,149320,436842
5e8042e3999ed314c03692f0f00659ad,68,55,123420,14328,109092,49,30,63124,15811,47313
0d34a351ff93bce8ed3a1cb1eb2b6aa2,81,64,171198,38708,132490,95,73,182226,43380,138846
1d6fc47e76dedb38169282edfe96b20b,48,38,46971,16230,30741,55,38,40825,16780,24045
8c1e76e8021bec16461577c9b1e31787,27,22,22137,8257,13880,35,19,28260,5154,23106
9cfa967632eb52c1af688647efb4df1e,60,45,97452,32885,64567,79,54,100540,28969,71571
d1c4ab04a787e97f983ea54673018473,17,10,2407,1702,705,9,10,1903,1345,558
8d9f48f65f2ec256ed377a30e25a7961,82,60,96584,26204,70380,80,70,142646,26385,116261
40a6bf78478b5a1f1cd07ae835401bae,159,152,591552,107554,483998,177,144,561424,109262,452162
34a9cc47b731c78472fae725153a50ac,23,20,8128,3245,4883,20,17,6327,3096,3231
5d64a7c47e3470ecd0f807cabf40d9e5,53,29,46774,10314,36460,43,25,33692,12207,21485
c6861b47cec75d562f5968995900d705,126,102,383712,64246,319466,174,104,370254,60037,310217
567f9cb7d143f4597a1d3846ddfc7b6e,168,124,607989,103396,504593,173,125,665576,109749,555827
6d38a651ecd42f37110c6cd66e5c1941,64,51,127015,35058,91957,64,53,86261,43433,42828
3384feed4d94920467df7f832b14c92a,44,37,66669,21809,44860,40,32,53936,16635,37301
af3bd887e502915daaab9545f8294af3,6,5,695,374,321,9,6,1361,203,1158
190d0fc8a7eddcae6ca11885ac3574db,47,34,22046,8641,13405,40,32,22181,10850,11331
138d9df533ae64e24105d072125cedea,55,44,67021,20895,46126,54,38,70155,25015,45140
8882509f50e90b5bb7f12e87f7d3b323,161,119,613885,211939,401946,145,117,636213,174260,461953
f6c122dc55820279337dd361f8db2df1,39,32,33254,10543,22711,38,28,25244,9832,15412
49cb043bf86aecde07cea1bb14e697ad,136,98,572694,67082,505612,140,104,482063,76137,405926
bd780e2c289bf8ff4bde49524f20c35b,93,79,138362,45520,92842,74,64,140464,35964,104500
0ef4a015ab91e0591bff42381fb81ebf,55,54,93329,49807,43522,89,71,147834,35835,111999
f145d9ba7223458a4cbd33c776ed2d84,203,156,580110,111989,468121,216,141,509301,94104,415197
65e67ee292fa5ac3d72b26d2d5e00b20,119,85,236117,80189,155928,144,100,306703,65293,241410
edf8748c63165852139685fba0fab151,152,136,402501,89085,313416,121,102,315441,79724,235717
41805d73a7527a835b359dff006960c0,30,21,22391,6442,15949,23,23,12616,10847,1769
a79151d0f4eec4c48675cdd1a38d307a,86,69,168159,52809,115350,68,62,103834,57675,46159
e426ed02242d5df02630ea6fd708c2be,46,39,45717,20546,25171,60,48,58548,20605,37943
097751627086648252e9f2639cee79fb,15,15,5512,1017,4495,20,16,7453,2771,4682
5507de0edcda3c1f63a8b3f178351e01,87,63,156225,30086,126139,96,71,198476,32004,166472
b2e1b309625f28ec79ff6dcbb8b0e422,51,38,87141,27505,59636,51,39,64901,28241,36660
e1ce00c69ec6174883115f425dc8d5f2,30,28,13319,6914,6405,35,31,22218,7502,14716
052886fd4aa37e9172dc7a2018da5fb4,159,123,622855,145298,477557,208,121,713304,123718,589586
3f2fb7a3034557ba6c524286129ce34f,209,150,685857,154816,531041,187,163,648821,158988,489833
fc46eb6d5f97fe7100822d12b19a1b6e,149,125,472413,59102,413311,110,93,255206,82135,173071
cd6c4c2e525cab23aa1ab9dd76a6314f,21,23,6975,6306,669,27,18,11672,4393,7279
f6f7bce9aeadf7ead1a2fe6837063e3f,189,134,1051504,125739,925765,178,118,632307,143482,488825
083af6ca6b2e0b0112e207bdd8d751b9,154,115,418354,140507,277847,170,113,393927,98056,295871
b267a9d210bdcdb07483a2e7e451fe76,124,89,220325,54107,166218,87,69,132098,53806,78292
b95ffd434022b11dd70a609533028754,111,73,181967,36222,145745,126,103,199374,48767,150607
bee797c3ca9ccfba3b2eec83da987047,34,27,24802,8348,16454,29,27,20173,8585,11588
bce55f4683274e4e055c71002cceaf12,51,50,51868,25006,26862,48,36,50629,15535,35094
3ffb1f61029c5300db0c6a19fb2e2379,136,107,615931,160282,455649,191,147,696630,197713,498917
07960ad066bbb8ccb80d2843b5fc40d3,62,43,82023,26870,55153,56,41,64453,28427,36026
6180b1f533f2147c1a7bee8a3fed44bb,3,0,406,0,406,0,1,0,62,-62
ce9f6561417ed98567f10f5614454775,31,24,25105,9064,16041,33,28,15277,11553,3724
0da0f5c6309742e73d1410d191c80211,12,8,1512,609,903,17,11,1676,916,760
c4d1ace80407b1f5fa170e107d5466b4,73,53,107002,37533,69469,64,53,81298,37290,44008
16ee06225b02b22628c5b8e1935d43f3,112,86,154264,33849,120415,92,76,142215,38534,103681
a4f8a9852a41123c3ca7db8997498532,167,129,580498,109815,470683,191,149,834315,94519,739796
b2108c0d7780f6196fa99fee9e7ce060,187,128,708723,171614,537109,208,150,959773,235951,723822
8dc9cc9c16cea9c338d5722d8d8e45d3,86,72,169732,66951,102781,91,79,193956,62879,131077
0a96d5982502e72a301f0bb10819803b,111,89,217958,45527,172431,85,74,153286,53619,99667
921730658a2559bda3efc0addf1fa6a1,31,19,25781,5501,20280,31,21,16451,8695,7756
49dfcf44593d5c4b03b2e7e1589b75f1,85,66,158588,32004,126584,94,82,169475,46458,123017
317a7c6a9b057418f134077a44efc73b,47,39,44223,14420,29803,38,28,27870,13087,14783
b3e741f44268def1b41b50a3d59420b5,82,72,163290,46907,116383,74,60,127546,47654,79892
85a02abc12c031d88214a3ffb9a8517f,122,107,314581,71483,243098,123,92,317689,91032,226657
cb30359ad54709353af8725cd7848e99,73,51,110405,24646,85759,85,59,94967,38211,56756
66f9e1e3d756530cb207478b54c3b35e,41,33,43956,20045,23911,60,52,61593,21449,40144
00a06b5c93a8270974ba120956f8d7cb,144,95,495048,89681,405367,163,144,585611,89578,496033
b7bfd5f8bafa2c24fd8e6eab90569883,99,83,231572,79250,152322,116,97,280881,81022,199859
f31de4ea49be391b16a7575e9897a46d,190,113,622844,88548,534296,195,142,646375,108088,538287
f4e216015142237334a1ab3ab350a4c3,127,99,233913,63384,170529,102,76,265690,51793,213897
1e3a97e2233941aed717d521957091d6,9,8,2179,1682,497,20,12,4597,1232,3365
bfbba6ac19585451b852dfde015bf721,42,33,28557,6831,21726,29,26,13936,6192,7744
67efe67afd199f8e518361ba01d3f1a3,59,35,64358,22839,41519,63,49,68864,19778,49086
48bb9b7ebefdfd4aa15b945ce798dfe7,65,44,107466,29472,77994,66,47,94987,29345,65642
5adcb815d7545fd7dcf174d522299943,178,129,747297,137875,609422,170,139,638468,131908,506560
5dd88c2d2c60f71f2947bb1d59019f53,100,78,256041,65234,190807,139,82,320037,69478,250559
7b621d9cfa201b7ab8f976755edea728,173,139,559245,74640,484605,160,135,641692,95823,545869
2d22b2922773dbdf207a51a99902b7e0,158,124,651886,159728,492158,195,177,739426,134990,604436
57061af4ddb69d84487324fbbbc040a5,117,100,232293,60820,171473,107,77,235120,64209,170911
b80859bdcc82b4a47e623ffc3c0376f6,88,64,112015,32376,79639,102,77,75311,39294,36017
a044b3e641297f5e0ca719e2d437080e,43,26,27328,9410,17918,40,28,20730,9387,11343
af6b93cc944b6b8c95b2dd125b59da46,209,109,410351,61359,348992,134,91,300386,67538,232848
cf98b63b9d60b894bdb1eeb5db6d492e,175,96,414858,61125,353733,123,80,338463,71674,266789
822120ac7a377a18c6eec39bd06e882e,42,32,30915,11819,19096,58,48,52174,10298,41876
d3b7aa1fbf567652fa56d8da0fb5844c,54,45,66805,20727,46078,66,42,90027,17279,72748
385b0104e3a68096176c57ff0a0a30d0,47,36,40307,13767,26540,41,35,34413,13738,20675
36e70bdb9f4b2a269bbd200bc3196ddc,55,41,51245,23220,28025,58,43,73344,16965,56379
1f40eb9d07b50759abd4899c85992781,111,87,259966,53935,206031,109,87,212469,67262,145207
7fdc39de2eca45f9d70bd9fb97c74532,94,79,152644,47844,104800,85,59,172270,30936,141334
267f96a88e86be44e76d4988a3f0952e,91,75,197975,57687,140288,118,85,234550,44816,189734
eebb25522dab18fefbf582df3e7a4879,172,95,344600,70898,273702,164,120,334690,95045,239645
9b85195f9835b61ca0e1d5a72f35663c,130,85,241222,41394,199828,137,93,247043,44523,202520
19b696d7c76d45478956325550d11afb,119,95,198808,96086,102722,145,93,319187,72048,247139
25e1b66361260e3df4b7c7e74a126ebf,139,108,541548,152989,388559,195,123,632935,121647,511288
89304c6755587f7f036fb5670e8f682d,89,64,95242,20965,74277,77,59,96474,26655,69819
a609dfe3b76d8ee27d0ab367fc21f0c9,117,103,262086,69753,192333,70,66,186827,62576,124251
47683626596b2c6ac0929cc0f9071a27,38,30,21585,11597,9988,42,34,35866,8369,27497
b730263573eb526d1abc9c719b2979f7,200,127,1111925,186686,925239,203,152,841803,175608,666195
a4ea912da5c23d1103882e143881e307,105,77,222405,40918,181487,115,93,209236,51741,157495
6ff5811fbff9a3091e25c64f14338213,126,105,359603,105673,253930,148,116,423024,75940,347084
5a9abb51c58f2a0a3b75ebab76e0429a,140,111,386261,66191,320070,102,91,303193,88074,215119
3538d7863af9a23b52f71abd52837924,5,6,1364,427,937,5,4,212,1258,-1046
fcb0d60547a548409b9fa41b1fc46cd4,161,86,330923,68866,262057,130,92,395986,77604,318382
3e18fc602cfe7ae736406ea30f4afac5,72,58,110154,29327,80827,70,53,82361,30446,51915
ffb946857187b4f6f2704bdde72534d5,166,138,428496,142135,286361,198,140,557370,138306,419064
8b72faeb533de7e3a7b16da8a1feadf9,68,57,123367,25359,98008,81,62,89785,35249,54536
25433f313479c6ebd6983885d744ebe9,101,75,161851,42798,119053,95,74,144200,41251,102949
bccd335916e7a393bdf6eec21597a473,126,109,237394,47983,189411,126,94,206481,49045,157436
6f4ec6a74bdf1d454f765aa2673172d2,49,38,35018,20546,14472,79,63,119869,19786,100083
cc0d9be660778c199beb3a1601418d77,183,109,485102,91935,393167,132,103,379834,110534,269300
08a26fa705139bc20ec3e9b68b438af5,6,8,669,749,-80,8,5,1171,370,801
5ea704199552ed54e1d17554b8aba6b6,18,9,4429,1563,2866,21,12,4199,2231,1968
4db887ce4e0f68db94b049f0eef55270,69,37,70706,17346,53360,55,48,63586,33009,30577
6e9ede4b968c7faf6f78cc43592d2ee9,29,18,22094,6722,15372,39,26,30619,10023,20596
a6ed0df582672eaba5f105932d5c1bdc,34,26,21724,8467,13257,25,19,12282,5580,6702
a6b7885ac23e1f54262f4aded059f8f4,144,96,296378,45225,251153,118,103,268665,57578,211087
60c287d40c60bc40bf960f6001fad737,73,65,117585,37445,80140,79,72,124216,41343,82873
c50ac05e484a4f977b7049b2cc32c46d,50,36,48790,22824,25966,46,39,70788,20002,50786
e2306e237c384e79515385229bd3e308,155,110,531924,117249,414675,177,140,638537,166310,472227
86d87b72769c5682c5b6190d0d97e9b1,56,54,108607,57166,51441,109,91,237174,67784,169390
f8f2e109a83e3bfcc2d8044749ddf34d,90,68,111885,34970,76915,89,69,106616,27308,79308
af40d3d89ba887c84df06ba77ce5f603,53,49,99228,38316,60912,48,40,96114,30160,65954
8887b36ed8e32d9861e37e5608a625ee,132,112,425822,73669,352153,157,130,426177,97674,328503
d1d00753a08a6672ac2ad660fa5a0b9a,156,112,373714,61281,312433,128,90,264541,45502,219039
ba008d79f2c415aa4272a2a2b2580c29,47,29,48551,16112,32439,41,34,34734,21674,13060
130b0a2dff9fcac0926024d45de0ebdc,67,45,91643,20070,71573,47,39,88004,24590,63414
0a79a8075f73f18802aa2ab6984a9f06,140,105,477680,130829,346851,169,119,598225,110140,488085
c47b07f7abf42a1a217b8078d2596aa6,197,136,721756,102633,619123,154,128,705804,112797,593007
f187379a0125d2aa0ee07d3e6f3da0f9,63,45,123627,30032,93595,101,60,145929,33810,112119
ee2096f0063399aa72a75d089d8d331a,17,22,9347,4824,4523,25,18,13946,3826,10120
ea7dd431bf26ce8d8878045c473d21eb,133,81,322607,71979,250628,153,94,394684,76915,317769
33d9f15fd569d1dbf428524e05d60c04,177,107,514126,110323,403803,171,111,571939,137646,434293
68dac53db7af802efd5e8b8fc289bad9,110,91,230097,52915,177182,139,115,245079,44107,200972
f0f464c9bb0da332ade1ac83d70571ef,138,119,283732,74784,208948,112,89,231439,59445,171994
acf44aed5863815ea630763f2a1c293b,123,109,299278,71175,228103,141,104,297680,60682,236998
2721857f9d7acdccff6928327f907584,50,56,50234,21908,28326,62,47,56816,20357,36459
d426baec9dab4bf5fb0fc76388ddc189,177,117,521186,119721,401465,141,114,411454,119245,292209
f779cf45abddbc7359bec0457c685d35,194,151,737421,170918,566503,152,132,674699,156869,517830
c360d7aebab45c7b15a3166526ebe65f,143,100,271425,31970,239455,131,99,228078,53559,174519
ef48e2ed071658481cc5bb2029cb5376,66,48,97929,28022,69907,63,47,79802,26847,52955
9ea8ac6203cd300f6b864f94d99eacda,29,23,21790,5629,16161,51,38,47144,7591,39553
2b5fde4ffea099f8712173f54145fadd,105,65,190965,25084,165881,64,50,97410,20125,77285
ddd46127cd299686d84e371f67ede76c,125,101,425614,76919,348695,154,106,395853,89006,306847
c43074994211b64bf72f80aacccfaaad,38,31,36927,7351,29576,27,25,21172,6558,14614
c9b1658f84bbed95b3efed3caddd18fd,151,112,290266,70051,220215,133,97,328966,70958,258008
d4257a38b9111692196d62cc0d9e5886,102,77,357303,112578,244725,156,126,506360,155153,351207
c669140d4159f46675653323223a444b,164,110,465286,104750,360536,140,118,406887,107245,299642
9507b216ea0258574ae5862be502a749,4,5,354,300,54,6,4,513,293,220
d02efe97bb91f940344c08c748845f80,94,80,168518,46184,122334,120,98,273252,32956,240296
da7d9a315e5f2d4557b738d8fe9defe3,54,43,109641,31202,78439,47,37,76773,40606,36167
665378649fbab90139026c4602783077,64,52,64276,36273,28003,60,55,92922,29432,63490
7bb4e4b3f806ec82b9efc2697bf0edfa,32,24,24294,7958,16336,33,30,27084,10155,16929
ded052e07877b89ca3982086bb61e7c3,26,20,10696,5636,5060,31,20,17668,4656,13012
94c622c3843606e6875878d95ae70db1,53,32,43720,9843,33877,38,31,27764,11601,16163
122d5323fa4efde2d222f0e489938b6d,57,49,74301,21558,52743,60,58,90782,19669,71113
2fba1fb782db2dd1a26f048ccd2e3ee5,23,22,11789,5319,6470,22,17,9697,3188,6509
9290a9999961eb85a4cb50047d19d44c,42,31,27786,8216,19570,34,31,24769,12519,12250
604f543bef4c58ebcec52054b3be5d23,125,92,291697,74460,217237,148,124,529921,75462,454459
adb39ff73620b242f26a0e030ebd203f,84,63,128211,32684,95527,66,54,97459,18224,79235
fbf7d8e42fed14c3915c1b8145804950,114,104,225194,46482,178712,115,94,205404,49797,155607
10931d638742c5e10b57aee06723f3a2,59,59,60332,40218,20114,65,50,112922,25124,87798
e74468a5e3461ee48304fbfbd671fe8d,82,58,77857,22405,55452,86,60,102684,24101,78583
5378b04ac8a54b6f350b9917a3bfdba2,139,95,360874,125767,235107,135,104,316156,122218,193938
5947010788c8df9398132007dbf112c9,98,60,159091,36047,123044,108,85,186102,38132,147970
d0dd0fd8abd2499be39570bfcb2df37c,135,92,354766,53615,301151,149,110,396075,61296,334779
15c7312da7057b4262a32eb5219f3b64,124,87,234131,43243,190888,91,56,144270,47959,96311
3e177891803b8e1bc4825c154758706f,89,66,153671,27098,126573,58,56,89209,30139,59070
21635716c4e02e9196c877b06de2aca2,34,24,21138,10721,10417,39,25,31180,9896,21284
5181e0b7dd37c519710304afe94621d9,65,44,96269,25305,70964,68,57,70425,34196,36229
d22494c3c7d1248c0960ecacd703f564,19,14,3892,1775,2117,18,13,6758,2287,4471
8d56f0f059a4f6a80f589c5387d57c02,37,30,30040,15877,14163,35,23,25744,14870,10874
f712c17630923b3b23353992c34eae8f,17,12,1798,739,1059,16,14,2436,799,1637
55f8775fcce761796bd26cbad6808885,105,72,157279,33314,123965,96,66,143810,38699,105111
132f805b73ba7f8d05bf1257041705bc,93,65,114060,39023,75037,78,57,88405,26279,62126
829b6f41d78f3babedb8c6e12b757d1b,95,74,191613,38049,153564,83,72,158076,51551,106525
42606753357abb51b7688734a89b98a3,167,102,466265,79178,387087,160,141,463372,102562,360810
aa3faa3fd8a025dbf818d0eeb7f289b7,147,95,355843,96904,258939,109,94,302982,106776,196206
5e12bd73b38c545063ee43ac8bc85a49,97,61,154574,23279,131295,79,62,109171,31673,77498
da2d930376ef3f1025c44fa9beba6be2,28,25,16028,7028,9000,26,27,24598,8717,15881
14950168b3b58aba635796725ee7145e,160,128,480791,90873,389918,175,140,428145,69776,358369
6652fbc6008cc6a4141e90f4063dd644,116,88,341570,75767,265803,158,92,391589,52678,338911
7f36fe4f85e0c190189ec5d94d795284,143,114,535816,133767,402049,150,95,499111,114669,384442
794077c3c83a138bf9ce437e4ba16010,43,31,38526,11876,26650,31,27,38504,11136,27368
48fc07ee48bd0ae83f1a650d6ce89076,167,131,613031,158891,454140,160,122,562318,153276,409042
228f706cd138035052a6b535733ca61f,41,28,64972,17710,47262,37,27,42694,19303,23391
0b0691d7ccf6dcbd29f6006188468337,154,116,419040,102655,316385,161,109,401840,136769,265071
7cecd5ceb9a65777f31e2c4c8884a720,52,45,81525,35170,46355,89,70,161882,46277,115605
81994cbb1ffcfe2a3cce1baa44918c1f,170,131,488294,92249,396045,133,94,338803,67294,271509
19d469838aa82d2c5a3b55221b594a03,121,91,298072,52868,245204,139,77,262275,53590,208685
7a2dfae424bf543023aab1d3de42a680,111,87,187669,47775,139894,109,78,134875,48530,86345
34c72cfacdffa23916aa05fe4c7e449e,121,92,279889,64131,215758,135,124,374685,79826,294859
d88c89efa97524755f124353bfe87929,92,66,207011,36427,170584,113,92,218150,49022,169128
b15203d65960474d133a95a7770c864d,235,152,681555,169990,511565,209,116,715417,181259,534158
9776fca833710bc8026b5d9ef27353a4,43,37,56411,33618,22793,48,40,99400,28428,70972
200f2748f55390238dbc88f1bf5d586b,148,120,390944,55666,335278,156,133,438564,53616,384948
1fb8d8bf5b55a603a83f07f7cc579251,18,19,4669,3513,1156,18,15,4432,2300,2132
369ca775f596dd3fac2b8dd73646a2f8,99,83,222497,71465,151032,121,87,289703,63126,226577
cac94e3cb65dbd94b20db1451e1978ee,136,111,569914,165086,404828,193,126,684711,108497,576214
55c02889b4b910b3a6f71452c44aa670,182,138,812774,154877,657897,141,119,608271,172993,435278
919c75b1074319feb8963bb8c5c6a496,198,154,1497334,231593,1265741,197,144,918615,257185,661430
b348cc7290e961abd6764c3dca02dc29,55,40,58878,18415,40463,49,42,65028,26328,38700
eec1a504a252ab77120731e26755966c,129,94,312997,75366,237631,155,122,326315,80540,245775
c567c7987207102193a8c5d434f72159,56,37,63221,24266,38955,67,59,85619,27864,57755
7e6475f5f9ae53fec5ff56f7a7ed68c9,8,7,1382,1047,335,9,8,1323,1447,-124
1c9f593ae5d7d93743d16b173c765439,34,27,34185,15949,18236,36,25,41891,13504,28387
d15bc21b215f6880f96b76227d8e3d12,9,8,2026,769,1257,10,7,1343,313,1030
d877d5cc6e35472dd471a8e2f093a470,50,55,46508,18490,28018,43,25,36337,9619,26718
96ba5173c862854efe50becd0feb7b3d,55,35,66683,14020,52663,51,40,53300,18572,34728
95d8186fe1a160153d9b318ed2c111d8,41,35,27747,12206,15541,45,38,32249,11526,20723
55f679ba6fc2f81fbef4c8b7b06f7c0a,178,136,732196,192353,539843,188,138,704626,176927,527699
9f969753f9339cd9cfefb0949c3f2655,160,124,535708,86393,449315,153,121,406349,113227,293122
bd40a33f1630b8fe652e3943f24f06de,50,39,46302,15157,31145,38,24,27614,9297,18317
36aae713789a77a218dff09202d533d0,20,18,4669,3495,1174,23,11,11116,2037,9079
4c30d1968521fa53a597948c8466e656,14,14,2484,1143,1341,16,12,2089,883,1206
bde2259a01f2d1e408fb1388216964fb,129,91,211850,30953,180897,104,65,158946,21496,137450
da9baa3f6f22c82b59f893da9dcd2957,40,21,45612,14473,31139,39,25,39711,10064,29647
3913e52b43b53c221296b97044011cc2,77,62,125094,36303,88791,57,46,87976,21611,66365
f1df7d0a2157a067d1ef8cd0266c5aa9,165,137,604267,130350,473917,163,117,688420,131291,557129
50fd4ee6409930c29cda87f08ad12106,36,24,32823,10622,22201,36,30,30286,10030,20256
14d9fd5a41e85c48b32ccae607cb1dc6,78,58,117551,35779,81772,92,81,112386,38222,74164
822f009a5b1e0d345e8cfdf03833b46f,172,139,546456,130396,416060,124,87,291908,105812,186096
a5837982d2fd754acb88bcc8484ef1fa,41,42,63451,27635,35816,60,55,84191,32393,51798
cd27ce036ac44533bbce8f3bfb39bcd0,116,81,236625,73925,162700,120,101,358793,81290,277503
c40fbade0f2c27ef1c3e3e1073621edc,169,129,405760,108484,297276,174,137,516549,89710,426839
f8ffe8e91cb0a4f92591c7e302aff03b,60,42,86294,21180,65114,65,49,89311,18432,70879
e779d0fa16cb26758f5ce5cbdc61f587,106,90,281730,54698,227032,122,102,278576,54064,224512
bb06cd463152fb19bc5b76dcaef91299,64,50,87425,16862,70563,46,43,48090,20573,27517
3d128339ec90a5a113fc20cdf374a2a1,69,63,112228,39734,72494,87,66,117786,33587,84199
e285c90a8d1341c269a916d52079b9f3,137,100,507413,69399,438014,149,95,365678,82135,283543
607a1b4a7e56a629c4bf2b4e0853d9aa,137,114,420118,87994,332124,198,126,520564,69229,451335
875065bebf43d1b26c0f8e5753e26833,111,75,244924,40138,204786,125,94,275158,59590,215568
7800b569056cc34d8b2641fdc3b1e4d4,158,134,417329,94839,322490,150,117,571725,92798,478927
d0f9b8075c48f413331da8b558fd096d,59,40,67608,15752,51856,34,25,32702,11510,21192
87f1afca2f409f8c2138b3a0632bdbc1,58,49,118137,25435,92702,59,44,122547,32388,90159
1fda7ebe98897dbd54794fc5d13277be,14,10,2348,968,1380,20,13,2271,1305,966
895de0f23cab9dfe659b3635b3574e5d,23,22,13490,6739,6751,20,16,11953,3888,8065
bc768066a7e9956a588856c402119466,137,112,404632,65194,339438,146,108,409024,75680,333344
46e87082a4e6d03e22ffee1363740792,55,46,105297,35229,70068,61,55,90496,35746,54750
10d492bbd2258ee31c4747309360793b,97,67,176346,94702,81644,156,117,444942,65691,379251
2c1dfe643c5e06b2aaf8b0b2316a67fd,65,59,133939,42781,91158,69,53,128806,38224,90582
c39d6d5dd5f973429734467c1fce55ea,130,95,340993,69687,271306,95,66,150351,89279,61072
36b62ebed13d41af6f827920bf82ba40,131,117,376712,57482,319230,112,92,262046,62864,199182
a41535fa42bc26c6321fade77b1b7513,2,2,99,91,8,3,0,215,0,215
b0e21e5d9a8badf2c177a2f7fbf87f03,36,31,27066,13436,13630,39,35,32417,12626,19791
5eae80ae122e80e05a6410652f319182,150,119,412266,71464,340802,142,108,390231,76477,313754
855103cf6bebd2971111a5a0a753e23f,134,105,286017,60108,225909,118,84,239774,55788,183986
c47cb26074f0d5bd3e12c9271c9c533a,62,49,100165,30009,70156,59,52,82518,32569,49949
9bb7ec88d841fd363497002fb65f8479,21,20,5367,2638,2729,23,20,5758,3555,2203
9ee793681f3ca7f359ed0b5fe7803d5b,92,65,195618,40660,154958,85,60,143434,51186,92248
4c7ea1dd225159569ff6d5b3377976d2,150,122,326422,58404,268018,108,85,368251,49705,318546
e47b63b56e5733d0ea908ab622d64bf4,28,21,28778,7900,20878,33,24,24885,12325,12560
33eee9d682b6411304713dd564e2f868,48,38,49637,15845,33792,40,33,32416,16243,16173
1fffbdecd9716ece6e7c5855a987e9fa,91,81,217303,44793,172510,86,73,139233,33513,105720
3383b2acc7b0940c341388713c14fb41,133,97,379620,83235,296385,146,115,378971,76446,302525
59f4ea529636a81b96d287c3408bd6f6,77,50,69190,17037,52153,61,46,64106,19986,44120
ac7af73228354ba4a481512b333a92bb,136,98,313065,88491,224574,94,72,290627,91388,199239
639ccd858238f29f93fa8b37f95950f1,107,71,171260,43659,127601,81,65,127849,65780,62069
165bdb1bc7b5ab341d7c176699c77bfa,23,13,6376,1730,4646,19,20,4827,3444,1383
b54f2ac8f3c2f38e342a48ba29f4ef22,204,151,622563,126557,496006,134,96,457112,110573,346539
a919f105104d2a74f661bd512c211b83,108,90,415540,95784,319756,127,93,324043,85862,238181
989ff75a875496e24c8ec8c411923fdf,119,81,284693,68290,216403,109,91,280184,79994,200190
43a653d1c0b4c03e13ee735314ff21f6,16,19,5068,4727,341,23,15,5955,2599,3356
3f531d4fd1b1d3e86f09b54b2f6ecf63,62,54,164088,56696,107392,77,67,132867,47699,85168
5a22abffd910b17ff5bc1517475ff0db,125,73,223168,51485,171683,64,49,90507,70324,20183
72530933bf7e19443e51d3f691e0e18b,74,58,102649,24567,78082,84,70,114096,30199,83897
c38a10d62521d5ec62d07544a373064f,110,85,193404,32428,160976,93,79,135468,33356,102112
d8fe19272ed2d34862bc0090e78260cd,76,46,69649,27351,42298,69,50,102039,24950,77089
467e34b7d12deaa59fab680aaed29b3e,188,122,793809,140961,652848,189,139,710054,149018,561036
0277d6b27bd498ce31308fa0b49cc43f,33,26,19981,8033,11948,31,27,21507,6996,14511
8ec7ab5a134a7c1b1828ca571bec78a8,114,90,256381,65593,190788,145,118,347460,78108,269352
3e0d8c54946ff99f1c33c20b1213fa95,158,118,536620,98306,438314,140,119,403892,101408,302484
fbbf9e484e8db8505dea345cda97f71b,143,114,394450,75440,319010,125,94,332573,63705,268868
53351bb93a50ca79c1c5c9f426cf8d6d,22,17,7255,2098,5157,19,16,5973,3109,2864
2036797994bc22e104093b2ff7cce136,221,144,751922,115161,636761,192,163,703715,127994,575721
d8dfea9152f62eefa3b342c3440a1dd7,139,118,318990,82020,236970,117,93,339401,78766,260635
53c80b7ee4fffa311c110ccbf50f6061,113,92,137726,48743,88983,87,61,145038,36844,108194
ec0ddee60a2aa1082970fd0c013c41c5,63,56,114351,48927,65424,80,63,142158,48072,94086
d18a607f73644b59dde3c3c0a4fff689,51,36,52749,15884,36865,57,47,45750,20487,25263
d5930ec2df28a9a4ac1e66e0c1dde9fd,149,108,419034,78620,340414,149,123,363263,84662,278601
c30794417a72c2a9b7fda8c2680818cc,116,80,377424,78134,299290,181,135,605089,82916,522173
58aabc8d878c6aff7d0d069ee8dd3018,139,102,421004,73799,347205,129,102,304015,90185,213830
4ee6569d95714805f8fa0aaa5035f9c7,115,77,266573,68801,197772,149,89,251140,84804,166336
47a4cf3228e57a8e91c9ef7676ea3fab,100,69,219283,44127,175156,126,105,305971,68190,237781
b9a01e07cb737e9f103eef1fcf4babf7,39,34,35679,14358,21321,45,30,37210,12919,24291
082ed811098277dd40f4628ffde40ee4,75,47,163658,80266,83392,104,86,281222,75531,205691
0fd2182147997f05ea4a62a8854e6fd2,51,38,62331,16352,45979,45,44,29834,12021,17813
87aa0e1e4f4355d89ca079a16c9204bc,143,122,314580,51104,263476,90,66,147639,52558,95081
72d23cebf12d1958b6dde1763e66efe3,50,39,33023,11546,21477,41,42,29146,9625,19521
91be3e163d654393a6fbcb95a3bf4eae,147,94,296387,52862,243525,131,89,215324,59512,155812
59c42e56b600d365af6870b066580076,90,75,165332,33251,132081,91,61,170685,37979,132706
b6548143d6ff5aa5eaf209a8a70d9b16,28,25,19022,5848,13174,37,25,30224,7099,23125
035ebc5c48d0636fdc75a579ba31de19,130,95,246476,46219,200257,143,120,342912,67611,275301
9ba1b0e540e9a0ebbc7943546668ef95,47,33,44867,20668,24199,57,46,68005,22698,45307
55d7d25a9feb1338ba762410bdef9b29,64,41,102856,35682,67174,54,38,86380,33604,52776
b703900db194688ed7e51ef500513700,97,71,210177,77545,132632,127,97,297816,47759,250057
de157b2c2ad8cc2f51e276d52e26bebe,68,48,119497,40122,79375,57,43,105105,40407,64698
c35141a824b3b2519e20a92044dc9282,183,155,563152,80111,483041,134,112,425430,93140,332290
e6366e584fc8934c7efc806afadd7b35,31,26,28632,8982,19650,33,29,25096,11070,14026
455b938aaa056ff7252ae01bd0cd242b,113,86,248536,47184,201352,108,90,271874,57703,214171
50ab4569a83a90bd4ee39b578f18d855,125,95,210400,39759,170641,104,96,175074,65250,109824
e8dff5683498551d19e269fa0fec7f05,151,103,517097,120187,396910,157,117,498713,171751,326962
b02f6d9b7f71cf5e42284806db15b336,32,23,21912,7292,14620,31,33,25467,8983,16484
c9e29f6d7b5f127233c3ae295b997e17,140,102,420301,102522,317779,173,135,519955,102673,417282
ba5d18de5dd3ced76498f8a66afec11f,44,39,46103,18351,27752,43,40,51938,25551,26387
74ea083c90c65f154cfdb07cf4924fe6,35,29,31231,12771,18460,37,27,34260,11395,22865
9ffbc4e97b0e6aea216a6fc58371e741,44,39,44490,13199,31291,41,39,44098,15917,28181
93b3c5e7e4e60a4806ba31dbb4caeb9a,165,122,561894,84268,477626,172,126,444832,88748,356084
e25973f72f77866ba6c2eb9975a9b54e,6,6,769,1270,-501,7,7,1300,799,501
1a7d76bfd7c23a2e65f5b69c0b6ca5f7,136,95,384976,79705,305271,190,166,532310,117067,415243
f651b72b740b1b976ebf8b6a78818555,95,80,227203,49728,177475,96,80,198723,57430,141293
aec44fe5910e574402fdc043412e8a99,39,31,25694,11877,13817,45,35,35279,12885,22394
6fef48afa177b988f3e9bd3bf47ee5a3,39,25,38543,12387,26156,35,33,31180,14581,16599
94ac2722d90397cb87da9999b3a5585a,110,75,252505,110050,142455,150,110,351930,111098,240832
49c212d19e502e7c0384885c9b072422,126,98,226773,52505,174268,126,99,223734,51087,172647
78b60e1a3160a41c9bb931c7493cda1f,88,62,103450,34148,69302,82,62,136744,33988,102756
2bbaff184851af23cd2f12bb016da0fa,123,81,219430,57230,162200,112,89,250044,38019,212025
2525939893917d084567add71b311a45,23,18,9224,3253,5971,24,19,6704,4440,2264
8d3af656044dfa8f78059640768d82ce,44,33,63665,27284,36381,45,39,65724,31117,34607
41bc77427389b5d6f9406eecc7fbb1ce,189,150,729990,121735,608255,152,118,415710,134279,281431
b3648ff260b1214514a3b0131295de25,77,56,142866,33922,108944,53,47,79874,44132,35742
a6932557887b7963b7a04e34477b0aff,41,31,58415,14960,43455,35,26,30701,21337,9364
acdbe46f4be27b5d98ec4d2a1ee7aec2,175,118,404448,51978,352470,114,93,252995,66107,186888
878c04fe91303554ac57fa41e0fa2bff,189,143,582932,82526,500406,146,108,324123,104350,219773
16370bc4908297b2b75b963196e87e9c,98,63,179229,34589,144640,88,72,173847,39533,134314
3f4684c46347323d9055e92bd9a01ad6,37,28,34830,6919,27911,29,22,22020,8030,13990
501ca44c3f3c2a42fddc63482f4fc783,121,79,312720,93198,219522,174,125,466086,94993,371093
f620e4939214036dbdcfe9e9895ab0f0,92,71,254403,82688,171715,180,143,462936,86317,376619
baf523c82a0b1ed28f0c193bdf6826ff,91,72,173312,32545,140767,97,69,174378,33051,141327
b394ae1ba48765b63fcd3c81a9d75994,1,1,74,593,-519,1,2,593,144,449
6f91be931107d5fbea7410f82a91378c,89,58,135916,32888,103028,85,75,159935,50167,109768
6eb84c7df1b1e28e086ec7265abbc802,54,40,63264,16011,47253,35,24,46423,16563,29860
2cffed43c35d101bd7646b343da14c85,179,136,517415,112373,405042,124,98,365237,107815,257422
5136456d1ba0cf85b71e8c15cbd395ad,2,3,181,145,36,1,0,75,0,75
6cd900aad4fc32a12712eb01a15a8a36,124,116,278726,69083,209643,136,102,264195,78269,185926
c41de722f101ed93d3f04fa9e82de941,25,22,20067,11441,8626,32,25,25432,10405,15027
744c39586666412c02a65a40d12ef884,39,37,31826,14211,17615,49,42,50160,9662,40498
da9cf7706def0b43230c50910dcedcbb,160,124,427526,79702,347824,147,111,337589,87405,250184
e3b76bde15613db417e2b16aee29c46b,22,18,4983,4499,484,24,19,10309,2614,7695
75cd0cd7b43af147281ba617eeaf0980,32,25,18307,6028,12279,28,21,18011,7422,10589
155a96dbabeaa244eb9a454f7cf539b8,92,56,129966,32230,97736,87,60,99174,32080,67094
270ce4b4f4cb9f3d772af6e6871ca37f,153,125,447022,93404,353618,142,93,427959,114513,313446
70d59a83ece2547f92d2c6c07ab1495f,91,78,173034,60557,112477,88,78,200136,48625,151511
576bc0d44d4d445a197b143faeb4b4d6,92,62,135776,33817,101959,102,56,124875,35132,89743
9af808b48777f00805a215ad919162dd,107,93,190893,58402,132491,108,81,252601,51070,201531
423746246140620a81167364d7c77019,89,63,139532,26392,113140,73,54,102720,27065,75655
65d8514a77e5b2267d209beb7ed661a6,194,152,704479,160988,543491,170,119,572256,142373,429883
7f81adc84ca8c02fd260f425940c5cd2,101,73,190839,42774,148065,101,87,208617,39124,169493
8868c40731f445f28ac6b9f758fe1288,36,29,13883,5334,8549,29,21,11579,5433,6146
6f6923fd1d8ffb6251e21abe4ec63b03,171,122,570326,110715,459611,138,102,454392,135477,318915
85052a420b4ab8fa18305805e6dc60c9,204,158,708880,106225,602655,149,123,512441,81170,431271
da8fc014d85a6d6cc89c532fb27ac463,9,7,1172,960,212,10,7,1187,888,299
1c9f9f34d001a6facb97df74b6600bc8,15,12,2767,1131,1636,13,12,3429,1753,1676
d83e1a398c07bb83ecb63a8bf67a1db8,114,88,266288,67484,198804,159,112,344090,62529,281561
cd4245c625e9f76f653c3cce9dd41579,42,34,66671,17743,48928,31,29,34389,21660,12729
839c5f085cad19ab4f2ec2fb0637e5a0,147,109,300433,68189,232244,113,83,197796,59113,138683
467db3d96ce0fc3d52c1ed03085625c9,22,16,5028,2536,2492,22,12,7814,2299,5515
2318e98aed94e38813fd56298b916dbb,107,67,196982,59571,137411,119,89,247304,50852,196452
46cf5f3861d7669916614a0489df9bd5,49,42,70768,22037,48731,52,44,71962,23090,48872
d363d3b616980a88988a20fb26c42b96,76,46,88462,26585,61877,78,79,121694,29932,91762
5488be2f08b82c0bed0a84297a5b2eab,90,68,161558,35181,126377,104,89,179069,40198,138871
82bf5a2c7fdcee2c95bf9ee923a782e1,23,21,9964,5378,4586,30,22,11991,5023,6968
2c14d216043ea2cd9ef077c3a51ca9fe,38,28,59060,14483,44577,59,46,65262,20985,44277
9e23bdb66470aed801d8395cb5997cc2,123,81,302066,53463,248603,135,90,241508,62895,178613
a3acb9a901da40e78c5ea7f383bf6394,87,74,190159,46845,143314,83,58,195791,48385,147406
c038a9e88f356d306ba41e4ad7789eec,86,70,112890,37069,75821,103,77,137431,35091,102340
33d390a9a9b68dda77fc44ab6d4017ce,108,89,286214,44261,241953,114,92,260918,59196,201722
0ad247328a0fd98aae921f36533b17e6,50,36,63649,20386,43263,55,45,69537,26510,43027
9a4a28a33d8494271edf92bc8d94e0f4,66,56,98502,35091,63411,88,63,119451,25484,93967
005d421be8d64bb04f81257aaecebea9,40,31,44642,14786,29856,42,30,42797,17231,25566
ed1cd22c0a96677888dd1a99e8857ed3,150,95,472859,80490,392369,161,107,559266,99361,459905
dc258752effc0b1f78fdb2764ada25bb,66,57,76624,22993,53631,54,44,53607,20382,33225
c82116cec7573a11425cc8f9c2054c88,165,107,530719,139310,391409,141,121,571068,146997,424071
738f8b8f1420e9b56fe70a508ca5782d,39,30,28592,10781,17811,40,37,23201,10689,12512
7249b47a1bcf9270fac6cd6297cfb9c1,20,20,8129,4491,3638,27,22,11409,4631,6778
a5cb71622df26a44eb65ffd3eb83b37c,64,48,73899,34600,39299,77,42,89701,25101,64600
18319eaaf88a579c4fe843211093804c,22,19,10280,3482,6798,27,19,15391,5067,10324
2e858cd5b0148f0032d492804a0a4267,41,33,25873,7794,18079,39,28,21043,7580,13463
d7703764657dcf01c6d64687c3569bd7,32,33,27528,11545,15983,39,30,27223,15380,11843
4498b928db79c15b381f78af2fa14d37,91,61,206096,41582,164514,138,124,346789,54738,292051
55762156d3e4c5ed29cb8df72efeac11,114,86,204189,41074,163115,101,96,196607,47545,149062
a4824a6351852c251fd3cd1988db5c23,35,33,59287,23151,36136,41,38,50373,28432,21941
cb37aa44c77dd9c1294aa7dbb2ccc356,23,17,6816,3815,3001,22,21,7540,3802,3738
ab115d5be51875065e137f1b36464dd7,178,138,606113,133720,472393,114,82,330242,107434,222808
3e643ed89285235d55eaa651fa6e7cd9,104,78,192288,50566,141722,152,108,241644,44557,197087
a0365fb0518eda0687378740d2e244bf,70,71,106107,28863,77244,47,40,54810,24941,29869
e64de2b771b4860abbc74795a403091a,28,25,16412,5240,11172,24,21,12202,5965,6237
9e6bbb84f14cf3c02cea222d54a63bec,177,123,686536,122379,564157,180,130,645530,106128,539402
333b75fa7979b8dca10d5ebc3cac2e60,38,33,31472,9796,21676,47,27,31416,7882,23534
fe29f4136d71c86bd1a53d9c1faf3bbc,66,49,132967,27528,105439,56,41,110232,29647,80585
5f4d4f6714f7d92da222ced6bc1293e3,38,37,52419,13075,39344,36,23,33265,13276,19989
616d7f3562b37727c61422562de4ac32,39,29,29468,11734,17734,37,27,31487,11307,20180
a9f2b8ed6bd98198184d14ce6c796777,66,65,79456,29898,49558,77,43,94931,24634,70297
bdfc339c7165c0faa881de85a3dc6734,105,77,174076,38916,135160,87,77,139766,47344,92422
5c2df1f47695bc4a7b8088b364186c8c,41,34,45764,22311,23453,54,36,56289,16644,39645
e731a31f23602b385b778b42b7dda423,164,123,445905,74472,371433,115,99,345423,85399,260024
4763f92bda343598f39671ad9460e1b1,68,62,71080,32408,38672,87,69,158138,18024,140114
f497a99ebdb5220f2c3519aba7ec7db2,29,25,14153,5712,8441,40,26,15484,6242,9242
9f02f0367ce7a4416bfa79400ea0e27c,96,73,147206,33712,113494,90,72,127392,31147,96245
c831f9df8814ec62636e47a555d4b8d9,123,90,206747,58062,148685,109,88,217874,41256,176618
4c2705367f01dba876a7195f9fdd910e,135,96,286738,48662,238076,106,79,215918,56290,159628
1d4c505074071b00f16a1a9f9a73f02c,19,19,3755,3222,533,18,15,6067,3111,2956
7ba6fbaa704e96888e273640f0ae587d,70,56,127984,49067,78917,73,66,132505,40868,91637
545cfcf5f2a0b209b9b50400ed832898,34,27,23464,11070,12394,44,27,28504,8262,20242
74c27fd600e3460eb71a866cba466067,51,30,53400,15320,38080,55,46,67595,21886,45709
2b81098c83e91a4d8f1325f73c82fcf8,54,45,72885,20441,52444,45,34,52564,17871,34693
74211d28fb0d233f1f86d201076e0814,104,93,252848,101136,151712,145,112,324053,86320,237733
04728b3faddc09e33d968966d718e3a9,153,125,328372,50835,277537,102,84,238519,47595,190924
70a92c4c677b865f242bad06d2982edf,132,90,340587,93241,247346,186,143,433506,109026,324480
20c902d0a9ac768e503cd964b9661cf0,169,133,695500,145879,549621,197,176,952301,147133,805168
51d7f298b93fc0f9b7daabcaa4bdc506,94,71,219913,58426,161487,128,98,344724,58426,286298
29b2d8e474c6ffc6c96b4a6a4345d67d,106,81,214457,65081,149376,93,67,186455,65487,120968
637aaf6ae2a06cbf06cd97c958298eaf,26,26,12123,3531,8592,25,19,9025,4128,4897
0c72168abed586e0cf1fc2b8df76ed1c,92,79,264089,77697,186392,99,84,266395,75305,191090
049548d86c31e87e8bfe347812717b5f,17,16,6069,2906,3163,22,15,7641,3171,4470
ac870737d8fcee522d423aa1f56eec7c,35,34,32288,12175,20113,46,31,38579,10549,28030
54810725cd9c27d61ce5cca32a450d45,71,54,117510,38046,79464,85,73,122832,40467,82365
71d69afc5d34ff4c9d0eddb32b6926c4,29,23,17060,11678,5382,24,23,17643,6973,10670
b2279338103361e806d2e5b21b08f204,185,146,577854,153892,423962,162,135,479849,115282,364567
d92138c979ac392ee44410d99916fb9f,45,31,31119,11224,19895,42,27,33596,10616,22980
7cff33378b39213fe9092fa6f36f95d9,55,43,56486,25851,30635,50,36,57115,21622,35493
f3692a10a5898801ab78ee848f85fb75,71,54,138626,25582,113044,72,56,101264,36855,64409
d4a9e1e5ca3efa0710ce785063f67808,96,66,144451,31230,113221,93,65,97011,46826,50185
5da41edc947ed68bc26758b743549628,71,68,129996,36571,93425,79,67,104118,32682,71436
f247a1a50ac5708e0914de8d3ac1f073,97,81,160186,46193,113993,114,83,200999,41415,159584
6a1ddacad1fe416e426ae85b45a9d9fc,134,88,281064,55705,225359,139,105,353340,61293,292047
f231f9ad4fe7c2c18c289efc3984be6f,129,102,401625,112749,288876,119,109,385824,125989,259835
a4b013f83a47732aacb49dc077d8ae29,123,82,379912,100398,279514,188,121,539419,64996,474423
8c0d27af8c26dcb22f3580ad8ab2f8de,114,77,208841,41437,167404,146,116,358163,49784,308379
dc731e69abf892e187999ad29e640069,10,5,1162,644,518,10,4,1273,226,1047
679a12b94ca447d0468317d59e69156e,113,56,168859,38645,130214,75,45,104008,44656,59352
f75cbc9e2a5514cf3c0af49d65444f8c,25,18,11891,5791,6100,23,18,12781,5173,7608
5cf80d3b3d84afb85874d9a76dd1e64e,27,22,15402,7833,7569,28,20,20516,4447,16069
b29169a8cd707ff7b888f7c322f5171f,36,25,34856,14993,19863,51,40,58381,16868,41513
35713edbfe2797095f8f27b9f4b8b382,144,92,284870,61082,223788,92,77,177399,89613,87786
2e30ffce5b56f69d918ed34b4842431c,44,44,84260,30478,53782,69,53,94781,29048,65733
8577c7c42cd03f9be805a8f2cae2a939,34,23,28519,9173,19346,39,27,36468,9390,27078
564600cc0e1b2750c4460ec1486956b2,106,79,182528,88046,94482,128,93,271648,50362,221286
a3642145a1f2d27b967e6928a97ed2e0,46,39,74363,25037,49326,50,36,76937,23552,53385
72c329e59034e67a4600da49b6ea57dd,98,59,203727,35672,168055,115,101,261849,48654,213195
ad9bd47d74006c75ef44fbb4cc16feea,126,93,209553,38029,171524,118,86,233005,49278,183727
4a75119c3f87e85ee60574ba12de8d79,146,139,482888,149797,333091,125,99,384579,112410,272169
e8f9f5421cfae051517eee75c67b011b,35,27,19310,13520,5790,40,33,29289,10908,18381
45b6f9da1d10f5c0b2f2369fc2def0c7,79,60,139065,46837,92228,79,55,138087,45217,92870
d0280d7175baccdffc23a9ec00ecbe9e,3,1,219,165,54,2,2,169,167,2
ea9eaaa3e766fe785d4fa1ff267a888b,105,87,191551,53183,138368,100,94,183212,43111,140101
ef14e35b711e216926efe3228592a9b3,48,35,70807,13155,57652,38,34,42647,11386,31261
f998f1880b1f0c474cb3b30e8c4899a7,129,104,532936,129204,403732,204,153,786406,139476,646930
a1bdb08b6d8c37c94f4659e689f904c7,63,47,52895,17833,35062,61,40,79045,15605,63440
2f62c13bfbaae3e56051b196a32c40ba,105,88,359908,82754,277154,131,95,265660,73773,191887
4a6c57ec10a15a2b8a24fb249be2f42d,82,63,160313,39085,121228,90,80,185729,55482,130247
3b5cddc6e32a15e8e57775f777309537,87,71,166797,37893,128904,44,42,76546,31378,45168
5d96ce474efdc7a6cfab22b284c1a830,75,61,99611,21333,78278,51,37,50162,17523,32639
16a9c4dd0ec602a2219c3e422fb5922e,0,0,0,0,0,0,0,0,0,0
142252d466f8e8fb2f5ad8c55de9e1de,34,26,21484,7274,14210,30,24,13669,7080,6589
8fb31803437dd4b6d04642ce8c106316,219,158,1236840,239687,997153,208,153,1211801,198504,1013297
bbe5de1f605ea5d3510f94504ab46b77,186,136,424749,80029,344720,122,110,313393,99931,213462
616cd2aaa882dc9ed5f61b5128eaaf68,38,27,33328,10829,22499,25,24,23053,13721,9332
1d3511dea1ed00eb491a9b2cdf826adc,73,61,89679,27129,62550,57,45,75155,20354,54801
59f25736a95084ac03db373bf4e81aa7,108,77,168316,48843,119473,92,69,156004,35747,120257
e686f79633b2ce1e9d7b8e685c1c72e3,86,62,135148,38242,96906,99,86,218919,38689,180230
18fba681f6c53b0699726df66f197e52,62,49,94893,19698,75195,65,42,73542,19245,54297
b6a33d043551986348746a9c9c61fa94,65,55,108175,42530,65645,79,59,175927,30026,145901
06da8a846114ca13489aaf8f8cea7a71,162,130,617413,153745,463668,172,133,597197,127325,469872
516c601b1f1b4939a2f727cfcf61cfe3,118,87,243921,68948,174973,115,98,306222,74139,232083
dfa1940422270aac86e2c39093de7964,97,73,134488,38863,95625,95,73,145190,40668,104522
ad6b93cd0b1f1c73b052f4e971e13c1d,60,43,79383,24764,54619,69,57,99514,24068,75446
a54a79a9aa86b81ae05406664bacac62,74,62,142898,44279,98619,94,69,207404,52562,154842
a7c705f9481032623a21322fbcfaffdb,203,147,774871,165744,609127,186,128,731638,125156,606482
af61d79a8fea124274192253455f1105,171,117,426346,108104,318242,144,124,466830,103531,363299
cad70aedb43aaee1abb5a6a845bb6680,156,108,327349,69013,258336,137,102,300644,71323,229321
6542e7ce35ff840236f81617b081265d,36,29,24524,9874,14650,27,30,19205,10983,8222
5ada01fe7aab29f783818e355d1b9a14,35,24,24973,11129,13844,36,32,25570,11093,14477
8783be8d7bb50466922ecce1a26ecfc6,209,156,661248,110963,550285,156,114,514463,122836,391627
5abe98d59ce5da50c0b00011836494d0,95,72,149660,44623,105037,72,59,133412,36839,96573
a812ba1ae560eb23aa081b612c3404db,109,80,210555,39511,171044,91,72,187719,48598,139121
6eaa08b2a771cc9da37c8628a79bcd03,4,1,395,108,287,1,4,108,395,-287
4d4d8aa426d0779388f927f5fead4975,128,94,328837,91616,237221,172,121,411744,92912,318832
eac2ea431776dc6e46df5243b6fb0ab7,184,115,749029,113223,635806,139,99,440127,111400,328727
e825335b464aba4f4332c9606fbe269f,22,22,14426,5100,9326,29,17,11780,6196,5584
979a4e0bad2406518c974d5ea9325607,36,24,24164,11328,12836,35,29,37425,10645,26780
97e5f6a20304996fbae6645bf9a92407,44,40,52877,19983,32894,38,29,46222,16629,29593
fcdb4066217f6a9f4a326009b023b35f,43,35,32985,11035,21950,41,30,26732,13316,13416
f3f75f882acd0029d762f78eee441bbf,122,87,187300,51327,135973,107,98,216537,45575,170962
16bc320e3c148be98795687c19b84ef9,126,97,292369,64041,228328,99,80,231462,100209,131253
a0f4bdb43be49a040cbf2c8743aebe88,99,79,253677,82085,171592,101,74,251971,66320,185651
bbc6b8c41c02fef424d07675a0c9c475,90,71,244722,105977,138745,150,101,367573,88539,279034
c4f3cddfe78d8c5e5685f2d6d7389c27,69,71,147486,37729,109757,85,55,145386,36209,109177
ff1d2abb1e46aa252667d71437daadb2,55,34,39092,9911,29181,38,27,37750,10597,27153
e9414bb0ba250060e34f32a743b3e83b,85,76,135019,38664,96355,59,54,83147,46911,36236
a61928b8e0f89fc72958e28a4193e22a,53,45,63771,29016,34755,71,55,120532,24523,96009
3923f161c73dfeaf48ad1a1f110f23dd,24,17,16708,5467,11241,21,18,11781,5780,6001
e5e5995b2a6e009e10ddaf861c608f1e,49,35,46822,14799,32023,42,34,33931,15134,18797
4595fddfba1701b0eebb38eec6e2fd08,26,26,21949,10401,11548,35,29,24807,8568,16239
0da1ef3f77536517beadcc9773b86dab,79,68,131527,30759,100768,48,44,62535,36071,26464
18f9b23819c9349fbe1f991b53f61741,103,81,217142,58460,158682,152,117,293362,51514,241848
b48fc5f0169edfc7ebb42fb6bc150eae,103,80,246558,49407,197151,66,51,131352,51700,79652
9794f938e5fb3da55cfd6299fed02e62,226,157,1236901,191154,1045747,186,146,1560289,199000,1361289
afadc74e0faac392e5cde1b8e3884abf,77,74,118678,42683,75995,72,59,121870,27297,94573
aaa6c4ac9437a4aa01a701438fdde259,53,43,45888,19368,26520,36,34,36479,12988,23491
b109385e63b27ce174e774dfe767d5d7,73,55,107147,49472,57675,97,80,172734,48953,123781
f234240cc8d4a3bc54230d062de16ec8,48,40,39078,14350,24728,39,29,37664,10262,27402
bbf8facaeb0fcdf9acf9fa73703935ac,74,66,90863,43555,47308,65,46,117927,26989,90938
f17972920a7fe16eb9df84a61e66c7c1,29,25,16065,8741,7324,30,21,18292,6105,12187
a8647266b1a40384e50d090e7c2e2ee2,155,103,297482,73743,223739,151,97,260005,60918,199087
d020af1563ca7036397e9075bad27616,78,55,124532,18629,105903,57,42,66380,22713,43667
22b28b9a5f60b711ee5f68694d9d1f35,180,149,577596,147357,430239,146,115,454247,108639,345608
bb920cadae38f01beff1d9084194bedd,94,71,163938,38290,125648,99,69,155557,36286,119271
580e653661589c98588ba801d89ff0a2,75,55,109462,65211,44251,114,77,217085,38835,178250
32f202b700a17df40f208dd299a5cd8c,135,128,275729,80897,194832,127,104,258295,55602,202693
fb15f8407d4c7c71ac3f3f29054c912e,40,33,40704,16793,23911,51,38,36847,14542,22305
9108350da51d76b102f22e81f41a840e,101,84,180849,67350,113499,142,94,240451,75159,165292
74ec2bf53150f1ec42077a571de266ec,62,44,102455,30901,71554,73,56,123829,27728,96101
94932d13e01afc521a286a24f885e6b4,45,37,60718,20351,40367,41,37,50685,19110,31575
b759b6ea5005d0f5a7b01575ec022347,58,49,103366,40622,62744,78,71,126322,36734,89588
b5a939d6dd69d9ca553226c06201c9a2,90,66,147601,33474,114127,102,98,178836,38800,140036
70fe3572e52ecf30865a83297ffc1017,128,95,454260,133556,320704,173,133,482704,131268,351436
0bb86c5c4630c6336e9a4506a70d563e,175,130,675043,153576,521467,163,112,536319,171268,365051
175b622295aaa084d9ec8386a339da5c,119,100,290059,98575,191484,136,95,305476,80760,224716
7ca6be92c7310b89a727fa6ec14d6c99,64,56,86646,29781,56865,74,60,90551,23399,67152
0e34d61c9af4ebc42a334e082dda23d6,77,51,159301,35889,123412,79,48,101301,33126,68175
9bf6227b6616b9c0ab02bc08ae68d967,95,75,210049,52719,157330,117,97,298872,50453,248419
dcfcafa369c5e79961fe048b2f949bd0,84,56,135546,28261,107285,89,57,131965,36995,94970
8e2ac9f8f4c708dd087e75387eb232fe,27,23,16617,6967,9650,26,19,10876,4126,6750
f48fcf66eb00985669e8333c67b45e8a,41,29,30776,8647,22129,36,23,38260,7240,31020
154af91747a4cd6ec7ef074ff81ac5b8,123,93,272381,72493,199888,153,110,380899,55325,325574
5facd0bbc007bceac948e756cde6de30,145,103,353399,65987,287412,135,112,335695,51697,283998
0fc2f924513ce65c3e4d20f216c09b38,47,41,88314,21310,67004,72,63,104279,24633,79646
2829f23f212f0e788b10e8e277add1e0,45,38,39624,21116,18508,56,39,61462,20329,41133
d48ed2cfd36e4112f0ac956e77f15086,123,93,321263,77559,243704,162,129,581467,111517,469950
389a8d285a17807dd253921871ebb3bf,38,32,29847,13645,16202,41,29,36734,13698,23036
b5ad97320ba5647745f66dddcf2e556b,123,83,288570,78263,210307,148,102,341019,123859,217160
a0601986a352094dddcf50dfaf6e848a,48,36,65553,13718,51835,41,30,36246,14298,21948
af37e5e0819541c8384f74383c4e100e,17,17,4361,1796,2565,17,17,3157,2987,170
a74db74f8ee8689dd72ea4dc5329506e,148,128,584956,98741,486215,145,121,568734,98336,470398
64695d3f2b336e01490fd629a8a0f9ae,82,62,136221,37227,98994,104,92,181750,47082,134668
533b6c3cc28bb5cbeb1ca1afd9b70cda,188,146,760206,116113,644093,219,173,1003185,117949,885236
c6fa1c44aca92448b297c687c6c9bf57,28,24,21853,7664,14189,33,24,14527,8528,5999
945c45691034db893629d00e9dd04b7f,186,129,1260681,242884,1017797,225,174,1159085,266044,893041
3b2a26d058272740d8a6e2f66667870e,43,37,54661,23835,30826,39,34,44837,21517,23320
4c9cd15a2f1f78ad3fd6aa1bfbcb43e9,81,60,81479,33012,48467,81,55,125434,19783,105651
1992a9393b69ad3bdefa83a2436ddc85,138,102,269603,47162,222441,114,97,186555,50652,135903
71de94c1b884e651eea08f174f535c0e,144,98,417247,64537,352710,143,124,435173,80511,354662
160a296687f71be5fd223f5e7eb0233f,67,53,101764,39763,62001,105,83,180208,40987,139221
d410c0772be2e985e2154bf9750f87e2,16,11,6457,2483,3974,21,19,10003,3529,6474
dad689e8d4ce725b36b72a5c4ba1a52b,91,73,154236,46409,107827,85,61,151734,38921,112813
b69be41b44f1d6c511dd03254f8442c0,71,52,107799,19041,88758,80,66,154844,32868,121976
b8e273d1cd3af96b313c879c20bcf0ec,21,14,6493,3169,3324,17,17,6047,3327,2720
d5daf7ec9be30f988cadaba0f12c52f0,204,161,696368,161868,534500,174,120,577942,117672,460270
4a643837bed588f212323639d6cccaa6,157,111,391169,94990,296179,157,116,370582,87577,283005
458e31555870fbaff5e706ecec6f3c5b,95,83,214091,57618,156473,100,80,233884,51151,182733
3688faa02ada5a9d19135faac7d24914,43,32,55389,15904,39485,32,28,33489,20594,12895
4f9c38f65af32daf49c05c4c26cc0a95,114,99,296408,52616,243792,114,106,228983,62964,166019
1bb5d92420d2444bc2592b511da997df,96,61,151318,40958,110360,81,59,126232,36840,89392
d8537078d48101e8c3bfd1f2e96d67b0,29,26,11567,4250,7317,27,21,9746,4636,5110
fec16df30a839504143ce8435387f939,88,66,226305,89584,136721,198,122,473425,74694,398731
bf031ede39ef422a7b92d39d02c6e69e,87,61,119341,27953,91388,87,68,132861,32989,99872
177575378b24313c615a8e4ead23b050,49,28,44132,10813,33319,33,26,31450,11958,19492
79f60ff7c6afdc9a4d7c68574f6485da,240,141,594672,120824,473848,170,114,423347,85209,338138
22c861a9a211b7f1fe08f41cafdbf08e,151,116,450290,99334,350956,140,105,350653,97623,253030
68acf9814945b0c9bf216ab7cbba3572,126,112,238660,46533,192127,119,90,216361,52006,164355
bfc823fbe5161e13484f8b12b555c960,129,118,365078,104970,260108,120,99,328243,107755,220488
ffdbfb76e55a8a2b4fe4af951310c5ab,38,33,35705,20617,15088,40,37,57153,18028,39125
c9fd5c8f61d8d542a0432ae31d1ad137,145,104,444027,88118,355909,122,105,320753,85098,235655
f7648be957c9701ddd78bffd57f48cb6,77,54,122511,30619,91892,43,41,43662,34268,9394
e0de4ffbca94a289f20c80b175bd5da9,75,57,114076,19906,94170,61,48,115868,20910,94958
7287a654a7aa4077242b15a3f3ac66f1,127,95,313639,84550,229089,148,96,305792,70809,234983
58d57be580466db52dd7f24d3dcdab48,27,27,14792,6758,8034,20,17,8687,5180,3507
e6ec91b177f93c6c4472137fdce38d20,60,38,40937,14264,26673,50,45,61840,18024,43816
77ab8a6bd0e1261960c358ff5c31b691,104,84,308552,76298,232254,123,109,352603,78836,273767
2278f66492240112c48738169c433175,96,73,208467,79365,129102,124,106,285566,70618,214948
09707cbdb6a9e1fec4708d8db7b47738,36,25,35976,13741,22235,30,26,32403,14183,18220
75413de6d630af60839bb4c33bbf1f25,124,95,201902,58618,143284,129,106,303485,62208,241277
c896b06faaf899d99d0ebf3bc8afee29,117,106,355086,93607,261479,87,56,256644,72467,184177
884dbbfde917468d81dbca55f227e4b6,212,148,610704,117219,493485,168,108,501141,156092,345049
b845cc8ccd253199aa5ab85501160b92,86,71,141745,26626,115119,96,73,155001,27868,127133
a26731f7aa131fd45331cb57b00e2348,113,84,217777,50808,166969,107,101,217438,60472,156966
ff7656aabecc6974d0ca9179ff952447,65,55,56413,28206,28207,92,76,133388,20426,112962
ae12d62801b3c8fe4c8b7ff672c19f65,119,69,265324,76238,189086,142,117,310123,72756,237367
c0e3447307f80cfd7a0a0cc35d6e440f,76,59,138210,45718,92492,81,53,138370,52274,86096
b84d857f280e97311e7c32822a5f6a4b,136,101,325154,79128,246026,140,103,566301,79981,486320
fe66fa49a638968012b7bd6f5a492899,109,80,185071,53568,131503,79,54,192206,49255,142951
98973a0e6b212f677c5f27008d876cd1,191,139,561556,127610,433946,149,114,519262,128961,390301
a51c2acd4094ffdc3dc3782af6708ad9,55,48,91668,38652,53016,54,42,110108,39493,70615
07da6ba4d8e2310341f93ba9fce74b11,82,59,165558,35678,129880,87,62,125934,36597,89337
234cba1b82a1782ca7de2e136e2312f2,47,38,38606,15408,23198,43,40,34695,17385,17310
5f7cc9c2e27b9e6b1f0fb71d02387141,39,29,39815,9549,30266,38,29,25345,13506,11839
ed44db1dd35240a9592d77c74bc2fbd8,108,90,230149,56534,173615,170,128,298279,70405,227874
afa676b3b882f691ce9919c05987b14b,161,116,385237,97599,287638,145,120,423990,97760,326230
de1e4eb0f11805ad8c16bc802eb877b4,58,44,54089,24372,29717,47,34,56340,18617,37723
34505a6bb195ce10557c833cc1bda23e,135,109,250382,61874,188508,158,114,322516,43654,278862
18ef2f342c355fc7d74caf2b3854d3ad,59,41,104171,23958,80213,52,47,69576,20712,48864
8a5bf659f9dc9461ac1cca5a3623099d,98,87,255379,86278,169101,146,108,318079,67648,250431
bb80195a255d7281616d1e6914ee9e52,31,22,12689,6357,6332,29,25,16714,6065,10649
57b39905e54e6abffdff06fe04ae8094,99,80,189023,52021,137002,110,89,186317,52385,133932
2ab62ee5b814d1edd0b02e28cc0af362,64,57,119382,17504,101878,60,45,107411,20321,87090
45b156e0bfd1027e85a8d1549e400305,152,113,359690,48045,311645,131,104,262379,71233,191146
acbfa692f604cfe3aa81cd400b498ba0,92,84,174683,40515,134168,107,65,168749,34167,134582
d8b932b95fd73f9bc52b73ed73eb944a,165,128,552213,97272,454941,211,142,777689,78209,699480
d172aaafa2354f07a8811500cca33990,90,56,122695,26610,96085,73,50,70552,30211,40341
027b5c4d159bd73f312b35d1c6002007,110,93,147526,60397,87129,129,102,252754,49630,203124
1d87c45498100a3ca34b2fd1d30b51a4,49,45,82680,33833,48847,47,35,71231,27936,43295
76527120719ca9961637bce82c1af30a,51,32,63068,27887,35181,72,68,104431,31067,73364
eb1d93126936575989c5c2832c8cd720,84,68,149607,50231,99376,96,74,169226,45381,123845
d4580106e89913f2a4c98e860a38e0c8,143,110,414048,87067,326981,66,54,166376,95306,71070
feda8e8aea4f6a9f2ed29e1ad2920783,21,18,5854,3157,2697,20,18,5448,2519,2929
481dff0f39a205cc4e1dd0bdd4099e89,68,44,113902,44446,69456,109,96,223240,42983,180257
5a741945c937daaf31208dde414e6a8a,42,34,42350,12639,29711,39,27,37117,12413,24704
18f6782254fbd6fd51907a371368a4a5,141,112,337532,65679,271853,85,75,152663,79957,72706
87dfbeb46ac5afcfe79c9fb6bbd895a8,139,109,382954,84495,298459,146,102,327647,99095,228552
00236ce944ca539da3a539ec5d694afe,56,48,62745,21451,41294,60,49,90635,17350,73285
317594801854912d7ec6af6c6fd9f3e7,119,81,227723,59338,168385,89,64,182185,51102,131083
a8d8058f211843d71721ac047f5a9002,53,40,40617,24194,16423,53,38,50086,18562,31524
50ce9e38e9f732cf343c08beab58ccae,167,126,382133,108376,273757,143,115,380465,100121,280344
7d05ff0488605dcf916f575e6a5b9301,43,37,52633,15081,37552,48,38,46400,14614,31786
bdfdf7cbc5d465acb9a6fa3088a9cbee,67,52,85279,24845,60434,87,68,97785,30472,67313
6f26e1640c23fe89807d398441ec3ef1,113,96,233116,64456,168660,149,133,383826,86177,297649
e87d631f093331cabebc5b4453555474,43,36,49717,12459,37258,44,33,27766,9849,17917
2cd5415ee6d18f450cff5b03adac055a,86,64,109327,44864,64463,90,60,123603,23345,100258
eb34cd98ff8009e430c5a3f40ca3617a,14,11,2342,1191,1151,11,9,1904,1519,385
c42dcffb66e8aeb5098690d8f1811a25,158,112,389839,106430,283409,110,100,374768,106533,268235
b2eb60e726c9b95eadeef6a84813e738,163,123,456709,94592,362117,184,139,577265,71233,506032
3cb8cfbc0d7c6049cdf5f5377189a6cb,139,90,274574,67961,206613,94,78,221184,88492,132692
8af0dc9e6497df0e2a0bdfa607ca2145,32,25,12775,4692,8083,26,23,11207,4710,6497
cda912e7085cbc9a43713a8cbaa88651,79,62,163143,33857,129286,73,63,148244,51595,96649
01145c53c776eaf79d877c20a0689b2e,24,19,13660,6585,7075,22,19,13348,6154,7194
5e152ea0a434708c2586c50ec4c343c5,11,6,1917,788,1129,7,6,1139,1047,92
b55dc7d19bfbbb647555544dfa769ce8,81,61,131160,38162,92998,81,62,109303,39152,70151
2353c254164f2da4ceed5f788c27f99c,113,89,286738,94762,191976,125,79,275930,89377,186553
f4fc8a5e63fc807186ee5e9b6f520c29,157,122,795140,234106,561034,234,169,1084621,205027,879594
003c5eedc6994cf1ea167834718e969c,179,139,674412,91511,582901,224,145,628834,130779,498055
a5cf3e3216df0c6c4a769e728bf3a24f,43,29,24354,9037,15317,57,38,50153,8386,41767
54c550309d6cd096846ad56901b7b501,64,44,95815,22014,73801,62,48,87613,22844,64769
b36a521f5a75a37dcc7fe4da65f78ae5,153,116,601753,123627,478126,205,161,757305,132209,625096
d7d27369f86c4c26561b2fcd59aab375,68,56,131786,48573,83213,124,93,251936,45173,206763
20e2b1987ae51c3e9b47d9f29556cb47,158,120,369847,64906,304941,142,103,381743,49600,332143
a6e105f7a4e27ff6293af26e0e00a378,105,82,205797,53656,152141,111,97,210103,61239,148864
6e0dae69f3ad6aab43e2936e4e391b04,30,23,22909,10215,12694,39,31,24953,9462,15491
7d8c9341f26242c4167a418369bee941,115,96,247622,58018,189604,108,93,235226,62455,172771
61144833a0c49047ac5d17d63ee278d5,56,42,109242,34776,74466,66,58,104904,46116,58788
6027e9ed84c1eedb33bd95fed7a4e269,116,105,287863,77116,210747,122,93,259210,57366,201844
398a735d2c7cf9e422d8dd23e5dc8f81,174,118,452700,83830,368870,168,114,567672,90891,476781
ebb1b9fb6e582bf89810148aa8bdb9e4,83,67,153993,34114,119879,55,50,83923,37528,46395
9eeac6eba3b99b1fd57d35e9d1ebbf95,129,77,246325,40939,205386,79,70,139091,54901,84190
860b3a2fad58edd2a5bf38ecc2e64f61,131,107,353380,52992,300388,128,109,224962,44915,180047
2b8c71a380dd5d4a5d60938d744a41b2,125,104,355462,134981,220481,141,115,479594,107969,371625
20a6bb7a85b7192d65911c1b12ff50b7,133,109,343592,61396,282196,125,93,314464,57549,256915
10ab264cf649235aa21df670c385e074,112,90,228130,54324,173806,101,84,207997,51592,156405
f48f9a9ca4893f095e09c37b346ddd55,146,114,378466,71864,306602,131,93,267712,91976,175736
59229217c303d44a1e2ff25e1f4a0943,0,0,0,0,0,0,0,0,0,0
f13d9595101795e16458d90002223b39,88,63,201435,40502,160933,67,64,121401,52690,68711
f3dad8d55a41fdea50ec48bbe4793c2c,40,33,46546,15169,31377,38,30,29696,24123,5573
e58a7ac3a9a0e8565d8bf2c79eb7702f,20,17,5064,2077,2987,25,17,4740,2660,2080
519e7d62f199b725e61960853cffb872,61,42,74057,22300,51757,61,53,84395,27969,56426
bea6ec1b254346345905b2fc09cefb82,26,25,19662,8865,10797,31,26,22758,8009,14749
8635baa3408af8a615ca5fc8871c6e97,95,76,108985,26909,82076,86,50,105520,16429,89091
253b25c6826eba9532f0d77af12519ff,44,29,37150,15400,21750,43,32,55320,11367,43953
025dee0a05f5739a5c7063a198688495,155,110,567789,122028,445761,131,98,481025,147006,334019
2fb5bf1901c205f1e51999010852df1a,91,80,172471,115153,57318,138,101,320423,81743,238680
ac40db1c9f7efdf5b40b608ed6c3f07a,45,35,34395,14586,19809,37,32,44087,17296,26791
5451ba274e4c963e64479311d0e2b6ea,36,39,33060,18903,14157,47,35,51011,17593,33418
3cf36d7fae3baf484c61c0cd28a6947d,22,23,36065,9573,26492,21,20,20715,10129,10586
2e6b5ba0639e05d9bd816181268bbf39,8,6,1701,888,813,8,7,1140,1531,-391
fdfa57c7f3d15d497d73d64a57161856,174,128,355777,71617,284160,135,109,256426,85438,170988
7020589acfac244eeca7cad27449e81a,51,46,48726,20761,27965,64,54,51127,18715,32412
0ca0ec7a395443f86b1dc9a44c94d048,70,41,77804,21450,56354,74,49,76133,25790,50343
644a178b6110571e950ddb0711da2630,173,139,354978,116955,238023,160,121,417060,107782,309278
efcfdddc8900d6601a2f8a46d8e2d70f,48,31,53765,10156,43609,37,33,42970,18342,24628
67229f1e8b68b7e3516be5c551db1892,125,105,370892,101144,269748,182,133,447998,96025,351973
db03e21e11f0cd013b0cae0e1926241f,58,48,90091,23639,66452,88,65,113310,12770,100540
9f7bff2471486870de7b339e77249551,103,79,190652,25833,164819,132,115,212371,33722,178649
e3ec37bd3fffbdde8d897a1fb51da7a1,167,140,525037,145367,379670,197,134,544938,121593,423345
e314a065c78a9518e73948f6b221e66a,85,70,137636,43366,94270,93,75,171313,36829,134484
85e7e1e84b26992a00d4c56c5d14d399,103,86,167189,38320,128869,62,51,93713,37378,56335
475c32714429c0f4971e92e32bf52423,153,129,491487,77974,413513,147,125,374102,67623,306479
d3288ae29899c75794ebe5bdfe0e140b,88,74,172339,42445,129894,99,84,203507,34643,168864
7eb03def1c94853f73b5731de27d92ca,34,24,17163,5809,11354,24,20,9009,5665,3344
304522efd40b94968f6c304e2e7655e0,48,32,67284,21686,45598,74,44,99924,22706,77218
e6eb54226c75d2129f3685e912a985a1,55,45,57482,24313,33169,49,36,62168,20848,41320
c25717f5163690af753defab6e5383b2,232,181,1041270,272619,768651,180,136,2031435,170895,1860540
314c70a9adb263c4644034b31564a19c,102,85,153735,45803,107932,107,88,180588,55754,124834
026a1941edc54e74c12597800af3d3e6,30,31,21444,9192,12252,35,22,27683,7945,19738
29a638d6921f8e56279763eee74e92d3,36,32,27718,15128,12590,43,34,43148,15208,27940
06471dbf6ed954b27660045a2db9eb73,62,51,55921,21812,34109,69,46,81248,17588,63660
6d0659cfb0aec8e8d2a8c20697aa6aad,169,92,378464,78429,300035,171,112,459334,87969,371365
14869c382914efa7a09b90b6be4b0e4b,141,95,271975,55992,215983,115,82,180919,66686,114233
dc1b4e657b46d97253301c7e59cef985,16,14,4635,2730,1905,18,12,4664,2635,2029
4f6dfd8b7628f43b32c3231b07d79b5b,142,93,316447,45568,270879,107,81,194245,46239,148006
ab1c7efcb4a0dcbd7bdcdd4791de3b65,175,127,528779,100327,428452,187,98,392327,59051,333276
1bbd94409ee61e9dd4bd41e93a2c36a1,57,42,76307,36690,39617,82,68,107044,31464,75580
ce543263480b7016483ba55e9d49b28b,19,16,4425,2008,2417,15,11,2962,2228,734
a26c279fb860733ebea7b0b498641bff,97,66,114481,45603,68878,108,76,191190,42470,148720
1e793435a0b77faf20cb2e76814b5ce4,9,7,1397,683,714,9,4,1729,849,880
7c39b4a8b13754299fe6da543d896db0,81,71,173966,43887,130079,88,72,199634,40516,159118
0c37901f761e675437dfd7a34ea423b3,135,85,266645,59686,206959,75,62,166501,73668,92833
8e21f0873d0bb4c026c67399bc8560c6,146,107,252999,70129,182870,163,135,378142,60115,318027
95d5d89465deeea7e43b987a5dd8c572,65,62,82181,21543,60638,79,61,96354,22289,74065
01c6871a4a94e821425a557457ef6b16,130,98,351232,104531,246701,151,131,417897,111146,306751
c3c4c6941804e62ef6b6056f519a200d,140,92,326916,77636,249280,94,75,196716,67661,129055
4404ae8946144afdccffb504ed0b9e71,78,53,109291,15954,93337,58,47,84549,25379,59170
29ef4215669d486591788fd04c39b0d6,23,15,11500,2915,8585,25,20,10066,4640,5426
e270c8976df3272b312003b31a4fde94,105,65,218380,60728,157652,129,87,268878,53495,215383
213b8da1ce5722db47c3175aef0bb567,0,0,0,0,0,0,0,0,0,0
64c35d28ed64538756a296ce38658037,144,112,360712,133183,227529,173,110,520673,109613,411060
83441cd170367724f7aeddddf6861b18,32,23,23897,10640,13257,35,29,37200,12061,25139
2e84f54b3b66abbd988baf5731ff9825,97,72,205099,60956,144143,97,65,193383,66294,127089
675279d61349fc508994a3b854805531,60,43,57590,18920,38670,48,39,57435,19984,37451
4fc7475ca60b09c855234344f406edd4,40,37,61463,35211,26252,57,52,80807,29269,51538
ba4709db73516d8a131603a5cbff0e3d,67,57,112619,20836,91783,46,37,85506,20847,64659
a3d9ae69680a3467bd40432c0bbc3e79,127,107,296139,70337,225802,136,94,326115,72268,253847
f98d2403b3850df6ba17e46ce66f6a28,136,119,319464,53905,265559,126,111,263449,68965,194484
50f44ba33d3bde6e971b663516b98c35,54,43,75446,25308,50138,88,72,158018,28140,129878
cf046dae12af49bb5bc68bd9b1714740,160,104,545248,110178,435070,192,118,621471,106351,515120
63bf1b030b01a3dd488b1357dc419297,27,20,14544,6407,8137,32,27,12542,7057,5485
556de8d3219a5f5a760a4bd760fa269a,121,90,314578,103602,210976,111,88,449586,73985,375601
7a2fc50bff4e99de5348635fd5fd54c0,76,50,111413,31273,80140,88,73,125413,40743,84670
df32537a8b1deab5e1104638ebbd8b8b,29,23,13528,7316,6212,23,18,15512,5620,9892
8ce44e39a7d5084d8fbf5af520a8e5cd,158,123,503085,150505,352580,152,115,536381,120411,415970
13985f94b7907a5dfd8e3e90bd47bbae,31,28,14988,6035,8953,31,21,14314,4330,9984
d492fb9175bfe64def7f788e5c5b9755,45,41,71875,24323,47552,65,53,76204,24531,51673
67324f5c62dedc0cff7b53a75695836f,27,22,12102,4188,7914,26,20,10611,5384,5227
90da825b5894dcdf3d64071d2f494b5d,23,17,8400,5441,2959,19,21,9728,3819,5909
14a36760fc5f695bbd1ca57eba6e0f88,11,5,1528,310,1218,10,6,1327,427,900
4db039d61abb700432af0fceeb9ec63b,99,80,219307,44181,175126,110,86,232975,45152,187823
fa2822f42a62ad1c8443d75ac2aa5271,32,25,20906,7067,13839,31,30,18320,9749,8571
74cdb04c5fac86cc0112091304af4cf5,100,70,157444,41033,116411,94,70,138014,50793,87221
f803cc5158bca0b2ab500400dab60b48,83,64,137989,50047,87942,140,118,329553,54425,275128
b554a9522db7a7d15f6fab7f82944cee,77,58,145097,36784,108313,105,85,209415,49559,159856
9b30da9e2666478ef675d1a0ae71f363,29,18,22959,8558,14401,24,24,27225,9153,18072
419cb352027b939f0bc6f56213aeb6f8,109,90,289707,63752,225955,132,101,304503,55999,248504
b5d57b9a6efa89bd850dcc1e83eb18aa,151,115,456086,73415,382671,120,106,349127,124743,224384
daff34383b8b8227c2ad65fc0cd36560,176,133,520113,101237,418876,115,89,352461,114385,238076
d19b818f22da748799ef5d5ea45c482b,34,24,17933,13333,4600,38,28,27635,11004,16631
ce5a52a62066ca418564de0342648ed8,104,87,226784,55641,171143,102,87,179206,51604,127602
4ff58cb683641adc02a1a54792d1031f,139,106,263338,53224,210114,129,97,246395,49133,197262
869aa1d1b515a713d04debed3ae7a16a,51,40,57843,21472,36371,48,36,60072,22241,37831
b0ef92c30ea73f6c3e748df767c0ea9c,110,66,180022,24762,155260,81,74,98774,43390,55384
fbfe3c2191f58ab78182bb82b4554afb,27,19,10926,4521,6405,27,23,9759,6674,3085
bd534c16037db186926cbe95140456ec,172,144,520212,112167,408045,187,135,559933,93053,466880
786921816db4add6807d2583b1602b72,152,112,434757,82304,352453,96,71,233868,61955,171913
bf95df1365179761303fb3a3b25119b3,32,24,13322,6926,6396,32,29,19229,5968,13261
1f1ec22b8b1a439a47af62bf42d2b4a5,101,80,271966,62462,209504,111,87,270349,62360,207989
c64725240decb07b501c3f319ff87de2,53,35,79652,22363,57289,57,34,68247,12329,55918
4ee25929c9e53185e49351e9c57541d3,25,23,18382,4642,13740,19,13,6154,2248,3906
842c2517e9b38ad22ed5305ef5ba3a6a,60,46,62462,23307,39155,65,54,78027,24296,53731
b13e124f60c655c78c1509d3b9fccbf0,30,25,16151,6752,9399,26,18,10977,3861,7116
d4cb1f4e86626ca0200954de62e0e8aa,40,38,71310,23313,47997,62,45,51467,23332,28135
8e6577470a52b57693814598d2c336f8,211,116,621115,124251,496864,178,139,748865,121506,627359
32247d630bdcb611aa741ba0b390bfe0,93,76,184567,64839,119728,114,84,291598,63940,227658
c5bd1db64a5aa8baca8be30a140f6508,76,40,153752,24326,129426,66,53,119748,44667,75081
9fdc2e6cbcac15a924dbb84f255b0b67,27,16,14235,3975,10260,27,21,20199,4497,15702
f4c8e83eee70b1375cfecd2d6f04d456,131,107,336283,71939,264344,113,92,301842,84118,217724
670a7bea1c63aef3a30d79563506b53d,17,8,2957,924,2033,16,11,2829,1813,1016
f924fad0fbbd0424f91c6cad8b5d92af,93,73,198623,39606,159017,59,49,133401,27237,106164
e5d8a3397380c67abc61b6a8ab80c3e6,40,34,28669,9750,18919,39,29,20859,9292,11567
e18486e9132e641638430de13eadbf61,15,18,3047,1551,1496,20,13,3113,1483,1630
fb5059b7f95a827b7fd03704e13e241a,133,101,280907,72863,208044,104,84,227055,68242,158813
7452ed7c9b5a06dc6452d383bd4d551c,159,141,455300,107844,347456,178,126,460144,99930,360214
f65b4b18f69f54cbff3c31cc2596ec0c,54,42,54599,20233,34366,46,37,52719,17912,34807
a65e9dd4226be8a58abacbfca483e28a,34,24,27173,8304,18869,41,24,25399,6516,18883
b9be0ec4fe03bfc27ebdfe8ef9ccb6e2,22,22,18485,11572,6913,29,23,34500,8751,25749
a15ae9cd2aba765c5f9957e2d127d211,93,67,127077,34994,92083,59,48,89958,36936,53022
3606742e5ceb93819df7a8470e75ddb6,29,21,25398,6446,18952,32,22,15528,9060,6468
cb977c4e5fe31582e561c6338355f22b,32,21,20652,4439,16213,37,30,11992,5809,6183
e365b12390f80d827eddac13c97b7e48,91,80,224463,79051,145412,138,119,342007,69693,272314
49f5ea67d257889006f02ecf6a9849f4,59,44,63972,21081,42891,69,56,81753,25354,56399
31838794000108122d615c69cc0ce028,136,91,218473,43728,174745,151,151,301920,90041,211879
ce89174d7705603f3cace338f3a341dc,67,52,81295,24087,57208,66,64,86771,30608,56163
aae104d4766e445a08c8ce2ae84eca16,107,74,171308,52169,119139,99,81,236749,56332,180417
19658e69c9730cb6dc73de960521653d,25,24,28457,9909,18548,26,21,22577,10464,12113
5fad1c10736164c193d681e28a9e1da9,51,41,59139,14073,45066,51,34,42357,17684,24673
deb64b8b084c608bb7f3104a1037de30,131,109,468337,115889,352448,178,139,552011,139529,412482
3773f121c63aab17de5af50ca9d5ac4a,39,36,29025,9912,19113,40,30,32244,10883,21361
24252935c742b794eeb2d22baf928ddc,47,40,64983,20307,44676,52,49,57704,22563,35141
dd3c23ce85163db22826a4977b7d6754,122,114,311139,92660,218479,87,78,258326,59012,199314
1b7a9a37da480992b7ad2312a5a0d1a2,15,10,2955,1922,1033,11,8,2753,2027,726
273606c4c79eab0b9ca110c95434279f,47,37,55888,37151,18737,65,53,113440,25223,88217
844e432db58c0a45e3c4c4d3f663fe86,28,22,22652,6588,16064,27,24,15843,8459,7384
a7962e86dd6edde4c5fbbbb4756b17fd,30,27,21246,9844,11402,38,32,23060,10998,12062
d4b0fdf07b3e6c41e60c158b83253038,5,5,523,306,217,3,3,238,455,-217
209e8ced37bea77d1587131168ffbf90,85,59,91586,55431,36155,76,66,147484,44664,102820
7c5abc6970ae7fb0a6f9a03c42df856c,39,28,27482,9351,18131,33,27,23177,10426,12751
0f92e42b7c2a2fdfdbddf169a50541d2,38,37,34947,17418,17529,55,44,39602,15609,23993
59a3432b25a9ba18e9aa64251a86e4c1,25,16,11437,3519,7918,25,16,10373,3231,7142
a22107af255e516d8fc61e453c658d67,73,50,85792,40096,45696,80,61,124805,31368,93437
2fc26cd3a724378bc9ae5f9be24b1fa4,73,59,136525,29856,106669,56,51,92598,36394,56204
05ab39d435b825d2392c3ec15d4f8ad6,202,166,1019379,186514,832865,189,149,880738,216080,664658
d71ec3cecdfe70871dae2af7776e6cae,55,39,50042,17272,32770,61,38,64442,18222,46220
512301a2a26b4ed8eabaf0bffc4cbae2,24,29,10534,5616,4918,36,19,9203,4155,5048
92d6c1362616c42a84b42b10e830dd73,139,88,271268,46537,224731,160,121,382239,62666,319573
430479749cf297b5077aa14e45ebef3c,183,108,722222,87847,634375,198,126,810527,128504,682023
56830c12549b1f5f9fb754d2bd4568e3,31,26,18497,6037,12460,30,26,14816,5594,9222
2400a4ad7aef808eafb7af0a856d21c1,132,81,251755,70184,181571,186,128,392957,75131,317826
772b4ec4a0333beb3c56aeffb8ea529c,93,77,181070,42944,138126,110,94,203776,51181,152595
98059bfb784a4f9bf3d01351e3a5f92d,120,77,196324,66340,129984,143,103,202700,56545,146155
f518cd00d847f2d2908137b09ba65b4e,12,9,1369,2215,-846,18,9,3783,640,3143
147a11659cd97569ebfa30a0b332113a,34,28,28618,10531,18087,40,31,38709,9523,29186
1d8a1d1d5d05982d4099afcb16da5736,38,27,28322,12276,16046,44,24,22620,9378,13242
f2c4bd0599cd85643d3f41be7f040945,136,118,277675,61976,215699,146,120,372949,80827,292122
1a9b51c63c0840330e65e961c099b3a7,145,105,302514,63670,238844,139,103,306127,59457,246670
56390131418549d8e202cc603829a8b2,46,40,66819,29928,36891,52,42,91732,26673,65059
dd4c134a51ddf7fdd066afc5ec66b25f,20,21,8286,3708,4578,25,21,9078,3523,5555
8b80a77f8495a19977f97a45c3c739c0,56,41,62888,19379,43509,49,47,63793,24909,38884
462e22e8ee08803b95ef52a571f50304,136,115,382220,69631,312589,129,109,292867,74030,218837
62c76a2c04ccd587482f4bc522714937,88,55,105331,32309,73022,74,63,93499,29963,63536
37146c43b116c762779a6623059dc0c1,153,110,341461,97003,244458,122,101,312629,92345,220284
d6d8df198aa867ccd1afa734f71eeef9,161,121,796996,147593,649403,175,130,792666,157520,635146
9eebfe4f9c26921bcb7ca0c4cd5dc5e2,29,24,14321,5559,8762,30,24,16492,6285,10207
bc1a0165ffea8e8d4aa3fb4a83055c3c,89,75,162613,42145,120468,86,55,168471,38251,130220
c156c8807beab1e5383a7e6706464142,145,109,384971,83573,301398,170,99,414630,62685,351945
e1e27009ea430ad6b9d2300976256f21,68,56,136201,24885,111316,66,45,74330,31265,43065
bedc90f7ee7ebbcef9d51f7ab4873d35,126,118,346092,65128,280964,105,82,264241,86172,178069
9f99b4ad198d6eb7d9257362c9ebc3f3,54,40,110874,23141,87733,40,37,48434,32418,16016
e4182f6e2fd8658ea2b2744c4f960e58,141,115,520627,121681,398946,144,105,577531,93785,483746
b03e4b2cefc515309a0cdb806b5a16e4,134,100,345471,87148,258323,200,138,465623,93245,372378
c8eea93810f015f67ac522d9832b1230,106,76,280038,66926,213112,146,120,361941,63704,298237
ff14668f4945ec900b10802fb666ebd8,154,117,539020,131007,408013,140,118,592102,111596,480506
83d2485c6af46e765bb16c3ed92236d0,133,105,547798,180343,367455,199,155,922582,104884,817698
87889e140e3c4b903623ea28374eeeb3,127,95,240114,36647,203467,90,78,138245,41429,96816
a6d9048b5eabdc7ce416ba07a3777ee1,142,110,416727,91634,325093,147,129,456164,83773,372391
788adce87ef2d82acee2a7073146dc42,176,103,295901,40095,255806,85,61,199902,48855,151047
b683072954ae491cb3c8d53fb79d3d47,28,22,21262,8312,12950,28,22,17835,10905,6930
6a4db54a583801492c2d627366df48d0,113,74,204009,75514,128495,121,97,292005,70099,221906
a2271f89db8cb4636b1f1c0876fc16ea,182,129,656494,149705,506789,168,97,663836,126073,537763
826edbd518e1557d587caf5cc20c424b,62,55,79990,35971,44019,91,62,106978,36546,70432
6505284659d19df32e06aaf05c4c48fd,104,78,210161,58591,151570,119,99,273122,78741,194381
d4d02db3c331d2ede1f45c22efced0f6,147,126,374733,101340,273393,133,100,374155,58840,315315
ef76df2e9d25fbfb903bdbf7654438fb,35,27,21319,9958,11361,29,29,18822,8296,10526
f47d12dde01dc6123f66381d6ba8ef43,65,49,73908,37058,36850,87,68,119233,31693,87540
0888549b076e6a44f4e717e003244248,121,109,226671,66740,159931,97,75,206160,55765,150395
6932c1afd8473397c16f000c4e1e630e,25,23,12391,3821,8570,33,23,11509,4772,6737
3aec44a629a65deb26d94ca533840d03,11,10,1890,929,961,13,6,2281,324,1957
1b51b491b6b12f1628d280007f24e541,204,152,712168,215424,496744,139,122,541987,221336,320651
fe7238a8aa2f70afda83dc9af370babf,81,73,99097,50014,49083,78,62,163657,35647,128010
5d258a460fc11a575e2e9d94c262b3e7,64,52,95347,24679,70668,64,51,73281,32825,40456
4a96dcc0bb01d8a715fe260699f6e079,43,34,63417,24887,38530,45,39,60256,29752,30504
5efb1d49052377fbaa3ec6f8c42ae43b,77,77,114329,27261,87068,72,48,73854,17853,56001
c4e9262cbda08f7463d9b41f6df1f47d,47,39,52921,16671,36250,37,24,39896,17985,21911
0ff605d270752ed2466a59f2107ccb3a,85,64,157862,34218,123644,103,67,181586,34983,146603
f2eb49cef3302dc358233c190396a225,53,37,85635,22632,63003,74,47,72877,21941,50936
ede773ba5ab5b2290b140da2b60b22ef,158,108,503286,128832,374454,150,112,417926,131591,286335
f9ed6cd4bddd70591135132c88577693,57,54,77490,33946,43544,64,52,106538,32759,73779
2d32c33bf8d2a266dfedbb61bdda07ff,53,41,69400,24536,44864,51,43,68377,31129,37248
97efd005e795ed35ac5723d41f6452b0,49,39,66791,30680,36111,55,45,76342,25869,50473
38490c4c12019b65e32eaa341a946e91,47,33,53794,13253,40541,44,35,38557,13724,24833
59d72f9f2606135f4667db69ea4c239f,63,47,95568,20016,75552,82,65,116640,22122,94518
d5228b1be7b2fd692daf070833ff9c74,157,126,783262,131582,651680,169,128,645321,149324,495997
2f57792d4949d3aec169560bafa524fd,48,38,45187,15023,30164,45,33,40358,17685,22673
c8601b23e540a533dd00b8004a25574a,42,35,27001,8348,18653,36,25,26187,3922,22265
fa80adfdf5667969e1a06c5e5212ac2f,87,70,253493,46054,207439,70,54,136245,44062,92183
e7faef46b9862db201a2591eab02c6e5,84,87,224724,53525,171199,127,96,210802,48805,161997
7b59af5e6f8dc729d9bc75a437c0d12a,90,73,131884,40295,91589,82,56,124763,30399,94364
d8ec364591437aa904f194ffbb5ac3e4,118,102,270373,61139,209234,124,93,285439,64034,221405
5002768bf7dad06537429b74d986cb98,4,3,533,338,195,4,3,405,296,109
b463ac23151879b1c49b1ea9c17cc46d,117,87,177630,46599,131031,129,66,169623,36004,133619
c128729ebf08f0e80ed1fb5827b4b293,197,147,817889,142687,675202,168,120,610675,154054,456621
5dd9335d36303cf05ce16e21c56432e4,79,58,147362,60965,86397,118,87,246318,42020,204298
fdbf1a436376016b51e5aee65493f338,176,132,618184,146833,471351,158,129,861216,98212,763004
812aef8c44d5eb1ce11feea7a2050a12,88,80,135985,45532,90453,87,79,142709,50070,92639
c13fa330613a68926ac211a7489deed2,91,86,223650,73308,150342,126,74,231619,47900,183719
d040c5f20ac038fa82c8a97af3f8d23a,186,146,735326,166220,569106,154,111,664624,140304,524320
dc1e3e4fd50e77f93d5c58445cecec14,155,111,427579,104682,322897,140,107,479238,83333,395905
c67eb78dd0928ea36c33ba66c9513b2c,92,76,212944,43231,169713,109,81,163935,44760,119175
1d87e4049063ddaad465b4905f0f7787,81,70,108728,32239,76489,92,80,141276,39129,102147
4cf7280e94fc9e0cb1a886c2120a8c27,144,108,453466,102161,351305,188,137,620286,79073,541213
20187cc37907d72f3393c85b69380e64,79,61,175719,82289,93430,126,121,325428,88699,236729
490c4fd532c4eea284260303bc12ef9a,91,71,187853,39347,148506,108,87,184297,40292,144005
24784a921cd66c3cef13779d814585cd,50,36,59646,21536,38110,44,33,53762,18210,35552
b82d0e0189b4a31ffcf7801bc50689d4,166,106,454178,71903,382275,93,84,219342,71612,147730
00b0a2933a5ac712dfbab708d6e76358,167,131,544809,111809,433000,160,127,547423,88451,458972
498caac1274fa7b82b4271295f3ff0b1,138,104,511055,69185,441870,199,159,736755,97498,639257
7095eebf67c23d38dda480a239c2bf12,100,78,227683,50589,177094,114,99,260966,60278,200688
e37caccc3124ab50d1623e3381775ab3,50,36,67385,15169,52216,42,37,37972,24200,13772
dbb9ea8b5a0d1aef2f391a97ad5a1e2f,49,27,39328,10164,29164,38,30,30221,12584,17637
81b5605c13029a46a1a341992eb05be4,24,20,11020,4212,6808,24,18,12987,4079,8908
cf01090b80856066ca6f42eb5a01bf17,27,20,17198,6798,10400,26,19,14136,6245,7891
de10f8be38fd15ea028b8ad0dc507c09,44,27,33779,11710,22069,40,33,29309,11531,17778
18f4635b727f029718bfdf958bcd19d3,22,21,10325,4642,5683,23,20,8572,5400,3172
906d55f69dd0cac5a38ff7ed994dcc01,157,112,281456,55499,225957,129,81,221190,58971,162219
b53b69125c7fef99f948c03038d395ba,12,8,2440,1863,577,16,14,5446,1687,3759
586d26e5d11c1ea59aefdff6baae258d,42,34,44559,14116,30443,41,29,38853,15911,22942
7a1690f82bc468076207e7d3bf65d5ba,17,17,8095,5695,2400,24,21,10719,4221,6498
fdbaa184c5dd5959f1e2f7dabf4ec0d2,18,16,4862,1805,3057,20,14,4747,2738,2009
0f0f446a53a011efee4e493741662db9,97,75,169988,41506,128482,93,77,153084,39956,113128
85aac38960ef714f14887afb2c1933ea,55,47,91290,20507,70783,57,47,75376,21107,54269
38302f8a04ab7c63104ead5dad33c8ed,140,97,304141,74453,229688,145,117,359943,56978,302965
19f0619cdc98b5af4147e615471b7cdb,77,61,118907,36999,81908,83,50,122912,28492,94420
5d7817bf7d951bb10e903458ff07f714,132,96,231037,58391,172646,100,68,213078,74874,138204
e9dec2c7cc17b29238c1ca6e999ee641,58,46,100062,28079,71983,58,60,105419,34459,70960
2c816e56aadbbbc831b84baafd6ca4b9,71,47,84780,22244,62536,68,55,85880,24010,61870
ad21a37c9cc72de6db933ec0293a4bc1,87,55,223971,55436,168535,98,75,264882,73204,191678
8727ee6afa684fdbcffc34450b777117,74,43,81115,22834,58281,58,51,85273,29905,55368
b55775e27fb065539221b50646c0d710,148,116,576425,103011,473414,151,86,510176,110465,399711
606e13b06227cfb64f9254da5c71d5b6,107,88,331774,85477,246297,128,104,310878,108469,202409
58164b702e25a50e956b426ac28f546b,120,103,202033,69262,132771,113,85,246576,69861,176715
6f83759ef8366bd9b3ef2c988a49e6af,38,27,20385,13993,6392,43,39,38680,10449,28231
2d0eda42bd7b34043eade0a97fe87145,154,97,404930,118729,286201,135,77,401016,109936,291080
e6c345d375e5386816b53bd6c8902559,75,53,117159,23785,93374,105,91,144045,48908,95137
abeae7273cfdb69c25bbd406510c2d03,97,87,172825,38762,134063,64,57,143507,46013,97494
ebaec1d8a7046e7a6b4e196580d92cd9,51,39,71357,19934,51423,63,54,76465,23439,53026
02d070cef018db5182606a04b24dcef3,130,107,420526,67134,353392,184,143,431668,98543,333125
a0edbc1b5548906fb939ebf1143f1f28,123,109,238488,59913,178575,125,120,245622,78362,167260
f5675ed5933f4999fca8e71b391a990b,46,36,36222,12491,23731,52,46,56144,20291,35853
cc4c56b4654a7196769c963d52a43e7f,116,88,298139,45104,253035,99,81,221051,55398,165653
bf9ee5b1ac3d832c4dd1c807a7d8d2c7,29,17,15454,6175,9279,26,24,16312,7640,8672
a1c6d2ea257eee6df7b487c8de28ffa5,121,110,347078,86652,260426,126,93,267338,43935,223403
bd18c15090b4149c3c2d52d39d3f757f,43,35,58823,20906,37917,54,33,57818,17506,40312
311db6c6b41fc8663027ee7285b4a8f4,57,47,63716,21734,41982,48,35,72978,17089,55889
e846db3b073a904bbb70cd141e78553b,56,47,74014,22270,51744,51,48,51434,25326,26108
5b9b3102770de9801bff85be8b1259c0,64,57,80351,28296,52055,74,51,83104,20336,62768
98743680229ceef84ed2fe659fdb19c3,101,90,230864,70257,160607,109,75,211186,46661,164525
e6a410874b005a516e22cd4caa858948,111,83,264353,72734,191619,115,102,242606,63242,179364
7ec1f0c2f24a34cb8d2f6656a4529c93,27,19,9823,4923,4900,25,24,15988,5564,10424
53ce397aba73880ae8f2190e62a96961,65,47,80030,35471,44559,79,72,129609,37101,92508
245bbf7d68de72ddaf81ab587fb97ff3,161,104,423372,100580,322792,139,114,481057,107006,374051
28ec8571eed4c2199db070e7a72872ca,69,43,78450,26057,52393,68,50,96664,26004,70660
348ad4b553f20f5c2648c03f4b76bf4c,2,0,134,0,134,0,1,0,74,-74
da2ed011663630f784e7b85c1cc090ab,37,35,36390,16367,20023,49,46,48809,20681,28128
e3ac49d8c37a0086fea2e6f7ddd5106c,154,113,632626,194262,438364,143,120,600070,184121,415949
f84d5b330d123d8f3a717b7103a73ddd,38,25,24349,12522,11827,37,29,41117,11711,29406
108fb199ac4c2532f5b555d4ec90a6a6,98,71,182060,34433,147627,104,86,215080,36311,178769
7e08e01bbd14a69ccf892410c5a526da,75,65,144815,49495,95320,87,74,189511,49412,140099
57f09e6a55769b58ca9f5db56ebb15b2,130,108,418495,134966,283529,180,152,692706,124827,567879
c1620295fa9793d1378712cbe6f60238,138,99,427443,96324,331119,163,123,520019,84673,435346
94769b91ab2fea77d324e8ee099329ea,70,58,155412,37459,117953,67,42,104981,25696,79285
f339284d7b2a4454a8aeb4a05b9053d5,158,118,612449,134798,477651,201,154,663380,149381,513999
29def4985486c099fd2eedee7852ec42,200,144,834016,178089,655927,212,131,961685,148981,812704
22cc494097aa562edc8cfb3ca19cb69f,38,30,70181,18176,52005,43,35,64180,21025,43155
3c3cc7d7a0de266cb4b253dca0301db8,163,118,478346,137007,341339,176,140,575737,99277,476460
b92b96e5283c4d898a02d8129c79cac9,51,46,46963,30397,16566,89,62,122131,29681,92450
509a7f6aadc4b7ce07db87f409778ae8,69,58,64306,27584,36722,82,71,106530,23507,83023
1349e3ad7f3f0759d79441aa415b2f8e,57,40,89441,24907,64534,70,53,124455,21209,103246
16a3e0ac3349520f97045dc223a432ab,211,154,711917,124778,587139,173,105,504467,90127,414340
7ff0bf955dadf1f5a0a5a9b287a7b98c,100,75,190600,40175,150425,108,88,158233,47203,111030
e06b1b13e64d6064eca261cd06d4f0bc,110,92,173745,47650,126095,90,75,182082,50230,131852
0a479e440fe67ef9866d34d725d2f4b0,36,30,35535,10659,24876,37,28,23481,9759,13722
bd609b15ca02cc87bdd90f8118bdb8d5,125,78,450422,114492,335930,180,138,512459,157520,354939
ebadd9fcc588a3ebc77cc9e3459a952b,38,31,32325,13722,18603,38,26,37686,12214,25472
8122c01306f010277db36c47ac2daac8,149,101,640033,128901,511132,185,151,1041701,144863,896838
87a5474a1db722aadf9b02030473def9,103,82,235428,58283,177145,153,111,358699,61470,297229
95a73abf6a2d57684d8fdb1b866ca18d,10,8,1451,494,957,11,10,1916,651,1265
c31548c76063dcf860b1db614b758df1,29,23,28754,10854,17900,38,35,31931,12543,19388
63750bd80d1f9612eac66e06b3fd2c1d,130,106,335081,61655,273426,119,102,255534,74637,180897
9b63ac75015a24244e6b89268f10282a,160,127,405362,66683,338679,133,105,258072,53026,205046
f412fd73929a0120838e6e7b1f3f93a2,34,27,28946,9736,19210,28,21,23489,6424,17065
8808d7b6e13d783f0f210cfcbbca6367,143,116,358029,72573,285456,144,115,308364,56992,251372
c3b7852b729671d474154d5c9302427d,90,76,266981,37579,229402,123,103,302573,63927,238646
2f437426ecfe6da44f6b04237857587c,55,45,47082,22281,24801,64,49,89725,22133,67592
6b11eda2f3922571fa7e9093ea7cfec5,30,19,22538,4724,17814,21,19,9369,5915,3454
7b075a705e1bd0f5171440410ec5df4a,132,100,354476,115838,238638,138,101,441238,80887,360351
e4c0d156d3aed18c5ec1b8bccb4db396,166,132,530752,135711,395041,121,92,431511,140181,291330
9a56eaf9397b8c40d3e6a24c5dd09732,94,76,154177,36204,117973,76,62,109970,33532,76438
a204282737381f8312726f9fbb7753c1,196,152,847717,175515,672202,194,157,725308,142536,582772
6deae95a194aa299ba9459d4fdb9d914,28,17,8868,3570,5298,25,20,10012,3656,6356
6925926d681f07c57fc3bb0b7b29bcf2,9,6,1010,285,725,7,7,1534,761,773
fb3d431c6fbca9185e643a1f211092c9,106,85,170030,44399,125631,95,80,185332,32571,152761
8c0dc0302c6e4a92c322b6144428c83c,110,85,229964,49004,180960,112,94,218038,61929,156109
b4df2fffba6f356bf0f8dcf47a12e725,45,43,62467,22941,39526,41,26,60199,14317,45882
a5d00186c0913ff66df3cec2cfb0e158,47,39,58651,21166,37485,50,43,64759,23758,41001
c62e10eedccf357ffb34b8a355ecb0f0,86,56,108823,30396,78427,88,71,119093,34845,84248
53de95d40cb1de163aba5a513b4840fd,107,66,246254,68382,177872,117,105,333789,101907,231882
83562a82d0077ee00623d3e5be40d73b,161,128,576833,73834,502999,128,98,312773,75343,237430
a7faf0e47a60ef655b1bbd81666aab57,117,82,291273,86593,204680,145,128,356181,91029,265152
615569057d895240f6e8ed070e2ccbf9,60,45,80273,27877,52396,68,53,75888,20454,55434
3b9b8b78ee20450178e011a2bbb961d5,76,56,151912,44471,107441,73,57,112386,39868,72518
a7bf0096c058a8b8a141a4d57dca7e49,17,16,3617,2098,1519,22,15,4455,1567,2888
60a5cc7d81fbd002423d1391c4b5ee1d,31,28,16706,10826,5880,30,25,19162,6856,12306
57ff0b4110d6774cfc25451b19f55167,67,54,64152,26345,37807,73,61,120934,19662,101272
b8372c2e96e7d2b22d3d0dbf139a591f,43,33,24450,11930,12520,52,32,49313,8524,40789
863048a1c869e2389459ffaf1cc3e554,29,25,44140,14714,29426,54,44,75297,19779,55518
6e3d088c6494dbbaf163289c48bff312,48,40,55421,26382,29039,56,43,63465,20138,43327
d60e89e75e39bc4aca3b169951ab1794,143,132,371174,130195,240979,148,121,373846,63214,310632
305e2ad0ac5a4ebf1435ce63fe9cb187,114,70,179460,53708,125752,116,87,203110,44795,158315
f9531dea4a288534d23783b75d333504,76,59,121456,22198,99258,94,71,110214,35277,74937
45e4c68bd08b64595434ebb222a8440a,70,58,98693,29626,69067,62,43,77886,17619,60267
16165c94da98992829bcedf3e2cbb4a8,120,98,279445,72096,207349,150,95,239380,67607,171773
90fcf539e6cdfedc718149d7608e7d76,141,110,523589,142331,381258,196,148,609110,114653,494457
2ef6915d9a0d435901d95f7a2f788298,173,110,500846,104622,396224,104,82,342663,83984,258679
d42fd20fc67df7be3b17209d42fc8cda,107,86,203818,48060,155758,85,65,167098,54595,112503
1438f5487ea72cdf88e8debad69bd315,98,65,151946,32176,119770,113,87,212798,45632,167166
eda1fc21fa53e4704d0548911c5d3d63,22,16,7104,2762,4342,21,21,5155,3213,1942
c46b73ea749d439ec6fe29b2d7145f35,84,57,132144,34844,97300,91,70,150941,31380,119561
db58e68d35b86fd5d9f402106e2da7f2,29,22,23334,11899,11435,25,25,24184,11299,12885
3c26db1cba1fe6ae0f0376da8d94603b,107,91,254425,43710,210715,147,103,252589,32276,220313
d6298a9cda9078a7fa4feb153a5a3b8c,95,68,148598,44349,104249,90,73,111059,30105,80954
ffd17799ae7e3ec726978925f34dbe66,111,94,315755,68310,247445,140,114,315284,68848,246436
973585c1417d68bb4bf12002130d3b46,44,34,45013,14665,30348,47,40,46287,18587,27700
604e6ffa874b97d3e8348c384b64a33b,92,70,184415,61523,122892,132,104,297090,60773,236317
26d2000c211e06290459466b1273413c,99,83,185687,41821,143866,107,89,173580,48053,125527
768313d3705093ba0eff96ca745b4220,7,5,432,341,91,7,4,731,235,496
1a28b61c3ac6b233a367fad27df872ef,49,31,50552,14216,36336,47,41,47327,20811,26516
0c1a7e624391a703a3b543faa59ba11e,71,59,147973,50538,97435,90,76,178809,47905,130904
72feeb86933dc6c6f5d07695b7080b05,73,66,142094,34343,107751,55,40,90545,32593,57952
db50ed39bffe10e8bbbf435dd8c4967e,117,95,438599,138890,299709,182,119,529571,118774,410797
0230d2f665edb13c8e1cbed704def18f,112,89,206157,43568,162589,102,70,155490,37500,117990
3ee349f6810d8044563d8459e384dbaf,144,99,247852,42060,205792,97,79,199782,53022,146760
451411cd7c4b743d48264e05b29d37d3,43,29,27703,11601,16102,28,30,24154,11462,12692
b417fd2c2eac7e624293a1f2ab9e1b18,18,12,3318,1152,2166,13,13,2160,1702,458
8290db36083799bf82eccc867e752a77,67,51,117063,17601,99462,93,82,133832,25839,107993
7500317256c77d7cfc1dbeca3a828000,101,74,153407,58526,94881,139,83,248807,52080,196727
917be079df8fa7485d69f0a654fd3dd7,63,53,74800,16741,58059,76,60,74016,18942,55074
8dd8b3ad0dc41b7cefd4eb43cb5461eb,58,48,64607,25246,39361,52,41,55950,18031,37919
fc690f7c7171428acd381a4e25c0634a,162,134,490105,83699,406406,153,98,398364,93753,304611
e9416dcb9284fd2c1dc331992dd0a435,48,22,38442,6227,32215,46,39,50989,9649,41340
b59ec39924a77b153a1aa68591addccc,28,22,13642,4428,9214,28,20,11885,5198,6687
214b09c63170abf2acffd66218b0e02b,36,30,32401,18935,13466,44,38,58712,16484,42228
f794837d24d99fb4a2fee13f64a5de23,60,43,67299,19174,48125,64,46,56044,28158,27886
81be87b69c5d36e4a74d57e04db37967,66,60,101949,43740,58209,83,78,193602,34485,159117
3f615dc533cb49f7bbee5272a41816e6,53,49,54421,16152,38269,39,32,30418,18161,12257
ce8d79a614c322a9300e35a60f38983a,172,131,457311,136759,320552,160,106,478271,105045,373226
a82cd82bd4b1020a49bbb3c48162d14f,120,100,245463,45369,200094,127,114,244035,45092,198943
9538f4d746192c0852fc65c7b05a6d5d,57,38,46468,19822,26646,71,52,99504,17959,81545
12104dbebcd1181b6aaa5712c698b585,134,101,259475,29314,230161,70,57,74018,36983,37035
fc4ea348275262ba4dacfab36015ec8c,136,91,324405,58597,265808,134,101,216156,79278,136878
44d498d36f1f27ceb2bf776949e888db,39,33,20239,9768,10471,44,38,23685,10356,13329
5d9430e12bf57ca5cd14ed5b1cc52857,111,72,208370,40922,167448,89,74,179299,44383,134916
d4c8301d5c77a2e469b0bb99bfe82e95,133,97,239555,40329,199226,103,85,151494,40730,110764
76b4ccfba5323947968c593a7f937ffa,165,127,346535,74226,272309,149,112,328734,76964,251770
386c07ef3411ce5b4c70934a2c89ef61,41,33,43593,13330,30263,42,35,37141,16038,21103
631312b6861d5cd4f2da8e8740998dc6,120,87,349642,80327,269315,154,115,353997,107190,246807
df8b838034838473dbb3e3e568ab1e20,89,67,127068,44423,82645,50,40,80284,24063,56221
27a27ea117d5bf6592ce9906b8e6655c,91,76,145377,56155,89222,67,52,138436,51290,87146
d164329130eb68dec4c4fd87131ff463,72,62,150584,55292,95292,63,55,137768,43350,94418
b29008911841fb6754443d0de284b7cd,100,75,201905,43298,158607,94,83,156074,35611,120463
34b49552cbdb7b74af79e6a9d93ac9a2,62,43,60308,22682,37626,61,45,100663,20591,80072
4a14fedabb9e2945480493a3edcc0a7d,210,129,705425,86811,618614,194,135,694231,87689,606542
9171c4c67f8dff1a86ba3ea63ee967ad,163,126,441933,133895,308038,170,134,486373,92025,394348
907f950de6930bcc1694ce781d411a6d,65,57,126226,31099,95127,60,48,103791,42073,61718
15bde1bfd963c14057b8acf3825e8536,26,19,11664,3387,8277,24,17,12216,2481,9735
960baf7ad1a41dc520541c67dafab846,181,133,401759,95566,306193,165,108,441565,91011,350554
dea4febaa47d9f1a2a36cad0b8ca3680,8,4,1119,363,756,2,6,590,364,226
49861e4b263f130f6fd8b0682030a53c,168,158,489816,98261,391555,129,109,307916,77945,229971
bc9f1cc797c6875e27fe38e9829a8bda,37,33,30135,9985,20150,38,35,30145,11597,18548
fe4364b28448c357d8be41c1867f4201,123,103,349906,110131,239775,174,128,407758,102595,305163
a98cb7ee72b0963bc6bd659ff55ab4f5,33,24,27524,8814,18710,35,37,26367,10085,16282
622ce0236cebf7d4517582015929335d,88,57,157577,58977,98600,80,59,163028,66455,96573
39ad81fd104842b87f34de5209b6a3dc,121,102,315908,73123,242785,145,111,361396,66781,294615
297c71317ff763128792d0d293f026d6,193,147,619404,116445,502959,145,115,545341,157923,387418
14404b5e8de37279fd258b703203e3f6,122,81,251370,50139,201231,81,62,147845,52900,94945
612d4a715c44ba26a8a1ea7d40bb0c3c,42,40,36636,18614,18022,54,40,40810,16479,24331
13a62b41b2da5a34480abb6f93d78fb4,100,83,225221,63982,161239,111,78,217201,62717,154484
2fbe57e7167befb5e55825f4548adea3,99,83,226536,72680,153856,136,91,388527,66320,322207
d0d6f539f4b9494376fd90b6eee6017c,29,28,22873,9220,13653,42,29,26624,12337,14287
a7d26b96c766e2f41c38969ac1a4db97,221,154,590205,84409,505796,171,138,498061,85681,412380
8560cdbb9c10b0153874f1ec07edf35d,15,11,6397,2059,4338,19,18,6371,3659,2712
94bf6b38b4447a33a30021efdb98241b,185,138,944930,165772,779158,174,107,562473,128919,433554
382689bb8f4a808d25854bd9dd8d9172,166,97,463308,135261,328047,138,83,390832,120472,270360
f81c0ae89f8e6b55107bdacf5d2cd5a9,170,110,464412,68017,396395,131,109,341519,93690,247829
5dff6f37834416a3d6fc769890217cd0,94,71,180448,63815,116633,103,73,208881,66231,142650
6c2ae0ed99957c3b38f5dd39dff610f2,47,43,41864,19546,22318,42,38,52870,16340,36530
e815a88163f2101654cf09e2ada16212,96,77,205846,42391,163455,61,59,105854,41793,64061
7625c390a6762047d8aff8e4a19d977c,29,26,26577,9519,17058,29,26,18186,11998,6188
231427e6ca5b0c2117ef0e6952b3edaa,195,146,812559,195772,616787,193,136,1007435,154943,852492
1051adb3120e865e866e803835559f6b,41,30,44285,20660,23625,50,38,61314,18034,43280
058d05b0cbf2c21963b61ad6457fc2d7,66,47,93523,29491,64032,57,43,69816,33558,36258
f216a099bcf4b752e49ef753bbc08a63,22,18,10742,5815,4927,23,17,9021,6973,2048
a3708380523fc48eac577eb80c96db28,24,18,13027,5535,7492,23,20,12339,5285,7054
d30cb0e4a32b4b809a121d95664787bd,58,46,63166,17422,45744,43,33,45104,18329,26775
d4143d7a17aa4eafc8eaf7c47c95d802,25,17,9392,5464,3928,24,19,11950,4207,7743
066aa1510286ec8f333aa859cb05b805,56,57,68468,19369,49099,79,67,97332,19492,77840
47c9fe8cd3dffae4145127e491cd347e,61,51,119275,27745,91530,67,50,95248,24374,70874
d778c4a9b238c686e369e474672ddfb4,129,98,351914,88193,263721,161,131,362308,78810,283498
86bab5f78f166405feb3e9195dc8e16f,121,100,388954,108288,280666,184,153,579996,120879,459117
e5c5e651cb812928747e33f1a1db8342,178,147,646137,145638,500499,176,119,660963,115279,545684
35f5578e0097d93f59858a43816e48ee,66,52,152694,26588,126106,53,45,87741,30098,57643
95432bb78ebab4e0a03c3545f15b9404,58,43,72270,25503,46767,62,44,74023,24236,49787
93320d057e6dd973a8cd988d9bfe0b0f,131,95,274064,61251,212813,162,103,390427,54836,335591
59e368107dd9b519250c3e19157fd5ea,138,103,363347,79334,284013,126,94,323962,66578,257384
72b4f2e9bf09b40673b542bc3629afbd,28,22,13477,6551,6926,32,24,12270,7997,4273
fe4bf30ff3583589b573a4d739864599,173,126,641335,152767,488568,166,133,668728,150815,517913
736e588373f764c212b4152f2fe5302a,117,95,253621,57320,196301,81,70,187555,55191,132364
c4cac763dca9d9a2fea9d0990ac35884,27,24,13054,7587,5467,24,22,17476,7987,9489
4d529f86a9685e04945f0060a50227dd,179,132,670283,102227,568056,162,120,670211,102063,568148
2204b5002086350ad8a4e464748dcd3d,131,98,260252,72790,187462,118,74,304078,52007,252071
c82583b36093e90f1e9756e04c59ce59,82,72,243961,87261,156700,143,123,407980,86769,321211
abaaa55bf9a49023df4f4ee0d529c977,81,61,145154,45919,99235,86,73,137214,47076,90138
f67edfe46910f7a212f540cdf0519241,141,88,414083,65210,348873,184,142,599077,116961,482116
cce63e529bfe26de49a0d61d69f63475,75,59,125243,44738,80505,102,79,164644,43567,121077
793d98abef2b9ecdee8029c5a6b40814,35,31,21562,10005,11557,35,28,28318,9276,19042
641f027c8bf732ffeae7e0c550d3639d,112,74,201065,31202,169863,87,69,193963,53152,140811
decda68b95378283b40d75942ac12b16,31,23,11315,4363,6952,27,19,8991,3716,5275
f1e355337e75499f807437f419737a2f,100,87,174114,60167,113947,83,58,119611,65308,54303
085efc0ed5d73f25b132485b70e59786,28,22,11413,7234,4179,25,19,10903,6062,4841
99ea90100fe4a94ba34a2e6603a2e39d,160,136,559972,166751,393221,197,136,775962,94091,681871
81eb00e855770d70eb11ba9b9a58d0e5,95,75,184933,55118,129815,139,113,277081,56961,220120
f40c1272406badb55be50e83a0279737,31,28,21563,12362,9201,30,28,26008,9365,16643
5786a8ca58dc409eadc7eb7e8182e9fb,25,17,5846,2344,3502,19,14,4739,2026,2713
a88a7645be85a4b693cb2a9869422595,104,86,219960,54074,165886,78,60,213612,53365,160247
2b5ac7356d1b73c43dbf03d7144a6726,111,90,162430,56161,106269,90,73,146886,44073,102813
21c3fdc7a2a8142bc8fbbc84d59f85ed,159,118,611690,132504,479186,187,120,746312,134365,611947
e1b296634e3909e6db0ed9332e10981f,91,80,188444,63537,124907,96,65,174714,48165,126549
ec13ee4e419ad64ce1c64018bd62aac6,48,35,68859,21867,46992,48,35,63763,21644,42119
7d3354d87088849e062e2e45db13f202,43,23,37071,11943,25128,42,31,43361,15731,27630
3c1492796871cc206511405d3f3576a0,80,61,201094,83233,117861,114,76,203438,97311,106127
34aa7fa3cd3ffc5a9c634fd6507b9eda,62,45,75035,33904,41131,80,65,122180,34511,87669
f0d1ca9f8359aed322ce695954fb870e,22,18,5882,2006,3876,17,11,5565,1844,3721
d95cda75de757c8e3fb69837b0268ff0,25,20,14520,4281,10239,29,24,10244,5883,4361
4cc595d972d5ecd8883145ea327018bf,169,105,500027,99754,400273,179,137,591558,115099,476459
b55e7727bfcca37ef87402ab8bd9d894,46,28,42753,12891,29862,44,34,35589,12005,23584
78d4d39f65c6483108565db9a4ee4679,5,5,408,182,226,3,3,192,146,46
a98c5ccd3560105a3ee7d7cfa69054e8,78,59,136093,84366,51727,120,81,270268,71433,198835
47d1d5c5ec5d3bed69bbe784f3129d3a,81,67,154454,40524,113930,97,69,165774,29531,136243
88f91eb82f481550585e67774861be66,59,54,93786,46391,47395,66,49,127860,35660,92200
5d94f9dabc40ae9df6c228fc4cbc2f4e,153,125,414157,97769,316388,135,89,315583,67638,247945
1e004b96427b0bfff96793776ea97af8,117,90,261913,61628,200285,109,85,255977,62554,193423
6e771a2033be4208158e11b97265aa7c,133,115,320569,51408,269161,123,95,263080,47213,215867
454f40de6d33fdb11f7c626cd1b2c05e,140,114,374808,62064,312744,106,102,226895,92223,134672
4f0e74f7ef1a2c38a7e76a40dbbcf1e8,114,76,208436,75463,132973,158,98,297860,48959,248901
0b03706c2a9192dddb785c0fdf747b38,160,122,736654,159126,577528,180,158,722723,158638,564085
0c25656595f54e10bb993d525109eb8a,28,20,12846,4875,7971,23,19,9430,6805,2625
43773d49416e6c5bacabf4002ff9f2fa,134,98,336066,89882,246184,160,124,336935,111574,225361
6c0d678448442c291e10e48166b72bcb,109,96,212163,73001,139162,137,123,283007,80387,202620
fcdf279d44810b38689c827f92650451,135,111,326441,106260,220181,80,66,227377,107751,119626
5bbdfc7bf93ddfd6750779634b6315a9,115,93,211912,53387,158525,136,98,291798,48669,243129
ce2cbe89536563acd508d4f4febe103d,2,2,430,296,134,2,1,296,422,-126
5aa4c96c338a10c16623cfe2b2495138,22,20,11293,4415,6878,23,17,8237,5142,3095
aec371969cbb839c1febba4256ac37b7,56,45,55129,20882,34247,55,37,55128,20081,35047
d8b7b7270380da3431aa7bcbed39f747,91,65,144463,49424,95039,113,92,217335,40715,176620
3b6c68c16632529556a8af4bcdcb233f,179,119,696100,146141,549959,195,157,807955,154404,653551
27d71075468c643e8e0df5f2370629e2,133,105,344697,93655,251042,102,76,223006,66335,156671
5bb78482d29340e2c8a367b13c77309a,122,83,227473,48969,178504,94,80,173634,70168,103466
b277022b3fcb6c297c8cf63239a73c38,90,79,134724,37551,97173,134,94,230127,30180,199947
b695716e442553a4151e6b5ca3fbe68e,123,102,210561,43092,167469,102,80,122055,49099,72956
a6552b6cd4c3c783090b3a7379c91e5c,138,114,457813,94599,363214,129,98,378994,79299,299695
37993bb63a01f138bdc29952964252a7,78,61,135679,40046,95633,118,90,159792,31278,128514
b0235853fb9c7949d592670a8b12a728,117,88,218969,46948,172021,107,79,180937,70282,110655
1d78191f23a3a4fc1b2b3641c39eee9d,116,109,333492,114533,218959,89,73,257978,89133,168845
2d00eab6a4b9327672712d99213e0356,38,31,26856,11175,15681,38,29,26907,8197,18710
ac8f6025a3d3a3fc07f4c831c589b9d4,34,29,28833,13207,15626,41,32,37808,13966,23842
e724d8e5fe1237be8d1b22686150bfc9,185,153,920599,248388,672211,208,184,1028416,288483,739933
2696fe6e734cc700393f1d7751af5d0a,142,91,542586,148337,394249,137,93,610535,106302,504233
4f52ce63b3c5c7edf83e946da5ca9fc9,166,109,451031,118770,332261,168,111,546109,121432,424677
07ca93a242e6b347783f8284a39dde1a,27,24,22371,8059,14312,31,21,20507,6847,13660
93d47a1ab1216f510bd651802960f219,41,31,36792,19411,17381,49,43,42389,19890,22499
2a5e3ddd5754a40a59dad88cdd30124a,34,24,35107,13000,22107,30,25,25908,13160,12748
6833d84f02ebfa36b93ebeea9f5cf100,117,101,313956,79752,234204,116,86,282263,73351,208912
152df76f405403e6d4bc7ea3173bb679,86,75,203991,72107,131884,179,143,528417,65863,462554
a600968a52be2f20177da7581ac188a7,151,94,291284,81630,209654,109,88,280636,69703,210933
cd06b8867907902dfefd2c8d1bebfdfe,44,36,53824,18402,35422,67,45,100128,18315,81813
33ab1c9ba8a83bc03eb896fc277bb3a5,143,97,375851,64126,311725,152,117,300313,74308,226005
5737fc9dbe7e43492e0c22a959e20902,36,32,23904,8002,15902,32,24,15085,7881,7204
7776be9d9b877ec4140420f168ba2fe5,40,26,25086,6386,18700,45,42,31404,11253,20151
d342bd43fe600ab39d7ee112a0e0f9e3,116,78,327734,80263,247471,113,94,258012,79145,178867
4aa53a51ea4073a5a61c6854da75df78,78,54,130880,33329,97551,58,62,100188,50959,49229
7db63610ddb936928b4d3d87265364ef,107,95,248580,73341,175239,123,103,335717,68663,267054
d408027eab1e5eba3e20e84e8a0cbd44,100,78,262136,58146,203990,112,96,223564,84768,138796
4bd15e0aa71fdcad3edf3060cd0bddce,93,79,247495,47073,200422,86,67,156585,56513,100072
6aa24dc834e2511b514d45e49fe4ff17,189,122,447995,99497,348498,204,122,447386,125088,322298
b3c7e026bdc40a2a52ca1c261b1e7218,78,61,112880,27749,85131,78,52,101099,26471,74628
333f4a75d1c38b00633008e770d8f3ea,143,121,385496,89238,296258,154,111,314919,86264,228655
e7093dcdfc1cf85280367b4c18134d2d,125,96,214604,61846,152758,128,99,205547,40358,165189
552a01d3a8783be1f3cb87e9315b0a9c,191,143,845185,176853,668332,191,136,727676,166305,561371
6914d77a6ba6e762a4b2adc8d749a790,63,55,89446,25980,63466,51,42,70285,30623,39662
eb9580d898700ca350e958f94e85004f,19,18,5389,3618,1771,21,16,8100,1569,6531
ef34dd42d022970d281a4abaab387e0e,122,94,238213,56189,182024,99,86,196361,84834,111527
19af95f6dc9eecd4131a89fc7f8edd49,40,32,32634,13723,18911,40,32,36240,13729,22511
5c99c3960de099c62c0050aae27d364f,167,145,378325,62128,316197,124,106,242941,74102,168839
cba09aa8a1b72480e7f679991aa2ee27,61,42,93341,19307,74034,67,43,71990,25952,46038
13b0789c7b324c812f4fe531a44d0773,77,64,105225,46341,58884,68,50,142432,26686,115746
a89d7033f2b340da36d9906c0f554393,89,61,269917,86510,183407,123,105,312930,116473,196457
4407ea2cea3003e34def79f4f7849f6f,132,98,218037,33722,184315,111,78,173684,43499,130185
df18d9fc189c44205b31e0858277ed0b,22,16,12736,3544,9192,25,22,10236,4523,5713
b7f1ef7f484918ea3bc63efee49d806c,191,140,1036760,131577,905183,194,125,760707,232242,528465
0d98338c48d688dccbcbd9a30d3ee6a2,129,96,227086,47827,179259,68,55,79248,54211,25037
8f2ddf6ccb08584b8d1b79eafb572162,3,2,1521,1029,492,2,1,1029,178,851
8066260220c66e3b5d4efc599aac8ba7,146,116,531072,108980,422092,143,112,522758,104834,417924
5bce25e2961e45b8523edc0e84c71157,59,48,125006,32309,92697,61,35,97561,20304,77257
48ee04015b810bdde97e6b78ba837d2d,27,20,16814,3670,13144,26,17,11136,3381,7755
25d6b8ec4a5460a10db1696bb029b0cc,174,136,607555,127236,480319,162,156,459011,153791,305220
d67c551196758d00a5b25803e521dcbb,50,34,81311,12505,68806,42,37,47413,18597,28816
42d7ff721f5ffa2b019ac3a20f0983e1,22,22,11551,4734,6817,25,20,11156,5147,6009
5a738b0ead5b95331b9f4e53e2dfb826,15,12,3783,1325,2458,15,15,4651,1580,3071
02b44e68e75ecd3b452dd13d859ea39a,113,84,203797,54818,148979,151,108,316890,61542,255348
06ad33aa67b221beed475ece0c9e4a11,163,117,437147,82924,354223,154,120,616091,114678,501413
a51f1f1a7938b7b965dc3c51bd4e07d9,88,74,146586,39649,106937,95,79,132017,36940,95077
f4a4ac061bed5061ee7d13c6fb043702,53,42,61946,19973,41973,52,40,49365,25843,23522
1f400c553e7fbd3fc8a2f13985ea3da2,94,51,86302,31296,55006,96,51,121041,30940,90101
11380a599b63d3110003412e977f13ee,124,95,268305,53536,214769,113,87,328261,56557,271704
db2249e2a70e3a826c133ebc33180956,137,110,337962,67743,270219,111,86,285171,61516,223655
3da7cf5fc726c48bc7d9b8875498abaa,89,73,228951,75238,153713,131,95,309279,66703,242576
a70b897ef4aa41762791709fe9f9b51d,113,66,185166,35525,149641,92,71,143110,43571,99539
0761ec808781faa374eb9420a3227101,98,87,158040,50537,107503,65,57,104269,36469,67800
06edd30ea085bfdddb6f007413fabe37,105,85,165863,38298,127565,101,78,125249,30136,95113
6dd84096cba3b0874df8c8a8d745006e,157,114,420992,104000,316992,187,120,524014,65178,458836
34af013b57eb7ba7d7a48eaff07b602f,54,40,86894,18461,68433,66,57,82511,33824,48687
cd3a3aec50972291d9ee4dd9e903a622,175,120,584865,148395,436470,140,107,568741,126396,442345
dd799e5d67e69a3496e4550d395fc958,73,57,89698,34901,54797,58,48,96604,41150,55454
cc5a82a6606acc67670d5d8fc0615e11,40,31,33825,12456,21369,42,32,25480,14958,10522
98d238d06750a07901c7785639ce6b99,91,83,130525,49382,81143,100,71,144338,41979,102359
22de1a842541516ea8f7a7d149231fee,39,32,43701,13528,30173,38,25,42973,13934,29039
21fa9c1c9eeb02448e9343678ba6fef7,35,30,40364,11087,29277,44,31,30810,12260,18550
5c161ad2232785c74654e98ba604c87b,208,125,803909,149159,654750,215,128,1109299,140636,968663
f2f9149fa41bfa4d76c08bb5480a23c2,66,43,78097,20152,57945,58,58,83706,39740,43966
15c13edd07b08e2c10831774d7d26c0f,169,104,457781,92199,365582,177,102,508767,87460,421307
0ab9d4729103a3f6100b5ecd92e48754,10,13,1905,1053,852,11,8,3957,383,3574
1963b6809bb8d7a52ce40afcf1831aa8,37,25,29102,5805,23297,42,34,24139,11765,12374
e6216b985613b9f0baed16cc1e6c7ee7,19,14,6047,2309,3738,15,15,3203,3724,-521
62326324f46272ac692882a1a2e66512,32,22,24670,9682,14988,25,21,25557,6762,18795
2313776cdb773a80d00ee4126b74cf8a,96,77,189191,50780,138411,106,88,211055,55505,155550
ffa7f7e165e8b4540a7257d58315c3b6,158,115,419402,87564,331838,172,121,466573,72888,393685
5bc5748766848a1f64bd4d0565fa7fa3,45,34,39372,10646,28726,49,33,44156,11379,32777
185325c83a7413179929affb2ce78d76,154,120,316239,64874,251365,156,124,328745,90621,238124
9daef2b729670cf02f8b0c9b377a6224,116,104,228862,48349,180513,126,109,294542,48838,245704
4f198f89a630ed10578d27b6b510db87,114,94,279340,54684,224656,152,115,348127,64245,283882
2d421a5f603063410c2e7a9365ef9ceb,71,65,130067,46002,84065,57,42,90109,31424,58685
7fd90fb8d7e5138861e03ed478bade2e,138,103,372503,93355,279148,154,95,450402,103155,347247
ebb005fc10606891b107e4d10cbf1218,70,48,120926,34604,86322,71,61,107770,41354,66416
c68f2da0bbc95c6df93bd55fa9845de3,145,111,291728,62005,229723,132,103,262997,74621,188376
6c8f373a36906e48d5cb60cde5d6be80,103,89,248772,51406,197366,161,124,365391,51076,314315
10afc65a412b92a37e91806e1cdd6ed0,119,94,229260,69397,159863,114,88,283395,65977,217418
8403b3906ee146513c7110c548b3d7e9,145,122,361865,63704,298161,156,121,367658,75237,292421
772848f3be61a002a62a1e1dfec14a02,45,39,88814,26879,61935,52,37,82292,27835,54457
c85561d7794956a8965357e8023e221d,142,87,327337,65720,261617,136,112,395858,76342,319516
84bbb1b035dcec64ea73736ec28bb112,184,98,606890,120961,485929,163,124,722876,152028,570848
1e205e6e0b3a54c34a52702f09514fbb,211,128,775770,140138,635632,180,130,600837,146538,454299
e49f83436217f4a7630058361f715f4d,88,69,240485,92219,148266,130,94,363245,111473,251772
adbe3dea27976caa56b6761e3364f187,78,68,126939,38812,88127,102,73,157776,49930,107846
5a89c0cae3d7213751a8906799ee5bf8,28,30,33310,11331,21979,35,30,30355,14922,15433
a3f0e83a3de08ac98e75a5e9abc0d427,41,34,50304,15370,34934,55,50,43016,23664,19352
d5a4ea0a15b76ba09b60ac6d425bee14,41,33,47894,18433,29461,58,47,74169,14705,59464
c3f5fb8e1995e79fa5475262951d4d0f,158,98,407647,77167,330480,124,84,383094,99073,284021
ded37fbd46621545de5161b80aa8b2eb,51,40,64992,31637,33355,70,50,104363,26689,77674
63f0d3f6e3e533ab66cd79b635e32315,100,72,150830,35785,115045,97,84,134017,43867,90150
b91f8c1752caf3ab394e8985d8c4845a,12,9,1483,574,909,10,7,970,735,235
4b3048267afbc57beb322e041ddc6292,36,26,18166,7443,10723,36,31,26506,9927,16579
d0071f77dc28cacb9168af1cdb17c9a8,83,63,153438,29569,123869,77,62,122914,34211,88703
5ff7a7464dc95fe80da969bccde0ccd5,52,50,143208,25375,117833,107,62,201095,21167,179928
e296f4fc9067db8c85fd68a0c1f49c44,132,106,287497,44602,242895,99,77,233279,39018,194261
c56a5a65cda2c439599e8f2b6607739f,83,72,145355,48255,97100,106,81,129915,40167,89748
fdcef5462e34903997398c6f12f4b1ac,32,25,22799,7790,15009,27,22,18506,8446,10060
fe4730c9458d03c296f0079b23459187,254,163,1142012,191205,950807,251,168,1320196,215545,1104651
c10fe29048a4f850db92e7ec7a3dde39,145,96,346039,78660,267379,130,107,346456,80754,265702
39ab19d8abc2785e143d399de0279522,145,108,389911,72155,317756,156,113,336815,97644,239171
8b7f3fd6f07a793929f5db28e85b433c,143,113,434863,112219,322644,103,78,346784,106348,240436
a1e019a623dc4477acb3d3d0ea1d0701,29,25,28666,10825,17841,34,26,24927,9648,15279
3a0941741a2f3c8871a70c560241d40f,67,56,122051,38337,83714,91,70,132327,47525,84802
9fa9551006edd66bcb4f3a484e23dd2b,21,15,5537,2777,2760,21,17,5419,2550,2869
f7ab5fcaa3b750352ef26911ba581e3a,186,163,707198,185562,521636,173,148,612372,226162,386210
bde8c1718b2baf577873f6f155e960fc,79,63,141328,48744,92584,103,78,176466,43310,133156
8a64263bb3d25bda2aa10279d3e98740,134,90,431663,83986,347677,167,130,534026,105346,428680
21a9ef0b715861ad839a5daaf7d96279,76,52,231018,62904,168114,89,68,172603,62374,110229
eb8b3adbf21a61858e64a177a70d25fc,135,115,483649,137765,345884,140,109,393043,98277,294766
29592c6a32656da1d28a81d399a95052,156,109,455865,62165,393700,179,158,571032,89010,482022
0c77bfa3d2c9b4c2c973cc37b355634c,151,100,309237,55183,254054,121,88,263512,66916,196596
c7b9ca67dc9a98e48a131ea2f97c47a9,45,43,68576,18113,50463,45,32,52940,16422,36518
6ef4c8f1110cf7d7a98cebca9fe607de,117,100,305640,81811,223829,141,106,386977,62141,324836
45e68352a83b88057cb75a4ab328e3db,94,64,120073,35468,84605,117,91,173989,33933,140056
7aa5ab094bedb7d8e45993348678348b,63,56,71194,21707,49487,52,31,50366,10465,39901
ef0880b33cf161e8ea05a090f59b7b58,21,11,4915,2663,2252,23,16,6469,2774,3695
5d5cd62a1c2b9637204513c5a743c48c,11,4,1952,818,1134,3,6,2353,1040,1313
919285badab833f75c3465099914453c,99,86,242831,80131,162700,131,97,258238,60125,198113
fdcc69e42029204ff5f0705e3314357a,141,117,506657,94063,412594,130,109,396835,97750,299085
2d199955b9d4f2dd0ab565a04f2056ab,78,63,167807,45515,122292,119,84,269763,45851,223912
dd105628a5877069a33fad84adfda8c3,129,93,468038,129016,339022,207,169,666198,147133,519065
1a611fd35194f91dd1e7139f7ec37407,58,44,74707,24729,49978,65,48,98335,24767,73568
b8ac1e7de8feb7906483def71b29f753,37,31,17005,9781,7224,35,38,23152,8955,14197
3469574d7dcf59b0bf8a17611242495e,63,32,50052,12509,37543,53,36,45860,11604,34256
b06f23a6ab424cc367b7d96b31b4acfd,55,43,87386,30033,57353,50,40,64523,21302,43221
840c5d34cffadb457f646b1aff6241f8,114,86,213025,59826,153199,106,71,254374,55733,198641
facf1036abb166e3f9d6016cc5a33fdf,129,99,239407,62576,176831,108,75,224270,54283,169987
0f3b7af935b838695a8e0ef32e0e7d47,184,147,856240,254524,601716,202,138,939721,169868,769853
90307d15c4c3e1d848c136dc70c97525,72,58,111461,30068,81393,99,84,194724,37306,157418
aa50e35fb0b2dee2a85a930732f46db4,164,117,651143,134665,516478,188,149,815974,132106,683868
c38d7210a69e15acc195285d7303e002,129,93,460705,150482,310223,178,146,534504,110451,424053
efbe717a7270b992420ac377a588c4d5,40,38,46592,11283,35309,40,30,30315,7059,23256
c879b95207b5d67fc89eebf9abf3954a,151,107,539898,140535,399363,185,112,500274,127235,373039
7ba633a9f96a32558d98ce931e7baafb,52,43,58313,31199,27114,75,58,89721,22053,67668
245be31511b518febd308a02e0f1361b,126,105,292355,69034,223321,123,83,226569,58795,167774
bfd20b482d3e76581811a811cce83985,103,86,218573,55297,163276,123,96,321244,65922,255322
1f82c50670dad234274a65a834e79a51,60,55,68636,38122,30514,69,49,96046,28979,67067
c9e4e2ba37a0a844132d2dde33ef85b0,153,116,358851,77797,281054,154,108,269709,92178,177531
60cf722d4823cd79634c242598fa678d,196,137,450970,101866,349104,144,116,355250,117228,238022
b39420b6c3a435819634822666362f89,2,1,152,91,61,3,2,446,186,260
b03586b7cebb67bb6b08d07e3dd957df,43,32,65252,19575,45677,42,32,46293,19854,26439
5763e533094dfc9a729054a4a9738365,180,138,894247,205498,688749,174,147,1048036,201374,846662
dc46c63997e5c0d219583be698ea887f,0,0,0,0,0,0,0,0,0,0
8a82ae48ac2b75194f7946de084dec05,29,22,25884,7831,18053,34,20,16601,8948,7653
7814a6edfff8ac103dffc331daa92463,155,93,338560,71981,266579,125,113,318618,113187,205431
cc510e356182f498ff9dd7feb61a2a09,85,78,163358,68734,94624,66,54,243822,43826,199996
d7d8bbca6ab23754e2fecd495a7e1506,108,85,188258,58547,129711,130,116,287765,58385,229380
166e5b6c72e427592655f8b35d83e449,67,54,81525,34889,46636,84,76,140587,31884,108703
a1bce2ff6a48212447303c45b16009e5,51,43,69222,29574,39648,65,47,88993,34698,54295
b037ac123dadf2868217403a24d781c7,25,15,4506,1849,2657,15,19,4174,2466,1708
d7da36b1711354406e42143889c3d396,159,118,376619,60958,315661,152,111,323387,72148,251239
a9ee5f49723ef0c4172df4f5ec2f99ce,115,84,164293,40303,123990,104,80,142626,35049,107577
70c05d05414716dabdd0dd1e7905616b,76,68,143651,37539,106112,92,70,126975,32909,94066
9b9e2e9c29c843850c1a7dbb97c1859f,5,5,1281,364,917,7,5,752,522,230
92b641c92a76b19f8f7ac3530f1e4063,43,32,56977,14227,42750,38,34,32636,20380,12256
330eae3ddb7b141190afaab6e7e901b1,38,29,52657,16768,35889,41,30,63466,20710,42756
33dfe2c69b5c8645461d8bef0204a241,27,20,13350,7921,5429,30,24,21624,7392,14232
f05d0d736a983e33c802ca001f5b8cc4,163,130,338987,99548,239439,216,137,480831,74522,406309
9c80a9e48a6f954166e7f1d8e855ba79,42,38,53257,32216,21041,64,55,103908,19262,84646
5e2c2cfceaeee4a7b2e46d1efa81bba2,49,44,63292,26659,36633,63,58,70398,34235,36163
5cf2c610528977aea7fd7bb92eba5bd1,168,99,755929,197733,558196,218,120,836951,173390,663561
57b62c84fdddcce61fa600f3f38a2e22,36,28,23241,7885,15356,28,25,19052,7698,11354
4d1f07308c1c53cf430a83529fac3124,126,90,192929,45077,147852,127,92,206512,43694,162818
98eb5ce1e62c5bf61b9b676f193a9b41,50,40,86054,31244,54810,70,61,100469,31663,68806
330a1034e2d284bad939b628bff66472,147,127,435052,99887,335165,143,113,503555,92624,410931
b6c4852e177d1f3f2513e2866ae70206,12,8,2929,889,2040,14,12,3192,826,2366
145257aac7a02dcd35cce1393ee6cdd3,68,54,142010,50714,91296,68,62,160799,64465,96334
989a6b98023f1ffcdfacfb099c74af1c,57,42,61800,9339,52461,35,30,18743,14051,4692
2af2f614670291226eafa3a47a11b819,148,113,373766,62547,311219,101,90,202062,68647,133415
ed0707c45fbb85143a449b555a11c24a,22,15,3900,2018,1882,22,20,6784,3344,3440
e63bb29945d1c718ce69fad9b209ee45,56,46,93203,35381,57822,50,40,73000,23975,49025
915c3618b2d74e53c3f338bcea25a881,119,99,308569,47856,260713,109,98,246123,53237,192886
b8c82014299127b43bdf321640c94cbf,29,25,14521,7900,6621,25,22,13055,4366,8689
9e5ce60440e29d32a4d454f0580a4732,39,35,44470,12725,31745,40,30,45954,14892,31062
6bb4ffdc33a2348db1cd0310432807e8,44,38,59835,20002,39833,75,39,73377,26314,47063
06b343e17a1ca28ba02440d5e8a4b7c1,32,21,17086,11506,5580,48,35,50315,9970,40345
523ae6c401024b48e3c8562fd1be31b3,110,57,196762,56971,139791,94,65,182744,67389,115355
29d8414f2ac4e892accd6e7225c73bcf,31,23,25624,11730,13894,32,25,30703,11330,19373
9097f3c35c701aac75485d3fa90a4d6a,80,59,146427,35626,110801,67,45,82704,21021,61683
537d11684123f32977da1f10a15a6825,41,37,35490,16315,19175,47,31,37903,14673,23230
045bcba96c6c5f6a7ea1c52a4056b364,147,109,338722,61380,277342,147,132,494758,89644,405114
186606f93d39b4fb99db1c9554cbd118,111,64,160230,60549,99681,72,42,116074,54480,61594
097b18e6b85f2cafd76785dc8002971b,151,118,335992,67455,268537,142,117,302782,74412,228370
f5f5b739e54e90fb80d62fee72d3d082,140,107,432446,69020,363426,155,123,440840,72765,368075
f27e47e49c55c63ab8277d9d6efec82c,80,59,174975,57821,117154,118,104,240190,68562,171628
d21697498e646f4d0cc9df90561af1a6,53,37,43773,16457,27316,59,38,39041,15819,23222
99d688171398f755e335c7f4422d9f87,22,21,17830,7942,9888,28,20,21136,7833,13303
199eeaee051a77cff4b83c2ff315a272,36,23,44500,8732,35768,37,29,37843,10793,27050
e8b32db12d2837e8bb4c8f51191abef8,129,109,296760,93876,202884,116,90,232597,68439,164158
7e97e5443a718e9a4f2595dbbec8cad6,96,76,249567,55328,194239,87,57,184231,59981,124250
bc46f53d0bcf1f6aec57f44ca6ea4e22,120,94,235325,77253,158072,155,109,319613,63516,256097
f1dba13a61330d3bf7805841c2679366,129,90,275916,76452,199464,156,127,375570,82419,293151
826a274c17cbf8532dc08b791842876b,64,48,71242,19588,51654,62,51,76389,26364,50025
6984f3d59848ff0d125fd7f85c8d37ba,95,69,186924,46916,140008,112,90,244016,52176,191840
362efa25df1be6ed32a8959beab9177f,58,32,49742,13803,35939,48,31,44097,16645,27452
937828f3c9fe9b92995c411ae13d5c36,71,57,112494,25111,87383,94,73,118210,31869,86341
36f36fe9cd1a5f8af3af8685f22c1fa4,207,162,864828,200118,664710,199,151,884691,294222,590469
0320aadaeaabf00672867d9763dc54dd,31,21,18649,4216,14433,26,17,9503,3980,5523
b7c510c387230bc2e0897242843d013c,42,33,41578,16479,25099,37,27,33454,19112,14342
b218b7391b56a677c502268f4d33392e,23,23,5365,3787,1578,25,16,4033,2921,1112
585e43949aa79577afe410f463347035,160,138,623970,116181,507789,148,131,566719,142984,423735
c8f4c5f92cd21d4b14feae875451335f,158,116,364279,71362,292917,132,123,296491,96351,200140
42c349ed9b3ebb2b0e8749f811ba5a62,23,20,8802,4624,4178,24,19,9271,4426,4845
2fe301c5c676ca23a40e9ca203ee0ba5,141,117,318914,87687,231227,124,98,300944,68581,232363
361f3e6c9ca3ab649dfc432fa3a90787,29,21,22603,8027,14576,37,32,30163,14585,15578
41d8bfa1ca03bbe6cc0b6cf0bb4ae1fe,72,61,117294,37696,79598,60,45,97164,40757,56407
10ff9a1eb7358b5ee96748e981de7480,178,116,532017,104381,427636,190,132,534936,140725,394211
937000a2acbb70b0667488e91745bd38,125,93,336026,76798,259228,127,104,475549,89629,385920
60d6cc67dc8d4fa4246a4757c1eb62c8,125,74,268223,97970,170253,148,97,398897,66447,332450
8c65415494d775a1cfdc98422491f677,26,21,12950,4407,8543,25,17,9783,3429,6354
d54dfee1a30e3edf8e187878372dcb5d,25,23,9271,3137,6134,16,9,6220,1194,5026
324d7215e3c31d089e7aa37b15dd152c,109,79,206167,45725,160442,101,55,157155,52161,104994
1a0a6c6912f682af7d211bbe0a86eb61,122,89,300035,79681,220354,152,120,447450,86218,361232
520110579112746e8b2246e985d6ad51,137,111,459171,90881,368290,112,101,310361,101502,208859
c64a505f969877ba944abb1dd2f068e8,164,127,477762,91286,386476,187,152,470148,87589,382559
ead7ed2bb4a8aa71f787829ba9ac4ce0,136,111,337045,77004,260041,135,101,315823,83668,232155
5d76a37c4c81b59e6983499b85e030c0,38,32,56363,16684,39679,39,28,33777,16030,17747
ed01196c57eae958bb53bba3f054eed2,99,71,138067,47341,90726,86,74,168325,39433,128892
df020352d52e3a199fe999d1aa88ad7a,139,112,516798,124071,392727,136,99,480985,114484,366501
71faea7a882e8beb737faa68cdd30260,63,51,71643,19211,52432,63,48,85099,21185,63914
d2a5e4bde7b9b78296604c34b57dc6e0,140,84,274071,55493,218578,145,116,384758,44826,339932
6ee42feca82b9f8dcf261d3c8e8138be,21,18,6022,2671,3351,22,15,6346,2132,4214
bf87dd074e1651fcb216eb86b8919dfb,83,55,176578,43566,133012,64,52,123354,51083,72271
eab1e8a834b413de785e8b935c593fa8,169,106,584612,146031,438581,187,119,671229,158526,512703
b62b84c68bc44f15f0a330a7c217b690,31,22,14552,6136,8416,33,28,12045,7628,4417
80ba79d8c744d4d6dc90917e2ff28922,97,79,197111,56771,140340,100,89,165785,37234,128551
575e05c90dceaf74b3e961f109ecee45,18,17,5552,2823,2729,18,19,5421,2883,2538
19fbe8cc15cc9fd9ef5895fa7319657a,129,95,277141,51506,225635,110,86,220185,49910,170275
16b5962966151b57b1cc8eeea8a0e8eb,54,40,65141,19599,45542,51,39,66235,21382,44853
c733088516117e7641345bbe5bd29a8d,142,122,538235,106963,431272,192,160,628941,134582,494359
2dd27f74f149188eda0d72cfbca14abe,130,99,286391,60892,225499,104,81,227473,84844,142629
51935fd6ad2bf00a4f99e6189ee2f6a9,148,124,409710,99958,309752,158,135,524950,123627,401323
f113e3696231bb3c812fc3828fc0de1a,140,100,282159,54965,227194,94,60,230470,65048,165422
c8f4da48df8e6ae83ea2b04a06b76a6b,26,20,10827,5042,5785,25,17,8278,5004,3274
18a77099bf015e3ea9f11a8ca6be4cb6,155,123,431654,106576,325078,169,118,491491,61469,430022
f020ddf791b3cec2bd0101d2cf8ce652,45,35,57126,18233,38893,43,31,34968,17277,17691
5c8a933aafe242e72a6d9007a87ab557,68,47,77324,25013,52311,78,55,82166,22563,59603
a697d3b3af6b17e889927d3dbabcf716,86,60,157828,44775,113053,121,81,168031,58286,109745
19bc793cada2d7fb091dc88496882708,42,31,49000,11743,37257,33,23,31615,8987,22628
684d7e1a89b3882290ef2dbdd3c62c33,127,99,173017,41066,131951,93,81,126069,47518,78551
52f5697c468341cda4145e6790ca5f60,76,60,164824,36399,128425,122,95,186860,37711,149149
21e8a763072712af19c5bee14758bfa7,90,78,140440,56255,84185,117,100,187730,44265,143465
a3b6c02bf4b2494b10473688927ffcbe,88,71,157216,38023,119193,71,46,70003,36039,33964
fde167573f1b5f84f96aaecaf1e6c935,72,60,83492,52133,31359,79,60,139091,35765,103326
b588f2b29a7fe116d5713a530bc99800,172,120,401118,74405,326713,139,103,321571,88264,233307
846772b653beefdcc0a08509b568ab38,145,117,354451,86723,267728,114,101,230073,72134,157939
6987683aeac767871b9ebdccb4064b08,71,55,100743,32259,68484,86,75,136457,30117,106340
7bc8aa4b6759c124466e76751bd66d17,185,153,562770,118568,444202,182,125,526127,122991,403136
aa6e6f0230391705849513746d408cb8,97,74,204497,86745,117752,148,99,320718,71144,249574
f94380be56facaeecb614e7414b57914,50,28,37749,15039,22710,45,37,58434,14474,43960
35d6c2880bad8a6e9cc3bdd2d882e5d9,0,1,0,32,-32,1,0,32,0,32
bfdcf64e216964f9f2eb8b7f51fd7271,32,26,30482,13681,16801,31,23,37510,12684,24826
e7cd7965e9291bf9a0b09b20d32d22d2,109,95,225535,71266,154269,120,88,226710,40621,186089
cc22a0266c325dfe0d100fe4dc5cf1e2,66,55,76178,24964,51214,47,38,69949,19561,50388
f66cbf6c01997381015efc53c3eb278d,54,44,61950,19220,42730,42,37,68681,22215,46466
9e90eeb3b60b287b98f72474677de9eb,17,12,4156,1764,2392,14,12,4319,1812,2507
7890261c4d1a49ce99681f7efbddde78,175,102,484603,98656,385947,170,140,540007,136692,403315
c09f220b969a7cfdee76d192ca55ce17,126,89,397554,130073,267481,185,100,513074,101762,411312
80d155621bad34773a40723785fbcd16,91,78,171834,47616,124218,97,83,258028,47050,210978
d67a21aaa2e338f66f7b3c61a4a146a9,35,30,31604,14491,17113,35,27,23560,10994,12566
9f6013a08ad443d44507e22576b7a986,94,72,199148,43679,155469,124,88,212476,45520,166956
7238624e3b6e5da6b383d10007944898,100,68,300080,56044,244036,134,90,276573,72809,203764
0bddb26463a00c2b13c2396433bc454a,17,17,5658,2538,3120,24,13,6808,2491,4317
9e2ae4750b5bf427a05cdf052017f684,69,61,77137,27248,49889,80,62,89930,29483,60447
24d4e43b709b65fc04161cfc571a977b,56,52,73068,37178,35890,59,47,64435,30828,33607
8f750cf7cae5ee49543088543c44765b,168,109,413090,122686,290404,162,111,427004,86659,340345
5fd439d0d4abebd2f69bb184e2117448,84,50,101378,19533,81845,85,65,100147,24809,75338
86be3545eac46b15ee5b4c104ff1a985,82,68,156442,37600,118842,76,64,107342,48155,59187
082d6f14ab6940f4fd59d58a80c672db,73,45,93384,17582,75802,73,54,81605,27020,54585
a9cb9e16c06829d892e0313e965d1754,51,43,84170,19876,64294,45,39,59282,28280,31002
e22275fc2a93fd498b84e61dbf52b7ef,133,113,335378,101523,233855,106,79,322112,90668,231444
f8ca7b11cb7e1ef7fed4bea937ca5a0a,74,55,105733,32780,72953,71,63,141486,38179,103307
ffa4aa526dfedbe8a5ddb65756f5f3a1,85,60,146975,50776,96199,126,114,313270,65123,248147
3c22d3ce18d843310a41fa9fd3f8f6b5,172,122,573480,109425,464055,184,153,560266,88235,472031
107c910da17053f1f7e473fc35a78741,56,46,59917,28856,31061,52,47,63699,26694,37005
0f617795420008fc3fb4863c90f6c9f8,185,108,482377,99252,383125,191,138,519523,109643,409880
03a9fe9a91315dc09b70c639375c752c,75,56,109442,17533,91909,48,40,66288,18406,47882
d390db1d0f5b1c79b0d19cf0a8496f58,31,24,22474,10479,11995,28,25,16259,9369,6890
7f1aedb459952466f68d20e7913c8a41,126,78,302219,77568,224651,147,112,485055,73240,411815
36cc299f59e8acc28f2c31d738d9a6b4,144,101,317981,32435,285546,133,93,233739,43998,189741
fa239e4fbb5f5550bc21abf52399d9ca,71,54,82605,25490,57115,66,39,105639,24957,80682
d44c514c68fb425ce6aa252b7517ab08,38,20,27048,9508,17540,35,32,30723,9405,21318
3e2e8db99e2075704ad6c24e508a7008,186,126,850280,150692,699588,197,134,696357,158690,537667
d5115b82adb77f5fc3086ef9ac37db1d,99,76,168700,44080,124620,115,91,131660,57372,74288
771179ac173f7df7700e961be8270ad1,90,66,148477,42252,106225,65,48,142827,40721,102106
2a97d7005e5bcb54eeae890288c42adf,15,10,2709,1916,793,17,13,3772,2042,1730
899af2f3291e532fe84f7c1413ea7be3,78,67,302827,102819,200008,144,108,467776,116608,351168
bd0d4f196247f50d6b1e329bfe4c492a,119,97,285450,103454,181996,128,93,294013,82322,211691
2339350fddf9ac15fa5f314ab2685c01,16,13,5287,2000,3287,22,18,5015,3075,1940
f0d79332eaf1c2f2190bd15f3939a0aa,24,20,7862,5790,2072,29,22,16241,4849,11392
48bbfee5ff52fe851eae71ca40d6dcbe,33,28,16655,8341,8314,33,23,23214,5455,17759
ec0b3d3bb676ba56491bfa20431756bf,53,41,63277,21951,41326,60,50,58626,22932,35694
8d1f35157fc1b314052e9e38f8e86b2d,61,48,139992,41716,98276,68,60,168590,42043,126547
b4a168e5ef38cfa66a9f4c48322e49e8,92,73,171786,42279,129507,119,79,199344,43643,155701
39b5d2f9469a21416140043b5a8e47d6,89,60,200014,43412,156602,130,107,201704,75036,126668
dc79f25926a84bd4ac7b9bd2a03f3576,20,19,5202,2760,2442,20,14,3978,2257,1721
efab7fda3cb9fd74f61de885d5e8ae47,14,14,5046,1467,3579,14,11,2064,1862,202
8ef7fe153e5f1c9aa6c9763906abd3e3,32,28,16971,7675,9296,28,25,22083,5672,16411
d313530eb1bec6c048cfd4243bb46a88,154,107,289463,71073,218390,137,107,355908,72282,283626
19957e5744f98add6377239cf557c6f6,113,77,182725,43206,139519,75,67,132976,40380,92596
1e84a5ac073403c32fdfe62b386b4ecb,56,42,80362,20581,59781,68,53,75565,29436,46129
80d8a01fd097e47b92bcadf611e57357,116,85,255018,47297,207721,85,62,148480,58014,90466
3d3925fd333655330d05664217386714,59,52,67214,26663,40551,46,38,53848,18869,34979
64a562440db3c116671b75ba4baede0d,29,22,16703,7952,8751,35,26,21347,8268,13079
e67810844a75d7973cf5792a40efe2c8,46,40,44721,15453,29268,41,32,43169,15480,27689
b42801391a49d02c15a10027af4b20fc,113,74,149171,46656,102515,88,62,104496,51160,53336
508217d874c86ea823b3fb0c14913e1c,152,110,428038,107017,321021,133,96,399699,102468,297231
5af90c6ff9b148ee3abbddfae86557ec,59,48,68602,19100,49502,70,41,95404,24827,70577
f47cbc9bbb2ba8c4e9cf84d412f9cf15,118,103,392132,164172,227960,164,114,504575,119783,384792
07c0a4226e14b5097e21394103e4f358,125,94,310077,78908,231169,162,117,496988,62207,434781
f5d9176a2737d2631ad363aab58e70b3,50,40,60991,14461,46530,36,27,35695,14560,21135
dbfcd5afa8e2cb4613ce077798a27958,7,3,496,114,382,4,4,304,117,187
04d921d48826fdfdb6f2675a553e724e,58,57,69453,18553,50900,55,36,51554,18823,32731
7af10c70b7c1672f44ffa96cd6661370,50,38,51989,16851,35138,48,36,48583,15787,32796
a02c41de4b401b842db40fda892d29db,208,145,1170642,212873,957769,220,157,885820,218928,666892
76b59c9751b924c6717cd82223206203,236,160,1041035,177355,863680,262,148,1210270,152629,1057641
48aa21fb4b519c5c8c68900f0d7bd28a,78,69,83609,31055,52554,105,72,151674,26107,125567
b8bac9869b4e7186af20ec24fffba612,36,27,20676,7215,13461,28,26,15931,5937,9994
32f8a4ed6d66c9ccfbb4a4fa8e38e1cc,41,32,24389,6899,17490,24,26,13005,5087,7918
93bc36f08a3f0732df7b09f14cbec232,71,52,119360,34749,84611,65,53,102478,32200,70278
7fc9f8bd5bf8fafb5bdf538ddf320ab0,27,21,11557,6321,5236,26,26,11795,6023,5772
c56c83944afb7f8ea02bc373d575232e,149,117,465722,190010,275712,240,183,885530,157022,728508
e8c77494f5c59629620bb1e6015a4222,143,99,338537,72194,266343,188,117,406999,79468,327531
b9c11601e71c29e8e12e658adb88f42b,41,38,52200,20424,31776,48,40,63568,19285,44283
46ae203ce02d8903ab4f35c5e288da6e,76,51,140409,39810,100599,88,76,205890,45891,159999
154325224e3b06073a3c299b53759798,131,115,350474,79918,270556,125,94,362363,61596,300767
287bb3da2df21e622a831f32d05a4da9,55,36,35152,11951,23201,48,47,53806,14420,39386
4c11e2eea4069628404b3b0b345f952f,199,151,637127,99662,537465,163,133,505296,110657,394639
75916461a078ef3c26af0a961b707a87,55,47,68269,19959,48310,47,44,50278,23828,26450
98d981dc5587fac2dfac0ed62d17b1ec,18,11,3647,1953,1694,20,12,4597,1831,2766
2517ef660635e47beae824b5e91a814f,26,21,11700,4136,7564,30,23,9868,5161,4707
0213292bdb2119c70101f83b0b1a856a,100,66,188409,32963,155446,83,76,103391,50423,52968
d5d5a0153dbd589f99e7459a1f5578f2,76,57,89304,43206,46098,96,83,188904,33558,155346
8ff5cf6c18de7036fe53990ed69eb60d,25,20,10853,4648,6205,26,21,8255,4159,4096
2f5edfab77e4c755014d388c91036226,139,112,577699,218281,359418,136,107,593968,145964,448004
f670c994909d78f1beaf0a64ab547bdc,51,29,47808,14809,32999,48,33,53151,17939,35212
eea00f6754d6714324e96bbef3781ba5,1,1,46,9,37,0,0,0,0,0
33a815b829386462cffee380f3165760,6,4,649,231,418,7,4,508,157,351
83011022e2b42210e0972fe9cbb9856f,116,95,292342,57463,234879,131,113,265572,79378,186194
b26a29f4eb0544688e4af2b260f54589,62,48,104909,47861,57048,96,79,146278,49813,96465
27926028e7be8493a052cb0423d3ef92,71,58,106606,29746,76860,81,49,110342,31325,79017
c8c974736a35b578339c4de9d19aecca,21,16,6063,2338,3725,23,16,4199,3126,1073
3b9edf2c613b37f0d37c012fc372af2e,156,136,374267,108389,265878,145,117,458255,93981,364274
9e39957f5be8ebd057d53716b445aa03,127,112,360809,72756,288053,144,127,403800,85007,318793
bab92bba9ca66ac41e44a933c5804bbd,61,53,68134,21416,46718,55,42,74529,22329,52200
ad9562796863bf41398525d72242e46d,152,117,409960,99254,310706,190,147,659599,114833,544766
f7978a0c0088c08b971d4bb73d77084f,100,89,338922,93934,244988,147,117,460750,68940,391810
76c82aeb572c300eb1471ca2384c9ec2,24,21,21755,9887,11868,27,21,27403,9313,18090
d7eec5dbd68208d0f5d3a101d2c0666a,32,21,17413,8664,8749,38,22,30406,5960,24446
04a3448713d275125cb074db9789929f,100,73,154227,37799,116428,98,78,174081,39986,134095
793931e8e812c9ef36a18995135c038d,0,0,0,0,0,0,0,0,0,0
ad9fda96bd7779267e157641cf76219c,48,32,36612,15710,20902,68,47,48021,13951,34070
07dfc1c7ae2bb9774a8e3ef94f9112b0,21,15,5261,2521,2740,21,17,5092,2871,2221
3605e6318427ef3f8add36e675a2bfe2,72,57,81188,23523,57665,57,56,61245,28280,32965
eff8c289aef54e2409231b42d469fe9b,32,29,26078,20205,5873,36,29,44929,15722,29207
b9f2e18056994a089018aa296dc0efd3,60,42,69283,23360,45923,57,48,79649,18223,61426
202389f67554b598803ba0b27264c717,101,73,200494,41995,158499,122,96,267694,79258,188436
b23906dd2165a039d651dc44955b965d,86,78,206135,67368,138767,146,109,462602,49345,413257
fe225597c22b6f1a5dda0fadec38c073,65,53,105091,40526,64565,81,63,162450,35248,127202
16e734b0c4757c07c1bd60b45d829f87,62,47,126429,20745,105684,47,38,57411,21856,35555
ad43354eea256edb14c41e8baa1bbd25,57,35,70562,21656,48906,49,43,77904,25737,52167
46cb629159c1ab68d7c6affa7adb37ee,99,71,158214,42604,115610,84,66,127635,35656,91979
1f5a5f1bd1d2e2380ad1b719458ac1e9,79,60,150442,32740,117702,94,86,163449,55204,108245
560efe17214beacadf6bfefb1ac5f5f1,24,23,13337,5985,7352,26,26,9156,5753,3403
487ade1e986f32c8fb01e195567a8ceb,69,61,110548,46804,63744,55,47,115823,38694,77129
c162873a6d81cff8f2709d9d61b2fc79,141,111,302872,57884,244988,166,122,570207,68579,501628
5734e02b9c1ffe41fa2cf72621779ad6,113,74,284834,75376,209458,121,90,305479,82827,222652
3d725053809179250b25ad9d43dbdf57,97,80,249805,58774,191031,86,71,219205,80510,138695
0b853639eb7ba8bb3449a52e4f3cb4ec,63,47,70722,22819,47903,60,45,59530,20712,38818
65a6df6b0da46f0097e06234e6e4f5bf,89,65,104835,54007,50828,123,106,252649,38355,214294
9be90c67a50652de91338a5643274077,132,93,405525,85315,320210,155,141,447079,113421,333658
a15474f757001d94ff25ee3c5b065407,104,90,231110,50552,180558,87,70,202355,39109,163246
83a71c8715201f9e499a716dca50699e,22,17,3712,1603,2109,16,16,2162,1924,238
570ec853019f9c3804cf81f6145ff838,39,32,29853,9914,19939,51,35,54454,7198,47256
f6f8dca3b87f18e26db1b42bac797697,119,87,284765,58506,226259,101,84,207508,89591,117917
32fe947837508dd93797e83b8b40f4ca,64,52,118985,43947,75038,57,40,81196,37900,43296
65c120bf64bb1515e11dd5cae5c962e4,65,59,92109,24601,67508,56,44,66629,21577,45052
72553a0475f261a9a9ac0d59118453c2,129,108,356660,51867,304793,170,120,397763,91466,306297
752074a59a40a13bdd1ec031ad751850,108,81,241254,89165,152089,209,137,580830,69686,511144
fafac15f226bcfa2a8b6d56946944f40,45,40,43975,17815,26160,53,31,46397,11218,35179
b26bb7394cebf0e4a7e0461f335a107f,126,99,274994,58826,216168,162,102,380517,42820,337697
5d4ec1330c2b0da8b0a84f68079d5fa0,92,70,153347,40373,112974,71,64,131438,36723,94715
25c790faee5a912f12e6c224ffd76dfe,181,139,652365,130846,521519,140,110,506413,108821,397592
cbf7ab0343f1f2fd8b1a2ec356caad35,141,111,389041,74703,314338,139,108,341765,73517,268248
91a4d9a3c8b8488977af64b926ea771c,67,50,73216,16504,56712,69,50,101253,27983,73270
771f128ffcf1dea41c6bd02d9dd53195,49,43,102007,21585,80422,84,56,158752,19459,139293
23597639f0283917564f7fa7c53618e4,109,94,250528,62157,188371,100,93,259332,47932,211400
5b5506481649234fd866922e34fba04f,40,38,40471,15912,24559,29,28,21359,10986,10373
14cf8094ffe284f518fbd572bdea0402,107,85,310714,88433,222281,123,103,282477,81944,200533
72d1ce933b7269e7a59e0fcf5db5a3e3,104,87,196001,47308,148693,123,107,192047,74831,117216
1c51844b430f5cd2262047426e0ca9f1,27,25,8449,6576,1873,28,23,18914,5076,13838
e24dbe90a56df47fac8d513554f241ea,82,67,181865,40378,141487,87,76,141287,53669,87618
91c027eabb45ba1e968c18a90ea7f0a6,52,31,47982,25116,22866,50,49,60384,22924,37460
7cfabf52fa467576de845b393c685c71,162,107,437536,103089,334447,134,105,390173,119992,270181
d831e63d152a4e388982e701e7c027fa,16,15,7158,2722,4436,22,17,4497,3349,1148
dcaa107fb8bdbb9f0fe0b802d3ec0b1a,58,45,101189,20871,80318,47,38,53038,15123,37915
0241bf3234315e2dac241ea998050629,123,101,290167,66501,223666,109,81,218056,50241,167815
e4e6f57c2c76d0983fb07da34f9cbd90,126,96,316116,69761,246355,109,90,269359,93302,176057
15ffc125dd9f13db0e427576dc88765a,39,26,15999,7537,8462,39,35,34471,9834,24637
0fe801130a8928c9479f035196ff306b,44,37,36345,11217,25128,36,24,29807,12288,17519
da99945626b809c59b3573a9cace1a75,74,64,104384,34003,70381,68,48,77925,19714,58211
820eccec4440f2fa29ec0c99a5a37237,1,3,25,664,-639,3,1,664,25,639
aaebf1313da92e7adc2df0d5c6ac768b,96,70,159116,27031,132085,138,110,170077,23082,146995
8617be9bf653b10c81252f1c6b0e25c4,30,20,25933,8422,17511,23,24,28174,10919,17255
5ef0bc854294789bb3d0f68f99644789,39,30,41692,11429,30263,41,32,27485,15385,12100
810eafe8b6191600a9405a66db366570,28,26,10653,6622,4031,28,24,11593,5100,6493
1abcad543f47062e778c7bd31ff0dc23,21,18,15371,4203,11168,22,21,13783,9121,4662
448d0feae82bf5c9f9082183191451f9,134,100,295361,51363,243998,123,89,237818,53865,183953
fb2f4b3e8afc94aa7bd8ae050e0b8edf,155,110,410507,89358,321149,165,118,482927,81493,401434
dd07c79b01c578bed48323c7d0ef33fe,42,38,34859,15496,19363,47,37,42257,13582,28675
3f91d315e05b6bd73798799bc21a4a0d,83,56,81217,26550,54667,81,60,84046,24779,59267
e2fa3e633fc2462c46ac5a7ec7ed65bc,161,136,554822,107822,447000,127,100,431041,82963,348078
eb286ce8a6e20215e2d0b616f75b6b43,54,43,70255,28934,41321,57,43,98872,24460,74412
4287ea9a82ad352d6f573052704fc878,34,29,20754,10695,10059,30,24,24607,10330,14277
e307eec8123f3c2d6e40d095992c4130,123,103,266545,58048,208497,122,99,283976,60523,223453
a33800a3cd0f12c87f0155949cd7a20d,23,20,10964,5918,5046,25,19,8985,5792,3193
388fbd7502befda2d6c025692c9a838b,109,88,243915,44493,199422,83,62,121072,46102,74970
94ff4aa3a8f7a304cdc01cff4c3c97e2,98,71,167160,31204,135956,110,93,202831,43104,159727
8ccd8a9afb58832882572c3c9bb100fc,80,65,117793,32237,85556,59,44,102997,31769,71228
ffeb60b7394bac29b431656742c0c932,14,10,4375,1546,2829,15,13,2320,1668,652
82edc362c12cb31617409f2f9ce07e01,62,43,65264,16512,48752,37,32,30584,11465,19119
b3b724d815e4d62e4a025cc5f988c6df,96,61,206695,42407,164288,89,57,160624,55535,105089
223f6e39ed4de61bf3b24ea33ace4a89,173,128,419220,88481,330739,162,106,350545,73648,276897
9f43f25e3b249bcd90443dda71481a82,120,98,367979,78782,289197,164,132,572219,83949,488270
bcfd3455eea4383531b09911f2b6064e,123,109,265127,64546,200581,81,65,156321,32099,124222
3e8bfe3e29c3dbb1eddb083355e7dc90,167,110,662982,212283,450699,233,153,1204695,167854,1036841
3fc5182178f784df6cca19b9a57b0409,32,25,22534,7167,15367,30,22,18992,5739,13253
c8f0a630ada48d684eacd0808d10ebd5,100,84,240188,49848,190340,96,88,208197,60202,147995
dc27f76de54ab7b66beff1d042d535bb,59,41,46188,13807,32381,58,38,68664,14798,53866
008d7513344e4b27c37f766547e4e9c9,93,75,230223,52387,177836,103,87,199329,55724,143605
97f50faf79640e5c6f6160c5a752a3ef,51,35,76944,25053,51891,40,34,72700,26056,46644
8e9dbf0b73104f2d2e6e81de78291fe5,10,6,1860,765,1095,10,10,1875,1318,557
e09cd3047a487d3ae2803fc7e65f1750,110,92,150366,45593,104773,121,97,205170,48232,156938
b794827aa01d2908d91e64880be504fe,142,100,335054,121421,213633,178,120,501495,82798,418697
0f72e5f6faf31321ab136f48a4a85172,81,59,124348,41014,83334,69,48,108479,27036,81443
bb8a4cb0288c240438655ac2cfe24ee9,77,62,129321,64007,65314,138,103,281919,56516,225403
f150f36795f81a43ac6c960801283028,79,71,209551,91945,117606,142,109,443458,61546,381912
e12cec7c48f25a1a60e0673212c61650,31,19,15635,5297,10338,34,31,17326,7916,9410
5023a885649a55339d8cc94942a58636,132,91,285047,57943,227104,100,88,193318,69781,123537
ecc6900e47f75a9bb4805dac81ab3cb9,94,70,123881,29314,94567,72,61,100344,27927,72417
7148ef5f00c0ca5ade5ebedb08744419,80,73,168538,50795,117743,81,63,124396,56653,67743
7d8094b417b124cf53dadea07147752c,21,14,5212,2171,3041,17,18,6097,2310,3787
bce33152c322f6c4dacff16cf855e77e,119,93,255987,48459,207528,116,102,211137,45718,165419
63a8232dab20c98f7d1f6e5278193a36,51,41,54249,14566,39683,58,39,55175,16859,38316
51fc5824b6245ae566c87197433aeda9,51,39,52982,16611,36371,44,36,47117,15274,31843
2d2d9ca644fa81595f39565ffc120804,26,18,15619,5412,10207,29,22,15485,5577,9908
6136b58c83178bd837170c16cf22c083,136,120,503271,113041,390230,148,125,405511,96958,308553
1984d766dc84d657e36fadbc59adfbe5,112,87,251308,52718,198590,144,113,280589,48751,231838
e4607d15fe79fc7d9fc07a8a1d0022e2,166,129,579276,158811,420465,101,90,329013,115844,213169
980bbf5aee773e7ddd8b4fbb1e7f75b2,93,69,233159,28970,204189,102,82,203331,42196,161135
5edc7d9c5503b7e2c4ff733b9350f266,38,36,38429,18999,19430,42,26,39126,13825,25301
b25548c02c70f8b54992c20bdb64c12b,67,61,119195,56455,62740,105,84,229875,56423,173452
a2d554b550b3459261e405ae68594762,134,114,365001,88331,276670,137,112,436864,75615,361249
d450d4e2ce169d11f6ed30e58c365877,100,82,173045,75833,97212,138,93,258645,60776,197869
d22a499088191c4441944b184713fa2e,84,79,140913,45332,95581,74,63,142852,26699,116153
5eca489511a38fc67faeffb2ef0f45d0,103,86,196663,33506,163157,65,61,93620,23474,70146
7c8013f76956ea81fb9a26b269e0c8ff,153,122,360004,108761,251243,173,112,353738,80664,273074
5fa6df25ecfa79c427aba78c579e037d,124,93,198333,40045,158288,114,95,226519,46003,180516
42cba53a72db614f59a41c4e408bab03,147,92,235768,47854,187914,117,100,213820,59018,154802
ce6693fb1402b7491dc7d4e38323f7ba,190,131,609094,119513,489581,185,150,665062,162688,502374
ebfbf10264f15fb405415bddb808f776,48,43,55846,25343,30503,42,41,65667,22552,43115
dc608827126219d5721833a6532d7e09,86,60,127300,20694,106606,45,43,44610,23407,21203
ca9f77fa0c620e685af6f663ba5f4f78,154,132,568954,121013,447941,126,106,425023,107767,317256
423ea1b59caf6938d47df02fc498962f,38,30,23487,10168,13319,40,31,27350,13738,13612
dfeb74183ce22ef3b540663c8b867aa0,90,80,180718,40399,140319,80,68,132283,61806,70477
1b2b7fc2f144287a25381ba4a5b62d71,128,80,246958,31539,215419,70,50,148292,34598,113694
07e05355ffe05ce52679924d5dab0650,86,63,168796,49150,119646,118,102,204772,46370,158402
7d383b3255964be135e8df67eab98df4,76,66,164508,47163,117345,69,63,133859,52265,81594
d089c4ba96581ea6ff80f07fd7262755,44,34,72032,23129,48903,39,27,47060,17485,29575
037a2fe4f33f1a1314e2b1756168c7c7,157,114,505481,117761,387720,138,110,464895,95700,369195
6583f6aaa7960795e79742e616dfb291,83,62,116998,48424,68574,95,66,151767,27654,124113
83f36bb380e97f4f7065a1d088b559c8,106,83,311768,74256,237512,147,112,365931,56415,309516
9ca09ce2d3ed353f9bb99c8dadef9478,89,82,172102,41204,130898,109,75,171452,31383,140069
d8d8b0bd446cd28f0fde3d4e58b8b19e,126,103,275061,82366,192695,118,92,297826,56367,241459
d4dce8a8242a6ec94ae656c1b41f655d,26,21,10031,5752,4279,21,19,9139,5356,3783
f18e1afb93f31633c00666f77ab97913,74,64,100110,32017,68093,86,65,124477,29739,94738
9bce9fe32ad6b0e65b2d9bfbf9b2dd90,129,97,300620,53972,246648,143,100,238697,53185,185512
d22c6c8e223afe6bf9dde82ca7767372,31,25,16357,5332,11025,27,19,12504,4649,7855
8e4a1ce6c2ce6154cd9b672a221d6cc2,123,85,269790,43202,226588,114,84,235822,47277,188545
aa2be52d4b51662bd2d1014cac0d9116,41,33,37656,16141,21515,58,42,54831,14583,40248
4559a4b5774acceb072d82d2c6a5780f,141,113,369662,74340,295322,116,88,325021,70199,254822
9e40ffb6d3e2c714e119e2d8406ca2ae,22,17,9873,2894,6979,26,22,10850,3364,7486
393e5dbdc3f1eef676ec0cd0422a4e6a,123,93,309028,60486,248542,94,81,227515,77064,150451
c3946d14693d21e7bbb0eb90edae61ee,177,132,570251,108608,461643,172,126,611172,92302,518870
99a7a43b67641bc0d6a78a8d44813d86,64,43,92737,15142,77595,59,48,46280,20267,26013
7c45f52b11760c41e439a0efc27ff255,126,114,344051,56582,287469,137,118,374337,68316,306021
485307c422c41fa2cea584db7c475c41,188,149,733935,100757,633178,187,141,891429,131764,759665
bd662aaa5fd70d2feb32124a48fe9b5b,12,10,3973,1856,2117,17,15,3586,1732,1854
3a27f7eaa7880eff77fe7f80fd4e185a,143,123,277842,52374,225468,93,75,148557,51761,96796
702aabf17ec50b57c7e86c66224df1cb,72,59,106329,45557,60772,73,58,138191,40911,97280
5a07b80785aa5acb8fb113c1fbbcac08,27,22,15313,8898,6415,27,22,19219,7966,11253
5efb53378f9c57813daf54f7e881a389,28,19,25987,6892,19095,25,20,19096,8366,10730
b5753203d6a34138a0082a792c3c1ae4,117,86,342129,95618,246511,176,117,450908,92485,358423
20e3ff6dec5c76a68fb68a95ee8e738b,152,116,643390,111410,531980,157,131,644728,137330,507398
10397a21887b2bfc42b63009eb4f8411,102,77,129919,62237,67682,129,87,239260,39241,200019
c9158ce2aa349aeade9cde998b783bb5,41,38,37618,15600,22018,45,39,35511,16242,19269
f8b5b682d53537ae554aca061c731176,76,71,109266,42750,66516,60,44,98957,28655,70302
d3d7931968003adc1fd96b81212c580b,154,124,453730,90428,363302,219,147,537871,112117,425754
abddcb553397ee7d3efd2f9661b348b4,57,58,62730,13525,49205,43,33,53019,11956,41063
24dce788128eae54976924669b4984cc,217,148,737834,148467,589367,126,97,458415,125467,332948
8c4b1c6656f2352c3783e06643a73102,174,125,360518,64217,296301,114,97,331449,75846,255603
0ceab588c3c913f9d6832fd572219030,154,112,323215,74508,248707,95,76,189150,77457,111693
20a8895070f51a86cac915928a068576,189,126,607094,85042,522052,136,111,584474,112892,471582
ebb9d7adb0fe082e8e5cab65ca9585a3,33,33,37951,18619,19332,53,35,43538,19255,24283
f6e5089d30701aa2ef800913ecc298dd,176,150,678285,122503,555782,110,65,388027,101872,286155
8924f56353ca2bde4865b2e88005876c,177,143,734587,164210,570377,175,142,759354,123652,635702
fbe8dfc5a296982129f8a328a69ebd2b,201,152,920822,207227,713595,215,161,1000251,202764,797487
64378de5ff45f63861510f34323200ba,40,30,29747,13465,16282,41,34,25575,15121,10454
6eb7a9645ba96160571ef0da0faf7205,154,117,670460,158078,512382,179,152,633254,162045,471209
fcdb79480c8c549b6ce40dea094a9049,137,88,394060,55172,338888,162,123,435944,90365,345579
64536c24b9334deeeb9c931086ae51aa,82,76,225598,105452,120146,123,105,323081,84833,238248
5561c0766c1078caf1dfed01af320752,179,127,505358,95841,409517,137,108,402230,93951,308279
bdb81f4c03bf4ca73623336ac998cd1d,46,39,58583,22160,36423,56,35,49015,22193,26822
af5a292a48f4982e3ef81d23e804fc3f,138,77,317072,114811,202261,118,91,237600,88971,148629
4407f911819e460101adc2ef0a56bdf2,148,119,351632,106294,245338,176,155,600214,98224,501990
cda8a1055c866a1796a80191f609e664,27,23,9293,4136,5157,27,26,13959,5583,8376
56069ffda68703a70436cccfb036b2cc,115,72,315197,102641,212556,158,122,459394,92637,366757
5bfcf2476351b2cb372bdd1d7a593803,76,63,98737,28800,69937,85,51,111957,25202,86755
76b00a117414bd8f9af48de3768d14c0,89,63,117605,36371,81234,98,79,172902,26878,146024
4e2be24112837e7f236bfba9fcf96aa2,46,35,37942,21286,16656,54,38,60323,18783,41540
8a8c6535a71753797f76745a22e2fa40,28,20,22912,12570,10342,34,22,26740,11818,14922
4654ed14226fd4c70f395902b4d24291,131,85,284740,45371,239369,75,62,111228,56893,54335
1c5cfd31436674534df44b878cbdd7e7,61,57,88293,29827,58466,45,36,71544,20417,51127
f6ffaa42fc5e6afeb7df1a43b3bfee1e,30,23,17239,6926,10313,30,24,15859,7847,8012
17b7ba360e134e52be11a215596348c8,153,119,303699,85285,218414,149,112,374847,95795,279052
fb4a52e13b06571d01a90dfec0c7511c,181,115,394491,87729,306762,164,128,373413,93664,279749
17cae987f24fcc7bf66df1428a8fd844,138,95,278108,57861,220247,152,119,359538,47091,312447
af038ee3a2a0c7712a6a5bda4474097f,98,72,146042,40603,105439,89,66,128657,34478,94179
ebae38e22a6344785b25586625d8b740,113,72,201927,43711,158216,119,70,223535,54205,169330
5a20880613ed348ddb7839af194c170a,24,18,5269,3257,2012,25,18,7918,2011,5907
e797478e0db8f25000771f0ef549b661,172,103,471106,105404,365702,168,132,513666,116051,397615
163dedb996910b95bfbb76aa68e95914,14,11,3675,3001,674,14,13,4792,1523,3269
649c746767ac3b3d3f45d972d26f1d99,65,51,105734,25400,80334,59,46,105328,23298,82030
1152c39bf5b84b22a8a377ed2b644ede,22,20,7524,4562,2962,20,20,7009,3666,3343
d3aafaeb44211b07bd543d56eb5441ad,31,24,16871,9901,6970,30,19,21881,5448,16433
5cde73c47dffb1590c042349389f19ab,137,109,490301,87485,402816,140,98,383409,76375,307034
a8354f5f5e6286a445416a3122bd304f,89,66,123269,27524,95745,80,63,110292,31755,78537
d35112acfaff62f08c9c14fa3cb3ec35,133,101,182682,44669,138013,98,78,195292,33477,161815
b50c69f4a5a1c638297de203e3a81222,73,53,76651,18967,57684,46,45,48987,24096,24891
c281a633a506d46224441adb8795d512,113,84,245858,64993,180865,122,96,259154,91890,167264
f863e6b0eac0633d22ea5ef0c1732bdd,53,42,43490,15371,28119,50,45,52378,16493,35885
a4c838b7b88d2de32dc1a3d9d57bd935,93,59,167979,46279,121700,66,51,137920,31845,106075
d2b2a873d068a2c95b68774f018b2231,148,108,535492,122341,413151,150,125,516939,206653,310286
c6448cb3a7a2c6efa688923b900b7c5d,113,95,270359,69416,200943,121,97,336082,68892,267190
86d891154b673a0fa0221a2919c0374f,20,18,7981,3883,4098,21,18,9802,3832,5970
382203beeff59be7a34bf21f9c75c07c,41,27,91864,16552,75312,36,21,73676,12588,61088
d7c1d0142238b4eb412969873ec18270,27,17,7012,4743,2269,25,23,7752,2844,4908
9e7df812be62f82ad209f47511cd5ce6,56,54,83646,37543,46103,63,53,109684,22795,86889
4d7839f68de19a0c06183ff9ae0b2cdc,22,17,6005,1721,4284,25,17,5400,1868,3532
a40833907b0abef5173b0448f236f4e7,73,47,90173,25823,64350,69,57,66137,29052,37085
277fe06e770bfef7541243cf5733830f,29,25,31311,12581,18730,33,26,26095,13593,12502
a9e94eef34a9e08e7f83d8e01b554033,20,18,20584,4435,16149,28,23,11234,6965,4269
23a1dcc98f5f747f14b7ffae661b5009,75,65,219389,60877,158512,60,54,151466,71853,79613
718bdba8171db9be0f6bda365e7f83cb,15,15,4267,1569,2698,18,14,2635,1311,1324
72f4b25e08786a22809a6473965ca7e5,201,137,773318,159802,613516,161,124,642232,214157,428075
ddea58ec2c04fc8aa3de3fa13975ccb4,128,95,231813,38029,193784,115,84,195446,39367,156079
482cf082c3982a553a02c976eb871727,92,77,195586,52285,143301,112,94,249119,36247,212872
92e42806bc8dd40822c2e466dee66ce4,115,95,245295,60129,185166,84,76,182076,66729,115347
c9080714fcca6318356dd1a85b10d7c0,125,89,739048,147517,591531,230,160,659090,162784,496306
5cd2d999bbc561466e0ddc0905eb1003,152,118,512308,98073,414235,173,119,567429,83505,483924
affcb1c52e482b575d00566234422e12,38,28,39240,15791,23449,41,33,47498,19264,28234
9c335a24f496a9b894532dfe232f1738,56,47,64423,26522,37901,50,36,55759,27075,28684
3f68bdbe46f86efdee3c2a147b95a0f8,86,72,170489,54533,115956,98,88,272807,60375,212432
2834685dac4c5a2c335a2a94f8313ea1,5,3,337,230,107,4,1,325,33,292
259842f4e6aec4b1cf71ddf578748994,158,100,333974,51091,282883,135,109,266033,75042,190991
42306731abb0dffbd3bcce232f68f14b,111,96,198239,34941,163298,95,75,138182,41288,96894
982812f47fd784262eb32a7bc2526140,22,17,7749,4546,3203,26,18,9965,3893,6072
5429adcc00d6e989589803c2887688eb,23,15,9247,3271,5976,26,20,16890,3787,13103
c9fd29b13dca8222ffd97c65893f7fde,86,79,228977,66603,162374,71,51,137871,52666,85205
442f958f9a433fb5f887914c7acc5e99,134,100,285544,56533,229011,125,102,298182,89462,208720
51f21d7eab11c43d80139cc36515d191,124,92,265491,61875,203616,171,131,398307,83252,315055
bb37d8b68ef5595beef6a917c6ec5171,29,18,15855,6228,9627,30,19,13640,3709,9931
c57d852037ffac3398a9542c1c33916c,114,92,269947,61168,208779,151,117,418920,79691,339229
030740e93060cea6ece5ddd32838a89f,147,118,456621,145302,311319,171,108,505069,143526,361543
7069a430fd0fa9fbd43b7b0be6e2559d,5,2,581,176,405,1,3,148,368,-220
cd161aebd1d7ab10eaac1c9dbd54bd48,116,95,252222,77779,174443,96,92,253720,63445,190275
3a58d6571aaa76a642aad88bf6d529d0,114,89,408532,92121,316411,135,112,403789,89311,314478
84ce42ebe238b18b6419e1248d6bba4b,178,128,481651,91099,390552,167,139,445211,121517,323694
83c272aaea89c1202238ee6e5063774f,135,111,292800,62203,230597,131,89,285081,58810,226271
03e316c6e46b99f9076a5561414789c7,31,25,25453,7412,18041,36,25,27403,6539,20864
5a2c093ef548e51d08efc8526b34792d,64,52,90909,28583,62326,68,54,97261,33670,63591
54d5bcdbccab0b4e6778b040138987d6,24,13,7651,3475,4176,22,17,5221,1962,3259
1d301b0452e9edb49dfbd61516719874,183,132,803060,120062,682998,241,145,601166,120905,480261
ec3e0d02b93084a31519bbb15f264909,74,61,144574,35770,108804,78,66,128531,42397,86134
2c6bea02e22e573b0d911a670d604160,51,45,43689,16772,26917,41,26,40978,10246,30732
82375f19d9825e60bdd93ed19a3c5754,38,30,34214,9724,24490,49,43,51118,15581,35537
0e5febb9522e0ac70956817ca7d1de17,73,42,88882,18515,70367,73,66,69688,28557,41131
d0a89e959a4cdd105f0d70fa5216b5cf,118,86,342416,58929,283487,56,52,156534,85097,71437
026daf4dd0b768f5a1c61562797bd945,175,117,546818,106301,440517,182,127,615764,124878,490886
7fb21c7a864c0cdd365645104d162bdd,72,54,81129,29961,51168,94,73,169636,25455,144181
1be1578590e8dd42567b8067fd49d2cd,77,59,122199,32201,89998,38,41,80322,28379,51943
880e69ec97ab28c8e0cdb0fdd79ad769,82,60,124247,29946,94301,83,60,119434,35808,83626
394082498762479bfdcf26fb93095e8d,16,18,3986,2173,1813,20,14,3779,1940,1839
aa3796effe71d38205a254e90a936a34,167,112,460126,79680,380446,124,104,312574,94859,217715
40ed1c45a677dc369315c52659858979,38,27,53628,16450,37178,49,37,62728,23282,39446
4a6dd5880e28082d0779536bc44d9dc0,117,96,232609,36604,196005,111,93,214645,54613,160032
9e29efff20e7c6446f74ef61fc16415a,110,85,269544,98914,170630,138,99,488338,107170,381168
44b549b7d58de9f690e0489c173e2b6e,135,84,298680,90648,208032,125,74,347985,77393,270592
9c80e7437f5b3eb18ab976917dbd90be,38,31,63598,20833,42765,46,33,64063,21524,42539
90d3d7cce4b1d88a427a838b4a94285e,147,113,349949,72007,277942,157,124,386507,85042,301465
0e9ee5f311700714538cdf32aa091df5,19,13,4664,2896,1768,15,18,3575,3631,-56
ea076ad311c96bb576a2e46d81ad30ca,90,59,105798,24155,81643,74,64,84152,20763,63389
833a9ec8c55ecb2d0d61536b02c03db0,118,80,158308,33297,125011,123,68,141546,32692,108854
7d9bf1b198dbfa115c557097378381ee,60,49,106271,32932,73339,59,40,118567,24398,94169
6c829198931ec8c74b582df69dcec802,153,112,480722,106791,373931,136,92,376420,70219,306201
5ae974100158f690c7a5304e34340d98,102,88,253698,53833,199865,86,66,179041,47110,131931
000432b654aee6e8792ce17bb19ccf16,25,17,15140,4746,10394,22,21,9222,5465,3757
46616f03ac762e9fba5ae4c54ee9d29d,244,138,1143895,162789,981106,219,153,794213,237641,556572
534043d83f2176597fc47a1b448240a4,64,38,53284,24658,28626,55,39,60586,24217,36369
dfb18b44b4bec4bb45412bfffcc919cc,79,63,116920,32644,84276,79,56,139372,22302,117070
c881c7f0dd1c9fb8ed405a9782c2c96e,167,121,455474,69512,385962,161,139,439032,70835,368197
cb3519740c17ccbb28d91bef7e5beae0,131,93,324927,105251,219676,135,103,447713,100075,347638
be0352ba56d4af27d18713956a5ced0b,65,38,68656,21140,47516,60,44,78108,21091,57017
119f0324d724016c31318d7bcf4a19c7,137,89,393835,96647,297188,199,138,430407,99231,331176
92d15b8d6405b1176126189577fec047,166,107,374486,111333,263153,120,93,364117,114450,249667
51834c43d71412b8d719e58e797748b7,13,11,3719,1662,2057,14,14,3341,2827,514
0c59d0bcd7a8c61d5d35dc53e0941782,170,123,492001,75927,416074,119,102,344725,101976,242749
91271938af7a52ca1b748379605be4c1,23,20,8702,2684,6018,22,25,8122,4750,3372
efd7e0163ea9bb14df3d38cd7db43092,80,44,119400,43683,75717,123,93,249007,46839,202168
59ee190a6987ac494cc5e58c9ddd8b70,282,219,1843504,346313,1497191,299,219,2933244,341656,2591588
c233b2c481bb157d11c6c80bc669f342,117,94,299694,64771,234923,146,116,327088,75825,251263
22c069571f099a97a5f61707a8de6cfc,88,85,158920,42141,116779,89,63,173911,42458,131453
dd53f8ddbd2fb4e6d7d8f525fcbf5e0b,126,92,359589,76108,283481,167,131,520048,80700,439348
43e5d380b9dba63ddb914a322f0fa4ff,148,119,404367,98311,306056,140,114,331873,76976,254897
e2a6fac84ea11d2f32adf32a7440369f,80,58,142837,60915,81922,94,67,170953,46474,124479
ebda49b65d8735d0953f240550f6f368,49,40,53367,15899,37468,30,30,24340,14050,10290
4e72db97acd599ce0912b00762785764,43,35,35348,11417,23931,38,35,24781,18295,6486
43a36f3d28cbaf50d1168a69d046b065,38,35,43996,11980,32016,52,45,47434,16049,31385
3d2fe14703740716d5942d67b5ecc067,22,16,9433,3788,5645,26,21,8409,3084,5325
35e85d03ae69403d21a359240df92607,76,68,141989,39062,102927,74,53,123867,28721,95146
4cbdbda029b3b7b66389c87695734b6d,142,76,270998,55151,215847,77,63,138966,80214,58752
7d2ea9a6378eec4dfdcd5d8485d8814a,50,43,73442,21149,52293,52,34,49667,23375,26292
7ab0a6e9575c3bb013c439a6c11cf572,85,70,135261,51876,83385,120,87,195548,36450,159098
d414181c902bf36735c75a1dffab52e0,116,96,211366,61944,149422,89,74,163040,57168,105872
58d0a80277ed4e45e4da45b0366d9c91,46,37,56824,22258,34566,51,35,55074,16963,38111
eab2e6aaf4e0fcd8cb59aa45d35957a4,219,153,913506,179197,734309,147,133,752765,204390,548375
6726b99a908c5c9e10e632274b06f53e,161,116,372730,69011,303719,137,101,373019,49171,323848
a9b759d0bb0b8e39f3f1a61567c6af3c,154,121,384433,56635,327798,102,74,289634,74324,215310
a9bff13d6490243951f325774781d262,32,24,25570,8087,17483,26,20,22649,9013,13636
2b2ef4d2f0372425b21dcd512dd5289a,50,41,78595,31720,46875,62,41,74991,26944,48047
0e422a5730d0de9282dec7c583f53ccc,34,30,45204,18870,26334,39,26,50024,17845,32179
624f248953a369477409a1f342f76066,70,54,101236,30188,71048,71,52,99652,29068,70584
5903137511a5b389688373e6aa0923e5,115,90,318135,123415,194720,175,116,405676,94969,310707
25f7cd81206da136029503e5da598223,67,57,87635,22721,64914,66,52,57171,27268,29903
368da2b9eb1c545255a2381bb683761a,99,67,114657,33153,81504,73,49,85066,28915,56151
87ea563b23a358d52b9952acdecd89ae,28,21,16331,7048,9283,33,24,22154,7690,14464
6102f17ebcd67b283b8b66fbd6216f52,140,116,373067,89977,283090,156,101,303248,67899,235349
eb37b1c25bd1011779f0e4ebe20bb2c2,63,48,117543,31926,85617,75,62,108666,18498,90168
b74fbd2a5aa70c7d8634095184a54d2e,50,47,64699,15450,49249,35,24,31027,16165,14862
6747a61c867b35cf249843081d586418,84,69,136856,33126,103730,86,64,121869,29760,92109
420a36a13ce17d63917ddb449f865ef0,67,46,120306,18056,102250,68,51,70216,34241,35975
611f84dffeaa34c92493a9537e39fcf9,25,20,7364,3454,3910,25,18,8542,3910,4632
1ddd073415a21ad3a5228e5b767e9d02,76,60,110595,30297,80298,86,57,118738,26833,91905
05051a2ca5a718005cc55cd0302262f9,75,57,103359,24158,79201,88,68,100133,27056,73077
27f7862160d8dbbed0c340f59bbc6693,63,48,99719,29074,70645,104,79,179862,29068,150794
36d0079fb138d8b43d599ca905eb057b,54,34,57478,18239,39239,61,48,63841,15671,48170
070613c0dde90e417e6ffd4175fc36f1,22,16,6189,2225,3964,17,18,3621,2261,1360
254072a9d23c4891468593ef12e4ee2a,175,130,736385,143845,592540,161,101,565744,119060,446684
2b2bec108c2b73904c91c99ed912680a,89,68,187989,42300,145689,100,91,192486,37846,154640
a3ae80126880dd1d755a9c4b8c1132c6,41,27,24868,9969,14899,42,33,32763,10349,22414
b37ceb266dbcd5174785a7062e976938,63,46,67675,23306,44369,66,61,74196,23627,50569
785ef14aa69606f16e302736c20d333f,126,99,334723,106394,228329,109,77,304024,63743,240281
5a41cc00b59112a9ae6c1f7b1c8917dd,29,27,19558,8756,10802,35,23,27410,8031,19379
76fe99d6c00036cfa2065292595d75ef,151,114,495763,127658,368105,155,105,550086,110469,439617
162864b453707c6999cc390b2f1936f5,114,93,217603,71596,146007,110,82,253268,43186,210082
b95316f4ae67b11a8926dbea6c0f439d,115,84,290247,83575,206672,97,77,214958,84846,130112
85141a39ee260339b66a338ef2e2c581,120,101,300334,70670,229664,126,81,336750,57719,279031
9315ef8ef38a16176e811e4363c6db83,45,38,46383,20578,25805,41,27,47422,10650,36772
ee6650446c4bcb6941dc8e74ac289568,182,129,468709,109597,359112,173,139,754218,116012,638206
484bd143a9d8152849e2643f457bd5c2,83,57,153513,33934,119579,68,57,131563,42532,89031
51daba96a8621360af3baf2d5e71c176,149,90,286063,60843,225220,137,96,274119,65674,208445
f1c17c7596f662bd162ed54ebc83e359,45,36,38729,9277,29452,31,28,20606,8438,12168
ceb1e4f63de54c769b3693052f2fe816,30,25,9530,4647,4883,27,22,10911,4290,6621
52256fdc63a541753e29630bca7b6599,27,22,11478,4956,6522,25,24,7650,6025,1625
6900e4ace84ca5ebd7271e797f544e11,28,18,23056,4689,18367,30,28,21055,8630,12425
ea4e26c6ecca076c5461af9452eee6ef,96,62,143902,34044,109858,86,69,175012,34677,140335
eea0e3f3a5f82b89513fd968b06ef7ae,16,11,3823,1781,2042,19,13,3979,1745,2234
c40073eaf3f9c914ceda6f5c9a634662,177,124,606766,127171,479595,172,138,548897,104625,444272
006c5713c9efa936420fb97e543eef16,138,103,303432,89773,213659,136,105,344058,70546,273512
ad71ae6d4c208ed0653d4d32fe753df3,79,63,134704,34597,100107,124,74,188246,31442,156804
3d5d381f7a7aa61231c434fc15f48ead,96,66,168700,45761,122939,112,79,219720,36966,182754
f4d6710c4d64d07b0c22cca4fbb61068,62,42,67849,13339,54510,43,34,35776,14649,21127
b005eedfe58155b5b9a8af38bd07c8ef,103,82,235730,56662,179068,129,105,285593,67621,217972
1ff5009aa66d34cc6d8c5aa381755989,48,41,43252,14049,29203,35,30,31709,9470,22239
22e0b36991257278aea39966d53a6767,80,69,150222,46837,103385,106,82,209744,56055,153689
3318d475ac5a204938fe0e7b9e0e1889,153,114,374807,83936,290871,145,119,438747,86728,352019
827a18bb5b7b917e639d20a07645cc2b,54,45,77704,32640,45064,82,65,94024,31124,62900
82b0fef8bca49141af2895084a4ea342,138,105,302020,40769,261251,121,98,245028,53102,191926
896f39a856db93d4cf78925ebb622cf1,42,28,24165,6700,17465,40,35,26614,10086,16528
93ee85a772f4acf8fdcbfe0ed7eef169,106,82,186615,43402,143213,101,90,154334,57036,97298
4d4b18a4582b8f71b2a5d4681d3c9723,97,72,157781,55851,101930,72,62,104043,50152,53891
8f004ddb53fa28512dfef4f6b8c3b8e5,139,96,258251,71527,186724,122,114,252158,104216,147942
39d3ca1ce68acec8f2ec9b5b2bd55a14,163,122,673031,143393,529638,203,155,813031,135662,677369
046e4f8607aa2ddba37d6077ae0155d7,46,32,56836,11041,45795,38,30,36355,16975,19380
0b9690a074b0201a83bad44345ef053c,176,119,434728,96142,338586,152,107,470544,108777,361767
aea9d343b38b38bf0befe639abb79371,162,115,440749,45162,395587,131,109,318220,92587,225633
4163f9a294334d04bd89ccad304955d5,143,114,467459,53780,413679,177,146,576265,78862,497403
e318163dc75af36520ff9c02766ba56f,41,35,55256,23197,32059,55,40,69335,20278,49057
884f51635f9a1748a349e87cc18a14f8,144,101,289002,72361,216641,145,126,336162,91779,244383
4b59fd31f4d9b16d837e6dad5d4772ef,86,60,173312,43088,130224,84,68,185377,36363,149014
8c4fe6a9b049f20030544db042876bc5,60,41,97074,33336,63738,76,62,122948,39075,83873
cb7346ec66c67d617e0cd3fb5f85ed76,142,101,498311,94631,403680,150,116,627609,105680,521929
d20fb60af94cc88a67b3d7308b56461c,57,41,73777,17881,55896,96,61,96989,18298,78691
3421dd11aa38e4044a32074d9b36f629,55,49,75816,26287,49529,56,51,60723,25884,34839
5fcb0a24861cffb07f1b4d50e5f3d617,123,106,292741,89591,203150,130,105,370652,65290,305362
2d090ae80254a4deb70e706e7825c1f2,150,110,412435,112803,299632,166,132,522097,97294,424803
9e114c4764541d325111b5c130afd340,29,17,19149,5205,13944,25,24,17697,7410,10287
f46ba277795e7bd25e597e6c63850a5e,140,123,359964,103989,255975,131,108,344250,88980,255270
bf162f44be1b80725269e71a0fb77b58,12,8,2864,1140,1724,11,10,3383,1794,1589
4035eec56408233a7311067df6e21b31,131,115,315257,66931,248326,131,107,349188,72906,276282
111f111b6971e87137466ebe1e97d70b,132,107,338558,92746,245812,118,104,312628,79504,233124
cc93f1469cdc1e9c590b8e2f8ddf51bf,102,74,152833,40385,112448,83,60,137253,31105,106148
9487cbc2c33d9ea269cb3669ef9affec,153,116,439068,118587,320481,159,118,584640,115895,468745
673065f57970cb6079c6e941602c4163,87,70,109667,32771,76896,91,69,114634,35259,79375
007a89c2d838f4df2c0c8dbba2056268,141,108,462037,82915,379122,138,95,517230,130244,386986
7f848855d8898833fc2594b1f3155c5c,106,85,254954,88181,166773,122,81,269939,60391,209548
460e502bfb7fcd936d78226b2e90bfc0,16,10,1572,553,1019,13,10,1101,600,501
e52ae5e951799911390b310b93af7184,115,92,213228,48524,164704,106,87,198512,54556,143956
e5edf1358f522f5e0a88527e176b46ba,78,54,172329,74017,98312,83,54,188750,46788,141962
d749d40748a679066487902d962c94c4,129,106,332913,65745,267168,121,107,293108,78159,214949
58cc1172b2131c89c2e5812579ea829e,157,131,588773,89009,499764,162,125,424575,129347,295228
ab52d4d13bf95be2fb73346497caae08,81,57,157064,33482,123582,97,75,200819,33973,166846
8b0440884fb65d649698f4a5965f1a98,148,118,438695,99213,339482,170,127,446101,105901,340200
fe7ac251bc1c4da3fa82cbab2857df34,60,46,62509,23667,38842,61,53,78402,28815,49587
69d2047b3200863df4de2398bc200591,53,41,58843,16315,42528,42,31,39182,14265,24917
0d4c02e3942fce8a0f4b36e326cd6304,78,52,147298,42416,104882,88,66,170052,55643,114409
80723b0015d3e158f53f6bcc1af81234,28,22,25239,11213,14026,33,20,25360,9162,16198
3c112ed28aaad881c7ab1144a99f429d,30,28,32064,10905,21159,29,21,15498,7582,7916
b46c741eae30a67b10473ecdc4405d33,39,34,25669,14775,10894,42,31,36826,9497,27329
0d8bd148fc9d7cd99ab550091bc71a7d,37,29,30271,15015,15256,32,26,38749,11376,27373
ecc38b7dbd31db544f1bceb93f3eae76,155,130,336676,61849,274827,120,87,268637,59279,209358
10eb77fb6d075dbcdb0f8b4b4d5b7d10,115,74,290468,90725,199743,155,118,466647,106816,359831
dcea42183d7d4028aa688ececcc99d4f,120,90,240169,85384,154785,122,94,220199,60940,159259
6cebc02ead2fa8c4b4f527724e657065,104,72,174302,29227,145075,91,63,184298,31058,153240
d3957985345155c2915e4c142ccd331f,116,89,244809,49344,195465,101,76,177013,38821,138192
9a9616a81535f432a8020225eb4f582b,53,47,89404,32605,56799,71,61,99167,33518,65649
39aeaeef6e08af23b0f0d088871c9760,42,31,40790,12792,27998,64,43,59783,17337,42446
9d85d57b076b1bcb6dc388cad5c98ae2,123,80,224597,53582,171015,137,79,279123,48455,230668
242b45dcccecd6d3a89612f6bd4b9cd7,85,70,97438,34767,62671,67,53,91097,27830,63267
3746a77962b7688cd6e62d348d758047,170,126,576120,145448,430672,162,133,606820,169516,437304
6be42baa5e82848ff77eed0808a62b59,119,93,266196,80476,185720,128,101,303006,105586,197420
fcc0e35e42c042d455ee470995fc8058,125,99,293075,55520,237555,103,77,224283,49653,174630
e029d3031cb1ad9b0ef9af1350f1b5b9,26,18,26494,10721,15773,26,21,30168,7749,22419
415e215c4af3cdecf086b43422fc2382,133,113,385691,118788,266903,146,110,414302,73268,341034
f05a4796625d89b98f1183e3b2c289f6,20,18,5772,4866,906,25,15,12031,3324,8707
d7e396b06ba611f59313dd4c9b99335c,22,13,5776,1768,4008,29,16,9048,2638,6410
1bb1e2be71c1b3fdb392762e91593f21,115,85,275642,80256,195386,103,88,288459,66053,222406
fccefc5514a112ca4ff004acf9a1c2b2,113,82,252764,52778,199986,131,104,281850,48487,233363
ab3701a9fc7bfc610af30837e6be63b1,135,93,317527,74197,243330,152,119,362702,74042,288660
393649d3715f5d895f7194388d19764c,57,50,78444,30738,47706,48,37,68664,25212,43452
c1d7716413ba3afc05fba58c378f517e,26,26,23578,14211,9367,30,24,32989,11087,21902
b3d74331eccaeb0f253d190e9c9e2b5d,22,16,9861,4673,5188,18,13,7955,3726,4229
f8a08c47e9d1f9a6d441caf38a80ffdd,56,53,73067,23449,49618,59,48,55406,26336,29070
143db81ba87b70867051818d13d99f2d,176,119,638348,156056,482292,183,136,573935,113731,460204
5b8cc63d6663d9f930925a8d66e0b74c,27,22,24132,7186,16946,27,19,14792,5388,9404
dfc9dafd50507955ccce26c60a1789b8,26,20,17326,4035,13291,27,26,13887,6381,7506
e5deeb56e77a8ac6b6fb3ef292f18b08,55,40,58937,23649,35288,72,53,92034,20507,71527
c76006d903066cf62239324949f89cfb,55,40,62315,18377,43938,45,38,37859,17064,20795
8b861c788f333e355b9630e61df76480,20,16,7723,3689,4034,31,19,9663,2558,7105
b8897b8ccb535ed7f55eee1b844d297c,103,86,208724,43881,164843,83,69,139889,34180,105709
a117e1d6826616d96e239ab21e7a7bb8,94,74,209180,57092,152088,143,97,340650,37344,303306
f17d68e6bf8d14d7ac1b4ae0e700d0a1,40,35,44773,19142,25631,35,27,44136,16893,27243
aabb4801afb0ca9b788d1e50e9b4144b,97,80,224285,70233,154052,91,72,231966,72976,158990
5dda5d45b93cc87417f05ddcaaeed67e,96,84,231354,60597,170757,97,75,141476,49219,92257
317e4905b5f91adcf23bc9194f6a68f6,159,136,520678,105804,414874,166,127,530098,95603,434495
969441fd47e26be8e87a9e346e27e01f,69,61,82298,27895,54403,64,44,95479,23910,71569
b5d5dd87021a78874c9d6561f833f1ac,83,66,104591,51561,53030,82,78,188566,47225,141341
31175b5602742dcc5e1f669efbd55f4f,203,146,739783,103296,636487,159,129,746563,146373,600190
c115b78bd72f7a0bd6a31c3b652ad52b,185,151,842417,150405,692012,239,184,951965,168497,783468
8554c9399b0f666460ce63ffe3686c33,96,77,163146,55740,107406,132,101,272885,49705,223180
f48cb14aa2768962503d78a18b05e067,34,27,13761,4962,8799,35,29,17577,5853,11724
0cf921e3c67951d2c2a27422332c2f5b,197,138,850639,169560,681079,184,127,661637,143468,518169
62c094ed1c01539eeb0d0aa429389bf6,1,0,101,0,101,1,1,300,101,199
b3e5a58b82be559936a82c309d695325,28,26,12187,7469,4718,28,23,20125,5825,14300
426ba7a20b8faa152ebfb4b326fe3a3e,34,24,21094,9488,11606,47,43,46875,8936,37939
a4a7bf2a833219c3dfc7fc038eeb8c5c,118,93,258864,81124,177740,162,133,416333,61824,354509
ff0765db7af3f3d85f9726ef085fff63,142,89,427587,124232,303355,176,118,541093,168300,372793
1ca0c499a586d15bf57147b934e2292e,184,123,582618,138299,444319,162,120,1090904,155402,935502
f223318ba2e164da8671c9e15d064eb9,24,17,6376,3246,3130,25,19,6726,3641,3085
f0a35acd8dfcff501b342c01ba77e81d,47,40,64498,17224,47274,54,41,68570,21497,47073
bdd051d8a96b4a702d635f7da511274c,25,21,19180,10201,8979,28,20,21446,8813,12633
092ea6177681b1c1a4064d973af79eb1,56,50,64968,25356,39612,63,44,65177,17024,48153
081380792901042c0238e4a322e1edd5,67,55,135122,48792,86330,67,46,138072,37169,100903
19d0b82d4cd5f1f98d6847777921833e,139,110,354903,87140,267763,143,143,336353,103102,233251
807690f63f71cbc5c506ade6359e5e03,76,69,117027,50905,66122,89,71,177238,42743,134495
41683aae920e34f64320675f0da9386b,21,16,9535,3410,6125,28,19,17457,3831,13626
cc9e8f1b024e9f66a0e379874744d1b1,196,135,690723,124846,565877,189,140,706406,90101,616305
0ebad4a0dddf507a0aace0977989dd1a,181,163,497160,139853,357307,120,86,567493,134602,432891
516f3dfbb12f69b9abf2bcfe5fe7b56a,109,98,189669,58791,130878,77,59,116343,47673,68670
ef6c23d0e1ec9eb2e0e299eeb8d1dee1,48,40,71618,24618,47000,60,51,68325,25086,43239
3860c50511c2375713343b13e22dadbd,47,48,88402,31268,57134,80,49,108215,29946,78269
920f1292c09e81be526a8fe69737fcc7,125,86,387138,85964,301174,171,137,561889,106051,455838
f83f9dad0078fc8c387005ef1c65cc4c,38,35,26570,10346,16224,31,27,25216,13094,12122
2606467d294f044ebe9a0073afe2221e,25,19,7757,2634,5123,24,16,9687,1876,7811
cfa9edabaa0123a76a92149fedbb25af,12,9,2086,641,1445,10,8,1256,832,424
9038d4a400c68f94f02e59e30b671a56,125,102,350283,83947,266336,102,82,271453,84685,186768
68c51d958d741d9440fc1284d9e856e7,50,35,91374,17643,73731,49,41,68763,18886,49877
4c72dd662f0b9c72e4b6c2a2887da90a,96,70,177394,30397,146997,81,66,104123,41823,62300
053babf453b866e33d57ec63b84f6476,116,84,189426,54337,135089,93,74,136037,45089,90948
f0e06116aa7e0307974e824c9ad898f1,85,56,141651,45465,96186,115,98,210723,53761,156962
3b1a7303bb838b50d2ed4ed38e4c6df8,63,53,98404,24966,73438,59,43,77824,17138,60686
356c06cef5c2bc65b2f181bd42c3f016,24,25,14755,7722,7033,41,19,26251,6298,19953
ba4db47c5b15293d4d516ffe9fe5a301,64,56,106621,33819,72802,60,57,87050,33958,53092
d4a10a8def5ccb7b799b652769c5c77b,50,45,45670,27536,18134,68,56,110652,19613,91039
d3e9f4885fa3b6cde1b7ed513f651998,125,101,282039,83675,198364,134,120,301130,102888,198242
47112437a6d02165117326359ab5c22c,26,20,10260,4353,5907,26,21,8687,5583,3104
d9650f75711ecde7c53f8368d452739f,89,83,230072,40197,189875,114,85,159230,57424,101806
b968cf1ade29dbb9409bdcd924c798fe,101,75,131424,35046,96378,107,76,171963,32880,139083
cf489f4fe3f7b9a2bfff16285a2b08a9,45,36,35162,11878,23284,48,32,51544,12315,39229
1824656f0b59c8fde15ae5d98c9fdc41,84,64,121503,34623,86880,52,44,66208,27304,38904
fa6387487c63b640292c0490a9afbd68,130,98,261855,46000,215855,95,71,164814,36006,128808
4b8a98b8e809c83244a4016bba2d4843,141,106,419589,149321,270268,116,109,360686,139873,220813
d2c7a62fb5ac025be7ebb50693ae45b4,143,99,339666,95086,244580,180,112,375058,77874,297184
7f1823a2f0a857d86b52af195697aa0c,43,28,33652,12651,21001,36,28,35737,11450,24287
66ef2b23e917043f136c686f6c02ab78,18,15,4336,2777,1559,24,21,5582,2775,2807
222990c021eb1cfb5e129d0db11076f6,42,38,44486,25031,19455,49,35,64985,22279,42706
3bc05a666591ea14e7a6f7aa51396c32,15,9,2195,444,1751,10,13,1682,1162,520
26d39f5eaa69c987e4d8df9e2213074d,153,122,443066,109057,334009,131,103,351932,111352,240580
c62d19b06c89be8405ca4c07e9c8dd84,20,13,9684,1888,7796,19,13,6455,2001,4454
005ed7032448842cbfbd5c9a0413d5a7,155,121,535352,88743,446609,177,134,540283,86597,453686
8a90176e6fe1394db039938afba27f13,28,26,24618,11060,13558,32,23,26246,10145,16101
82f5b529679f203b3a8be4e8f2b08865,2,2,181,111,70,1,1,31,101,-70
ac67febdddf5f0b70d2341240915ae44,69,55,107341,20450,86891,69,58,73155,24045,49110
a3579b2f304f1a75fc12452e4cf2c82e,22,15,17991,5114,12877,31,25,18121,6442,11679
7e4c4d2bcc1d979f4374619dc3872a15,127,81,298867,56381,242486,147,112,368436,56292,312144
34d3a234990f8f6784abf4c168e7f0aa,27,24,9546,6297,3249,25,20,11561,4967,6594
a8bcc9d1be47a5cca103b2678ae54645,56,41,78314,23802,54512,58,49,103411,23187,80224
11e457212726d8293dffe78bb54af6aa,128,110,332497,71693,260804,121,93,296963,54793,242170
daa75c55f651c64a6bd5c5b333f02d55,61,47,86732,31484,55248,99,79,164973,26423,138550
ec8aa041aae4eab59e6dd09cce778f47,65,54,107367,42339,65028,119,107,231505,46126,185379
7fa7a0c346d211d38cf1cf48d2e969f1,47,34,56153,22187,33966,60,48,86080,26366,59714
a89beca7138487153c96c458d13581fd,38,33,39184,19819,19365,39,27,45560,17806,27754
84635eb43fa55ac19a2659c0a83dcab8,90,51,157747,31763,125984,103,80,134883,37726,97157
ff4f7f0f759309f61bfe358de8f05463,47,40,73376,30577,42799,59,39,70260,31287,38973
8b0b4502046e60126cc111a631d355a4,90,70,193477,56835,136642,120,93,244889,61182,183707
0b1f837c62ada855948f8dbd29f55a50,90,74,206208,52006,154202,100,90,237310,66773,170537
3dadd5d35815d7fdcd3d8944a0b3dc62,97,79,300794,99808,200986,138,122,424564,109474,315090
a1fbb9ea9e51718d6526cb61c8ddc621,30,19,16073,6924,9149,33,24,18240,6610,11630
61b4b37bc0f6998e321a4f5be042c5a6,87,67,227752,52659,175093,89,67,229656,50637,179019
d409353d563da62d8dffe6c1b3e8f1c6,72,59,131016,36384,94632,89,68,136217,45775,90442
a6bfc52773d761e1306844520c5da04a,92,74,237013,47710,189303,104,74,213622,52778,160844
71ef9ad827831594ec78c97e9db327dc,32,29,26344,10689,15655,34,27,25184,9745,15439
e21d9aa1509a77673305c8220bd18459,62,56,118859,32042,86817,82,70,118567,28861,89706
064b0f2c9530372cefda1595d5e8096b,26,23,21677,8975,12702,32,23,21139,8170,12969
ec93a182e15f5fae407ee611d70d98e9,87,62,147124,46567,100557,139,93,231192,37611,193581
bb94c7e9f71af986456a5c33548e75c6,42,38,35552,8310,27242,39,26,20809,7131,13678
9ea05ec429231c0ae168472534cf6e7e,41,31,37518,16691,20827,60,42,93116,14450,78666
f9ec924ba09bf6c1346529bf34d40d3f,25,17,10590,2783,7807,29,28,12574,5493,7081
9dcfb3db5bc5a1804f4df2d16fd24d15,17,10,2191,1590,601,11,10,2499,866,1633
0a363376ad9169ed8414fb77187c17d6,84,59,177636,55694,121942,68,56,136976,53060,83916
7bd5784056bfeab75b22be2b024abe01,28,24,21686,9848,11838,44,36,41452,9896,31556
6cb76a2c784437a712069e17a1287d9c,57,38,93737,24903,68834,63,55,121171,38142,83029
4afc31762c6318c7411e2ac9cbc24bb4,44,31,31048,12456,18592,47,39,40179,14810,25369
399b893a84a272bdc573a448889b98b3,196,140,765735,154863,610872,166,145,633815,160893,472922
c828c87fba8f5451c9d139eccca3a8b7,3,4,900,952,-52,5,2,1000,716,284
f3521498997e2e29dda89b49ada99b47,130,93,238835,42664,196171,96,72,136225,63072,73153
1e6c70b1ecc03d38c9b5ff4c82453fcd,133,92,330146,84218,245928,188,149,543773,143012,400761
3963fa70ddec423a22b5bd81c76b84f3,98,88,145189,46230,98959,111,83,177438,40879,136559
b94c91fbb09b418ea83d5021969e16d8,26,27,16498,9483,7015,32,25,19214,10068,9146
a69f1141e9b8582c90d3e1ce1c80b723,167,124,533343,86780,446563,173,142,505168,125046,380122
0b511bed3ba6a504292973de90ae2cef,46,37,81529,30469,51060,62,52,91157,33997,57160
c37b53e2203ab03f5aa58aa546178bdc,52,43,62589,29220,33369,75,61,94804,27727,67077
45b9ab85bc3e805f00387addaa8bbca7,125,97,346827,83509,263318,134,101,394869,69263,325606
ff9c5b46443507b240621552237780f5,48,40,47666,19456,28210,58,37,63245,14346,48899
168e2123fdc2fad7136ffa1a1ddfeace,21,18,7133,3040,4093,29,15,8118,2756,5362
a984e05f64a01954528bae900eb1c2f3,129,85,239481,46051,193430,80,70,149418,54607,94811
047ffd5cf0d28634d428e020186e312b,94,57,108645,26045,82600,78,61,104314,29610,74704
dd55bddf51561d268b56afd1187b07c6,82,73,173932,47449,126483,88,63,139155,42649,96506
eac3a62548d5e63544b95154b8232a5c,100,85,249714,54305,195409,124,97,236877,43600,193277
ac3bc9b1b661c6d093a4ed038e772d6c,62,46,87786,26388,61398,62,49,70909,19926,50983
27151e8b2f6dbb7321290db112772813,168,131,473706,124402,349304,135,93,397056,117726,279330
bdb3f3e3ae580b546b9c555b2a75732a,178,124,620470,112805,507665,195,139,631865,91710,540155
57e2573fe2551d2ab166f88e9b28b9a3,2,0,137,0,137,1,0,84,0,84
769db82492a77c7c745503869295e103,162,124,567287,129755,437532,125,90,372747,128483,244264
b63a200b8177c1951a0235ff7fac82d2,86,60,97998,35914,62084,100,85,136590,35885,100705
1d75cb56158240da9c7450172f610548,34,23,23906,7419,16487,35,26,28687,8148,20539
09e7f9440c053b8ce4a5f281734ee970,109,93,310301,88483,221818,143,125,313082,90330,222752
ced73703c9462bf5ebd870cf0f526caf,23,24,25699,6340,19359,36,25,18215,6466,11749
d6db1d5d6778645bd7d406d4aebca291,46,34,54634,21242,33392,44,28,41521,14445,27076
fce5476cfb38034e7bffd88bbac2afb4,33,30,19396,7469,11927,31,26,25738,9091,16647
683d79e12446ed9240f1c07b7ef020bd,68,51,117778,40501,77277,98,79,176936,41696,135240
4bc4be391fa665facb7269ff67d4a0a9,29,25,17201,6125,11076,35,20,16420,5795,10625
0824e7533cf990364ae0f7f084064cba,20,19,6772,4675,2097,26,19,8976,4095,4881
ed87667c38c36b4c1d6a02474ab60d68,39,33,64786,16379,48407,36,25,45396,21050,24346
c45fa9b3c53b9b290f0fe70481cfe6d7,24,17,9143,3989,5154,28,18,12765,3339,9426
002d200e205eaa0316dd278b085ef616,48,38,70149,24095,46054,49,43,74913,24674,50239
73e701f4e843b08394d779182f248840,26,17,17799,8374,9425,20,21,25815,9590,16225
cd5e462cf2b124437499b04843bb6c88,51,47,74237,23987,50250,54,45,63640,22257,41383
b41d85036eb01f2089cc9874ffb37608,115,91,248471,51007,197464,76,71,114136,54115,60021
0ab5575b91d5dce8ceafc404fe49d557,83,64,146122,25379,120743,99,87,169237,43486,125751
184083e0aa29d996bdf60dcbcde5bfb0,37,34,33866,13720,20146,42,36,31767,14626,17141
367a2a7f76a3da6aea2a250937d0e793,90,74,155238,60847,94391,95,77,152917,55670,97247
fb4e429641ecd0d6c0d7aa0ecc43e2a0,80,71,164766,43956,120810,104,81,185843,45267,140576
39a49889d17f720b53314c4126d85f06,25,20,15907,5973,9934,23,16,10930,5831,5099
450c2bea9c43523e9ba178b7dc1a9c2d,138,102,451437,130641,320796,193,123,599261,135908,463353
ca8e3fdad1455b90fb6fa05009e0f940,109,103,395599,100785,294814,160,105,364212,65417,298795
c77f326a9afbe0fdb7203f79bfb605c4,130,117,250252,93142,157110,140,117,336893,68533,268360
b229b8ab4ea9526f291312a46b225a03,35,27,40798,18536,22262,39,27,37791,17660,20131
5e0de0afd854b2a15958c2913077b840,105,78,212722,61595,151127,141,98,318170,69203,248967
10343daa4d33101429f0144ab11a5d41,19,19,3806,2478,1328,22,14,4428,1824,2604
4f67f690c2f8451b117bf2898fcd34b8,124,83,284280,46369,237911,130,96,279384,55106,224278
f8f8a05c49e300187ab99fad8036bc95,11,15,1899,2633,-734,20,10,4140,1222,2918
41fc9ec2d1b99c899fb23a0b6446402d,33,23,23651,11128,12523,41,27,37648,7414,30234
401228952b5fdbb41d58aa8a8d2f39a1,31,27,34579,13290,21289,36,35,35485,15785,19700
d619e4fc94afa39468e7042aee5a70e9,49,41,54263,16220,38043,48,39,68389,16465,51924
b0fa3b6fb2b2ea47e365343454f39375,19,11,4366,1152,3214,14,16,2334,1347,987
ae22055cc9c5e56873da256da9a3494c,127,97,372359,84010,288349,150,109,425071,96819,328252
8c06edfd1717b947d92f177d86b9ca5f,28,20,22278,5074,17204,24,21,13059,8632,4427
aa3b7b4ba7577e93af270d6bdaf0cc46,17,12,2822,759,2063,15,11,2315,1342,973
f1780ff9e6f6679ccef3d8547a5603bc,62,44,85079,30004,55075,50,43,97019,26185,70834
a6ea35048ef1d12eeba31c473277f92d,93,82,179033,43869,135164,114,79,201314,41119,160195
9c440a2ca795a31801b5e0b3bb4fa48e,31,24,13001,5589,7412,25,24,15724,4634,11090
158d0cf3231b107a8a715f3198ff6666,124,102,257135,76454,180681,131,106,259174,67800,191374
79452c4bafb233c1d7784b9a1b4f4b98,37,27,43481,15443,28038,35,28,35028,13118,21910
bd17b18d051b85700596da07b8cec1c0,89,74,183174,53976,129198,109,92,246054,40291,205763
490267bb0679ac71334d39fe071020e4,85,62,115549,43059,72490,99,94,210302,51275,159027
711fcd87b8d90798c222c4016ae539ba,39,33,34350,15960,18390,46,31,36911,14650,22261
07700ca59b652eec0afebbb70edf5aa7,134,112,316526,59591,256935,104,73,224233,56521,167712
0e9e23cfa7996d9e5129eae5ba9f44a6,119,71,233417,57842,175575,104,80,201671,63733,137938
d9c617125ba3877dfe82b02fa3f94a26,162,128,638572,124349,514223,171,108,552550,150164,402386
d75ce7043f25ea53c2daf0d0061015c0,41,33,31331,10179,21152,42,40,52204,16803,35401
6ad1d01bcda6026221497306adba0029,105,82,316062,88199,227863,123,95,371155,117224,253931
1f015532577ba27aec9a27d3ae2d4c38,153,132,425227,96151,329076,158,122,410941,78422,332519
bdf58077d99c404195f7e160ae716f5e,82,67,170924,47132,123792,77,38,162503,24276,138227
3ea841050ed5e6dbaa80a8bfb104d37f,127,94,316370,57501,258869,146,107,365087,85789,279298
feb99eb97dcc3168cb712f74254de85b,105,75,185063,40848,144215,100,67,154753,37226,117527
933ba2edf04275acc90f099b1b324597,105,80,229764,55980,173784,116,84,267092,53643,213449
f88e9def2c5979fc44aec7bc92db716b,118,102,207276,55772,151504,84,71,169056,58275,110781
c53bd2e7e292e5847ad6de65d7937846,139,102,334817,62413,272404,127,114,262011,84655,177356
60b326c9744c6d9304d92e3b7c9c799b,111,99,267403,77011,190392,104,88,254297,114633,139664
09e54952b9ead957d132203f6816232c,141,74,275834,61742,214092,138,92,289884,64729,225155
70ae3590bc661286d9534e4b47ea006b,83,70,148459,44073,104386,94,81,156831,31999,124832
c3f52582cdc5557bba775b7c0ea54a8a,92,69,159166,67302,91864,94,60,211044,59560,151484
ce8acec5c8957bdbff08d52039d0f86e,80,73,125680,45107,80573,159,109,298416,37700,260716
1ffadc01d0e894878cb00b53e5cf9375,107,83,178440,53958,124482,128,102,251472,52432,199040
b714edd8548f0f89371a2c0b1c37cfc4,35,26,26993,7567,19426,27,18,19174,6266,12908
6f31a4826d07b9e27c7820887e981538,85,69,153467,67485,85982,138,78,266723,46205,220518
a25682f55f05e48764fb77795c0b1918,49,36,62338,10997,51341,35,32,28699,18012,10687
2ead662334a6e56f0636a277b374f5c7,96,81,183123,28782,154341,101,80,193557,39767,153790
8134a7525e7af1012cf3a02bbd27a7ab,118,110,356054,65985,290069,89,83,218385,73994,144391
4d244decf4b037a86ba8097f7b57b019,37,28,33260,9904,23356,41,30,39487,13752,25735
31fe72e01c8a4d6a907c8987bf9ad936,73,45,86784,17314,69470,41,35,56686,18870,37816
67c509f381d09f9bb3a9e023b051179e,95,74,172901,45198,127703,91,63,137374,50237,87137
5e74c77d5837c76c679b812e4c0f3e19,42,31,41656,11829,29827,41,36,46815,13560,33255
0daf5f8fa4ead978e3542f678cc78171,76,65,127303,40590,86713,74,63,140377,38736,101641
6d9bcabdafb3553e5cd0c7eefa33e88e,178,135,785569,132028,653541,211,155,718768,176600,542168
4623b1eb27e72d73ddc7f90209b56c56,26,21,20905,7007,13898,33,25,18777,8587,10190
fb6c6d5a921b3317547bb0f69886dd73,131,88,310814,45139,265675,119,103,266103,49346,216757
2d1fedc0b6dcde0335cd34401cbaa833,176,133,939570,180297,759273,217,155,855585,181736,673849
3e576f34111c902dec5021cc3189d486,20,17,21476,4677,16799,21,14,18787,5830,12957
8d7a0adb3432e9e13679c0df758cf73a,94,66,167600,37191,130409,114,89,254559,36693,217866
4746b79f7c5ae23474617163ab22f8d2,90,65,138316,48691,89625,107,85,153999,52564,101435
764417731f8cfca0a58a0d7151da0a8a,15,16,2298,2400,-102,12,9,2459,1329,1130
409bf691c2d2930653c82349f963d634,179,139,516842,165150,351692,150,113,678569,128738,549831
00eb415971ff8e95cbe6df21f1a0e1c8,91,73,278553,113807,164746,150,124,391362,124914,266448
af714c4b87af2e37765cc21554e15fad,119,108,317484,72930,244554,117,92,300062,74141,225921
52b127c1917c90c4dc90890638ccee47,33,24,25534,8853,16681,33,28,31792,10792,21000
7b6a8890a7d126eb596aefba29b0a592,46,36,70185,25715,44470,45,40,49272,26961,22311
402bd5719f6929fc987477de5ec4c426,157,129,523737,90552,433185,141,120,448106,151898,296208
0e3473c5f5c132ef66a42e2a938b4024,111,84,298526,53587,244939,144,106,337735,65401,272334
1860f40ea8a3f374cab3df02263c3a71,77,67,156577,51214,105363,108,92,231861,39952,191909
af89bd6b4829e1d02ce991815fd006d3,0,0,0,0,0,0,0,0,0,0
fdeee45248f492b0e4acebf4a4075429,114,92,272488,103496,168992,154,106,374835,75213,299622
43beba7382d30625cd64cd0567aa6f9d,54,47,55353,25742,29611,43,38,40906,24086,16820
4d0ae4014627d7532e1e8cbf51f2d035,29,23,17373,8506,8867,27,20,20645,6454,14191
37c56ed531f06185978a0fa1b5499ecf,127,95,283101,54728,228373,128,103,286949,48043,238906
de29e3127adc74530292c64d77832831,130,87,319492,82233,237259,106,80,352268,85520,266748
19b4b9a2ebd328baff3dac729c3b3799,109,89,202324,66730,135594,115,83,186782,65688,121094
4aeadb02b09f470f07e5f50ff5f7b02d,154,120,508216,127410,380806,163,105,453593,102020,351573
0476488c161cdba327880485172fd1f4,87,63,189272,37533,151739,134,103,209070,55923,153147
32dde6e31d3a317aee95550b530aae0a,195,159,899770,118538,781232,166,131,778277,164477,613800
277118a914ea66e05c0ef65a9257ed5f,117,91,208937,56025,152912,74,65,157867,54219,103648
5bb6c4a4b7e419a706ede2e24842e915,149,111,542071,90445,451626,152,120,528232,133185,395047
a14ecfa09e889267459b3c9fad9cbe35,18,13,4520,3019,1501,19,10,5442,2125,3317
1c3a7b742acc3f4a637036d470e992fc,27,21,14486,7214,7272,26,19,16136,5051,11085
eddb17f241ecb6ca4b31f5e7c4256106,72,71,124129,41318,82811,62,61,75666,49452,26214
16b496b7fd6fd93955fcbdd0ddf97c9b,35,27,24789,8414,16375,38,36,40153,12035,28118
2a65e273eae3cb060cf8284bb0e0239c,67,45,51160,17717,33443,62,47,59715,18731,40984
1c25410d29b5d15329cef1af88f93afc,180,129,542651,97468,445183,136,112,418672,107458,311214
4ac6dba58ab6eb9136b8d6b4aea5b38d,20,17,5018,2300,2718,23,12,6184,1487,4697
269146366d689674a4b82f31236fd012,64,44,79008,29768,49240,68,51,86624,39441,47183
d0c9677f1c19973ab90195ca3970633d,104,86,209447,44310,165137,97,86,199416,61348,138068
60aff8a7e6cbc6578f643a77f856bc9f,124,93,176431,50950,125481,134,99,217226,29735,187491
d5b1649521233d7056eb150fd24cd061,145,82,344342,71626,272716,157,103,424642,80913,343729
3fe7268e3f3063d73011d801bced8358,46,42,55742,41715,14027,68,52,132331,20513,111818
3587112f1e5ce8bb58c6ffffb921e055,116,84,193966,51491,142475,126,85,237358,36370,200988
6cf402f4d159cf387868e8702727805b,45,40,78719,26148,52571,57,48,95808,32787,63021
7edcf946ea1da1d813677f83892e7303,92,67,108641,34406,74235,94,72,173828,34144,139684
f7453bf9aedca694e05ad698dea6fb48,103,73,244487,59757,184730,121,101,278023,72416,205607
41ff4bc906b4acca9eebb72002299d33,92,76,173767,50771,122996,128,118,305494,50884,254610
0dc5a1b222c804f1e957b3bf7b2b8d89,145,113,336081,79390,256691,172,123,461520,57586,403934
9306c4232f7e8e9c7ce21f381a44e502,85,61,123687,23602,100085,86,72,103319,25197,78122
03d5fe6fb8455866dfc446a6727f1ca3,24,21,13990,6919,7071,23,19,18808,5514,13294
56e98d1bba633a70c60c1391ddaa2fed,121,101,328396,64465,263931,139,97,287081,64880,222201
fd949a2a4df8051b5fd3c6651756c51f,25,15,6736,2874,3862,21,25,5809,3733,2076
95a4569e34c1aa8506ee9a866ca4ca3e,111,72,194214,36963,157251,91,55,163400,30034,133366
ec92eae7d1c29bfe203889c7e80320e5,138,116,339664,84127,255537,113,95,363008,79764,283244
8e76407148381a3e7310498051a2ab87,129,89,421516,56709,364807,111,101,271765,102706,169059
d64b5a8061e4c4c067065acd92e615cb,110,93,316912,65495,251417,88,71,195503,69187,126316
260b2f9d366c7c48c10ddd09661c607b,115,90,285213,68083,217130,126,114,293578,80786,212792
7c28f9f9eaf56f64a605565767685a57,133,103,306261,93814,212447,94,61,235167,80621,154546
dbdf11162c457076030776d3ec014618,65,56,54788,17859,36929,50,37,33885,15878,18007
44c595afb6ed9a013b54899c48e5e009,32,31,45276,14830,30446,37,34,28343,17956,10387
3ceaa4f4536e48a127138133c077645f,184,147,526634,90801,435833,148,121,354902,99901,255001
3d8b58bdf8ce9b9a121c44c53b96672c,144,97,342592,95813,246779,149,136,476548,113030,363518
ccf7bbd54c8a2ccf457e6263257c47e6,45,36,58826,22330,36496,59,48,74459,26556,47903
08fc4d2066171eb09368d63f1b693b71,67,48,69247,15323,53924,62,47,69847,20926,48921
f95ef9f47fa14d4592fe4e1942361d56,25,24,12613,6031,6582,29,21,13105,5483,7622
816c36df40f75cdf23df68c0c9ffe400,48,36,39391,9286,30105,44,35,19147,8412,10735
a253f6d0babeaf9979f580bf7b66d638,138,107,380819,83896,296923,188,152,709794,74303,635491
8354bc9ede23e21c16a412ebd6b3d51a,129,106,372221,66986,305235,142,112,411200,73136,338064
f00c03d3c67edb3fe242e0fc0a72bfdf,112,91,167256,31948,135308,124,96,201924,36739,165185
99031facaadc70609f288044521ad7ea,23,17,7595,2244,5351,23,16,7493,3639,3854
0602de0bccc64f99ae24590cd83902d5,148,103,331171,66346,264825,164,106,384071,75802,308269
7e09ffa38c992c6757fceaf0699a3c7f,69,56,89018,26403,62615,70,69,86666,34157,52509
1334492c80308b87dd009437ef68a6ef,154,108,449798,79454,370344,158,124,441001,90320,350681
b1f30fef2adcaf02ddced6a48bad5d7d,144,102,490265,132717,357548,163,109,539404,128103,411301
b70ad59965cde2748f6116f72d2bb80a,76,58,145824,48889,96935,62,58,117257,70766,46491
2d08425f538761db8735bb62d9fa853b,30,16,13873,4482,9391,29,26,17678,5706,11972
df9555508b06ef6fc2f78a96df307da3,92,82,194747,71600,123147,119,100,253777,63666,190111
a8f772fa4a17c1d5b14794800feb97af,17,16,4763,1310,3453,20,14,3585,1119,2466
61a83c6cc1b2ab58025f3d0519070ce7,0,0,0,0,0,0,0,0,0,0
3286a38b87b98987edc6401b59e1fecf,61,52,65557,23437,42120,62,49,83252,32736,50516
85a2602c3848dd445c0430b2e84e318d,81,60,102654,43831,58823,92,76,93551,36634,56917
b67c10c927fa672b1ce40ef0f6fd2288,90,75,135220,34495,100725,89,79,153256,44649,108607
56e37230c01d2ff6783f3fad8d43d83b,121,87,222289,46170,176119,99,80,162835,47439,115396
478a1e0036a47cc9f988bc2e65e1cc95,133,91,375223,113220,262003,186,124,462760,114935,347825
733bbef28f44e3aa24ac2f539da25bf5,23,17,11561,4878,6683,26,22,15310,5189,10121
e20966ebf464ea9845064332b5c9bbc5,88,57,163696,38992,124704,87,57,122415,44595,77820
17dce7056f1f62b8f4a3fcc7c36a4d02,42,35,46115,15884,30231,41,34,31121,19054,12067
2bdf70eb7c94753efe943b52b0d95c3d,37,22,22687,7353,15334,24,20,20842,6120,14722
911e1bebcf2118d805abe75e22f64eb0,27,23,7568,5495,2073,18,17,11140,2297,8843
b1c55047911f96bb6d292f70baeefe85,142,102,409349,86066,323283,168,128,498470,74005,424465
2e026f6d206482ba38165cb2684db34a,120,90,319920,88949,230971,155,112,391324,84254,307070
67b4f19b5a1cf291eed9b64115f2b27a,134,101,287196,65566,221630,121,84,236246,60845,175401
589468ff990e3ace93654ad699c3722a,105,79,298849,58293,240556,109,98,275753,69781,205972
ed4cde476568e60a5e19f19f8581256e,88,70,187068,56720,130348,79,71,184816,52230,132586
aa0d1e067f65d9326e0b6edff457dc64,158,107,382137,111703,270434,133,110,442004,106129,335875
092524f32bb1b231b635c2133ddaeae8,121,108,283759,69589,214170,126,115,243096,77151,165945
4866e39619c3a472db60d0757fc4b97c,176,153,675577,180713,494864,164,117,707115,131201,575914
1a55e12e85cfe769b43ed3bf73c344f7,30,24,21453,8384,13069,28,21,14998,9350,5648
1388ed36e7c1ed09d5c71377e3b68ea1,208,134,730326,179708,550618,210,173,829362,211037,618325
b16209af4f86fbaa4f4ac0c9d85ba36e,105,57,351112,67566,283546,216,151,667690,91406,576284
761175c4c6bba543c49d58f3706209fe,111,80,259465,61709,197756,170,108,448993,64305,384688
507fe83ed8153132b0dc3642629c0c41,21,24,6676,4138,2538,25,16,6475,2563,3912
233aaa4484bd02f378a09841a8cb1efd,132,93,277401,55432,221969,115,92,219659,69268,150391
50c9b83e0a3b44fc345dc9f19d1e23e5,99,61,141256,47304,93952,98,89,167877,55061,112816
4006508bc674769530a2d4ccc3785314,0,0,0,0,0,0,0,0,0,0
b178cb7803a988235d02488a189526f1,42,32,45041,8159,36882,28,25,24607,10431,14176
489c4bfe5fd0f0eae232416abc06c206,119,105,283929,60466,223463,106,92,212998,52049,160949
a1c849279da560a8a3f59cab9cd61a3f,31,22,24575,11042,13533,34,24,21227,11026,10201
659a1723194975696fb0260e25daa378,78,66,89900,25370,64530,70,56,78367,21499,56868
98be53eb2c5355a8f9a60b5eaf6ac241,59,44,68887,22322,46565,49,49,62517,25513,37004
2c92c037bf3974f2345c0191bf69fc14,158,110,440937,145246,295691,175,135,691166,145427,545739
cbdf8a7fdcad8ced9cd8a9f21d69d4df,25,20,13976,4949,9027,27,20,13969,6260,7709
3c12899e4373d779113f73ca5820eca8,173,129,436225,78988,357237,175,144,431841,117057,314784
44cd00eb3a40d242841257ecde2faa7a,55,42,65503,25733,39770,57,38,62697,24299,38398
cffbedefe409d346c4c50ed28cb80de7,41,33,27246,10168,17078,44,30,29850,10585,19265
fa9784888523f2aac411d968f6c00944,2,3,365,564,-199,3,7,564,591,-27
3ad6cc6f16a900542fe738cb5538307d,177,152,620505,153062,467443,180,113,498575,116864,381711
30364ca3a3de2be3b927931461703c6a,146,100,243208,56065,187143,99,80,208626,51391,157235
736129ff65fa7233dc2aab0b427f3aa0,80,60,142468,27810,114658,88,84,149169,43728,105441
12a46c7df2210c8fad8b73d02b18b536,83,72,153288,45229,108059,98,89,189655,62658,126997
43a1bac5a43c5b52c0f74007fdcd59a2,84,61,126140,19840,106300,46,47,67339,22706,44633
f1ce16d6b4422140a6ce02342828f2c8,110,90,332463,71186,261277,139,111,355505,71915,283590
038ab29e63c02eedd1d8a260daac0f9f,26,17,8186,7678,508,26,20,17139,6115,11024
435c900251b7263c129a87f294a37a6c,56,45,83435,39912,43523,62,55,79023,40877,38146
7653b4e8b8be52ecce7bc84377d56cd6,0,1,0,41,-41,1,0,41,0,41
5909250de3652527dd062e1d54285472,59,50,64542,25351,39191,42,27,66062,14026,52036
ba39302e2e01048e51eafeb37bf6c5f0,29,24,17688,7971,9717,37,30,23916,8603,15313
0532423f50fc167d6146efe53c2e7c20,77,72,138009,38536,99473,82,55,114426,21709,92717
25f7d3a6fcd1d004653c666f49ab2205,28,20,12760,3448,9312,23,17,8469,3163,5306
5ddd492c110d0aab6d9b12b8e3fdd7a0,62,42,70815,19528,51287,61,55,70656,28795,41861
7abb74f9204700197f8b31c3abad809c,28,24,22022,7370,14652,36,21,15994,10057,5937
ea7aca6b8fb9a0ee23f92754b77bc8ab,128,93,283495,57343,226152,126,93,407673,67541,340132
63b31387497427c09d91791e3c8f3e0f,44,30,56535,15229,41306,55,45,40504,17442,23062
bffd2445b4f8431413a17356e83b43a1,43,32,44083,11487,32596,50,52,63246,21453,41793
2b2bfd0718ab95b546846267f56927b2,49,38,58167,16797,41370,42,38,53357,17216,36141
b8e30ddde3c53bcc15e6a2ce94614418,163,120,536723,102684,434039,164,127,595479,149891,445588
76bbddfaa244607ea4613947927ecd7b,65,52,109539,34163,75376,78,69,141645,34463,107182
8d19ffec1830c785f3d4314537441f39,21,18,10676,8389,2287,35,25,30748,6793,23955
686a538476a7ac5bb1bccac2ce0c3167,27,22,16686,7455,9231,30,23,17293,7067,10226
61200bb772b57778b784a8bff0aa2376,169,119,661539,147095,514444,209,151,751129,114326,636803
145bcd5ac9fa940456e83660595d3a8e,11,11,1412,1113,299,12,6,1601,458,1143
5ac85ef6b4a428fecb9ca0a525e29807,217,163,1118032,130703,987329,206,162,873265,184343,688922
43b6a416b4c991b709d1ad39fa9a774c,61,51,98233,45337,52896,81,61,164682,43694,120988
feb2997022d583d36907d89e4770dffe,23,20,5783,2933,2850,19,19,5540,3340,2200
52eb946f059e0c9351315e3e6ca91022,129,84,320654,54172,266482,153,126,338290,65372,272918
20e02ae55fc5d4f96b86e64b7940a581,136,114,227706,75277,152429,106,88,265283,54790,210493
ef3b2fe6be664469e140fce3d58398af,66,53,95930,28368,67562,49,35,51213,27956,23257
e227c128df01ba93649223f38de7c13e,118,81,283996,56352,227644,107,101,248481,106127,142354
cddb6770f2969c52bf038ca8f25af45b,92,66,148702,47523,101179,87,67,123803,53632,70171
670b26163a63c1c0c0db31a20a42c9ea,203,129,960496,165145,795351,196,164,876257,341751,534506
fc3ac04257cb5aab7f1f08c272149635,156,113,636623,111593,525030,205,139,701524,103249,598275
28058786f08f4ce1e6e2164002b0d437,70,48,98478,37964,60514,54,36,74331,40327,34004
8d96b4c9aae942f3b929c5a872a5a380,28,23,13764,7179,6585,33,23,29768,5611,24157
270b62b5eea9f07558af3e482a4c2136,139,83,380228,76964,303264,126,100,375874,84776,291098
ce26c28520ef553284dd15344fae6b14,190,126,601975,146969,455006,165,149,626057,135674,490383
85e6cdcbc335659667e1635766bb8068,38,30,45633,17892,27741,45,32,62266,11585,50681
718e82298b4c7262b54909092789623d,67,56,87097,27285,59812,53,40,57697,19249,38448
dc5b0d39cc72812398918037510bc8be,88,78,135331,42482,92849,101,65,127581,33085,94496
6e2cf3e2e4a0811dc8c0829c29d32d9a,42,33,56355,17719,38636,51,35,66539,18912,47627
226b3063a3e2bee1e07bfaf728acf9c1,172,134,661889,123469,538420,171,105,475411,124775,350636
51d8bd2f0d35a0c83fb6a09480e6e039,22,23,11729,3651,8078,24,21,9866,4995,4871
d6e25fe96d6f8fc2601ce5a03e3359fd,105,88,254787,52891,201896,117,97,224748,68264,156484
7372a7843120389bcb0a9c9d77c5e879,26,21,9135,5477,3658,25,20,9893,4650,5243
7afb3d173f6dddff2e991e87dbb18d2b,87,67,133438,43345,90093,99,77,118247,39943,78304
5642f6ec387889a62e9d65f6ec2e6766,146,115,371922,77643,294279,166,112,403267,77113,326154
7419f9be8138726edc7f96a0e4ef00de,118,109,222777,58874,163903,106,101,229246,55378,173868
b5789f82777ffa313e574dc9b48fb3a5,205,161,890249,225000,665249,197,133,896522,233765,662757
7cf9f0a108f328ad14a4d1fae46874b1,62,63,79790,22022,57768,60,35,65458,18231,47227
a1f1a7c0de2c3fec8e59ad53fd2c9dfe,35,30,51277,11834,39443,50,46,55576,22451,33125
7ac845120af89839082451876ed8d639,64,36,88343,27156,61187,64,55,76190,25216,50974
13c987403352935ddde496952dec162d,60,48,75075,17526,57549,69,58,104909,19371,85538
05e22cc73f7b357b4e3e3cc2d328b3f9,101,81,180185,47473,132712,86,68,132971,42547,90424
8a34bef804fbeb6ff833ca74758f439a,118,86,175896,47564,128332,99,80,195732,42040,153692
3166dc18a730989cdd1fc7bd1201ccb6,55,41,76176,26997,49179,44,37,83710,21732,61978
9b670e917c243a8dab1e321a2ef0489e,98,68,158428,35587,122841,88,66,111657,40986,70671
4f5ac11667cc9ec0ef418d8b40038bb1,81,55,104227,20364,83863,95,77,122661,38669,83992
e698c75a20344ee65978ebfa9ab67298,33,28,30154,9583,20571,33,25,22881,11688,11193
bdc4d94a95a9352bf767c8ad76f0c1b2,140,109,273241,41006,232235,128,96,171713,46165,125548
60564ce550e14eb08bf7bee251fdd6a7,123,84,254797,76100,178697,132,103,279092,76528,202564
fe0d5bc94b6bb25f3b24b68ad03075c1,129,98,331124,95893,235231,181,121,435768,72356,363412
df6cf6ed1689e2e7e85f60964af08116,126,99,262139,74664,187475,127,104,312216,75598,236618
0763b6f54a192f6651d1db475c6e2166,79,56,114188,36188,78000,94,79,240741,41428,199313
20b46ad19c2abf2ea6818b84bd0f6b05,150,106,398705,65596,333109,118,97,323625,82684,240941
ad548693841b78ead32f0a55e7da7fd4,132,90,356007,88166,267841,114,87,302648,71787,230861
7f1cdcd7a6643729a41565d6cd3c7c77,37,27,30471,8494,21977,32,32,18746,10847,7899
97c84df7a6844e9ecb25af27907a70ea,32,22,16221,6036,10185,26,18,13710,6060,7650
adc5ee1aa96589bce3e63a07c195cf10,121,95,428973,101674,327299,181,136,603201,112009,491192
f51b021a5bfcf9f9969f09821b67d2c2,83,61,118600,33423,85177,87,68,106001,40428,65573
43c7e35256ece943aab48d9291565e4f,67,47,70469,18862,51607,55,52,56879,24686,32193
ce79fab6c404a12861c34bba53a9e09a,31,26,32337,9451,22886,30,23,19380,10499,8881
2b2ddf64f0e040ca1333b5ba556ef3e3,46,39,49054,10400,38654,39,28,32596,15832,16764
cbb8c09050652f022453eb8054ca4dba,24,17,12056,2850,9206,20,16,7018,3602,3416
ec34c514665a859cdf613cb4f713404c,131,102,352153,81135,271018,114,93,392794,79197,313597
816fbb0f9dff71b92164282aadac6a9d,26,20,13901,7370,6531,27,20,14149,5455,8694
f86c63d1735ada18553ca429aee3417c,141,111,311098,79078,232020,118,83,246657,60364,186293
e1bcb8051042ffd445b8e4847108d090,148,120,438709,118515,320194,206,158,759970,100911,659059
95cf76dd86fd8c08de3bb7ee13cca563,92,63,163303,69811,93492,135,66,212306,53293,159013
1a0d0f2188f5f3d26b36a3218c9dadae,40,34,43974,25985,17989,40,35,52213,21976,30237
954a697a43f53cb2e3fb9525d396a4aa,95,57,134715,49243,85472,102,73,185605,44460,141145
24ac49c8f3841abf91ec6a9742a9a05e,62,54,149659,66092,83567,103,86,342561,63437,279124
00ecf748cb1aa0d895f816c68e5815c3,23,17,6352,2146,4206,18,17,4334,3527,807
4c02c0f654899ab85a59e3a2ad931c14,114,86,237462,48344,189118,120,77,222973,50136,172837
a4b07d9d23fec353296e39d772fdc1f5,8,6,709,675,34,6,8,675,709,-34
26ac801854439485639dbf54290f5e1a,42,35,43062,14339,28723,68,46,73915,16149,57766
39a3935eb9b6e3f117b2bf6675d96d6d,116,88,344552,120513,224039,178,120,444507,118821,325686
85c1473bddd86842f67c82f085ab0cec,101,84,221619,62999,158620,125,93,321569,52719,268850
faf48d7ba17c8317ec4e52ad2e8dd4be,112,93,203796,62902,140894,124,103,226528,51376,175152
32bff87a2b4b4021c773cd824acd5cd9,42,30,29926,7753,22173,49,45,33756,11556,22200
4051a4e00e3ae2dcb75c2fc0c55d77dc,44,37,59091,25738,33353,46,37,60968,16494,44474
e35040a66932fdb7cad743f459930aeb,112,81,187686,44913,142773,104,90,175298,68645,106653
e45b3b0c1ea8f3e34b28d1960159fd9d,6,3,1810,459,1351,3,3,459,662,-203
49b2afc79f4832369f098c7760e7cb11,144,101,286257,67561,218696,146,132,377491,110297,267194
9b04131c11e6be0fa2c0f9016b1c2e99,145,112,505821,110457,395364,180,155,566963,154329,412634
0eba5e81014c41f0d159c42b9291c161,114,85,121627,44912,76715,104,85,139832,38310,101522
1b3e2f4f844b202cb1b97a6ce5a92b06,85,52,156645,33852,122793,100,74,135472,34076,101396
ed94bcee0229030a5d5615f246e54f25,29,23,20378,7733,12645,33,27,19677,10636,9041
3386ee49e1e7f49ebf0ad99805cd3f68,33,27,25372,9659,15713,36,31,24197,12155,12042
ed66fa04527f737fa80df983bb04eb72,119,101,359874,87009,272865,123,103,313075,87168,225907
10dbfa0a3fd513dc1a7bcae88fdf0b66,148,132,367127,67248,299879,114,98,271978,85789,186189
d4780a7eb626d2c902be0430fab56b48,131,101,471738,126418,345320,175,127,594996,118742,476254
75759aa886fe184b8fb15acba97093ba,132,99,346538,73396,273142,150,97,445139,78705,366434
ab9b177c7add11f303ca535149be116f,87,66,128285,46168,82117,68,54,125629,41657,83972
57864d9e499a2fbf31379158ac40d015,32,24,33911,11685,22226,35,27,24936,15060,9876
88213e665efdfb7ee043e6cc7a5e175a,55,49,58501,14883,43618,38,29,35706,13097,22609
db595cb5406bc892e1bd576b38bd61d2,66,44,82711,19013,63698,54,47,57974,24913,33061
fa7f0002402098fed26ceb8ad8485a2a,152,128,407160,83975,323185,175,139,480354,89054,391300
16353e1b77b04220bf6b7ad41da37c9a,167,138,642429,109149,533280,214,154,951392,102088,849304
2a69d35ac5161906d0a76e530a4ba53a,20,19,7448,2553,4895,21,17,10901,2921,7980
763b5dc1c24d4e10b43788723feb5fb9,34,30,39055,13463,25592,48,48,38557,17399,21158
d10b7a4b73d18c396657a7786c233a76,170,131,543287,78126,465161,94,83,266138,111819,154319
207ca967f97d1027aeb6a0904e35e368,96,69,137690,28142,109548,102,91,176090,36919,139171
7fbe18f3f5e04e7ded4acff2312b1d53,145,125,574322,111670,462652,166,106,523259,97275,425984
db0c2f895caf6abfb4b791d151439000,27,20,13019,7873,5146,25,21,13666,6131,7535
1ff3bb1df9185a59953ccd169c98a52e,24,17,19738,5897,13841,29,26,21546,5733,15813
dba47d26265f28919934205fe7bf1179,150,101,357638,64742,292896,119,90,277671,66055,211616
229386aa6b4b1ad9eb5850659801ec8e,61,44,107370,25890,81480,68,68,102695,37391,65304
0af9f95c014a5b1681615092a5a03a6e,61,50,61367,29386,31981,56,42,64911,22247,42664
40922179c58c198c4c9e15ce407d08c6,43,40,36361,13677,22684,49,35,37706,16401,21305
4cd8465855865968379bc3723df77a52,26,25,20857,6150,14707,27,21,13579,4218,9361
37f8e384115de87bd9a683d53a8e103e,51,41,61738,18443,43295,43,32,35381,16999,18382
7d7007ba0d44cd5c8e50b23c582f6df6,189,137,823770,174841,648929,188,148,704193,123643,580550
ccd0e9b3bc4ae37b713a16069f20f0cd,44,28,59562,13253,46309,36,28,25729,15246,10483
3df9e524a29816f2521438931331007f,26,23,13291,7683,5608,26,21,16288,6708,9580
d14bc09f5286f2954e071f7abc5b51f4,137,108,365896,64510,301386,160,120,409382,64103,345279
178ef6a289849b6f50027b5b8f03006a,89,66,116306,33373,82933,83,68,97843,40791,57052
9b96f913128a40f28ada631c1b901839,40,35,46737,14172,32565,52,39,56077,18773,37304
4248ca389a122cdd94f213682bbe7d96,90,71,201760,61817,139943,139,98,249137,59072,190065
61858c049aa9efc949ec3abbd62e40bd,128,97,320837,69260,251577,147,120,380335,64965,315370
fb056e9ae9d6025327c7c0c3ce04452c,16,21,4775,4584,191,22,14,9751,2982,6769
7efa4466260774c683138544d40965cc,86,71,164233,57119,107114,86,63,237090,57655,179435
ef062a83129a94901e5453486c18a7da,119,91,191657,44052,147605,100,75,204369,41641,162728
25d5bdd4aa59cd46a7c30424d5f4a12a,91,86,220199,58843,161356,72,55,180278,33286,146992
93173eb9642a3355dfa807fc0e64de59,165,140,450451,131446,319005,150,111,503750,113949,389801
8a761cae3b243a816f4952a33a7ec90b,149,100,327235,81005,246230,110,61,216998,103756,113242
9b7cc968904c38e424cc8f5f163076c5,73,58,78889,24767,54122,89,63,105660,23364,82296
8a1e39ac5afdb17e89ab0fc1f66b666d,190,134,459572,153600,305972,192,144,528493,116420,412073
33bacc588a8ade0473e559099258ef4c,89,71,124466,36583,87883,87,76,124349,30965,93384
4b59f3d3e93702842b03ca3c9c320e27,128,99,459305,91196,368109,160,138,371674,85384,286290
94d1f4a493302425480a0f59e2821f9c,91,72,142984,33111,109873,84,67,140479,28243,112236
4df6aec64f0947ebd5d84e97dbceca36,165,134,694463,167677,526786,223,134,783948,116808,667140
252ffc1a8e7ba26045d676bb84a58651,141,107,350467,54029,296438,119,97,259120,52939,206181
7de39feb0ed40a92717c7f2e7785ffc4,238,178,1310567,214698,1095869,223,177,1386909,152876,1234033
c62c7386f8f1c83c5d8787a07daece87,39,29,59337,14397,44940,42,35,53990,13264,40726
eb2746d8729110e6e6d437d8f82cf95f,53,43,66356,26847,39509,48,37,62870,19518,43352
616be93b907ed94344f87d18c73bc216,33,28,17772,6737,11035,34,26,19342,8641,10701
47eec507490da9ae9dde59866a5bf62a,159,123,661031,133790,527241,167,136,555993,154272,401721
dfadaa71f2a6e039160e9d3bb45b1b6d,62,43,102206,18716,83490,74,70,119830,30534,89296
3164ae9109fbb9b748a748e09c2e28d5,24,22,6677,4282,2395,30,20,10496,4179,6317
83eaf12744b7b143138f38968d4a2ba2,40,32,36874,6279,30595,24,26,16116,6721,9395
a9ba8af7b4ce1a3757310440bdf48372,143,95,322794,43557,279237,153,114,348895,51729,297166
69823ac3029a6e39faf51a7baffdcab8,181,133,459594,95777,363817,109,80,230487,66981,163506
81df394cdc2629488495e33ad45a50ef,44,40,34018,14030,19988,44,30,34683,11878,22805
3e24feff47db3b1524fc42d6ebdb7a58,122,89,300417,44308,256109,116,95,183299,59565,123734
961c1450a92ff40f7192dc3380b42977,44,34,51938,9326,42612,48,38,65602,14900,50702
8699b1815b71d129a88ab6b18c3d5e98,92,77,190295,63734,126561,118,93,206105,56522,149583
350aaf28011fdf465216352e7980384b,151,103,462821,93085,369736,159,95,476466,73870,402596
335bcdc6a8fc482f31230ea4f5936219,28,24,19915,8866,11049,42,37,34375,11158,23217
6b393914384ba97fd8e02ae55c9dcc55,135,102,429952,71021,358931,113,83,290211,54400,235811
76e8a9fe292b26cd1d5462a7764d38c3,68,60,88938,23528,65410,41,36,54187,18368,35819
a06a7fe708425083ef050c31be1ef23c,90,68,136792,37508,99284,116,75,199562,35204,164358
87347e59280b13e904249e598d096816,153,106,423635,116484,307151,153,124,478923,86618,392305
e82b0b30a349adb91e3e16a1639ab64d,28,27,25817,7970,17847,32,35,28013,11835,16178
043f1215b70ca7b4d4703200f4716eeb,85,74,131706,39868,91838,93,73,155080,33836,121244
87eb11d0c042d6ad8fecb49b713ba0aa,88,63,104185,28115,76070,103,76,118011,30501,87510
8b7cace5310756bad367b6fa92fed763,49,40,76019,31851,44168,57,46,93583,31198,62385
fd7bc44b49afa4365478ae9befe622ab,76,58,84280,26878,57402,66,49,97141,22775,74366
7a82caaf628bfba2b02a7a9f99537ab0,149,134,382534,74960,307574,117,91,232689,56248,176441
87b19025f753ec585e5d5fc72c5474ad,69,41,68574,19798,48776,53,40,61188,21393,39795
9dd18f86f48dbaec50376d1cb6a86245,139,92,296093,81759,214334,118,79,273325,79161,194164
716af58f2096507725eb1690955909af,26,22,15008,6276,8732,22,20,11015,6402,4613
ee355087dd598c3027ec8c89999959ab,5,14,794,1168,-374,11,7,1670,615,1055
4f6ae8675d5e0e7c81c6dc77599962fa,15,15,3579,2538,1041,18,15,3759,2624,1135
ecc706a4a05049affa6e5c4b99a138f6,105,82,147205,24139,123066,86,48,96254,21290,74964
9302cf447aeacbb5f7133f2e4848982d,19,13,4329,1389,2940,20,17,5253,2157,3096
7b03b1d0b4f3770fca720f6a920060c7,27,25,21344,8482,12862,38,30,20429,9370,11059
168e26e49fec39ce5387f5923f840bce,41,33,54081,12348,41733,58,47,49561,23464,26097
c49d7260b03cdf57363539a1bbacda22,149,110,489490,93149,396341,149,127,589338,108554,480784
3705b56c1f83055f1eed9819f05b95da,101,82,178651,46386,132265,94,73,169425,43547,125878
9c5af7ec32e634b3df10cb6b2de391de,73,57,147105,61728,85377,65,54,158601,67940,90661
ebef019e47b4529b1a6997f39ccfc4e8,180,137,908264,222997,685267,187,133,898125,171062,727063
7931b609e88b527034c67b62ab943b51,188,130,559278,178769,380509,199,138,686973,144597,542376
86b0ef0a3208ee764d4ce50e1d776566,38,25,42125,14869,27256,54,43,61209,17527,43682
cfd834e0db4cdb0aa255a1e82f535b8a,48,40,59107,19626,39481,64,50,87211,26145,61066
983b30a1956f20cf7ff04dc0034ec702,47,43,65947,27204,38743,72,49,97176,23215,73961
66c26741d77289188efe1abe62eba2f5,199,160,680621,194890,485731,188,140,739364,127255,612109
caf0fe1dd34c74dff659b64524266abe,131,117,274078,44633,229445,83,66,155463,55543,99920
d5d154e2830771a364781871df056bbc,106,80,182880,44537,138343,89,72,159690,37312,122378
0b1e59ac2fadca504b723fb38966ed3f,109,87,177842,47004,130838,103,92,181099,45762,135337
9ba4aede0b475eaec0567f2ece5cb4bd,51,44,55676,25892,29784,62,50,60822,20494,40328
78d302f941d50ee6c8a28332b1bfeecc,54,43,83081,11112,71969,58,50,60671,20322,40349
24c7e7f89fef1ed1e468d74439cda538,37,26,54182,15197,38985,34,27,45632,13446,32186
d93203253a2b71408383cfa1731de8ea,37,29,24134,19317,4817,51,32,40608,14095,26513
e6d61fc30a2227e10b470f662c59ddd7,2,4,113,611,-498,4,2,611,113,498
6984b0465a4f14d4b1c7584e703d14e1,188,151,548261,159769,388492,186,130,579283,109642,469641
872090c6c14f30c5730f70b3fd21007f,187,126,460226,105189,355037,160,130,492750,90128,402622
85803da2924d17ccc69d6229933f88d4,33,30,14121,6984,7137,28,28,13560,7509,6051
9769b3fa75c67ab4b41f968629682ecd,116,101,263605,62325,201280,123,79,202483,73017,129466
c353bd9cd10c47a59320eec11548f3d8,1,1,51,13,38,1,0,51,0,51
d0bb114124b813e039d3db6bb3929745,73,54,134611,54719,79892,74,58,176190,58996,117194
76ab6d4a5a720251ea95ed80619610f0,156,96,348337,70172,278165,173,112,522898,88112,434786
4a2b4fb3b13168b7d556f6ee175bc6ee,23,17,9343,5029,4314,25,18,9682,3349,6333
fa102849a6127bdc38a0aefeb9a073d9,70,54,97229,23675,73554,54,35,103923,22788,81135
6bc92dc293116cc4fe4fbf861e43b364,66,55,62273,22095,40178,66,48,50550,17791,32759
ae6a0917cccae667050889693cdd73ca,175,125,481358,89606,391752,192,126,470148,87555,382593
6a9d682311d068a962088a5b0e5c54f4,44,34,63515,19784,43731,38,28,44128,19758,24370
c8c0b13ffb7679a12aa4f238f34690b9,169,127,638000,161044,476956,185,148,815790,143818,671972
fd8b83f9c68d82cac6ce294efb9c339b,28,17,18223,7043,11180,26,20,17296,3561,13735
4014ea19c05a1eb5059e53726ac1d514,34,33,33051,7163,25888,49,33,27277,10656,16621
e92c3750b68db48ed9461ab5b56dc55c,49,34,72692,19243,53449,50,40,56006,18958,37048
36c4bd24be571ee1930c56aa7c054a9c,2,2,179,253,-74,2,2,253,179,74
42d30c011607b26c6d9610a26123c5b6,152,124,523453,117742,405711,166,133,659567,106888,552679
8c26c518cc145d8659b5903f39b5e25c,57,48,78443,17647,60796,32,25,39134,11794,27340
9771d4dc80f2d1ae94b1b3d0e8249006,51,44,125524,26345,99179,45,38,72233,21697,50536
513aea0118a7a21e47c257a6f9dd9f14,87,70,161951,60437,101514,138,104,265926,65379,200547
10aa8a8a146229ddb42412fab53d4841,106,67,149006,44970,104036,108,83,157859,48962,108897
9f469bb7844a1cc89cf3b0e92328c445,60,44,86223,34865,51358,99,93,167741,38217,129524
b2262e060d635b5440051183b2bb71cd,177,125,591743,60489,531254,174,140,522548,96615,425933
b815801fad7587fd6a3fa0101899805c,44,29,28472,11933,16539,39,39,44336,16576,27760
f706695082c53756e448a3b8c2c9ce12,93,66,184172,41556,142616,63,50,106378,53496,52882
4dc40b4b9ab3bf12979787311f85c3cc,82,52,175515,36201,139314,81,56,113222,34964,78258
fd9c58d42a33fb429b6796fd34949ab6,28,21,12953,4204,8749,24,21,7942,4764,3178
770a0c410c5d18e129a606478e9e1b6f,32,25,24464,13652,10812,42,30,36388,11705,24683
0b49c3803517b3c56cc0c8df8c1b753d,123,85,290193,63859,226334,154,111,367628,55494,312134
cb0065781673c7d2c0d9a76d6525210f,93,73,153290,38877,114413,119,98,216344,61198,155146
fc36396c364ea3bf22310e525fa92a0b,46,40,36508,10852,25656,38,25,20675,10556,10119
c863a5f6fed92fa0811e3e1b841f784a,138,115,579561,106701,472860,136,102,472928,93004,379924
c13746f1cc644f7c915529f8adc70ba4,55,49,55858,19065,36793,48,32,43330,16975,26355
559a9f4f47dffd1b2ef9865c533a7ec3,16,10,7436,1221,6215,21,15,3357,2276,1081
ba6a1dca414f564ea9a7d4a153524851,91,79,196428,64440,131988,102,81,227934,78419,149515
9c1770adb113d934c185daa672814893,191,137,1006757,126143,880614,201,143,746081,169731,576350
e425da51f617f57aa2b32622331044cf,28,19,14787,3373,11414,22,20,10496,6675,3821
4e34fcded2219597d05443261b430db9,113,79,243713,59326,184387,156,120,405834,53923,351911
bd3bb214b0e928172b15142cce9456cd,77,60,140107,52590,87517,108,92,197177,42560,154617
29f5499fad1608e60780e24ae25a7dfa,146,97,364384,113379,251005,137,95,430303,123486,306817
cde7e893120e1371700145e69e235f0b,52,42,59750,28466,31284,62,45,97017,18688,78329
996d98147574fffadd46226e1f8653f0,80,69,113898,29321,84577,93,86,132511,34087,98424
ad45ea940743be9c371b7fcb3567c93f,160,115,464087,138186,325901,158,98,681380,117985,563395
29d0f08207cd6e111960dcd322cbf342,113,71,212655,81749,130906,130,84,290325,73267,217058
aa81c47b163495988dc79150b353aed1,153,123,545869,152613,393256,182,152,642119,156223,485896
2044ffb8434431f344b5a5bbcfe7a870,138,123,486126,71896,414230,104,97,286455,89736,196719
ee82bd3fa0c32917f8242a59ce0645dc,134,103,363081,82179,280902,133,103,373846,76474,297372
59d053c3bc31fb1786f795a83d6714a3,82,78,115412,45850,69562,115,88,201431,31813,169618
1911fd9ede0b7292abff64b75e47a4c1,97,90,268960,77063,191897,128,99,290741,76610,214131
2f97d4b9a96de4c74a58a69af9b71efe,215,158,939326,250587,688739,200,152,1287737,209509,1078228
17eb314d370e90157b6d83094a632ae0,147,117,642932,123533,519399,206,140,722157,105913,616244
5c30dd1f2078ded5aeeb2189fa61b9b3,144,103,491199,151419,339780,176,136,603370,179602,423768
98e78076b15612e1aad21a9bb989a756,42,28,46298,12032,34266,46,33,39994,12499,27495
9549ecd0699c999a63d75e9da66cfcaf,71,57,61069,16700,44369,55,40,54633,13573,41060
ed9a46b6ec35e15d7ab1d1c62feeec91,79,64,152618,31702,120916,71,61,93030,23445,69585
d1ff627cff39ad52ced95ecaa37b8843,73,61,105829,44487,61342,84,64,152707,51824,100883
3584ab8eec978f78d8d0b416abf128d8,36,24,45544,12557,32987,34,36,40731,15072,25659
f1c265cf473dc76781bef1864d3aba00,62,48,104095,19934,84161,73,55,110749,24127,86622
2a5a85be5bb437bb28bd7da465ba6084,2,3,133,119,14,4,2,248,66,182
c613542eb93170013f88f42e5a1c54e8,167,100,438624,104576,334048,143,88,374776,110783,263993
341730098d0e75d59323eaa4f7019b38,61,37,72674,21865,50809,52,44,50208,25538,24670
806738014259ac83077d46f8eb8a9b34,31,28,26288,12218,14070,40,29,29103,10965,18138
62f1e96afba28a98e1a493a648377877,59,43,100505,25403,75102,62,50,98783,39065,59718
333feb76bf29db8f8d50f93fb347bd2e,111,85,206464,58994,147470,130,92,228114,69187,158927
a254646586375d6aac9c8683ebb59edf,90,70,145066,29978,115088,92,76,131179,25794,105385
fff1e218ffbb24df059be504a8f831b3,47,35,63924,17078,46846,38,26,47833,16858,30975
33bba9805b584d0643927f787fb18723,3,3,140,234,-94,2,2,178,84,94
70b8c7131764dc1d704d9833051e158a,145,111,394335,83218,311117,173,136,595413,74819,520594
5a08c229697c481e2a44b0c24360fd2f,0,0,0,0,0,0,0,0,0,0
b98e20e53a128e2f9401c09209672ac5,53,32,69401,22896,46505,43,31,82479,20011,62468
c90d0fcccb08a6e6e6c50094b02af569,173,109,392939,62505,330434,139,116,346369,80681,265688
45ede720453d77dd3d1b71efd59df0ea,65,40,62583,24182,38401,73,65,108531,31971,76560
ac0a19f436c401cd37d75a7b923230dd,50,36,37701,17139,20562,50,36,39562,13215,26347
4353c1595d87508bf4705495bbf02208,159,120,338556,48883,289673,139,129,318106,67205,250901
cafe533f987ed33b287ad504bc8e2abb,74,65,127271,33979,93292,74,56,128339,40988,87351
b108c6bb924e83c972d2b168d5e6faab,29,22,26836,7743,19093,30,26,19191,10239,8952
7d97c15a984d58042f879d2cd80ef361,92,69,172274,35828,136446,109,79,224662,45544,179118
c6a4bcbba8d20791906d3335c686dc0b,93,67,347037,125365,221672,180,140,608533,86684,521849
684a1eb8f3b353fe3225f1b0f862110c,107,83,382446,119792,262654,143,100,488663,80568,408095
54ab2d94bb0cdc38e2e6dfdc7ca9bbbc,44,32,43144,11021,32123,38,27,18711,9712,8999
d2a0a2f0184eb7abf69f90fd725633f8,41,28,47494,15449,32045,49,47,71321,15972,55349
b41cc491e7277c01a5b91e3fcb54fec3,31,24,16933,9133,7800,28,18,19769,6991,12778
0559d59f2c7e0ec30a704adc9fcd9e3b,140,105,361613,80594,281019,140,113,379713,64137,315576
55288fa3185b0df04360d5b70f5ede88,45,34,42559,12761,29798,35,30,34343,13126,21217
0cf5404794a0eef4dc976cb80d7709d9,27,18,10792,4648,6144,24,24,9301,5953,3348
b384c3c484b736eac223be086bbbfd7e,72,61,117719,41015,76704,105,86,160795,37281,123514
6cc241a02675cca7811d48a9f3f0f401,34,32,22984,10628,12356,46,35,34753,10555,24198
9d6bd6611131aa6354ae3ecabbc27fb2,45,37,50131,24069,26062,52,47,78903,25559,53344
17001c24cbe10cc3dba0e2976d5fecba,97,72,118016,30579,87437,86,63,106283,27716,78567
efdcbeaa9489862df0779778865c97f3,107,91,206400,52236,154164,97,84,189489,48649,140840
64d2f39b817b5f833cc98215a16c2be8,46,33,58309,17564,40745,44,31,49419,15309,34110
47566e4ab7029ef6ed11184d88a85537,28,20,23927,7810,16117,32,27,30772,9286,21486
55c1248d78c21d06b8d4f8687b9e4381,119,92,269927,42461,227466,114,91,212900,60792,152108
31f308fa3b79280053808f10d7cc24f0,229,173,630172,182870,447302,208,135,743451,133953,609498
8d3be64f599143feec4c3d756f1139b7,149,110,462915,92987,369928,178,144,562259,120998,441261
73e41228821ca174325f7ab1e9aea9c4,121,109,295757,61828,233929,127,109,309381,62283,247098
1d7b6a3af53c4646ca8dc382861e0c58,47,39,69666,22036,47630,47,41,60803,21858,38945
8e9fffb9b2d0151074084f11c7fa2cd7,22,17,9119,3419,5700,19,19,6740,3988,2752
9f270f6caf67534eb941ecc6196f56c5,117,72,230734,72819,157915,138,115,335373,110944,224429
5431cd6119c41aa9e3723e061f9ac06e,34,27,25695,8008,17687,39,31,35139,11148,23991
37ac5b66bf3a8df624f715894dc917e8,44,32,30077,10010,20067,42,33,23565,11752,11813
2cbbb5fecedd6dc4e620128f49c7a505,96,72,170425,40858,129567,87,76,189891,47493,142398
e0f88e56683fc33caa34e1d57fc5ed1a,61,50,73647,26326,47321,53,53,43035,18730,24305
ba56f1b9be4cff0b11c15cb38e3fb5d3,15,20,4377,2782,1595,19,12,4470,2461,2009
77330704a0bc5191c2d945837da64c61,69,57,101981,23731,78250,35,32,44426,19195,25231
5eb76158649c5df300dc7ab0cc8ef11e,43,37,40634,14836,25798,61,41,65194,11377,53817
98cba7ca80e2545066de474a32acadb4,49,38,48253,9832,38421,49,38,35516,9022,26494
493420d7cb8ade9031bd0c64fad707a9,87,68,141222,33221,108001,130,110,286881,52727,234154
034560b8c94be429b9e6ab6d25157978,83,67,145213,59622,85591,118,85,233455,33518,199937
753df59b7bc845f8f73d0c0d5249c836,83,55,154575,22852,131723,75,62,135496,35759,99737
27c9a1b2ea025a0cbd8a068913e5cdd7,51,39,72924,25212,47712,56,48,66670,31245,35425
d5dcd2d31dec3f67cfcfe9486365d49c,114,94,207978,86430,121548,147,102,328551,92405,236146
7372b33156b040c10689bd04cd2bf340,131,91,308407,55458,252949,134,96,321216,61122,260094
69b767f73cbde54b387c915f0380bdaa,239,163,793392,118298,675094,233,207,1422950,244773,1178177
b68f7c3501252046d8b583be4353d122,141,102,285261,79866,205395,142,113,404813,76592,328221
517aa3f2003a20ee78437537c3fc60bb,52,33,58923,17865,41058,41,32,37781,22758,15023
eece281acc4308ddd0d4546b08a133ea,12,5,1975,316,1659,10,9,1390,527,863
21f60ac5817fb192b3c8ac208976c0fe,69,66,80778,36950,43828,48,33,58133,18677,39456
d07f6a8573f26c2805eea8f0f77ffd01,5,4,335,838,-503,4,5,838,335,503
b54cc5344cb3055bd5885bb94136a9df,112,80,265694,73431,192263,101,71,272981,78109,194872
e981c52ba2250763f4471cbcbdd4327d,198,156,783593,102406,681187,118,110,371311,157188,214123
afe631a0321881e15cb18759a5c19240,69,59,96286,24176,72110,45,46,47414,21679,25735
17b9eb138a476b01d6828fee69d7c62d,155,115,661647,153710,507937,210,162,974186,186765,787421
274eb5de8f15226a39da27572a1a4dba,38,30,40317,8386,31931,32,30,23603,6903,16700
f2b44d37fede5b5864cf21008f028b30,26,29,20652,7571,13081,35,29,30749,6154,24595
fc387779d1cbc911f378c096b647c104,51,42,57491,22120,35371,57,40,70191,22788,47403
7c59e6935202442e2cee87ad19fa63f4,111,68,287407,46197,241210,76,60,164669,59795,104874
343ebe73eb3fb3ae57d47b8a42b47dee,143,110,413592,121063,292529,139,120,478797,101413,377384
cdb6074edb818fbe38b3fc86cebe00ae,67,54,96906,36315,60591,52,40,98029,24916,73113
675a1769b96c2748eafa34392d3db71a,156,122,524877,97174,427703,130,110,451186,95499,355687
e583dcb9c6b9b08111d62127b8e67215,100,73,171224,67024,104200,147,116,306721,58709,248012
17f153846850fe6da0697bbda4a566ba,102,85,183580,24685,158895,99,70,96802,28836,67966
082226b0c5efcefcadcd6908f89a7543,32,20,12190,3152,9038,29,22,9629,4059,5570
98b2a87b7ad4ad5b0b8be653941963f1,82,62,147646,37818,109828,83,72,116942,40101,76841
44412e9d32ff212f0d2d33a57c018403,69,47,108665,29851,78814,60,59,76171,39817,36354
1e0f8b62669e6655bc4254c2b5537921,140,107,312505,78595,233910,140,109,321095,91699,229396
becf9c8ffca1843279c4e6e0f87c132d,128,83,309737,65985,243752,131,95,318284,66587,251697
b80b59d71c88c143be5afe7843435731,156,133,617031,103087,513944,183,132,545292,119033,426259
fb6ad32ee134499288ccf19bbe057dd8,142,119,426357,102040,324317,159,121,540715,61689,479026
fc6bd1f58fb7fed00f80456a9f633b52,136,105,282278,67199,215079,141,116,299242,74889,224353
5a2367d0ce244d6988f93c14f2ccef54,6,8,1107,1259,-152,10,7,1399,1199,200
ee84861e709fc9cf5d48ba0f04b7f43b,150,106,366388,56185,310203,133,113,391487,98659,292828
15bed0f1266eafd8316e0cc9df41ee8b,113,87,328894,62112,266782,96,83,212391,84641,127750
acefc3ecc8b1fc6bb102e350c8827431,130,100,302602,69149,233453,130,98,317332,74711,242621
038b3d3eb00833ed616e989ed209e921,24,20,6835,3784,3051,24,17,7431,4138,3293
ca8f9b17d59df4f7ded5af406a9bd582,69,54,101458,20934,80524,83,75,117338,29501,87837
bdb307fb3ad44d4fc897305f18f0703b,64,48,61325,32523,28802,72,49,117122,22326,94796
430529c450bd73bee21f3fa5891d2424,2,1,86,50,36,2,3,58,94,-36
e13169af6829af0885df41c757e321ef,150,98,343839,101817,242022,132,95,289182,100264,188918
f5baee4c695fb2d5afa87c6dc631ecfc,164,106,553614,134916,418698,162,132,494526,143073,351453
09c1d7b5d1dcdda6ba87d126579d60e3,70,51,53896,18270,35626,51,46,43050,15175,27875
499580ad50b738fe2693b1a4b84c8edf,9,11,1217,1628,-411,12,7,2079,651,1428
78ee43daddbb3061a201714388b79a0b,81,79,111898,34490,77408,103,73,172141,31067,141074
35df64dc7417951c7e2422f1a2f94807,170,129,661168,104982,556186,137,91,408441,86095,322346
474168527c940abbb8884ee718e3372a,38,26,34845,14634,20211,46,36,43322,18247,25075
24d8dd34c0625d0292ca0230593c66d9,62,51,95370,30991,64379,70,53,67347,29420,37927
64ab46f9e80b9cacd402ba6187cfa9d3,61,40,55868,18101,37767,46,33,37815,16985,20830
acded5aff1d8e146de74bb9d2bbf50eb,102,73,177352,55769,121583,111,76,178851,44814,134037
32d8fc40e47c033a484ac555230bfb8a,158,117,380866,104071,276795,148,118,388394,101903,286491
9b0020b7ef388172145cda73610bfb0d,133,97,298116,45251,252865,128,102,240972,73504,167468
2768ef2fe80406a3edd7bc8af6aac3f5,152,117,591264,110846,480418,195,145,603415,122201,481214
343555f69077ea318ca834496a78ecc7,135,99,339529,73189,266340,137,108,399069,77794,321275
5701027729a02a39241fc015ccd52f13,71,54,169514,52540,116974,85,60,192291,34461,157830
38d794eea8a36c60ef46a2c9e164a8b5,75,54,101025,38923,62102,94,54,138391,22387,116004
87ed4165c50cc3a87d8cef9d483373db,157,116,494584,65890,428694,113,80,301874,60986,240888
c10326649171f1af5fc79130aee58211,41,32,32789,14028,18761,35,30,34309,12200,22109
53315bff0af1eb2792bfb7816919c954,136,99,291858,58867,232991,118,102,322771,70723,252048
ee84396f26a6faad8d9f8c7c9925e736,59,43,90044,33297,56747,49,40,82357,25689,56668
678294c598f1c48b9c701ffbacd42450,49,42,79003,22026,56977,42,45,45341,27339,18002
c51e6dd24c7ad76e9d89418600167de4,32,26,34772,15301,19471,42,31,52782,13312,39470
ccef0dee210028af702b206bf2eb367a,33,26,15030,8401,6629,27,23,12792,7118,5674
c53de4dbb1228f6ff8021ef238dc2a52,46,33,34506,11958,22548,55,37,41446,12262,29184
c4637d4e9d4ab94106155608e0479bc1,146,102,442476,74381,368095,149,115,454064,82352,371712
da36e839bc44e0ef8711f9d1ad89f398,130,103,288605,112378,176227,159,125,325660,81174,244486
6fdbb64adceed2739dc7017a91380dfb,169,113,369569,77604,291965,171,130,461269,129612,331657
609fc9dcffbc6a3103729a8c0f1306ef,82,68,149678,56342,93336,114,86,236941,51501,185440
b653c3f29fccd401c450b311c9a29f7e,19,19,4348,4718,-370,27,17,9622,2882,6740
39c2f34c02b11f8853205d1620f81d2c,132,119,245217,55156,190061,109,71,172295,43523,128772
2ab89f365ec41d8b5db9daed764efccc,133,101,388257,78023,310234,133,112,329970,93143,236827
8de1b22ed6a0208c81d04002ab6b5007,58,43,74271,23443,50828,55,47,73139,23770,49369
c187789c42604d0630ee579638bc8ad7,101,82,168999,44562,124437,107,77,200990,42993,157997
712ab6a6e525f35f1f36c9ee4c9da475,106,79,189921,50086,139835,132,83,216237,46026,170211
7354d72e8b0804553701f618017d0cf5,151,113,596963,147749,449214,175,148,605892,143915,461977
fe9cfcbddbf381020c5500b3104d736c,26,20,15445,4381,11064,26,19,10821,3938,6883
a30b9253e8c3543b368bc2094bccd1b5,97,80,141087,28462,112625,74,62,118302,32768,85534
378e0e2c2039ddad038ba111c30fc300,133,107,256009,49180,206829,106,84,222567,53013,169554
6b73f14a86bf2769641609cecdad2f01,114,77,278490,48524,229966,119,103,258544,51566,206978
4c8efa7412b1286e18fc5edad3fae05e,101,81,198162,75050,123112,100,69,207421,55448,151973
16905c176b4d2b89ec0a4aa062a70e41,156,136,495356,99421,395935,180,133,552658,76129,476529
4b4f8b536125a3bc142eeb09befa5c4a,57,48,113167,45022,68145,84,74,224631,50084,174547
b4b683305f5af2724b620725a74b683a,139,91,305459,43668,261791,102,83,246135,56961,189174
533e74b8eaa097780f8e9888a7dd941d,62,46,79957,21879,58078,74,56,86252,25310,60942
7ed97f0375e7cc1f3eee1474d1d85caf,52,44,57768,20394,37374,56,37,80582,19460,61122
271c0bd7ab4c72ae80124549122f1830,119,97,221555,39098,182457,71,62,127396,40064,87332
3dea8efcb8382ea6a97955daf7672be2,61,46,109462,36262,73200,85,63,164988,52330,112658
0d4a17a9a912a9d44e265802f6e5dc4c,17,12,2194,1653,541,16,16,3236,1412,1824
c3bbcf4e84b58c6ef6f7439b02997fb7,159,132,420958,120464,300494,126,105,358955,126888,232067
013e3d94d6be666acd881d1638340961,166,128,611616,104386,507230,150,109,392664,123388,269276
972aafee125257a7928f55a682d71e62,153,113,328701,76245,252456,169,96,346279,47088,299191
dccf57212b71e8a776e9a81a17ba9e06,97,72,328534,121745,206789,155,118,522514,110868,411646
1766c187a358c8366397e2c4ea1eb4cc,108,76,357097,93132,263965,102,89,331110,108805,222305
96795f4f7be38f80e66fa3b8f54c7336,96,65,196386,53120,143266,109,82,220064,65017,155047
f7d28fc167f23fdbe86be807f420bec4,37,31,24168,13461,10707,44,35,27491,11208,16283
cff0b39481ba317a5c243c028b6efb60,64,46,68916,17280,51636,46,36,38161,16801,21360
794f5036c4a626a860ba340838803356,143,122,313920,43467,270453,115,98,222937,32823,190114
d5d977dd2c0d33480ece5cac63c1a32b,221,124,814904,145280,669624,185,141,776002,177576,598426
d6550a10652ad105dab0bde739665fde,49,40,53553,14166,39387,44,31,30710,12430,18280
b408c913045790be1fc2ca3492c02c4b,77,58,165983,27019,138964,65,54,114240,29483,84757
fa24d1f6e1da6877a6c4951e5b042e05,40,27,28685,7993,20692,43,28,34035,13004,21031
e8b74d6de55dc1862328a92a6f68c679,90,69,172401,43443,128958,111,81,217806,50986,166820
902a602ecc0b94dc32cddc75083a0dd1,86,74,216926,61684,155242,79,77,199181,66307,132874
b4c9bfd27b393eb2a1f4a5c8a3c4fe2d,156,109,404792,73362,331430,149,122,377939,82628,295311
1186015f7852c057b992e588870e8e59,114,90,251285,120719,130566,147,116,361979,96426,265553
009c4fe33c997aafb1db237195d4fe58,51,40,68687,21381,47306,43,36,53156,19945,33211
63f7ec244eb701b9215b25a33ba46317,67,48,96300,37973,58327,86,61,151062,31608,119454
f25582e6ce4438bd0584206a526280a2,16,17,5629,3005,2624,23,16,5808,4052,1756
6ecdc55c03c8eda33a32a91b97111500,64,52,78071,31047,47024,87,61,143653,29203,114450
234f566dcdfea3be238821565dce9e9d,12,9,1748,530,1218,9,8,957,514,443
c0411735a5a007e6f89ad3c7be52fb15,85,69,193979,41849,152130,80,52,160768,45673,115095
cc002b25ddb2fffc6f01b01d03b15937,27,20,21659,15118,6541,35,24,43407,9392,34015
1ad1fd69cec8fa3d04689d2a4d051f45,144,103,356830,57250,299580,156,116,413858,66206,347652
04c3f477d68148763613e1ef94ad0cf2,65,48,127810,50567,77243,99,76,188042,44667,143375
03353bf403e4bf76a2630c9f889d7e2b,147,103,382022,66503,315519,110,96,281447,76190,205257
adfe7552f957219efded4ca4f346f0f5,43,40,77349,21881,55468,61,51,83124,34186,48938
e793a538e92e9fd6675cbfebae3d512b,115,70,170014,53896,116118,96,67,165431,49702,115729
7daa4afd75f90f6d4fd7fb95338222e1,32,26,17615,9201,8414,26,22,13269,7024,6245
832dc869c20b97765975f0559da7af59,21,12,9798,2594,7204,12,18,5584,3492,2092
ed5a8dd71906fdb8cf2c09cc61e0dd88,20,22,9565,6543,3022,28,20,16835,6832,10003
14b36d3fd63ada58ea9e997c87ca4234,156,125,371666,67838,303828,160,121,354509,63569,290940
7aee873b2581d7812996e2f4b67d0a58,31,20,12668,4822,7846,31,22,24627,5925,18702
fa0124bb2c8afe78f686bfebdbfac9c0,35,27,37406,17020,20386,41,32,52672,14152,38520
534e741cd3cbe9b1a1fb7eece53ad47c,154,118,590781,124874,465907,155,119,551044,100036,451008
98cb134121be9145bbb508f7f0259b2f,152,98,394641,90087,304554,134,101,372107,90152,281955
ff7e2a3b2958c78a591d507fab9aa70d,63,45,81578,18670,62908,66,49,74484,21810,52674
ee963a0cdae1d09d15a28a6f534651e6,222,126,547722,102479,445243,199,139,564704,110555,454149
4dfa8ffb5fdbcc351e6bcb1781c20c15,46,41,54605,22096,32509,44,41,51171,19022,32149
38b5c5a08317fdddd6d61e362ad03030,168,137,487555,125875,361680,151,114,522387,76853,445534
c23d018faf8b118f6fead6ddb7c97d6f,80,70,151288,50316,100972,79,61,109581,32729,76852
f7b1282221b40d1025fdad0500555bff,30,24,20656,7044,13612,30,22,21356,8336,13020
a1c3ca8239babd81c095a66685ff9167,123,101,297624,82538,215086,95,81,255581,78699,176882
feee0ec5fa436f095785de3ec726039b,216,131,759678,167840,591838,217,137,863649,263175,600474
9695c9a93aa6137800329d8cb649fd47,106,85,249575,56023,193552,130,86,224932,53575,171357
dccb488a833889ac92e1d4b645c1e592,126,99,259889,78460,181429,135,110,330617,81643,248974
e5558159f6c4b438b1d124410b2ed531,110,81,183061,42157,140904,122,102,256080,73090,182990
85b0ce0fd9ffb2585183e78d5089a77a,42,26,42713,16507,26206,39,31,48478,18162,30316
000a2ba6b82a4a1829ca226a880ec993,34,28,28159,14405,13754,36,25,46010,11236,34774
4079d0a814573f5b00cf14708df08210,48,30,40660,12002,28658,36,31,34291,12055,22236
4eec70156e86af6413e954fc831bbabd,130,98,303664,61441,242223,126,105,295400,44921,250479
8f5ae20db06bbc5ec2ff8039b4b78fab,133,81,217328,38723,178605,63,49,100949,46813,54136
a13d96e3345ebdf1a132ffbd7cd6701e,33,25,22763,10142,12621,38,28,27554,9669,17885
de3130b6217b9903271c7f644575f87f,127,90,334933,65974,268959,156,128,570210,70295,499915
0800d395ad7645d81ad71e27f5aa0c6a,30,26,29024,7053,21971,24,18,12509,5868,6641
4d8e7c3ff9f946751fd9198fcc23bfb9,63,53,65949,22496,43453,44,37,36268,14282,21986
8ffe7d06d643c9b2d883fb35ba30930a,46,42,44214,16231,27983,63,51,65174,13906,51268
d4799a2969e718b18d49f64eca44ec82,187,150,1524160,189723,1334437,278,190,1865133,190898,1674235
1dd8d2fdb92f9697a38a24d11ff5c77c,125,96,294976,71974,223002,93,56,176387,80257,96130
53dcb02527bb2e2c3c914e289c23edcb,81,60,110323,32979,77344,72,67,92111,41300,50811
1b57a2ca3f035ea7e680d9264555d522,23,18,9242,4281,4961,27,20,14570,4454,10116
70b11ae823aaeccb01f626e2619c04a7,132,97,358456,123966,234490,172,133,465040,116135,348905
14953888620c9450ceab79400ad576e9,39,30,20618,10238,10380,40,27,36206,7891,28315
1cc8144511280f6b33ff6e959fa6a959,140,98,377967,143865,234102,142,106,407237,120539,286698
5fbc438ad06cdeeed4b7504781d3ae21,155,104,592253,101307,490946,175,142,631759,123952,507807
a2dd1e0f1b40d4b7be96faf0c0235ab2,125,89,374832,73538,301294,168,127,577175,100208,476967
8a82c343f0819cc7664b0f5542db6596,97,61,145199,41533,103666,112,90,165024,39928,125096
a01823c755a3ad166c91b64ce9666dba,51,35,34628,14555,20073,56,42,54737,17236,37501
efcef80f0d76546e77cdfe7e97227c07,91,68,197605,72176,125429,122,92,299890,45619,254271
cacd195ed5d11276d06e2872a5fa0efb,149,104,347114,52337,294777,108,80,207829,63175,144654
2689e083484c81502c5347202634ef9e,115,99,289004,81058,207946,132,105,257333,83636,173697
622d925846c43be17e4d7201f64608cb,32,25,24907,10073,14834,24,20,22366,6707,15659
8416f71e517d033577159b04b5645b26,27,22,12713,3120,9593,26,19,9218,3385,5833
861e6463d515192a826efdb4c09074d0,34,26,33930,14788,19142,32,25,28089,11869,16220
72e526fee7defff11e8c289b0a929372,65,48,107180,39501,67679,84,78,156050,45505,110545
75414245ad8cd8fdb471413d8399bca2,109,94,312334,88917,223417,147,91,403549,104657,298892
0fe46f6466b984f7c5f973f0026eac55,33,25,43015,14949,28066,37,34,51521,14379,37142
3c2d3b5a9e56b4b9bb8df2c523452444,19,18,3555,1637,1918,17,13,3002,2100,902
92c43f9a4533315c0e15631c87fe8176,23,22,23889,12335,11554,28,24,36785,11120,25665
5c1438b0d40108f33a54979dc11f3666,72,65,103050,22222,80828,52,40,70965,27860,43105
606c26a904ddfd5103d2b4e2a08e32c7,22,19,4651,2763,1888,20,14,3546,1906,1640
2020b9749c8472a8cd18c0ac5aac5e8f,51,45,68901,18527,50374,36,35,28776,19688,9088
44e8a68237648372b27bb50d35771fe2,125,82,369018,73676,295342,186,134,641405,78498,562907
2b3921c1516c090b462a976f37634b15,102,85,162592,30608,131984,124,105,233023,50861,182162
6a14be466ccf6f49f57b43f13e60b09a,38,29,26221,10654,15567,39,34,26820,14895,11925
06a2a8c056273e1ce9d2bf1b59091afc,71,53,94166,30253,63913,57,52,79648,39624,40024
08c5a309e7f325d7a55cff5e83e65bfe,47,40,45202,17564,27638,40,33,38134,15731,22403
eb5a92d932c4032d2bbe2cadd8b2b8b6,166,128,328887,51633,277254,133,109,247163,59641,187522
4e65eba69374f3f3d6ceaf5e31f0ee5b,140,118,299392,51446,247946,88,84,177882,50266,127616
fed12d11725c4b46c5029af64093511d,52,34,56842,13566,43276,63,48,84652,17778,66874
3f3e6a33c0c9089639cc8dcfb0b4f9f7,162,139,514881,93750,421131,123,96,408180,108220,299960
78dfed219793c6718e8c9715ac4008aa,33,23,22522,5393,17129,29,22,16513,6985,9528
3677d5a365675184a350d4321ded88fa,195,120,631899,126541,505358,203,151,859123,150558,708565
d467ad185bdfbc7c0780649d18d34495,155,122,543538,156256,387282,169,136,530436,137103,393333
1b77af9cff56786db10eb492f01b160c,135,104,353858,67294,286564,100,69,339090,65144,273946
10de8de10e7cdbf9d044bd660ef09643,6,5,581,350,231,5,6,350,581,-231
dfc86357aff9063719e21def819c818d,47,40,48366,25207,23159,76,55,77058,25381,51677
25978eae521c6a5af2408ed69e3c97b0,60,47,65945,20263,45682,48,37,56202,17648,38554
72fe2ed3231ff21d88032eb729a0638d,84,75,166900,42497,124403,82,65,157410,35165,122245
7d730acbc6bb4da40577920f737823bf,19,18,3788,2894,894,21,13,6529,1595,4934
94aa9457bc64b36adbb97628351a0060,39,35,40176,15977,24199,58,39,80004,15587,64417
b48c2ad7332947abbf5487f936a8a19d,69,43,100848,45336,55512,63,52,123643,43454,80189
ab26185aab1e24de4331d942ef0b83c5,30,25,17068,12787,4281,38,26,35877,7014,28863
065a0d829e3dd67186d0c3f7873e5b57,74,58,106569,37262,69307,59,45,95135,24334,70801
f212a50deb48b3eecb95b385bb97de78,80,66,139115,66747,72368,128,100,275364,79965,195399
737259f6ad4765a5ffb44e7cbda89957,160,134,573981,116119,457862,182,139,640694,104882,535812
bd635454be87c131ccc51f3b215d68a0,97,82,193841,38140,155701,74,51,119836,32057,87779
3288fb563b8eeff43abed69f632a294f,27,17,5007,2265,2742,17,17,3532,1923,1609
b6f95e512b966cc084b09cce79c76999,65,52,112283,46370,65913,66,50,95951,49583,46368
c04f489fafce04a9df5008412fd34f12,45,34,43665,14674,28991,41,29,24138,10446,13692
0e9ba3ed6bcdd528539aef2b34bc204c,44,38,62959,22052,40907,35,28,42237,23025,19212
244fe219e0744a40153b67246f7bb811,43,33,51124,9149,41975,32,31,25151,19513,5638
a2335a4e2b45d8756bc2bb2a6ae680af,58,45,66214,20704,45510,82,56,101753,27756,73997
ae3aeaed8353299cf577576f1bd53cc0,135,93,297689,69318,228371,110,89,262551,76427,186124
6793d585eb83baaa769a4ab738c405c3,178,116,718606,142486,576120,141,103,590570,137862,452708
44ada504854bafbaf40f4d79dce9a05b,132,95,262453,49010,213443,95,78,198255,58903,139352
8d96174f8c994c173c1efa2cf0514793,38,25,56317,15487,40830,37,29,48283,21146,27137
dea729a173afee280cda53180923a754,149,121,342829,49065,293764,123,109,206982,56376,150606
2c4ff534454610e4721496a65f98d3e6,151,117,456074,107166,348908,141,106,465835,92033,373802
d4bf8549715bee53ed0a3031e0e0b492,5,6,439,616,-177,3,5,312,380,-68
cbb111abb362781e40c24c5e14bd8465,84,59,144390,24959,119431,92,83,144397,30072,114325
86189d76b664281868c5758e1a5bafca,43,30,60105,17864,42241,44,35,38664,21804,16860
6d00c654106e37fc82986c0c63f125f0,91,66,117718,32462,85256,81,67,134397,31865,102532
04406cc72c1c48e259ca65b77b896d1b,56,44,82292,25850,56442,53,37,70455,15632,54823
81c968890f01aea3d0dc45e189330c61,22,19,9691,4549,5142,24,21,8014,4436,3578
9e28615d24f73d1d4b11f1747ec6e633,201,125,752287,117458,634829,180,118,672892,130176,542716
debe0192e03ae06fd03a22ecd9d856ca,47,36,60168,19449,40719,36,27,46836,16071,30765
9d75ba83623b0f365f3a7dddcfeb3ba8,93,76,160178,50607,109571,94,79,194581,52309,142272
156ef4308c32c488948c46b6df06d15d,23,21,19703,6713,12990,24,22,16238,7411,8827
a8cf3c97283b92add464eb7b8b5c8b18,178,124,682197,164443,517754,196,142,750486,167084,583402
7f22e0f4b139f9214bd90488d6b13301,39,28,85368,26922,58446,79,61,209512,45004,164508
2f8baa1933de9886ce0ea9c063ccda5c,69,56,130459,33279,97180,68,51,93274,38510,54764
0b917edcea41cf9ab7d07900941bddf8,82,62,168075,58747,109328,130,99,286493,51584,234909
16407aac734e4beb3907edb1632f79bd,18,9,5001,1380,3621,16,13,2968,1860,1108
19b3f68ebb62d8137d534890b5c566bc,82,68,126642,32612,94030,96,87,132201,34891,97310
9eddf040c36cc90955b1c31dcb5280b6,126,98,243952,51526,192426,188,134,538696,56532,482164
ed305a7768aa183fbd502d09317ca0fe,67,48,136224,48793,87431,83,54,177727,37549,140178
a58ef1ad2adf045ac6f6a4519597ef7d,137,113,346944,88465,258479,119,107,272295,120032,152263
c9d9cfd11cd9cc107d8816886c686607,103,76,195194,51582,143612,104,67,164433,56681,107752
24757e54f54691235c5d6355f8695686,64,52,88485,37100,51385,59,46,109440,30020,79420
7b51dd132d23089d4110532a535a8192,81,65,144142,63964,80178,106,90,205402,59926,145476
a6438d88b4ea69b8a3534fb5fcf575f2,97,91,198264,44239,154025,82,67,121578,46991,74587
5a9d89048d494b74f35c0e298ee446e3,20,18,5063,3510,1553,18,19,5833,3721,2112
ff1a5f53c430698e8251fbf62d3968a1,48,37,64033,15406,48627,59,50,59651,17930,41721
484517a85f6418cdeafe963db6ab7fb3,53,44,52848,14931,37917,43,28,46545,6934,39611
3441d057ae711192727bdeac2de9514a,57,42,80731,27618,53113,81,50,148519,23073,125446
414c5cc71c6f684795d70a7828642d11,9,5,1291,715,576,11,6,1151,904,247
e3e7f255686058c043f9904f88bc389e,134,96,382855,90017,292838,183,144,592509,107246,485263
7c66d1fb1061718b5471c3e8d8028b58,96,59,164823,26821,138002,132,105,247230,48643,198587
5a324d8b37522e9f9684493465720023,41,29,28536,9621,18915,44,34,30504,15560,14944
ebda3cd44c4fcab4fde8a1ab80d5d069,164,124,547170,127042,420128,195,135,590144,101059,489085
ab573856689f5b54661018dd9b1eda56,32,24,15099,6459,8640,24,21,10748,6806,3942
634ce6f02a9cd9de46709e9fc814d13f,53,47,75588,17281,58307,55,38,78433,23432,55001
8e17619a822f315d2d0e9d829b4087e1,22,17,5357,2281,3076,14,12,3804,2342,1462
1e74894f221204f7fdf0fdf678c4e0b3,185,133,412073,77887,334186,143,119,313138,97834,215304
d09d517eb325ab8c07444e317360f109,75,62,121352,40176,81176,81,56,97600,38154,59446
5d190e8dab3d9c9a7607b1c230821394,75,58,95185,36461,58724,76,73,129804,39289,90515
4e4c3c1ff2186fe1743332fb8de6b73a,100,92,242501,84676,157825,73,64,155091,99597,55494
8dac199f2fcc57c1d4368eb0bd7dbaef,148,117,512650,93232,419418,157,137,486768,144959,341809
ce6c88eb567d6f777b02128f2e551697,123,100,492914,111150,381764,131,108,453934,96964,356970
f9e94b733d647ed48316a91546e991a5,143,114,371232,59499,311733,150,133,385671,68980,316691
1a68cb6bcea6b842aa47242b742f5105,48,46,91832,28854,62978,47,38,71645,16970,54675
e45a72c02283ba0805be218765c5abbb,38,30,34403,13771,20632,29,27,29605,16453,13152
95ff009a8ba3b286191be810cdd67209,213,142,886244,190394,695850,198,125,926969,189189,737780
ba857e46bee04fd12b867ba0f73ce6ba,48,36,48850,16758,32092,47,36,43278,12389,30889
2a64a8273de48f9a4e3866bce1d2f8da,92,82,179430,58392,121038,97,76,197736,40734,157002
1beeccb28e5d4bb28dbf1f65820fa021,169,126,458823,116501,342322,152,123,428455,124730,303725
a1aac93bb9b1ab04b40612e223c4021b,27,19,9007,5200,3807,20,19,9460,3804,5656
5d2f38598d7a826549dc078749d113db,98,73,194049,45363,148686,109,82,193275,41778,151497
e0c83868d5ecfb86ec56d4eee46591b2,161,128,550933,119185,431748,175,116,507501,116995,390506
132e69821c2e8af4aedfd0933f80d26c,42,35,41907,17641,24266,40,32,43015,15745,27270
b5f6732b0c39b79a91531aa890d617d9,137,85,205404,45703,159701,122,95,216157,48597,167560
af84194253f7a70afa4ae9b70d394b63,43,41,68946,27750,41196,48,41,56437,27061,29376
0be3e9db1d687864cad69687aff53afd,119,82,310662,96246,214416,115,106,253336,105425,147911
8efc889a61f364cc379bfdf460c57bfd,24,19,11101,3959,7142,24,19,7117,4627,2490
56ace542ae39f07e8242004b7162e97d,72,53,68236,20642,47594,67,37,59228,12747,46481
e0fa70bfbe278a3bf38561deeea19b89,104,76,192001,47499,144502,123,105,212576,48487,164089
559ca8a0dae5f112596146a1d9c71390,144,98,464223,70814,393409,174,148,483342,107980,375362
e6c4d4f520472710f16dcb56b521dde9,94,67,174552,57261,117291,85,76,163211,49662,113549
f7f71b9372b2bde0f079454a5d0573b9,90,67,183547,49971,133576,99,63,172260,51177,121083
5f5ce7e4f67eedb867c3730ff04abd9c,65,55,79237,36154,43083,59,46,82164,30682,51482
e42bcbc26a79195415c1157e763af13a,66,40,49077,27198,21879,60,42,65089,21236,43853
760c81a338fbf6114636df8156964fd7,131,100,300672,50905,249767,134,116,332349,72768,259581
b36ed6d74445b39850f9fe0a63882b33,187,134,650455,126080,524375,123,98,515668,135647,380021
1bcfac7340da35439be0d1da32540c65,105,94,239451,42731,196720,101,88,211605,50893,160712
c2631258073646d37ee854e4ae4e1f81,140,108,316333,59732,256601,110,94,280045,59878,220167
dc544abfcf930db0bf7943dd61408771,53,53,92827,31049,61778,63,45,92515,32544,59971
2316210dad0535b9034798db39a88e2c,98,72,156881,52285,104596,86,67,125638,57419,68219
625e9e8deecd061f3583b9cec8948f0c,64,45,88455,18957,69498,64,54,67126,22806,44320
5a5b17ec747ca0b3ea234c5fd8343ac0,134,109,288752,67061,221691,130,115,366475,60876,305599
a7fdb5dbae1a91abc3fb06729f1f8e44,118,68,201249,39471,161778,126,83,234288,51969,182319
94f6093fa1da4b472be4b352b5eae8b3,129,106,334355,65309,269046,166,127,483843,52967,430876
48828dcf93747c69e3955298568315d3,186,141,522914,66896,456018,155,122,534769,60139,474630
f7bde2fed1f63aa1e777f04c3f95c6d6,127,99,339342,110352,228990,147,129,388369,102185,286184
92068483aad6ae6cf511987cc9f1f33e,93,76,199740,65107,134633,79,65,125256,52903,72353
9e5ea8c8357d8b128af76a1faf48fdf7,203,143,470182,106904,363278,129,91,350119,87011,263108
12e60f9328433f1109c79b2e99173814,76,60,115010,27048,87962,84,59,85414,31004,54410
3c026685393bc65d4b29c391e647b7ac,204,141,714020,130172,583848,190,122,780130,132209,647921
ae32f50dea3a44925cead6f94b1815c2,38,27,25754,8277,17477,40,25,22954,10000,12954
7327454b9500841ae4b06094ef9c0bb0,81,54,118583,37195,81388,124,103,224685,38078,186607
af5e260b9b951f9f5cccc90ab5465857,46,36,40133,14987,25146,44,36,51379,15681,35698
27de3ed264ac43a526c9973dfc084712,109,93,225715,33248,192467,105,87,214431,26569,187862
66b705adeae4f55d60563ce9d3f5ebce,91,73,185669,46759,138910,91,75,165924,51431,114493
f31f306338c826a56e20abaad46a7486,20,16,3813,1721,2092,20,12,3845,1105,2740
eb8d5cfa0397a2f1d81b94749eba7222,97,57,175771,63132,112639,134,87,244474,62747,181727
c9352ec2ee063a17945f4e6929ac7ad0,147,109,527653,99840,427813,184,139,654325,105866,548459
4b4ee0a4034e12081e99160601a14702,113,108,268354,74154,194200,114,106,260851,79389,181462
a5755f45b1d2d09c62d17fe01a966f81,30,25,16205,7609,8596,36,27,16620,8038,8582
51f3bc4608ff2a390d59272a23c19a59,85,67,156149,49534,106615,76,57,99802,27527,72275
e7482439f79b90d2ab3ef0249a272a90,138,65,256357,61114,195243,96,72,187517,107430,80087
01c79e7ee73ebb0f892ee709f20ff099,148,120,362154,99026,263128,159,111,440795,80462,360333
44c1f9752efa9210bd3cd88fa6a908ff,56,42,78545,17985,60560,63,54,85544,26776,58768
ab580b932ffb0de8af69316987a86694,47,26,45432,14973,30459,42,29,41624,14522,27102
6215af4a39dac5f2bdcabfd89ac6ed35,109,83,346394,86170,260224,98,83,240175,70241,169934
a8257c7d01ff1932e2688585dc1c2f1f,37,33,27809,15370,12439,46,39,35706,15885,19821
ef5f3db5fc4498508399f4b3c12834d6,175,128,504147,102990,401157,117,79,300164,114601,185563
d8582d68dae3e3430399ed1aaa6a9a99,188,148,578096,130355,447741,170,132,541755,123881,417874
9305f4be2d7efbe533ef60b3e1415816,180,122,453991,121711,332280,184,146,608379,143866,464513
1265694be4a4f472634664463a419053,12,9,2191,1456,735,13,11,1650,1670,-20
c37d6f6eb10f001a2aacc7f8be39eb4a,156,137,419082,149378,269704,196,145,590098,113137,476961
05d02d01bec4262a606501660538c46b,228,136,737668,168235,569433,189,152,620601,205208,415393
4d125d9690649f8d4e0e96d71fc2f1de,140,99,407826,80271,327555,160,121,526225,92354,433871
7781a33075f5e37f01541127858f7f3a,91,70,164975,34548,130427,109,83,142498,37871,104627
043f2b88b422e8220ff07282d2e19006,121,103,357962,112109,245853,162,120,384459,79531,304928
14e8f6c7956db28dcb6da60a2d081748,170,110,452439,85529,366910,169,116,439538,95546,343992
582f8260fa603bfb9fc5b1b673244ae0,42,38,74860,19122,55738,55,41,68320,26066,42254
be164b497353f990c0677e4bf061c282,11,8,1712,844,868,10,8,2470,911,1559
757e69986a85034984390f3588c0b06e,67,42,126774,24602,102172,89,79,129526,34838,94688
10377054a9f17e009303d4b70d9e1472,158,137,537257,134538,402719,142,96,435211,107115,328096
00a8c05d6b133cb1a802a0de5b6830b7,34,34,45860,16863,28997,53,41,67943,14955,52988
864634fbe3fd6f78c65fcfc15994d176,82,62,137136,61577,75559,128,79,236095,44072,192023
c24a17835504cd4e49c49b5140f4e443,112,91,287965,92237,195728,125,91,317625,96707,220918
5599d3a349d48d795ede7340fa3ff468,99,84,207620,60566,147054,132,111,332200,42881,289319
561788c4b0f2c07cfc4cfe6603834c00,65,41,99099,24679,74420,78,60,142827,39851,102976
5e85e66faec08c679ccd86e4f7367ec2,109,74,165069,42965,122104,93,73,180213,37089,143124
d47f9f96f90ea3d8d5d50ea06af6a7c6,86,83,171247,84490,86757,141,126,327743,81663,246080
3a5caae31c8fbd399b31fe93ce22bdf4,64,54,96050,41163,54887,89,71,148529,36305,112224
c44cea851b0a6ec34a78d7faaeaa7a7d,92,77,151891,36246,115645,88,75,149508,44179,105329
7b64669a485c269ecc06ce89e71b13a5,113,78,202224,53311,148913,150,121,337986,58700,279286
181bb2fab91fccb12458dfb965e68fb4,0,2,0,289,-289,2,0,289,0,289
8dd2078b883fa9a00eb9a02f92944471,120,95,358804,72353,286451,159,126,566068,97884,468184
fd2f2fdb2888c3d4da22e680e0fa0923,54,45,73079,23565,49514,66,52,90954,17867,73087
94316028b0eb8ea54937f0337851d220,156,101,392702,45982,346720,125,94,232028,77346,154682
c931e24c6043051540b637b8ff89ce35,70,53,132351,31075,101276,104,79,135426,43598,91828
a89de5cb7236c7b240d201557cf8795d,113,90,221343,69704,151639,101,70,187618,62255,125363
5957be016a4452870a66da1e3e085d86,107,66,158896,68295,90601,122,90,221752,53316,168436
116d7f02b8761795a00e32cd367fcb96,153,131,599338,127178,472160,146,108,582594,129554,453040
4365acbadae417aafc18c18b58a44fe0,108,82,237357,53430,183927,104,88,284795,53615,231180
961c93a65fb7767cfba1bc96066781b7,92,90,147404,52200,95204,85,65,149976,41052,108924
3462bfcd8e89cd6a9aed29ab7d2a0111,159,124,667128,118586,548542,162,106,726584,85864,640720
a2c704b2bb96895f0e316c9cd7b90e60,75,74,237248,79983,157265,90,60,198401,115560,82841
6e543bd4f727431a48f2329777a79b3c,126,86,276369,44699,231670,119,97,198662,69843,128819
7c753286909ea5c062e94f98837474b1,204,128,664235,112803,551432,168,133,578029,98163,479866
9f889193a582041b633d844461720430,178,134,524485,82345,442140,178,154,581973,94016,487957
7f0bb2d0d3c1232c15af2453e3812e28,12,9,1506,1165,341,12,9,1615,481,1134
231e1086ba208ad827643fe8173bc762,134,78,295840,50455,245385,136,102,352083,68226,283857
f1ecbaafd547db879ee594153fc0e53f,78,57,102895,28176,74719,89,65,115074,30942,84132
2ac9595569e09a3b5f3041fc0152c19f,32,24,17640,8546,9094,31,28,16135,10460,5675
765004b272c7fcb54c87093238891c73,186,104,569163,135904,433259,187,138,741692,177509,564183
28a731397c6633566a246e4f6696e193,90,82,138136,56758,81378,81,66,191116,34197,156919
6474040686505a316f574a9394db35ae,64,46,104537,35208,69329,60,47,114225,31764,82461
d84ea1f64bc2016c57ff6a3f3601f6e4,76,59,116637,36689,79948,72,55,84874,23782,61092
428393f11821ad3f4c716d315c44f380,98,78,195217,55672,139545,91,52,222778,52759,170019
5b009eeaae141c0b037e5d78d38a3997,104,91,253784,56580,197204,91,76,168802,34883,133919
02f9a964930018b9d02f5b0eb6b3a91f,56,48,85674,29622,56052,67,52,98749,25484,73265
7c06d86456b75fe998e5b767143e3d31,103,85,150933,45713,105220,79,66,162479,42845,119634
2122983dbc3a2eab966a8d267fb5d18c,53,50,52629,27018,25611,57,52,88846,23286,65560
c43de375d4dfa3b37ff34ff5e0f4c014,174,93,468380,77835,390545,146,100,386599,74026,312573
7ff65fcbc1fb990bb710144457453c12,24,21,10482,4109,6373,24,18,10197,4744,5453
a10da1ef0b491558f536b8831c10b060,99,88,263966,54105,209861,115,76,204660,72035,132625
d2ffe0d5b9fa15b83578929e1fba8d27,165,143,568968,109868,459100,130,80,317229,85850,231379
d3b6db51880b70e56c12d372dd7ee800,27,24,17430,6697,10733,23,20,10777,6999,3778
655a4096f9be98884a337e403c750412,67,53,81307,25512,55795,70,57,67280,33737,33543
a2d33ea2dea9844b1a8efce70d543aad,40,30,29033,9302,19731,34,29,24803,7671,17132
0239c4fb71f427add6bb66a5e896508c,161,129,512695,110949,401746,153,110,349187,89796,259391
384926182e125cdce200461ea272b37e,134,85,347421,71219,276202,115,74,254463,59519,194944
24f563e4a81d9fe15eece9e2b3148aed,151,132,484464,148917,335547,157,105,449848,110594,339254
0aa78dc5b2a81809471e8fb63766d7da,128,92,370706,70613,300093,169,125,378831,99966,278865
920fe89806329d16270ef27b9f9643c9,48,46,62744,23507,39237,42,29,46982,19696,27286
d3346cc91183b0c47f0b9b84f166dc73,73,59,82498,32169,50329,70,51,82497,23817,58680
bc77e755b8534a7841536e9b178b8742,13,14,1577,1390,187,12,10,1723,1127,596
e19749409b1631a5ae8630f295ef9972,193,144,575209,98949,476260,130,94,377002,86950,290052
8cfa14f755d5d6e24e7023f4e0cea32c,23,18,18894,7272,11622,20,19,23234,4774,18460
7e7e90abb452a18b30ee7af291b3ac74,111,78,198744,58710,140034,91,92,208181,63244,144937
26952de10a93c38d7fd7715794e56534,143,107,343440,76214,267226,110,84,276199,63973,212226
62b8ef3c92b5b05b7799e79f9a33668e,52,44,48038,29015,19023,53,43,52748,23938,28810
54547bcc31e6196c3c106bca3fd84819,139,106,351628,111756,239872,158,51,318571,60158,258413
e8f3d40f9b8a817503f14ce749616aa7,78,56,153912,68296,85616,133,75,253432,48480,204952
219a31b097ceebf61d14f0bdf1f6a525,40,26,25886,9589,16297,48,29,39523,7917,31606
2c61ac1b0f3812671c59695ba7199726,28,25,14686,7303,7383,23,17,14515,4591,9924
6a327bfa8a50cf16af3c7f2f6f4b144e,111,66,261433,37678,223755,121,85,274139,50566,223573
a0c7cfbd411a2f68cbbdad3d2bcec14f,55,47,45573,10509,35064,40,34,24646,8725,15921
5d99377aafd9f74f3d40334dd5138bd9,93,66,200733,52578,148155,150,105,272468,61123,211345
d13d6f9e116985f437d9c063b9c0b17c,106,86,239993,52380,187613,63,56,136927,48322,88605
f23d88ee51369f3cc2f341911e9d39df,42,28,24480,11221,13259,32,24,29147,9043,20104
4fde8e8d84e1802a36d1308e02113dd8,88,75,133342,39174,94168,88,63,148031,28349,119682
81da766f33d63062d924f55e019e4dde,42,33,41492,13735,27757,46,35,28034,12417,15617
03e64442bc7e6d6781eb82690828fc59,111,82,165053,59657,105396,157,119,438050,55809,382241
9406f0101088853528afce7f3f18cfda,2,2,93,124,-31,2,2,124,93,31
5e34c04f67784c4f367eaaa46f3062d5,121,82,267542,55446,212096,71,54,153295,74553,78742
3efd9dbceab64a5d2790d5e0f6e9a5aa,121,107,261193,62840,198353,106,89,173792,54958,118834
3e4028c6593fa0d0715e8c5bb06a3d0b,104,92,193943,75437,118506,143,112,353231,50232,302999
6bc1f5e967ca9e893a4d6a6ccaa524ed,100,85,204956,79352,125604,89,64,172677,70385,102292
f452148f679c8dc645ddae2a3b567465,102,76,265324,85653,179671,179,124,424914,62779,362135
2cca57ad2b5ba85904fd45c177ca6c01,51,39,74673,23132,51541,50,41,70366,32064,38302
73cf5f29d8053a69af3af52e725c0e0c,165,123,429530,86679,342851,178,142,435864,89426,346438
71eaa3332ef7b45c1823907ff9dea253,11,11,1738,1277,461,9,10,1852,1511,341
b1ced3e246d841ee071b905644bcd4f5,112,85,223055,71461,151594,123,87,260796,63637,197159
1fb5ea024c3bc277832ee7d188f72fb7,100,87,223162,66581,156581,119,95,246663,65216,181447
78d4bc1e9617dff9d45bf1e515784b6d,37,27,28496,8430,20066,48,36,37031,12266,24765
97ef84a9ca2ca3d2b18025ff002d6023,14,13,4140,2499,1641,18,10,6127,2704,3423
8406f1ffeed4db98325b1ecc443326ba,67,52,98682,37886,60796,70,57,115522,34090,81432
49d678660822af97f158400de5be10c0,1,1,156,33,123,1,1,33,156,-123
14ff7226f92fa7b30fb7101929640599,179,138,638150,117008,521142,148,105,517973,122270,395703
829601614440b14d8b3adaeb843bb7d1,73,54,82131,24259,57872,79,65,77358,18314,59044
dad6de46ce4298cf457a1bcfe4ad7615,59,47,105863,32758,73105,54,44,76355,34247,42108
f883db1813d4048fc7129410a6c266f1,97,73,188486,41830,146656,155,121,301866,52289,249577
33e6b04af5bb762a8a47d6f34c395fd8,61,56,85052,23480,61572,70,54,66567,19911,46656
f2fbbf92ec7f5e28faf3ad4aa9334835,70,51,123026,39544,83482,106,63,218123,48992,169131
a6ca1b5c9a851e8fbb05467670fa1f39,200,141,791052,183966,607086,145,92,707093,198201,508892
c427d64337b3df101b3320330782a6f2,20,16,5903,2135,3768,21,15,3443,2886,557
c75d1de6798fa0fcf003c9acd3ed60ab,66,58,111121,25987,85134,74,61,94318,27529,66789
661b24a815f539ed6725b3dec591ad0a,147,99,362150,92042,270108,167,131,390237,68509,321728
da099447b642286f250f1158acc43ed2,55,40,50472,17261,33211,54,40,42759,14826,27933
40f2a12b70c364d1c01580da9f20b579,46,35,70631,18648,51983,53,46,71419,33035,38384
40ff1d1ce6478321c5d82a9fc6d1436f,86,61,115610,45992,69618,101,83,149618,44243,105375
760321b1416beb6982e0f621f68d10b1,46,37,68992,22739,46253,63,57,81293,29011,52282
1db8fe898d1beeda95c13d444b927974,134,103,378093,85958,292135,107,81,290747,86058,204689
66603d5fa77a046a68ccd06e13a98d42,53,36,71209,19702,51507,55,49,59873,28151,31722
dac9758e23736e8c9c671ecb8cb84a2a,130,92,253412,41799,211613,145,107,292082,53471,238611
9fb7a8420435ac78e18a07a7c53109fa,15,14,3350,1021,2329,15,14,1726,1888,-162
438f457a3c6c52631251fa5b13b0f51a,76,63,150039,45545,104494,72,48,144529,43093,101436
d481c1c276979872b0522edec35a4622,119,93,255023,80446,174577,110,82,221261,58434,162827
36636d4ba1d85e911b57abcf6cf8e574,121,98,309848,43834,266014,120,97,260482,53228,207254
98b185c6e8e96f461471c4805f269b65,184,114,308057,89595,218462,149,110,317419,80562,236857
e4b3a6a9a999d4a991c08ac96d737e9d,95,48,146080,21401,124679,88,61,102561,37859,64702
a8e975df2c68d400016e72437b8e39c5,198,143,585175,131757,453418,114,95,395467,153957,241510
e431aabf96416f207da391dac237ffd8,121,103,333455,98132,235323,98,84,262698,68535,194163
5851797507c9ec174a6bc2a98ea14c4d,105,91,172278,65542,106736,148,122,298838,48604,250234
f4713b8f4c9f648c28c4edab8e59d357,132,103,282559,61837,220722,100,77,249630,61926,187704
7fc0801c9af030a937212e89a9497fc8,11,14,1035,983,52,14,8,1808,560,1248
60be59ddcf845e5ef10dc07e851f4937,21,14,4417,1026,3391,15,15,1687,2163,-476
44fe93b290f1cff465a2e3d1cc3b75de,65,53,71608,32900,38708,78,59,98546,27392,71154
818a334b7ac8b0a9bf8ff6f37fac3a52,96,74,144006,56562,87444,107,92,229039,65943,163096
db7dfc3cf09d255bf3c099984a0ac95f,129,81,264171,43122,221049,81,58,159165,39300,119865
b1c5a7e5c5641966f6559e7fca7b3ee5,36,23,22147,7804,14343,32,30,20373,9058,11315
a6a66960e48429db697402d2f1aa88d6,89,67,131677,33978,97699,76,68,94085,28386,65699
74c89b0b2417ba8fe072bbaaaea8414c,154,132,515532,120578,394954,131,106,416690,133035,283655
7d787ba429f8f9db117722f72068ab28,23,22,5868,3554,2314,25,13,5399,1915,3484
13139044b5f863da0f839e7dac325b13,60,31,50153,16236,33917,43,35,47347,15396,31951
cd6fb7ebba9f969a6d204e4766eb8f4c,121,79,283548,104046,179502,145,100,372333,111073,261260
cc531b55ab54f65cc13234b6fe1aa7b3,55,36,56426,17263,39163,52,46,55117,17195,37922
475f0a241c08ca2541bb1c0752466e2d,91,66,118909,38375,80534,94,92,153685,33187,120498
5ccb627f0d9a6904f9671f7aa9aadfff,98,72,238522,57435,181087,109,99,326275,79763,246512
32de2c6d894a8fea38673eb0475eabe1,135,70,370390,57114,313276,154,106,371240,104283,266957
4457a30ecec854c169ecfc3ef0ef0a40,26,24,10309,5416,4893,26,23,11925,4885,7040
ac422bc3b1e34d52aa0fd34ae331de17,107,75,316890,76669,240221,133,100,352135,125168,226967
31ddcba09204954c5c5682f051f0dbb0,53,45,48727,15540,33187,48,42,54824,14105,40719
148e0c8bc7fbcf5d9a84bd5055dbdd50,68,53,90728,35698,55030,70,49,126922,36104,90818
f0ab74c41be8d765f5e693f493fe2b51,109,74,204931,30229,174702,99,73,153584,45581,108003
5441b644424483345b08f0066554fab7,179,117,451131,91977,359154,147,101,367585,76847,290738
4a0c8801945075e94e4a2c565cdae562,135,108,397017,79827,317190,102,86,224394,83801,140593
1064e590e8cbef1fd9fa410b719990ec,14,7,1443,702,741,10,13,2243,1065,1178
9b26034d58b37e1d76d944bae8d73b2a,93,61,128508,45019,83489,93,60,203653,33178,170475
528eda9e894460d1f34a2d6ea2ccaad7,169,119,748977,172100,576877,210,106,589825,176450,413375
08e534fa4ba4fc90b025b4701c6fb018,89,63,170700,36417,134283,88,55,151186,30650,120536
cbceac1c1ebe0a3b1d9735f2216b16d4,120,95,311491,64684,246807,140,105,363766,59905,303861
69165180e619afed49321ff860ae0ff7,100,84,184634,51904,132730,141,109,256184,56396,199788
2da0c5cfefa0790d2cf13d5de4e54521,141,116,352100,70560,281540,110,80,220108,80893,139215
bbb08fe696ca7828198858687efe47e6,91,57,180656,51486,129170,78,58,145856,52416,93440
841c7ec9de05d32d1c7117f9d335249f,30,29,22652,13196,9456,27,30,24759,10950,13809
836afcdd5ee8ef6535972cd078fab902,42,43,34083,17845,16238,47,30,55252,10499,44753
3c33bd1a1f5d5ac2f4e18c9cd496e02e,76,55,97456,18893,78563,91,77,98202,24693,73509
4ec234526743281fb7b807a5be526b12,70,46,76024,23387,52637,64,51,69986,23760,46226
e56e478170acf63892a3eb157a30c6ab,138,108,250041,85340,164701,132,107,267455,41040,226415
e1a5bf87ae7e02b24617d58fecb3c77c,138,90,346039,69215,276824,155,111,362194,54046,308148
ca853395b462aa9b9107af8f0785c77a,57,39,69623,22999,46624,48,36,64081,20480,43601
5aae0040760025d171400adb137f341d,131,95,276116,80376,195740,127,96,323701,67046,256655
06a63eb103f69f48f0a6c5af0033ec8d,69,59,93654,39305,54349,81,59,113340,26688,86652
93cc34739cc8473e6a4cef4de1cd5f64,124,84,274769,90773,183996,87,58,176057,75756,100301
d46d025dc418481faf154376fe2db78c,132,87,362039,96276,265763,152,122,391340,95202,296138
5c3380ad7189290c8aec353b97c5e2e5,138,104,328631,62839,265792,175,138,488128,63581,424547
31a094ac15e7014f9a445d583c033282,64,47,84892,25781,59111,62,54,74697,26434,48263
5e78f8e64556b935d3b111025dc3b478,217,143,864998,158079,706919,235,161,1305773,148371,1157402
866b7f56815ff5ae807d4b1c37ab2c16,175,120,412255,52881,359374,104,87,193758,58123,135635
5735bdb32a173eabddb8888463c86e99,51,35,73735,7855,65880,49,33,28871,12350,16521
4eb4e7b8da3853537789331d39c78d8f,137,87,321187,76590,244597,171,94,328900,56676,272224
0facbe26ea9b263ddd5f3da88cce2fe1,3,4,197,746,-549,4,3,746,197,549
41ec169f0fb5e3cc62c42a918f70abd0,72,57,97579,27156,70423,79,56,91094,25798,65296
c22d0a39b11aa909990b4cf1c337a55a,127,110,239989,66147,173842,126,86,223366,50367,172999
815b129dea9aefbcabbefcc242bf81c3,36,34,31973,11534,20439,41,35,30564,11335,19229
9bf70175158f76966dff2ef545da029a,73,57,124643,43244,81399,104,84,206248,38001,168247
1ae0a21288b2172ff4258c2764b15dba,79,51,120009,43082,76927,115,73,175592,48850,126742
745639d2c75c49005564362da9a26b29,73,57,128041,29012,99029,69,62,120111,34147,85964
3281aa0226aec2781c878b01e007a236,57,38,54935,11736,43199,42,38,52906,12807,40099
0fb10a29a7c8382f9f90f006a36fdb92,64,52,151280,53429,97851,133,114,350677,58782,291895
c1c496ba4d9fd6c73414b620343a88e2,42,26,30785,11671,19114,35,33,26475,15632,10843
3a6b41fb121a2f7cf6b9493d0e89a14e,29,31,18670,8988,9682,25,21,16169,4998,11171
6b2722d2654933b7be6fd8a36db62484,19,17,4659,2771,1888,17,17,3819,2622,1197
cbfef7a5a6389121f1a8965cc50fb239,60,51,97211,40256,56955,98,62,167491,40238,127253
8c2c29e72103582eb77058e80ded15cf,104,86,242373,57587,184786,92,75,222779,53035,169744
702f333b086f72a26154bc90d0cb06c1,19,19,6061,3638,2423,25,18,14750,2650,12100
ccbe60bb763f7ca74847b7642b88381e,104,74,172670,36653,136017,81,64,144840,48148,96692
6bc61b7cfcad41a1768b62ced201e286,22,17,5299,2442,2857,19,16,6166,1756,4410
3ce22fb0f675982e0eed208a37d860e6,206,144,782726,221142,561584,207,144,1547459,155986,1391473
f29e07dbdffc3b4002110d382cea2a41,25,13,14238,3827,10411,29,22,23038,7811,15227
db80a55d9f5f30d222b402461cfcc862,49,39,48813,15927,32886,44,35,47670,13722,33948
3922b936e8452883f3b4cb5deaf69301,66,48,116792,50482,66310,68,53,138825,39759,99066
7844f524289a552c0c1403468abf94ff,168,109,360774,117519,243255,200,128,514767,93480,421287
42ccb0fcc028c39c9e4292004ac0c883,57,53,68450,34155,34295,55,39,88140,18155,69985
babcf6e235fcfe7526e3e4e2d9acc23e,120,91,260899,46756,214143,99,84,217547,53755,163792
cbd43b3c93602c9415011303c7132a20,74,47,89099,26405,62694,98,52,88689,24180,64509
b50f8f96636d405a9a8219b58de7b987,141,96,409069,59983,349086,149,110,380161,70541,309620
40e5672137915d4f982d2e9a37d9fda9,43,30,45087,11475,33612,45,32,52540,15996,36544
9b8ec001646cef2ed6d1ba1652f27be1,131,92,325311,103588,221723,180,134,592517,79795,512722
586e867ba81ac276bf8208801a1b9aed,27,19,10126,5072,5054,24,16,8488,3472,5016
5a5438a0dc7edc778e574a9225e85114,65,53,114142,32704,81438,91,68,140615,27072,113543
080081080aff44f4201460976b599d49,161,125,387084,77564,309520,155,130,514862,80639,434223
b615744a24e839477ce4436b24c2b6da,167,118,633844,103606,530238,177,154,511412,88900,422512
ce6f55540638672d7297572be5bcdd71,91,63,183595,39597,143998,75,63,140516,46957,93559
931770eff29774ecba6a388680489f0f,190,132,649702,109190,540512,140,103,433035,140820,292215
5b5e97bc2052845fbe060a2568d343da,111,88,522067,114919,407148,188,139,981015,123858,857157
6dd5b2cad8757633f7fcdbf874d83e02,52,50,75988,27846,48142,49,40,61481,29115,32366
8fcd40adcafe70338b909f0ff00e2ba9,171,109,421050,90175,330875,177,132,444222,96462,347760
e2831814ac671347047fd05c8030d0a8,170,136,452985,138968,314017,150,117,532668,140598,392070
db9252f0ac56ee0e1aad411b8d57cb97,68,47,95318,31327,63991,82,56,92373,35570,56803
ed3899e7ffe28a51ff59aa4ed1efe922,165,133,397486,61470,336016,139,118,320424,65448,254976
aec12be6fe538e1375f0a4f951db4ee5,24,22,8768,5102,3666,27,17,9036,3833,5203
13d4d8628f3a5f199a1460c5f8996ef4,45,31,44736,12475,32261,33,27,25216,9771,15445
2c3436624ca91cf18c2ed45c3b024402,164,102,388149,141473,246676,134,112,382711,149947,232764
91a558631e7689d96dd2faf911717a5f,161,121,484524,77834,406690,100,83,304535,89272,215263
36448ab2034448a78594190b02ccba97,30,23,24044,6421,17623,31,23,13865,5697,8168
5fbfe990388075312eff2e3bd815c7e0,123,108,260672,68589,192083,118,95,314498,67029,247469
0af0c68e5b5d0789cc9349a357c2e161,66,42,115270,43406,71864,96,67,158866,43456,115410
4e35fd4a42812cb0b3d8f7d9014d6ff5,42,31,34354,10164,24190,41,31,35501,12902,22599
953fd0a64fb218bdc18c38337ee7140a,15,12,5931,1581,4350,14,13,2309,2143,166
73b345550555552e28b8faf9d35978f4,108,81,260682,69502,191180,106,71,251200,53967,197233
1e5216172a827fb7eab3774fc8762ba4,46,37,64754,26481,38273,52,32,74838,22851,51987
804a33859776705e6a8d739a577c440a,144,114,475791,109766,366025,220,162,738343,126804,611539
a73ec0f7177218c627b0f8ae73fae571,89,73,129984,32849,97135,57,52,102061,31649,70412
381aa4d28240da392daddf3cabcb6031,208,171,1115716,194439,921277,211,167,1111156,168238,942918
f6f197ae94731efdb4ffed4ba1116da1,130,85,315437,42645,272792,107,79,247968,46461,201507
19fc5543223fa1f2abefcd3a242b34c1,114,92,257487,49949,207538,129,108,265276,47664,217612
4ec4d0f775115e24c5810f492b5d1e90,154,130,375933,63537,312396,124,107,265691,69331,196360
9d09e53aaf3a5677f6f863e0dcedbb85,158,114,538255,128749,409506,151,110,487398,114903,372495
6057df88228ef7f82769bf4e8f94a30f,101,81,208992,62297,146695,117,94,357864,67364,290500
2f0dcd7c42d1144a19d081aba8db94d1,78,66,96775,27482,69293,88,75,142980,30954,112026
3ad8667a79fa29c5c03a713020d24e34,87,74,131326,42893,88433,105,82,205537,40749,164788
8602c49ca9148b475b32401547c43907,143,126,358739,76712,282027,122,112,248353,70100,178253
a83974c22c7202939dbca34f04202bb4,42,30,32099,17459,14640,41,34,47748,17338,30410
3e4e3b4cb4dff8ef9570f894500418fe,177,134,450182,97189,352993,119,99,294923,80176,214747
433183d1cb2e32e452785cf058b4d57d,34,23,10241,4292,5949,21,23,5972,4502,1470
770ab03a221c6f065d0e41ed8a68ec63,38,30,40657,14334,26323,39,35,48847,15981,32866
6a811014a5b409e7f11244a7de0662b0,59,40,51125,24771,26354,78,49,85388,18881,66507
996845c071f7b92ed580c742ffbe8696,125,82,200251,55539,144712,123,76,227760,51194,176566
39362fce6a301ff27331218689aaa27d,36,27,48412,14084,34328,48,37,55102,14472,40630
458b64a8c95a203063ec2436b2f31145,113,88,235047,50094,184953,151,120,315036,49859,265177
c2bf7df8e02db9ba466f70803a53702e,78,71,98350,31444,66906,64,47,82441,21546,60895
cf77a5b1f2513b09d956fbcc00e00f65,149,106,391568,83190,308378,89,67,186894,83810,103084
a57e8a096ec8d98d5328c1d940e21656,22,16,13192,5035,8157,31,22,20891,6473,14418
35135c1b25d22a54016d3476a3171936,135,102,391396,84113,307283,138,109,459047,106103,352944
1f9e20be8dbdc0bc1e293d92e569bcdc,199,129,942821,131912,810909,216,168,1257616,173549,1084067
561aac40dd7afa23dcfde5aed8c579f7,53,35,41351,18171,23180,38,33,43644,15045,28599
20784342a8fbb12e096040d46d1fdd51,175,122,785908,164944,620964,186,139,831715,166739,664976
c40061e9de1c90899ca702dbae6ffcee,34,31,23550,12002,11548,43,24,32968,10721,22247
c4b942f7ba06f008022c65f2ced4f0ad,40,32,18448,9468,8980,34,32,23470,9390,14080
4e6d375f6349ecd7f22bb8b71afb08db,81,55,153026,38013,115013,68,58,145634,53794,91840
e5a0d2cccfaf638a0d26771f3ca87f9b,147,130,383778,94142,289636,121,111,332598,78309,254289
750172ca1e0f1d78a820bbac30d09b4b,31,23,14738,8077,6661,31,24,18069,7713,10356
1642e7c4d876ca5f9bd48693590c236c,66,55,121579,61076,60503,80,62,180951,56760,124191
cbd4c155f7d14112d4c89682059be758,73,76,87309,30813,56496,76,67,113009,28437,84572
25e2c5dd8c73bab13636ff80fb37c270,53,43,65323,19752,45571,82,57,78721,17179,61542
ff4ebebb9c05632a8d0a31037a3f6c25,28,19,20977,8102,12875,36,29,43386,8412,34974
2f321fdbb86d36873ede9be1b3584342,150,118,446904,64390,382514,149,124,429567,78329,351238
5a0b4ad7886fc6181074a8cd4a4ff393,90,50,140293,48645,91648,136,92,286482,65291,221191
d26cf2a8e383987631268401be2cb4af,187,169,482431,144535,337896,155,121,495892,123588,372304
41fe616c7d23f7bff8b6850b7cec1c46,62,47,89863,24355,65508,80,54,87743,23504,64239
6dd9f57945395cb56d1df2adf9171fee,63,46,54325,16030,38295,55,42,53745,16001,37744
38f220246c19a1698d0717dfa8c06c0f,62,53,88014,22239,65775,70,50,57591,19143,38448
7418c728e8aca873a465446540955ece,39,32,32117,17203,14914,42,35,48522,16404,32118
be52d13b70c7c772f6b063d4d31e8930,3,3,479,240,239,4,3,408,484,-76
7743b14025f57abc1cd6e0755a0622d5,44,38,58921,20252,38669,54,40,53999,18500,35499
bd89eaea9af13a26a30b5f120cb5d286,149,115,267247,53447,213800,91,65,124807,45383,79424
335bfdba48eefc54c7f6679a0af01022,90,64,123800,46197,77603,68,56,122855,47245,75610
af43a37f4dee817480b919a9bc74b81a,124,107,330611,64487,266124,109,90,260871,66879,193992
25e7e7caf483175712d33a5efc76155e,105,68,157733,46757,110976,92,51,145834,45846,99988
fe213200e8f8da2ab51ee2814c28d49c,36,32,22663,9503,13160,49,33,40235,11224,29011
325df34b721fd37a83cd96c85e0bbc3b,204,141,614334,156367,457967,188,143,660634,147266,513368
5936554a1fff9d4632c519373a2ac3ce,41,24,49621,17148,32473,49,39,53980,22681,31299
6e638297fec29e9c51699b88f90a748e,106,89,272472,63061,209411,125,109,282235,58943,223292
7ab07c0d18b18c5a3b10a5c6fd2a6c45,81,60,233374,69951,163423,142,103,396171,76904,319267
c3d555cb75b11fdf69c6ac28ee9872e9,52,41,76662,39312,37350,78,66,130809,34261,96548
f87dc1ce7cc4fdec6c5e8335d9449d55,115,67,148358,35091,113267,82,64,102763,40004,62759
94b477c9d8fdb7e1f70fd81e81cc95b8,169,108,513634,117708,395926,167,137,590391,84977,505414
c28d907757b0b77df29bae92f24f8df8,15,10,1751,1004,747,13,10,1281,824,457
caeef298e48bd8f1ed76a5f77792ab9b,29,20,15283,5334,9949,24,19,17861,6562,11299
b6d958997d8818350e9566d5af0ed3ee,0,0,0,0,0,0,0,0,0,0
ec484f05fb9b46265d4915ce5e935cc6,147,95,254449,66050,188399,111,86,194242,58864,135378
2d66caad4a3838fa47916f5c803a2140,117,90,284415,58142,226273,114,74,187484,49984,137500
c3b6938a11827906d594271278257d92,121,89,242311,56387,185924,113,102,217810,58222,159588
a442e6c241ebd639d69fd55c04d660d5,22,20,11418,5230,6188,21,20,7717,3704,4013
13747bb4d3ed22684dc682fd995620f7,140,108,353056,43251,309805,144,107,323548,45456,278092
1494976b3c63dde85fd41ce78f825dc8,77,72,121557,23871,97686,76,65,90812,32356,58456
c25298ae42f8257b83a707fbec456536,29,18,15844,5166,10678,22,24,11538,4831,6707
9cdcb425cffe808662fe6fddf73fff97,122,95,265825,61521,204304,86,77,221819,58335,163484
b47a01f01bc3b0dd8975f1ad63fdf623,164,136,518971,117449,401522,164,119,501267,133664,367603
2ebf6197e8883bb03576115a8a1b5d4d,132,94,278557,83206,195351,171,93,343096,54283,288813
424dc1713a7b0894345adbc4e70b237e,21,18,7980,5002,2978,22,18,9692,3957,5735
71e8e218104a8cff1575592c8e96ed78,59,41,65072,23303,41769,53,30,77450,14452,62998
e63ea19a21ec9e945e5fa8e4c2495f26,74,50,117950,30415,87535,107,91,161968,39337,122631
7e22bf92864bd9d3a3870384ffa2b579,25,25,16904,8656,8248,25,23,18678,8133,10545
43122e887eafe0aa8d389741b68a972c,15,14,1988,1487,501,13,11,1695,1022,673
eae32d790a0acaeff8e9d7965d454612,136,103,359132,99949,259183,136,111,381487,79779,301708
2b087f33b74434e5300f2f8bd5381ab7,34,29,52577,15505,37072,54,38,76369,15879,60490
9d75353a34be80b2f7ed0a234c570c7d,59,39,112279,32870,79409,105,79,187422,40080,147342
2cb4d34c848b25cc48ffb3090979a29f,20,24,6627,4079,2548,23,14,6298,3779,2519
e32ef86f194d9b9d55b98e9b72c2eb0c,63,57,70715,14688,56027,54,42,53567,11663,41904
ac3db8d6aacc9420055a383aea62983c,38,27,45966,10158,35808,38,28,46461,11664,34797
2e9c1b7ab57c57815dcaba695f117865,37,30,48437,13661,34776,44,36,40783,17675,23108
880d880f04e7c9034a9645f9563e018b,142,129,407170,103872,303298,138,107,394281,92058,302223
eed60e608e6c996785f883c28438b783,130,105,303434,66116,237318,128,115,275017,72558,202459
dec79bc1796da57630171d0b79a69aa4,145,91,292436,66029,226407,133,107,261611,65249,196362
d9dd7e7539dba525cbe896fe8cfd406a,2,3,137,646,-509,4,3,751,242,509
e536661ffe5fe9a3611edad1100cf51a,123,97,262081,91911,170170,112,88,238839,88090,150749
034ba5bb54d5c6db888b7d438a18f2f9,47,34,40328,14897,25431,32,26,24840,16134,8706
b97452792a0933586a6c29052605410f,33,26,19809,10639,9170,38,21,23905,8839,15066
3253d68294f06bf935ce6ee4201b53d5,139,108,256945,81334,175611,99,77,283157,67287,215870
80e4a68d53ddc96edaa979f28c45dcb0,89,64,132927,33989,98938,68,52,101221,23912,77309
943f638a4c0825470a48f80f66c7c9de,138,114,400931,75245,325686,102,107,340283,96204,244079
8d3260ca93e6b68e32ffd100a795e9bd,123,103,286330,66771,219559,156,87,305263,61202,244061
6e51d452a95472d3b9d978da4df4e058,96,62,187316,28593,158723,91,71,167358,37121,130237
bc7134b1af538cdffb4e2645b7167420,116,86,237808,49632,188176,127,111,410820,59351,351469
51a629048aac4802eb66b7f177799695,188,137,827383,142589,684794,219,148,900256,161343,738913
61dc09615e716dd114a194241ba5d90d,85,60,86973,33232,53741,64,51,69570,33431,36139
b146e02f43dc84e5a1ffebb0235f3aca,67,44,76401,17661,58740,79,45,84998,22312,62686
f081c7e30f33054ebf174184462b0895,113,89,243445,57421,186024,102,77,210132,72396,137736
9487f91f897d84e59653f1528df10103,42,29,28436,10869,17567,33,27,24428,10401,14027
c64e69f37247871555b012cd46cd6004,146,118,442720,102774,339946,172,125,420509,114554,305955
c0da6a1adca17b4f7810f3be854f2cb7,121,105,314153,87281,226872,150,120,369860,85240,284620
efcc79e3941eb8a573913f1b06eb1988,101,75,191134,48635,142499,87,61,154876,58836,96040
42d255ee5eacfb11e36d46fedb3033f9,82,58,92677,26668,66009,87,68,92429,24920,67509
eab25cf0d32b29ef86fe1054c7fb73e0,18,13,5437,2142,3295,14,16,4659,2593,2066
ca202630100813f9612f6e37f6d839f1,4,4,191,581,-390,6,3,723,164,559
703fe501329e9daa545075283a2eb477,127,99,283214,47811,235403,111,102,246381,68138,178243
ce9c73b9147b8a23b1cc152d232b6dac,25,25,12408,6024,6384,32,26,15273,6294,8979
a2ab37bd3eda5e4856eba726dabf1a7d,183,145,531323,119659,411664,213,152,621288,98979,522309
3c9851dbc26a661bfa714126cf4f5ee1,105,91,275061,78273,196788,120,91,272006,71229,200777
d8098e02dc64aec4e475a577b439f80a,100,80,152934,37757,115177,67,53,102629,40748,61881
350ca200d09ff4e94372bd22f19080e7,39,28,34584,12048,22536,44,33,41619,13561,28058
f1a60d1e14d0e255905a2322b62b4df4,44,42,35589,12747,22842,38,26,28267,14453,13814
712969ac2681c6a3cfab096ccefd83ea,119,85,350934,98488,252446,211,166,635629,112484,523145
9a1a65a25d2f7ee0c8f3de074eade768,18,16,5022,3240,1782,21,17,5130,3552,1578
1c1e76b449deb88d291d05ac09dc2fd9,132,97,264924,66921,198003,91,86,207760,50716,157044
9c5f07f509fceb837d0da9aebcd9c8aa,27,22,11857,7066,4791,32,24,13782,5439,8343
24aae6f42d4c67c0884a728aaab585f4,110,87,183985,39134,144851,103,92,191405,46913,144492
b5702188bca32f9830f45dba43c4754b,8,7,1796,1672,124,9,7,2256,1175,1081
a2ed7cbd7f26be929be4cab295387168,98,78,216263,104090,112173,163,129,440379,71640,368739
6c40a9209b0c499a23f47fcd75066627,94,82,203312,51907,151405,97,80,209048,50177,158871
1d54591969dd61a092409190c192b479,73,60,88890,20511,68379,75,53,72905,28243,44662
27925635c8f4a87867f089e143b51883,95,76,155753,53698,102055,88,76,148868,57999,90869
cb0179d509a59787c08fba25d57635c2,177,124,915496,145096,770400,205,155,1191718,172600,1019118
5540eb22ae8cf4503580b58842325dba,66,52,86828,33883,52945,61,40,88128,30539,57589
0927c79a13a8e45459282dcc8cc49cda,35,25,20968,5374,15594,26,21,11803,5062,6741
9e59603bd3936425f0ca6a724b5a2eb6,93,68,119541,26005,93536,84,60,86738,24922,61816
60695312bf68c87d12a19091d2d5f5c7,76,46,88431,29973,58458,60,44,72685,27203,45482
33642274aec3b0664ccda499788477f7,193,132,827876,193321,634555,187,127,693039,195634,497405
98943e3af538d4774d4bab648de2cf86,195,125,1098787,249127,849660,146,107,958398,158890,799508
ce398ce4d6565713f90c8c30c700b60a,52,41,64629,19244,45385,45,36,70801,14999,55802
0b2678a7273cc259f8d79110e5158519,48,37,82267,25105,57162,53,42,59063,21278,37785
9a39c6b056a4f5efd623ed5f690e0b67,49,35,59540,17908,41632,58,51,90558,27321,63237
962eafda72b071d88fe7b4ffab08de78,159,118,368571,108643,259928,128,91,314395,81144,233251
db19df5e53aa9d67a2d3c5d9b9855c91,15,11,5055,1217,3838,12,13,1662,1898,-236
d6882209a24d4f8b049436ec86a253e2,68,61,121900,39235,82665,76,56,115617,19755,95862
987f015ab63eb5e4bbd4531184aadfcd,67,50,121720,30520,91200,101,77,147541,40925,106616
4109c2a192bc83d6544d0298a29372f9,114,84,202365,43100,159265,87,66,158414,42982,115432
eb83cf2d46e6e202b473e7842cd524a5,142,100,293425,51012,242413,150,116,348329,84510,263819
14f608b31d5bb74b504f70f220243a3f,128,99,365202,76107,289095,153,106,453046,60448,392598
240db33a6f00a0fa0e13da0416a7aa12,159,125,429859,116376,313483,153,109,294526,105537,188989
08c355ac9043bed30e016cda2b4b72dc,37,26,20094,8491,11603,37,24,21177,9136,12041
d7e9f70a7e8316b0a26245bd1d5196d1,171,106,340456,89208,251248,150,113,332902,81378,251524
5466b649d482991d6a968095cea0d88d,30,25,13964,7121,6843,41,28,20274,6859,13415
b7e876315b1b56f05ce9a7be417f0472,139,115,374400,98749,275651,153,130,377183,77171,300012
948d5e0659e5243c218e074d1a5deff5,187,124,501241,88087,413154,128,92,303937,78980,224957
c5502400f1e3ea3d9c538d59a5638499,23,20,11398,5221,6177,28,25,11119,5321,5798
1351833f2adc132e5e9cee5cd554678c,108,91,158851,59551,99300,81,63,156609,30115,126494
13badc6b6f56eb8669e95b208a64f8be,39,33,31567,15384,16183,39,29,40426,13876,26550
c3c73aa35e48e6c4f3a70577ffb60828,23,18,14204,4321,9883,24,20,9057,3677,5380
51efdb0b04cf4140e8cbf9cb229cecd2,30,22,23773,12015,11758,39,31,32992,8198,24794
ae643eace440b5d058472f3edc0e4bb5,134,92,442925,145321,297604,148,125,519233,182949,336284
6f6762805b46ad7231bf6f57214cd23f,73,50,109008,24706,84302,66,45,96831,30157,66674
882fb85421ac01eb56eefe0b8e73c700,149,101,480359,99402,380957,180,145,551898,137085,414813
a13f9bf503df2087a4a3da8e783244ee,17,12,4751,755,3996,17,15,2251,2245,6
1bc2685460afe40f110e67057f0b2f16,117,94,267914,85135,182779,126,87,270622,80192,190430
741ccc17808f63658f6857e74d35c68f,142,117,381608,84350,297258,155,132,552083,80860,471223
661381c0e18678eb1b2dde1dde6cdd27,184,148,779619,116744,662875,176,150,820774,189677,631097
118feaf3bcd4fbb7b9ed8b9f0e9461a5,208,146,571897,114208,457689,171,128,658504,126348,532156
19816fddf2c83a240145b08f902856be,151,116,770205,125681,644524,202,159,1054049,166130,887919
e976449eaa1983780f4408755860f0aa,174,91,353232,81982,271250,167,111,458085,116046,342039
15c88dec445484c77aa6081753bedaf5,26,15,8542,2200,6342,17,14,4046,4027,19
b1ebe2193a5c9b511a5a26db728d4795,76,69,105969,29851,76118,93,73,90693,30871,59822
9c4cf4141b8f4bf111547088ec179aec,174,122,612998,170126,442872,200,167,883191,140899,742292
dce312c5a19daa6974b736a00bea65fb,5,2,283,33,250,2,5,33,283,-250
10456ed0744eec605e0ea590e12b2921,81,68,110061,39734,70327,138,91,229134,33668,195466
6eb0d676c95e9fa8caa2db117cc5ad48,9,3,1022,287,735,8,4,1276,410,866
92bf992f4562ca36f430fb799672464c,65,46,122178,37192,84986,79,69,132006,38253,93753
68fd47c3b44016dc119913eeb350c85c,177,118,398973,87911,311062,131,101,391301,92695,298606
51429a613328327c8a18a8544ae4595d,35,28,22624,7981,14643,41,35,24220,10266,13954
42337f298345371c3e76ded85e256564,141,93,271606,72250,199356,102,78,177282,86818,90464
667981f47bd311640ca53946d8f0a0a8,101,71,168990,41589,127401,132,110,290021,58218,231803
beb10f679d88bef9ccbda6e2be5f01bf,107,71,215469,49950,165519,96,62,206817,37649,169168
6cbbf99b1a1ee3d3645cda44a01fca7d,31,25,25753,8279,17474,36,31,22501,11757,10744
f9db504357bd412e6b897d1a1b13a743,108,84,223955,47112,176843,107,101,206355,61156,145199
3362efd656064a3c5d720fc460fa866d,126,94,296966,91160,205806,90,69,183595,57196,126399
5d842508a93473a1c0a7d492c8208435,40,33,31103,10496,20607,37,26,20299,11333,8966
5b8f34a0e027209efa7e8f62cedb34ce,88,78,136330,37992,98338,73,58,89772,29386,60386
73f1664d6854e8c9aa06f3ae4ba9d52c,33,29,24612,9534,15078,30,26,22738,8607,14131
eec3c3c150bdb22d1200660a9eee6c0f,114,97,270650,58915,211735,107,76,216457,50928,165529
4652d9ae1f9a9bc51493bd4952ba8220,148,119,413671,56871,356800,137,104,381897,69169,312728
c13ed3c0a0d1603438490a8738f3f603,91,67,201950,42633,159317,82,62,189892,39591,150301
6b92ae6eb67bd001581a2c9b891f0d76,155,111,485332,71017,414315,115,106,444867,79386,365481
5817c3093bad43382d79ed5a43e0bf99,151,118,320534,55600,264934,101,85,194674,66240,128434
db0f651df81c7082db28706dfc64164b,161,109,393889,87232,306657,120,86,285930,97977,187953
bbe8ac7eca8534e1f2f85be95a3be29b,134,118,269981,70235,199746,107,71,159649,60018,99631
6ac10311d197482891e69a68876f1a5e,9,13,1833,1396,437,5,4,579,1223,-644
a062af176c642e8655c8aa6f8689337d,144,101,416782,63097,353685,132,108,359248,106176,253072
fa6312306ad5ec0f6d02318698615917,143,108,285703,53653,232050,144,97,351095,56875,294220
e9c825a127adaa8469a4b8cbc75a51dd,89,72,216538,47725,168813,75,54,126235,49782,76453
51369fcc627a9a033901a6a59b0fe3a3,146,109,477808,90082,387726,128,96,276588,77027,199561
d3a9a8456ac0e727f83b2c2f4252fafb,41,34,34162,11826,22336,47,34,48042,13130,34912
d45fca055accb76d7b418dce473fa86a,79,63,101980,30142,71838,69,51,109568,36135,73433
12988a47c80c609dd714700b1a7273c7,78,70,107293,35188,72105,90,66,98557,32697,65860
6dcc03f58134bd978c1b1328171e3155,149,106,374306,85699,288607,162,130,378451,113079,265372
7c4ce0c73f727448b9df52e9b93c2089,103,95,238377,89490,148887,162,140,441162,85150,356012
c29c5ae69e38a21484af8a2d342a096e,20,15,6643,2454,4189,17,13,5716,2510,3206
b3052ed93f38e27217a222f4b51c38be,99,69,135533,41132,94401,90,74,177243,26272,150971
ba260b4012d77f45c3444aa0aa209538,23,18,6317,2954,3363,23,20,5426,3667,1759
435039ad15d7910262f989da1a4b614b,192,116,557215,113158,444057,154,99,510620,118705,391915
6ed93619d7b2bbda67d53c145744e61e,32,28,29611,11430,18181,40,34,37274,10144,27130
cdf253ec7842588600171b8f0e365e8c,53,40,46821,12465,34356,43,35,41708,15107,26601
4a90782aa8ad9a6965c27e58cbf542e6,137,90,359684,59955,299729,113,88,245342,70083,175259
77d2d9284015b0d86faa2514ec315744,103,83,310756,59109,251647,124,102,244101,64415,179686
28a37b42407c80d6b61389d4346abcab,43,44,36067,17453,18614,57,41,59613,13597,46016
921428c49a216597afb0f32237efa588,28,24,25550,14316,11234,35,27,35545,11373,24172
461d424b2ecc47d0a19f2b3c68c3c668,30,22,18264,7369,10895,33,28,19705,5212,14493
55d80bdd4080be43879f3ac672394bae,90,72,223413,47279,176134,92,76,177216,64387,112829
9976bdb93852f60049479d9aa585c659,29,24,16566,7507,9059,29,21,17753,7631,10122
f39860613657499d43dfb10f3bc012ae,158,124,449401,129896,319505,120,104,421962,119536,302426
e3a5f7924e79884545da24db8dbf1954,53,34,66977,21335,45642,51,33,89486,14046,75440
3684da3e7600952becde1a49e56e0fd8,28,26,25263,13736,11527,27,26,24421,12298,12123
bb01b88f1765d119767740b5a6cd97f6,103,93,267823,79310,188513,126,95,300306,99758,200548
849dc5d1c4d35cfe35bc373bb1d40fff,113,89,239462,45685,193777,87,74,161411,38616,122795
d3df842b078c398948d78aff52c68f44,37,25,29290,17613,11677,33,26,47346,14145,33201
1ffc72ec61583c191056a6ef72342036,67,57,138572,43770,94802,74,45,121579,38517,83062
f2a2fa5638a4b01bf698b33bae6574ce,218,130,644433,109117,535316,178,141,738071,153925,584146
1ae89ca54d0a67113d257d49d19c5aec,37,27,21558,6778,14780,42,29,36290,10137,26153
ea1bba551e7066db89a4718f4e1b2e5d,118,90,269658,78648,191010,156,131,459464,64785,394679
0f4d84b6602ba749d86d7a3a6d7cdccf,38,34,48324,15794,32530,50,35,65304,13768,51536
575a042e73f0c30746ab6b1a238afb73,169,114,380781,59888,320893,115,85,249659,51684,197975
9a041f7f537ee795f92f7bde860d3854,100,80,168139,42913,125226,65,49,134373,41776,92597
8604f6c7d8b4b65e84c4039e69c50d6a,199,144,734034,120710,613324,188,138,550148,164376,385772
f5359bbee7a0e62d8564c412ae55f8d7,100,85,211983,49648,162335,74,65,125655,66292,59363
90d67cc66f44a991bfbb6db524804240,108,75,174046,56051,117995,112,87,217134,56650,160484
7c196827fd30e63f16984c745f221bbd,37,31,31016,8368,22648,47,40,37225,12821,24404
1db852a4d871d646e98090191469f4f5,59,52,103555,21376,82179,96,80,92047,32130,59917
8c2537ac2ac106357fc2c60120568daa,24,21,9382,5628,3754,27,22,11393,5568,5825
d26bebd609054a4474f25caf3d30a889,65,51,87831,21870,65961,39,30,56918,20070,36848
37ef87320120ed11e2719b4f10a12415,210,156,1058617,132679,925938,182,139,804431,157964,646467
b1ac149638e5aeb3b1e3bfdabda47b01,111,94,188029,58026,130003,123,109,257639,57842,199797
1833716d313c67fa811a794b25adf6a4,136,103,473545,103625,369920,170,135,530379,105281,425098
c532424db819b975390c511a8ceb28d3,142,102,326853,56008,270845,94,77,158653,76093,82560
84f74b5fd579d783c27eebb5f5a28f0a,110,88,282505,80589,201916,98,80,185875,83825,102050
cac2da5fe23e9feefc19d2360646afac,67,54,76294,19059,57235,54,38,58115,16740,41375
8d59c98e03e74c17aabd6e534702ad70,82,59,158191,33565,124626,83,66,138778,53702,85076
6cce842cbc03f4585878aac639c25150,68,69,154424,48178,106246,46,38,82370,35249,47121
8a45ee36e7a9b993da3091e12b2cf10a,86,82,216856,34986,181870,104,80,208164,41136,167028
056a58de72e33358905c8980d5d3572b,59,47,89557,24434,65123,66,56,64323,28521,35802
a843d95b116a2f43f54184d1b9034621,56,47,52669,18000,34669,43,38,49721,16700,33021
c3d5e3b0e2e7bc98b69287723cfd7d46,127,95,286157,60049,226108,78,62,139631,63729,75902
b66438ff1fa3740377748a45b90faa7d,70,54,113276,26624,86652,64,58,71610,23856,47754
0bd4c2fa0811b3645075523adf296ed2,86,76,191056,53633,137423,90,69,256230,70731,185499
a967e07a47d531403c58da75caaaf8fa,145,112,337509,58498,279011,142,107,329271,73188,256083
15c6b36647cb999ce5f8d82ce445149f,26,21,10411,6356,4055,23,20,12107,4310,7797
864a4ce875c4eba1ce49982944c48dbf,115,77,149242,26739,122503,93,80,96504,33424,63080
ca345f6cdecd521714d6bf72a167b40a,136,93,221502,51944,169558,141,93,254323,46879,207444
40d43e2e5fb8b6bceac2e2af0729ed7f,51,39,70483,17020,53463,47,37,38288,15841,22447
3b8ec0a0dbe9f9d2e4b02bb7b95c96d7,24,17,6061,2861,3200,22,18,10694,3592,7102
d13f74d648ba8723fdb85ed5296c7940,103,85,277922,91741,186181,101,83,264115,66451,197664
f5334ed7012c6f732a543313971ef156,23,16,8605,3794,4811,23,22,17933,3483,14450
b10f855af47b8db5375001128ce6d991,127,103,322626,63399,259227,91,81,177488,68464,109024
570207a9adce9f2c25129824f57ec680,140,94,327298,63408,263890,157,137,462611,72073,390538
964fc4e76e7fc07137364e2e9d5edf30,38,34,47771,10297,37474,35,18,18769,11987,6782
af4f8fdcac71b880d4f14af962aa9756,89,56,162998,24535,138463,64,49,108233,35345,72888
a19aefa934cdf14d9a3da7ed6bf781e8,79,65,125332,48377,76955,74,52,130027,35667,94360
d1b3e4be3a3339e0fbfd23ba1abf8918,47,42,42064,19833,22231,60,41,61618,15252,46366
ada94854e748b1717cf8943d156824f9,23,21,11503,3978,7525,27,18,11147,5733,5414
d27a2189ccf267531dab5a36f9594a7f,14,10,1650,789,861,10,10,1355,692,663
fba0cf60e40c1b2558b9a0dad3a3827a,137,86,242532,53699,188833,120,90,158136,84981,73155
58d2da13ae694b9220f865efd2db7b2b,203,128,850442,197336,653106,251,178,1061471,170421,891050
164ce26a36bf7012f10cdfe45f2b9b81,24,21,8286,3242,5044,20,18,9675,3135,6540
c4e538e30aeaa971ed79c57bd456d8fe,65,41,107129,46898,60231,75,54,138824,42310,96514
80ac983a2dd5392840eefa1919526c6a,71,62,131322,60625,70697,78,61,199845,56910,142935
2f136ba1825a6715839f77fe75e62c8f,132,95,226435,39274,187161,110,90,241452,38596,202856
dffdb129edaced843af38c3a1fc7ff15,34,21,20986,8410,12576,29,25,19768,8592,11176
11ee32b8029c9c5f8e4af18d240b0ec8,167,144,736888,109561,627327,153,129,542510,79391,463119
64d5faf39f84905026ac9e78dffa08ec,105,90,211680,79734,131946,118,79,219491,65172,154319
14505924cb70ed42e732b4e9c8952da9,125,99,256562,49803,206759,84,73,142435,70846,71589
095bee31e94026dd11a364c0fcc6f835,137,68,238573,47366,191207,118,98,315989,52573,263416
0756a734f50a84468080704be3012790,43,33,35439,17212,18227,47,37,45575,19014,26561
4d110aab11a21e77d9019db6667efa77,66,49,119796,23637,96159,96,85,169759,43549,126210
77f787af32058a65f5238f5632dde3ce,139,108,400411,98276,302135,127,99,331273,65894,265379
31d4151c0a336307508c03591b880384,36,26,43736,13508,30228,54,43,59367,19757,39610
6e88baae019be1cf3dbe0dfe258e832c,113,92,222099,50574,171525,120,76,236159,34929,201230
186486c9f753e27afc435f63759e1b13,128,102,347387,79885,267502,108,86,249625,61871,187754
269fb5d36e4214bb1cfd7afeec978fe8,79,67,121999,44096,77903,108,83,181524,50319,131205
87185e0c43940a1aef07cf461987c3d5,126,96,478041,155296,322745,153,114,613904,124560,489344
21ca946e21b6119782cd78a0436fd21e,114,90,255323,80898,174425,115,85,280598,59657,220941
d4202a332130fc9742d2531678067644,14,12,2669,1100,1569,21,10,2837,667,2170
f4f51d49db717562801f499c685c91f1,81,58,168538,60546,107992,105,67,212296,60485,151811
e5236db3d5eb889859026c13defd3a7e,128,108,343256,73820,269436,130,95,278514,73234,205280
3e5eedb9c9d2b7a49230b116febac10b,61,41,73747,21187,52560,60,52,67762,25851,41911
9841e17037fbff04a00576ba7dcc6e59,17,12,6479,1315,5164,15,10,3957,2022,1935
221cf0567d84c9808e344e05516d7560,130,105,397010,67426,329584,118,101,231909,83493,148416
05d10a76c2d61a72b81c3affcf48a5aa,139,117,480480,66607,413873,169,145,443369,103287,340082
48c24b11d5b62f9d5bebb83b2d855ba7,27,19,6661,3331,3330,20,20,7588,3896,3692
3c00811b699292b5b0ddd0869debe3e7,99,81,149674,37199,112475,113,98,181968,31690,150278
c84a96c32de980826617b0c6628ca0e2,66,53,92905,27632,65273,72,45,86173,30528,55645
b668d7d13c46389d23c404da736e2e38,56,41,93469,39102,54367,80,59,131702,33888,97814
f1eaeb7a3b313e0aecc0f91548ca1c0c,96,70,161774,37469,124305,131,91,232662,47940,184722
e374c1d976c578ad0a1cd0d5d5bca685,212,177,1074122,227427,846695,192,157,1058106,144259,913847
360ff38ff340104030fb314a17b7ef41,59,47,74294,25796,48498,52,34,78636,23281,55355
1901c0fc824375aa70cafebb8ee4f778,166,129,795088,118076,677012,188,139,663146,148664,514482
408c485c7f65831e60cf59bd6f592d1b,52,37,52880,9126,43754,37,31,24372,11048,13324
98b26dbbfa1f2604c29393ab76fa5456,98,70,204322,74995,129327,141,109,279357,98762,180595
fd86282ff06a923626989ac220c6eb49,74,54,160883,38755,122128,122,82,214320,51196,163124
16aefe90be2de5ef7ae9e6ba79c97276,135,122,441198,107437,333761,156,111,530743,85077,445666
06d49bab5456a009be58ff44060480eb,144,121,275122,71234,203888,88,79,179319,83592,95727
c2374305e092f09b4c2765d57b22823a,99,76,272328,109555,162773,167,125,459944,86553,373391
25145ba17f7e17968b75861e8a55dfbb,155,126,443269,80910,362359,136,101,331774,74067,257707
09f71a9f3a739a6b17949f3d5580d5ec,78,64,150545,60693,89852,78,57,125405,41892,83513
f699805d63f81e8e88efc7787e6fa7fa,121,89,306151,57288,248863,142,111,328236,89113,239123
579b4d119cc3bec02eda36975689d5e6,158,132,346112,78379,267733,92,63,170334,60602,109732
fe4878a3283b5344b9f739a4ee370aa5,23,17,6707,4008,2699,20,18,6847,3679,3168
7fe44edb86ece15320c2e203a592aa2b,116,86,173825,56076,117749,140,100,255178,44153,211025
290ba26ef7fbd19e19849e0f784ef1b8,82,59,116783,23530,93253,101,72,84134,27717,56417
dd0f344160c355f50ee721b06e02c848,111,85,290020,87119,202901,120,90,266693,84926,181767
96316dbc75d66ef7a0c32db25338688c,35,27,19372,9295,10077,34,26,27249,6924,20325
fdc4468a3924239340ebe6abfebc5dce,86,82,103351,37878,65473,88,63,137826,20794,117032
67b3dbad44c606bf714c8a53b72e4fce,39,30,33978,15809,18169,52,40,35323,12837,22486
91617c482d39b17d9fecdb2a8346a95a,63,49,138233,41291,96942,122,93,199587,50864,148723
e585da24e4f9217ae8e98dea31d5d56d,41,31,44836,15128,29708,59,42,69267,23474,45793
655815f6d7d105764d9c8ddeeca8d602,101,79,228429,66359,162070,102,78,224600,49641,174959
feb3f7d67e5396590ad0681325a06bea,102,78,172428,43093,129335,87,65,139390,45632,93758
e5fb6b7f723bdc4378e99052b8c4673e,152,120,454554,107544,347010,137,94,363753,89173,274580
77c3411f4ddd07f323e15d62d2806a8f,176,133,391478,64766,326712,93,63,163114,71992,91122
ff6725d6b79d33c3789a923eccd1108f,80,60,110678,35626,75052,102,86,164235,32646,131589
10f82aa9d7da1a96d2816ec1d0af7ecc,156,124,399818,103415,296403,146,105,371430,78237,293193
bcf766750ed6531256a8b3a5fbd12960,105,89,189496,56558,132938,78,57,138443,46857,91586
32e8d4991dfdb2b053fd862d6a5adf15,119,103,291751,79694,212057,151,124,419553,72189,347364
c8c5e5b9f8333e5df04ee373d4a6cbe7,56,42,42513,9392,33121,43,39,18552,10320,8232
d1beebe20028e9c8bebbe513b4f0aa8b,92,76,126353,39467,86886,88,76,166265,37776,128489
8aa4702f9ec0614078299e700574ca4d,12,10,1712,399,1313,10,6,1794,368,1426
ced0e4ff6c5059fac7589606712cfa6f,32,22,27299,9649,17650,48,40,46365,12705,33660
d7405eb71852facfc32ad5478caec886,90,76,172110,41320,130790,128,108,262865,48946,213919
ed47085e3e42a25a7c0b2c5312a4f8fd,81,63,246752,102163,144589,103,79,258008,89445,168563
cf5be9abf2d9b75bced4867a5a308a2a,38,34,24726,9316,15410,28,24,18155,5293,12862
b860a6174929366ad89d7109e4ee8dff,44,34,72571,20126,52445,57,41,91116,17600,73516
37cb47d4e8a5bda100db81016697f48d,97,81,342364,122372,219992,167,134,560776,84298,476478
a98a48b4da20988ffc84a1637812e890,17,17,3507,1820,1687,18,17,3623,1960,1663
948b758d75ffc97f059e5885b3e3a496,39,31,34681,12323,22358,35,27,16972,10080,6892
b63fb92f94add4d42870e8f734b4e61b,47,38,35500,14208,21292,56,37,49046,9521,39525
8c30cd8075e46c7d96414c4f7676d455,22,17,9432,3357,6075,19,17,3948,4039,-91
d90617227a15827588830dd023034eb2,93,81,153286,45994,107292,107,83,178242,51662,126580
df6456e48fc5a796b159422145b61331,98,78,178640,27145,151495,76,63,143901,28655,115246
17a50ac3b4906ca2004444e6ff0b6bed,37,24,30590,7182,23408,26,21,13678,10304,3374
eb61cff162b967a070b310d6194bf34d,95,76,191363,74994,116369,113,101,299220,71818,227402
b9b00dedc44d8d0435087037e03503c0,18,20,6802,3635,3167,27,18,7665,4102,3563
4dcd75c4a166389efcf9f55bedcc4a22,39,30,27076,9853,17223,44,39,35342,11520,23822
b8c4e16a5c6d7786a16444ed09ff10c7,128,105,269291,43820,225471,98,68,150448,37560,112888
1f86c4306b90e6d3cec627f29efa8397,182,120,460413,79621,380792,169,140,736075,122868,613207
958908d0e663f19554ada62adba83d97,129,94,398331,63175,335156,139,82,343145,46055,297090
c1cabeb12eec959c9d60198181943bd9,63,43,64026,18172,45854,71,49,79748,19447,60301
0fac45815963f2968965e1299e10f2b9,125,100,367848,69610,298238,146,114,270586,75149,195437
f2176cd792758eca5c681c2e2338bd3d,31,29,26300,9537,16763,38,31,37750,11590,26160
51b08efbb0e15f3fcf5477e2006086e2,20,18,8335,4249,4086,23,22,7774,4408,3366
18d6ea88683c3a360289776d26981898,160,120,388610,109766,278844,157,125,474324,100916,373408
f26fa44c8f3633ae1a48263882f54f62,159,131,430320,126283,304037,149,121,470194,103997,366197
c487074adeaa7eee930fcab86c9cd5c9,192,138,804336,174331,630005,218,184,1241416,200317,1041099
c8561f505c005051ffa72dcdb14ce525,16,9,1762,798,964,9,7,1140,709,431
7c75f480c2160b41447b7c40cc55d80a,132,114,326140,86142,239998,181,115,472243,69308,402935
bab56e7aed0b63c3a89f415cc5f253f8,98,79,180579,70334,110245,131,104,274568,52000,222568
7ac230916e11f3b82ea21e5928a55811,27,20,20610,7656,12954,25,26,14969,10732,4237
4ae6fe2f5298149af48f75f3fb2da6a5,41,25,33318,11807,21511,44,38,42106,12438,29668
bd24b695e92a245943b0cadeafa833b4,91,74,206184,55625,150559,131,104,323765,67027,256738
6d128611d479f1b2d826304bcba8cc42,95,64,181961,45664,136297,93,64,159093,39929,119164
9001bdfdc6ad4f07855e8715c2320364,74,54,106951,20371,86580,49,38,63225,20280,42945
ee942bb7d8004658b649f4b148210541,176,123,450628,61916,388712,120,101,273025,80974,192051
3b9dc934b3b50b62ca6bb04b6aae88b8,157,101,382218,84661,297557,159,122,544621,87742,456879
807a713907d6854014879a6e73b11782,70,58,98124,26140,71984,76,69,112093,29688,82405
1b4a5b05db51db32ce55514934571353,63,38,102117,21481,80636,70,57,80734,34989,45745
60595795c80479560315d438e5cd2668,46,38,72724,31435,41289,55,48,73613,24427,49186
6b20eb8f537e674e1e287b591c0e42ba,100,77,180229,46858,133371,121,99,238285,53837,184448
e1b063ade2e5bb21f11c930a25977ae0,63,44,81463,20734,60729,63,52,86742,32164,54578
4fa6b88f845996061879d90ededf6d01,96,72,203265,50043,153222,101,70,179700,42249,137451
6eaad120a3618535fbd7d188698251ab,74,61,172250,41964,130286,108,84,164331,46665,117666
f0027747d44c777adbbfd3ddf328bc23,11,9,1604,1198,406,13,8,2842,976,1866
5e3fb3405a758d56adf9205fef3413a2,57,50,76856,26008,50848,42,33,54517,14269,40248
ef8a5a65f265889d4ae168acdfd6fbc2,70,47,64394,26548,37846,52,47,56785,22825,33960
0cff91105fe93f13006f20edfd6c061f,55,48,66613,27239,39374,61,44,74504,21108,53396
e571ab3f0a59a75f22bf139ebca836c1,53,43,76613,22598,54015,55,40,57011,25085,31926
df3da8931d73fd849b3c44a52853e706,125,104,321778,102504,219274,156,102,393157,92679,300478
b1d13c1fe0a56b34bb78d6844271286d,127,90,264391,67390,197001,126,95,269614,69781,199833
678465cd4ff96ad475f3273bdb81685a,99,52,129586,29405,100181,74,61,92585,37034,55551
d66cd3f56ae252ee3f9daf5a5563bbb3,81,65,148583,53482,95101,72,63,109728,46558,63170
d038907d92f5145d3f5e83cb948c18dc,72,56,88785,31511,57274,83,68,116496,33440,83056
bc1150a09956fcc9f7df84617e237e6b,105,61,181441,30164,151277,117,84,231267,34607,196660
87bba1e34c7152c765979e9df5c2f27f,146,123,370637,108076,262561,137,117,338035,65256,272779
4c72acaf0224cc5169aeb8d9a3cdc4ca,47,42,50244,18033,32211,55,45,55108,21073,34035
39ee5629db9e298476a9c88636a6eb0c,133,117,355806,80955,274851,96,73,218030,53516,164514
336afffbfc9a7884e35a50b398ad0ecc,144,112,302308,64128,238180,100,63,167353,56424,110929
0c4df8d9ae168ecf66d2b41a5cd27899,140,82,305222,42406,262816,101,75,218189,47616,170573
1599bcdbed3fccc555d8dbc6ce412169,24,22,7944,3948,3996,21,20,5434,3271,2163
84731a8a6dc0bfa2caceaf6a134910f8,88,75,164913,31038,133875,74,58,142852,30636,112216
01709458c3b32c14fefeabf72f1e0e1b,65,60,67419,20193,47226,71,47,64645,18878,45767
d5ba9788cadd33efcecdc4195d8e5a1b,95,72,193219,73731,119488,117,79,299305,35794,263511
4662e0993a6473bf33753a8cec9a3db0,171,137,472918,124296,348622,117,93,345128,80247,264881
89a8decd7f0932a1fe30e138aaddded6,68,38,115000,10064,104936,51,42,60583,13515,47068
f91a6a33b65a71ef216bc7275aba33fe,163,121,462415,88814,373601,185,146,628575,95114,533461
e2f270e642cdebdb76cf0e3edf415517,50,36,46584,7709,38875,54,46,66212,12829,53383
0bf77926cb2169e2a2e52bbb536d32ee,147,110,511614,146848,364766,154,107,575564,108516,467048
403ddb44343306fef1f5af44782a8a1b,84,64,173980,44674,129306,56,51,77132,46318,30814
0d7e0aac8a58a2894ec6427b5dfa42e6,54,31,56618,14735,41883,32,31,25018,14516,10502
b36ec40dae81cbbee6fe46ed5b5a86b0,68,49,93406,30150,63256,78,69,116737,34294,82443
51774010407deb5c4c3a51bcc8c6749a,34,27,22071,6955,15116,28,28,15664,7705,7959
d7817f5736cef4d92359884bfdf1e98a,27,20,15529,7169,8360,28,19,13256,6098,7158
593cfd105a004735d81e9cf66b888d36,25,18,6489,3647,2842,30,25,8728,3211,5517
ccb801d1ada8ec8050dc0fe900445829,21,17,8722,7445,1277,27,13,15659,3244,12415
67af98316e29198be00cb085e69378d8,37,28,20389,8795,11594,31,27,17173,9348,7825
fac1f2b8b601a78c95b99dc8ddb1daae,115,82,279618,60631,218987,148,113,387665,79736,307929
01c1bf550d14294588942d6de3365283,48,49,121930,64881,57049,84,64,208493,74923,133570
f7550c9821f324f504dfb56f76626880,28,20,15448,3861,11587,24,24,12208,6431,5777
d2803d8cc59be774b352cc0b6128da4e,33,28,21075,5837,15238,35,23,17945,7372,10573
593a6a5eafc45fbaa6221baa4e9d360c,116,87,228541,58564,169977,127,102,270058,50661,219397
6c44992ded70a3dc7c1bf4bd0d4961e6,51,39,66654,17036,49618,80,58,130112,27812,102300
007c9a34776ac70a22c29eced5b5557a,46,33,43988,12254,31734,41,31,33127,18120,15007
abf265c8676469ee0e813b8fc9597b75,95,61,165824,49325,116499,61,53,110073,51359,58714
1cf27c78c8ed51800097bce279efe301,178,93,532046,94785,437261,224,115,504366,84067,420299
1c1ed3b11a4de199097e8f68e4d3549f,59,50,84126,23900,60226,53,44,80397,29471,50926
1b9f4ac22e34991a37553e7eecc41c4b,96,71,157046,40395,116651,113,92,159262,39109,120153
e5f56efff02cc9f48d2b66cda1d27a69,174,129,391623,77936,313687,119,95,312359,64201,248158
f2742093a34ef69ed7dbdf3ebf1084d5,68,66,124804,41236,83568,76,60,137610,34391,103219
290cd10706e8717299f923e57228463d,82,59,154106,41773,112333,108,95,208823,37773,171050
5a2cf3dce2ea7e71f18d366bd4c20366,140,104,272262,34650,237612,110,86,153221,38458,114763
649e01f61e23881feaa759d23b4a5e76,147,113,462215,139431,322784,176,143,619023,145147,473876
9de32c348acb825eac59ad4c76e3c962,67,43,88780,25792,62988,72,69,152400,34962,117438
0602879a3c8ebef39f2d10e72506ccde,21,11,6173,2085,4088,19,15,8561,2735,5826
6d1846b8bc99c64339d939d8672a7c1a,86,75,204690,77811,126879,145,106,420685,80238,340447
138725d93ccec1310267c3bff4a5e48d,78,65,155893,29858,126035,127,95,180232,50018,130214
86275a7b86b8a1df71bd925d5abe7c1e,143,110,381510,85035,296475,140,95,344723,124127,220596
64f3e234708df4edf8b8ca118c767b08,174,134,433817,111980,321837,191,146,586788,95860,490928
3e1305e60c51fc3537d742ad8f9403d3,45,39,44129,10276,33853,46,38,41675,11207,30468
7d06fd97528ee25f0cf824495ea4bd77,32,30,30411,14595,15816,40,27,27645,15985,11660
c706b3ed860805b543ad62fa0a1951fa,74,60,91960,26644,65316,59,42,65718,29204,36514
71a0f6aa4ce5d193f43772bc42df413f,23,21,21520,5590,15930,30,20,32767,5974,26793
be272f74cf6ece4cc7da1bc108606aba,167,110,521506,77975,443531,176,131,466126,103378,362748
002d53de4e6a9162e920c170627ddd84,177,127,439405,101498,337907,182,126,407491,92219,315272
7c0857644f1cf79dc5eab2da55a0015d,94,76,238945,72758,166187,109,81,235095,73873,161222
e780a83ea194d036e9ad71452aeda124,139,111,257175,53155,204020,123,82,182297,47755,134542
5bc64fe6d6248e8bae8186e03dcea207,121,96,257152,73732,183420,146,113,347578,75315,272263
f67b0bde77c2ae806b8cb587a845d5b6,145,106,363338,75932,287406,153,120,297840,68145,229695
9f96e27dd313253821a7dcfdee6291c5,105,68,203439,45305,158134,118,103,182078,55874,126204
73804c5e04853a1b4f7df817f27d7c42,30,22,32216,14337,17879,30,28,31450,13654,17796
f23962165b22e49dc4740c4ec8759863,95,82,232611,38137,194474,118,104,237393,66799,170594
a99a3c994469b3619bf8e221b0b8bf37,91,75,223421,63695,159726,139,116,356993,45624,311369
daaa67a6ccfb200323b83f481cab70af,93,69,188747,54781,133966,129,84,235833,48701,187132
3ef396c608a6bad7e82f29b11308fb85,134,118,691368,187040,504328,168,120,636771,162337,474434
17308ddba91b7f0c9bd35e9071007784,50,41,59325,13241,46084,37,33,42219,17312,24907
e767f35124031706ac6d42307d87f7c4,44,27,43493,13679,29814,29,30,26312,14761,11551
2fe896e9c702a5034a82392c4b07c457,97,82,164107,24068,140039,81,69,82968,33646,49322
8270571b940a3d2f5796a384cabdf707,59,47,59533,27318,32215,77,60,101883,27668,74215
3c59b2f83e9c4f5b61f215ee4ce1ab93,101,76,197725,42986,154739,72,49,149292,33510,115782
6872a754ea7343c948da3937ff38dfc9,56,44,56810,18255,38555,53,48,69731,23731,46000
5b40da11a34f21cff964a8876b25fd27,2,1,196,119,77,1,2,119,196,-77
1bc768af18c069c21b8067a5ac79040c,177,149,768907,130367,638540,199,152,687227,146624,540603
4f72fae44c5ce8e08bd8de897d3685f3,23,16,5341,2379,2962,21,20,5148,2866,2282
1687407815d2b0d558722be32a5a7323,66,49,97730,26724,71006,83,76,143345,34989,108356
0aa709c8937c3186e8f612bc2762faea,28,17,12863,3396,9467,25,21,7493,3834,3659
c0422ea706e7dbb8bd2fad2624a355e0,176,136,480678,84721,395957,126,99,344591,64344,280247
24daa544d67bfbcfe1f5d975ff6e614e,50,43,66964,31274,35690,51,42,73058,28516,44542
2da5fab9f17c0d5b8efc936bdcb6f42b,37,29,28281,16218,12063,39,30,37761,13406,24355
48dc341c773f53483131002c719332ce,47,41,43390,21518,21872,81,60,104887,21638,83249
48aae92ee03529e676b21ae5c7decbc2,37,25,24468,5715,18753,32,28,19017,5717,13300
545c53ed6a8b512e02aaae2e4d1c97ff,70,55,101784,34372,67412,77,55,122878,35704,87174
70221a1a717a8ffabf7fd3b9010f5a6b,23,15,7861,2829,5032,18,15,3716,2821,895
e5326efdc7dec26ffc99f4dc409483f0,32,34,18143,18301,-158,49,30,40622,9480,31142
c3cff7155a309eab7d4af961aa245e86,96,72,158850,40440,118410,110,100,201573,52654,148919
42f23a7adb7339e9e3275c5a11cb4766,74,71,146470,46922,99548,102,84,183895,39637,144258
58b0c4e2b6fe14aed6dd26bf3b4c29ce,65,57,122734,41925,80809,75,48,112183,32156,80027
a6c1372fab3103515abdc67bc0252975,88,81,165528,83423,82105,136,112,287892,66539,221353
d79646a11920557aaf9f1371e2694c29,66,49,123683,36037,87646,93,81,203736,45469,158267
fa933adf06508dca88338f620c504164,148,119,425436,87979,337457,158,137,478365,125084,353281
445b5afa56d861a21162324a8e0826cf,19,17,7914,4006,3908,17,10,5240,2280,2960
12ce86db2dab039c588d9661f331493f,182,145,890025,129558,760467,173,137,812414,127464,684950
8f632dbe70fc16497487ce7b9191664f,115,93,225022,56800,168222,127,101,292148,54990,237158
285e59f79b17dc43f8fb0176687411c6,54,45,113395,31523,81872,66,54,97366,32830,64536
35d30a21ebfdbe497bb51c9aada8ded4,142,96,334723,93658,241065,178,111,491024,71673,419351
4bde8ef8ec1033045f4fc55be1144dc2,94,74,176973,64721,112252,128,106,251373,84010,167363
3532c990f44f7da3dacd081f84d23ca7,24,22,11557,7597,3960,29,21,15292,6545,8747
dd2748e01ea119f37952e994b9146fd9,71,46,123847,16027,107820,53,31,78705,15564,63141
b6d0f6c752d81b68f4ced8f0596fad67,160,117,454672,72207,382465,168,128,516276,77157,439119
597a116e821f342e7d000eb9e1de8748,81,65,200687,61472,139215,143,117,325319,71027,254292
73ff4a73839f2195ef1993bb285f9d52,155,99,355891,103159,252732,116,91,300939,94524,206415
97c0da3a83f83da764098d4bd37e8a5c,30,22,22997,9365,13632,31,21,29018,9054,19964
4f35e0a3787050874a05e6c263086ffe,106,78,292022,59823,232199,147,88,377054,55142,321912
91fd9b21b633dc4ad5dac8d634bee3ce,62,54,105178,26709,78469,81,63,109149,30646,78503
560c55e0753c44bcb116c7fa11bf22ef,41,29,41882,11019,30863,36,25,27565,10530,17035
32979aba0661bcba4aac83fe0e79c5a9,91,69,130820,39513,91307,75,66,105424,53722,51702
49415d708a0c44b7c86a9283307c705c,149,107,305546,51027,254519,151,123,310509,68005,242504
b3ec3b8aba3d38c37f10677d0deb2a6f,123,85,285997,70207,215790,103,84,287057,67652,219405
f572e0000c43f7f2c2f01dba2a163370,26,20,9418,1769,7649,23,18,7452,2226,5226
607c37e30fbcc83e15323745bca4e914,88,64,252961,59338,193623,86,72,139920,42692,97228
910dbb48bd0c88ea6e0b0a7d0e90a54d,11,13,1930,1918,12,13,10,2726,1422,1304
62ab98f2b153a5b430f9b8248d56e025,29,20,16121,4640,11481,26,24,14912,8493,6419
248f68e0488175e97d4303fce8da1cec,75,47,73374,21971,51403,91,57,123392,16711,106681
151c34483634d9cc86fcdafcceaf78bf,58,37,71461,25496,45965,48,38,68881,24117,44764
ef7a260edd3f9fafa26e05311ab9d314,34,26,32147,11035,21112,38,24,32397,11328,21069
9f3d132342aa94b8347c363bfca49263,93,62,122561,53328,69233,115,84,246858,43102,203756
1721b4de4a14fa427d36f560bd75e375,103,77,179222,42312,136910,113,97,261484,48153,213331
3bec7b1c30663ec8144e05b7d714ace6,21,23,10314,5735,4579,29,17,11317,3896,7421
31f9b1999de4b997ad384fe9319f9971,137,95,332608,80740,251868,150,99,321667,93958,227709
e34c8f41f862e20090ed85692edbabfd,41,33,41516,12055,29461,41,31,36066,16349,19717
791b612fbc2913f0237735080e730c37,64,55,72442,24040,48402,81,65,79054,21246,57808
85bdd9e6f98d50e51b73130830ce1f16,85,69,160480,43193,117287,80,56,178423,40696,137727
0d88c5c5cabe62a17ca6905c1e668554,27,22,16782,7853,8929,27,22,17175,6472,10703
dc73d875dcb5016a3e48e617027008de,28,27,20190,12745,7445,40,29,40311,9808,30503
fe8e12fd93fcee6d5e6e4d560a4d191d,31,30,18547,7256,11291,26,23,19658,6016,13642
ed7d48447e7f89bb7da46e3758c294af,55,50,61609,13748,47861,62,40,37621,20009,17612
0093e9a01848b762cabbecdc3672d255,141,101,337906,72909,264997,102,78,250315,79957,170358
d150a405a877aa4856fe0a6f490adf36,24,20,7441,4452,2989,26,17,11843,3431,8412
945ed775415f826d94906b8256d3510c,161,117,376624,77314,299310,148,99,477843,59461,418382
35d54eccd3869bd05907057ffa3d5262,68,47,98295,29326,68969,53,45,95759,21180,74579
b1ada707365d7653d67e63196a6334de,83,52,167693,27945,139748,63,53,118887,40760,78127
b778e5f5e9aad3e584687baa9ea746d3,77,52,108576,43566,65010,97,70,151991,26967,125024
0ba8f4f2433062b3bf981789dc8b75fc,31,22,12403,5957,6446,27,22,13411,6395,7016
b289b0b739d33077f654a5cd1b43eb81,171,133,451487,94382,357105,152,126,512084,103191,408893
8117c2f646812b36666dea998c23484f,28,26,12747,4978,7769,28,23,13519,4139,9380
39c684465f99c61affcf1471c7fc2063,162,75,319980,77284,242696,166,122,385979,84471,301508
6f864194ebff70054ab27563b0b09c57,135,98,316721,51567,265154,150,104,358879,57219,301660
39df11127c95c5d8841bb9ca8ddd2fa2,69,56,146174,52903,93271,76,53,170839,39570,131269
dfa1aa6463ceb3e37c9d22e8e6ed34db,47,41,47293,24045,23248,57,48,74365,21462,52903
7d6d3181f2c144ea245bf56819b18dcf,89,75,159437,36939,122498,73,60,147289,34368,112921
8fc894f1aa1d039699bba78019133142,0,0,0,0,0,0,0,0,0,0
1b59ef82dfd8f3149f174a98500566a7,29,23,19700,7882,11818,24,25,12615,9814,2801
ff7e0e1a0158e7ed7a96f29979fcf97e,61,44,95119,25168,69951,58,49,85843,29863,55980
61e9347eba69f09dcbbd819ee0141ad7,90,69,161356,35114,126242,101,85,196917,45570,151347
9c09c02875149de71ef17e22a79f6f47,130,98,357957,77838,280119,161,153,494108,115230,378878
507d6f8f7568012b3c6fa23864b42fd8,57,51,58666,14976,43690,43,28,37678,12626,25052
1f474c41674ece955c68c0ae0519a95f,152,114,412507,99968,312539,148,135,400745,106846,293899
c0c0551670b3f3aa775ff5385c5c9c3e,175,96,565794,112190,453604,199,135,753700,132440,621260
ef105b09d41b048223c4971c84617416,105,82,215598,57733,157865,96,79,163578,89337,74241
86f1a650a78e418f956a456b7b57941f,142,109,296172,65428,230744,134,121,311657,69996,241661
bffb3814b0cce6384ada979c34ae9823,134,106,319819,87761,232058,132,92,334421,52027,282394
71ee49f7ea00e09e15c13fa1281755a4,207,153,1449573,144803,1304770,204,128,883047,177256,705791
88e03dab3df6a0d9eaf4f52d7c30d15a,54,44,48658,13761,34897,51,43,49174,14340,34834
378fa125915123ad9941a8d9e81e85e3,85,64,124904,27553,97351,95,80,171892,32170,139722
52420ab8fb686ba766c02827a603cd20,92,72,207922,56639,151283,121,89,245662,82611,163051
4d9327a803adaaaceb13e9d78a19ef66,43,31,44211,6081,38130,31,25,22696,6633,16063
ddb8809dc35b17158598a88faa58fcf2,27,20,13835,7698,6137,22,21,11721,7335,4386
c36a013e53557c9a1e1fb93e21ee56d0,79,44,56583,12363,44220,67,55,68461,19149,49312
afe27547f0ff7e824da1fa8345ef4a95,157,123,586537,221949,364588,200,129,673558,162333,511225
b5b8693c5f7ed94288aaaf953da3b644,172,131,926505,124149,802356,174,122,683594,129567,554027
6284ba6aa63999e97325901bf015fba1,150,110,237847,88859,148988,136,100,368960,63521,305439
6ee3eb16e6b1bb94956a7e3194442b8b,109,71,193397,60244,133153,86,58,158995,44695,114300
59b5bb91d73e0e981d1654540ec4259d,29,25,16048,6702,9346,29,21,14593,7551,7042
c8d7c29a902abb5e23f7c185e32d3a63,201,137,717628,151875,565753,180,139,1006639,213336,793303
f14b386e6308f6ba14db1b2acf2609d0,180,97,539028,168114,370914,207,140,714458,121920,592538
39e0c641d4f3c9f573097ff93503a3f3,186,131,670195,98700,571495,161,125,590417,160143,430274
36a26921d9a1e0dd1efb4efa8e759f6b,79,76,145529,31307,114222,88,64,119405,23762,95643
20a4666c694297ad8b1475548fc1451b,118,104,286172,61352,224820,106,75,215943,50946,164997
bdf44391a5b46e182ccd2270c453aea0,74,62,115958,36496,79462,76,56,112620,38494,74126
ce80844456a81ea7acc8378fd42c7e4f,92,66,180031,39871,140160,107,78,191783,29049,162734
22f6f67172195fe052caf03490229c2b,74,66,100783,31139,69644,88,80,143119,44871,98248
baa6f2d0534fba485e50fec264663b7a,37,30,41076,10680,30396,49,42,47180,19612,27568
bed73eb3ec9d21e2b8cdfb80c457fd2a,37,24,39491,9431,30060,23,19,20191,13039,7152
93bde4683101d3acdcc57ff16b825c99,76,66,100857,31196,69661,75,61,103924,22102,81822
b56778a671491e81388821b293887cd0,83,60,174959,41155,133804,97,77,157253,46400,110853
6db3bde06c25069fe98f5f99959cd8e4,18,17,5676,2126,3550,24,18,4981,2600,2381
63e2660cca8cc1300a66d937df12f191,75,56,133566,30190,103376,74,59,92689,37051,55638
17a31786e37d9ff4f92413bb2d93c9a9,209,154,594359,152659,441700,153,111,459933,121074,338859
ee0a5fbd5acd91aefaf6ebea198b92f6,2,5,122,441,-319,4,2,440,122,318
0808e3bb3e9c4209f0711708ac20a035,30,20,21458,7948,13510,35,27,22869,8219,14650
04e5e40f1d13fc17965b00031e031b16,87,75,162991,53905,109086,123,108,230184,76745,153439
af34a620680808ee6a7409beb2e133c7,111,78,291658,53900,237758,143,94,315729,76714,239015
1604dc4b11e6ac21b3b2bc73fedd3d83,43,35,74754,34610,40144,48,40,84324,36310,48014
8434c67ec206acacc71f1b5a15b25871,107,84,241210,45917,195293,101,91,221403,73597,147806
2f84a24755d803e2c9b8673d37db310b,41,32,39594,14694,24900,37,30,41242,17114,24128
c800bda114460d8b26a0cf5b432ea25d,78,61,168057,60382,107675,117,84,234970,60271,174699
1f8474d990ba54536c96b65db62558ea,19,19,4200,2677,1523,21,15,5977,2588,3389
0b80f3938472ebe58027368e9ff715c4,100,87,239374,65578,173796,100,77,163963,58684,105279
83615bbb053b68ec26486c9142e17e1a,19,10,5081,1445,3636,17,17,2587,3240,-653
d281ebccb8c43f1ead64c06a1b15152b,101,81,167272,27757,139515,82,71,115488,39319,76169
1761c91a4dbc3b4a442efda60e547290,104,77,201699,49124,152575,110,84,224548,43129,181419
9a0b3b14a509a05560c85b5b60ed8c70,157,123,416937,76799,340138,150,119,392059,90144,301915
e2b42a145c3bd944b940fa36d2aa992e,65,59,65539,17378,48161,50,48,34351,18753,15598
9efc24317c7393606a0977ae673e5648,105,94,205142,65209,139933,104,85,203556,45068,158488
5fa8d8b2d38c8f6d808329adf8cf15bd,179,123,928555,160318,768237,212,161,925655,229519,696136
c10f1dda03f1714fbb5655ce038afdce,56,38,47179,9966,37213,40,31,33383,13142,20241
7535364e91abe6ec750771672116e64e,45,29,46603,10252,36351,58,52,90322,24456,65866
134194bbe8773b74454b3f697fcc14d8,145,108,470928,94922,376006,187,126,774979,83289,691690
8d2ead5d811776087ee741ccdc40cae2,42,30,46952,19696,27256,38,31,50769,16854,33915
18b6b758e558a4e9a5c1fe38d6de3337,92,69,149176,48083,101093,89,70,196839,44823,152016
e24de788a96ffa265a5a23af5c0cc72c,116,99,295759,65092,230667,123,97,308452,55354,253098
c57e1f853b8baf5c39aad64a1a807903,111,62,184651,43268,141383,125,84,199083,64158,134925
b9717fadb421f132f46c5e2d71b22269,41,28,36844,7064,29780,28,25,15857,11769,4088
320708f58b0fb715ff550d70a639ad7c,95,70,130029,38927,91102,73,50,99174,36977,62197
103748406e15bacf64fdd7dabc4b42cb,98,95,191437,59759,131678,73,70,140278,44242,96036
ee2b50192621c5b6e9bab2946e071a50,153,117,671120,121177,549943,181,144,637027,140781,496246
7789a2c04286b635d1ab28064dc1fcc5,15,15,4686,3280,1406,21,14,6385,3105,3280
6d48993c1c71fc458a9c02e3cb35a5ae,133,103,408125,60008,348117,95,74,214533,49756,164777
5db287ed457f13fdea437e0ba5166f82,5,4,357,546,-189,3,4,526,337,189
673308a977af9bb40bed4c69dc5c6fcf,21,13,3745,2672,1073,16,15,3840,2108,1732
a879cb0db9df992f6513e62915b19dd2,34,27,26905,14310,12595,40,35,36129,12757,23372
604b848ab0db4dbe2451953fc2f3bff7,141,112,557515,96668,460847,101,76,276574,96151,180423
4c8d9e8682ed216969510e64a8bc0bae,71,44,155569,18768,136801,77,63,106177,27963,78214
cef58104db98e11d5e01f67d571c3430,147,91,321323,69527,251796,112,100,206571,87176,119395
66f98582a775cf67e20a16268bb2ca3b,28,25,14583,5749,8834,27,18,11005,4318,6687
75249f6ec010644001142da460b5b601,74,68,176866,51117,125749,122,99,270236,41412,228824
ba1916797ab1c2eff3b232f3faac142e,70,53,82360,28063,54297,65,59,88700,31838,56862
63cc1c90115880dad8cc4379dea36811,28,27,14715,7603,7112,36,24,35776,5394,30382
384902f7130fd41e3891ba3b6171a54c,98,65,259930,70182,189748,127,108,278427,79354,199073
01028e6b7d909f3710d09aaa8709561c,52,44,40218,14584,25634,55,41,27007,12943,14064
1b131faa5e44a23b17931b9e152e868e,116,101,295555,81375,214180,119,92,304296,98767,205529
eb80618ebb172e26a4be5521b77e42c9,150,110,537530,106652,430878,181,107,475383,120351,355032
6a7b7edac6d9e9bcc78de64b8f194191,50,42,96812,24817,71995,55,46,100217,42591,57626
4808f8cad69895f946a711f3c31ba5d7,83,61,171057,33064,137993,57,53,112059,37735,74324
16c61683800ca0cbe61a74d21931f025,88,60,175495,31959,143536,75,62,116003,47506,68497
06c39d0a7eb39fa8a9952b1f504225b8,22,18,8065,4476,3589,21,16,7808,2058,5750
cc4c70e6aa4170a0b7106329c638bf63,126,101,325133,69508,255625,117,98,282416,120500,161916
60c837f59b930c05272d5d681c76edea,171,129,666077,149329,516748,195,165,706071,137383,568688
541185b734135a67ad8aba0219bbdb23,201,139,1052118,172134,879984,169,133,904758,220144,684614
0cec8c2dc68b066aef3c1199fdf0ecb4,170,135,512186,107144,405042,211,165,934465,132315,802150
2abbf021fc458b019fb0143cee12c6a6,30,28,25622,9630,15992,42,34,33466,12940,20526
004e770cd7a508f8b34ded1ce0c37eb3,104,73,214910,38289,176621,138,110,393447,49044,344403
3a57143781fd4bab3d6fbd10f9b6f07f,21,18,13045,5321,7724,24,16,10979,4784,6195
c31d84fa086a697637319fb0deea4b8e,193,127,924095,127877,796218,202,135,747722,148288,599434
c76dadcf6e2488ff4e6ed0709d926a96,163,143,547807,130898,416909,127,97,389983,139853,250130
bb79c21c73549678bf922a0b8235772f,144,119,386132,84322,301810,102,88,260440,72154,188286
33af7dc0330a8aa4a7bdd58c01c5519e,160,126,530366,115035,415331,152,119,487418,102231,385187
e33ee911d499105f4ad310b7ca4be4ee,25,24,7273,5538,1735,22,18,7940,4642,3298
3bc39e8ad440a9cc5b3b83002d5a6854,69,52,97951,26883,71068,58,49,102816,33844,68972
13a343e631319a9164595aa3e7af154d,31,31,25665,14586,11079,31,24,25441,11180,14261
30742cd746b94b90f0b27c1515d0bacb,90,84,170928,39892,131036,80,64,122581,39488,83093
51c241a675057b3bb2af3ca9887afb75,48,44,33264,16542,16722,46,36,51052,9995,41057
d3b28f5ee40697b6b0a42083efa9367a,3,1,223,376,-153,1,2,376,182,194
c5e713c10c49d35f9cfcf2ad3776fed2,35,21,23362,6460,16902,24,17,12857,5743,7114
5b118143ca43b7394975cb8e62e9ffe0,105,76,139512,36590,102922,94,68,150374,35448,114926
de8f658b438dcabd253767d3ce2dc7b7,116,87,230798,53077,177721,86,68,188028,47439,140589
b0cdcca18a2137798ab7ade404c09890,32,28,35988,14763,21225,38,26,32890,14607,18283
a386dbd6ce9f8f4236378239e7eb226b,113,98,294697,66670,228027,125,96,304587,72867,231720
9f500a1a5acf3fc24ced8a1e2858eac3,23,18,8475,2397,6078,21,20,4187,3155,1032
35712f7ee9d74cb761b331bd3e6c62fe,209,152,555838,204097,351741,177,146,723615,160058,563557
4e4461146d92a4b6bcb7186c329b7013,130,105,329406,101781,227625,109,82,262552,86293,176259
6e74e756de2a279e0018864ce99789a7,167,116,709060,180010,529050,185,137,761904,151835,610069
785695c5fbf9e8a4419dfadd370e6d6f,124,95,344980,101532,243448,146,107,429074,87833,341241
1b8faab06d0e21abb2189a54b0af0381,122,91,327289,144435,182854,166,128,412051,139211,272840
db52238882f97731b35d3313c300e15f,140,106,350556,68261,282295,112,77,224518,66519,157999
61d221d0b814f492e9716f00fc2c88d4,149,128,371852,79083,292769,87,68,207016,56959,150057
3cade11d352007ab521d213b7080b37d,48,35,48357,17891,30466,58,51,72222,24733,47489
e6719745b6c156492eb2ea89bc9f467a,218,155,941615,203350,738265,222,142,709630,123709,585921
08410ec42ca2d638837769145a20d16a,69,55,69876,30756,39120,49,40,74944,22730,52214
041d69e84572013fd7ddf39172239d1e,77,52,129098,21284,107814,58,45,83422,25529,57893
d841a81d875b22e8b7cea4fe17a9641e,37,23,37360,7891,29469,44,35,39622,13945,25677
ec5b06e2ab93311b5b9948e6249d60b6,124,102,204835,60773,144062,101,89,213835,57022,156813
2b43b98a7aeaa11464469b6220b4318c,174,127,674028,107339,566689,166,131,601718,116892,484826
c11a9ead9a5c3766a7335e8a8515d34e,78,67,81469,34617,46852,66,49,78201,20709,57492
786ea63573f53f66d2d17f3d835cc361,119,73,181906,39921,141985,99,92,187747,46061,141686
62028b2f070e05e41b6dc3c670d97448,183,143,636319,90419,545900,160,129,464058,98515,365543
b897ded4d50000d4fd5ec86073deb1a9,95,73,191358,46188,145170,136,104,262919,62729,200190
de0fce299e9330be8b9a5129ddbc095d,144,104,409268,96458,312810,146,96,369736,91209,278527
c9cabf4231f1450afe97ae72f7175a5c,70,54,114369,32530,81839,61,49,93076,39246,53830
151738a36b095cf20d5a18d961ad399f,105,88,300530,104516,196014,134,111,352922,82302,270620
9ba01976304d939cf58d57c8604baab2,113,85,241278,78921,162357,117,90,258680,72993,185687
1a8317da8c3807d91944c68b1b2392b5,34,29,28019,15049,12970,35,32,35995,11780,24215
41dd79356c51fccfdaa6d4334e503804,66,45,98590,24007,74583,55,44,108003,27476,80527
69323a7445c6218d1c087a476ff60aa7,202,136,763824,151855,611969,201,132,831923,130494,701429
399529d31f55af17df5b2b4cef324aab,7,10,760,535,225,17,8,2429,493,1936
9bb4fc2d9d86adc3a85565fcac194a20,173,124,862282,96299,765983,198,147,839132,140254,698878
655b26b67c8b5e2625b80ee996b7f9a6,142,101,302376,81073,221303,165,102,328105,72295,255810
9dfb41e3d45c460f9da59e10f3fee9d9,53,45,74203,20259,53944,49,41,54403,25285,29118
1672f90950e5131778991867222a569c,41,33,39404,8694,30710,40,28,31937,7668,24269
c419aaa3514963b9cf32ed7174f2c325,36,29,53310,16702,36608,47,41,67450,21334,46116
3eeb945068a54c48a3919b2482687590,30,23,17909,7116,10793,26,23,13543,7893,5650
057e67e67f9f6163f9cff2015d07209a,80,69,116247,26014,90233,65,61,94134,33588,60546
45085a8b4fe89d21c5b4066b77c7650b,133,100,266264,56539,209725,121,103,254752,80107,174645
21d0eeb8bb9d711fcf65ed0000d9ad61,36,28,32679,10803,21876,29,25,23662,12088,11574
9362fd7bb04c7dc429ebc75b986e0a31,27,24,15772,5441,10331,28,27,11155,7692,3463
49bd1a19911ed8a5c6bf077429ee534e,164,128,465615,137501,328114,168,126,537505,112518,424987
c3b6d041c09705b966e6e938e08f274b,115,79,245370,56672,188698,180,141,417282,69956,347326
2d2ab64b7cf40b0b348d0e6737342a26,182,155,811829,133327,678502,191,137,861653,144131,717522
e711c952e5b063379fc1dd21ea18b706,6,9,708,1345,-637,9,7,1345,718,627
6d70ee81b68b2424f447bf612b488bf5,39,32,28066,14287,13779,39,33,28580,12154,16426
7625322c9bea785f9e47a6a55a0ff5b1,2,2,192,136,56,1,1,68,124,-56
7b9237aa19d7fe692284a60adfe5899e,165,129,416915,83692,333223,142,104,463504,105586,357918
10a08df46b99e6ad1b3e550cc739be24,62,51,61511,18207,43304,51,39,45231,13881,31350
c0d7dd49ba077df73e11d38215f257bf,55,36,43069,26450,16619,61,52,99990,32449,67541
c7020c0af7cdf94602f6f73b29670046,80,74,116670,44915,71755,89,49,133382,24102,109280
82d7e006d8cefc44f225014549619e7a,65,65,82058,38689,43369,90,72,130464,34008,96456
1ad63aa0939fe4fb5b42b2be724ed8c8,113,88,220516,40999,179517,92,69,183512,38514,144998
9340925dc860aa0509b65e52440bf2e6,184,132,926121,158269,767852,159,118,936884,187664,749220
6affc576949f0970a09cc17101cc7526,62,42,80527,18043,62484,49,38,54543,26027,28516
08c8810b7f3ce5901f70a1f2f1857a0b,26,21,14400,5874,8526,28,23,16266,6970,9296
430fbb275ee345a59b78e4ceca6a1731,168,113,418169,96960,321209,170,122,484068,132269,351799
02eb99f2680660ab0ae5ae8f80ff7032,131,98,342873,65580,277293,179,120,391319,73185,318134
5a10de06fc09b586308cb627f94fc01f,80,60,139925,53522,86403,77,57,176744,53161,123583
9396b8fc31895b45ebd229acd3a78bd2,26,21,14507,6151,8356,23,22,9224,7952,1272
cf42c5036d1a8f98c4e679e76b52e859,5,1,168,93,75,5,4,726,61,665
cb4bc3d50956bff8abdbdea9a8e50d94,113,94,254591,49110,205481,99,94,244104,73281,170823
b186c4eb831ded6a58ae5fab4cda36f4,53,47,44564,21990,22574,54,43,50679,20267,30412
6cd26b5cde23e7a9236cc3793e7062e5,35,30,28329,7311,21018,45,45,69489,15215,54274
fd028aa8f038de07b59d12eaa22af6b4,75,67,136208,70195,66013,103,88,194902,40592,154310
a5b2bc9abeba7445c2cd567a35944937,61,47,84017,26012,58005,74,56,104547,33304,71243
6a0dd278a706f59525dd6448236a618a,2,2,312,81,231,2,3,81,327,-246
283f529116142483198239c1045e6572,136,111,459740,136418,323322,163,134,717890,156351,561539
d3c57bb6b2f19ed5ca46f92586e9cd7d,83,65,214493,38651,175842,74,61,125427,38566,86861
c13da343ac204ebe85dea5d6e8867210,60,50,70608,27566,43042,51,36,58408,15439,42969
beb0c7d6b5a0524621594b35764eba30,30,25,17734,6537,11197,28,25,21174,7752,13422
582cf6bb9916043de7e291df5ecd0b92,41,31,48283,20947,27336,41,35,63464,30432,33032
8741abd2ec78d7e59c936086fd8e8467,67,51,101316,39644,61672,121,99,191553,36388,155165
3f22a421f83a70e02e571123714fee3e,129,95,378546,124636,253910,150,109,501527,99677,401850
b726b4b87d93572dc30df67e1bc7100a,69,59,183801,54910,128891,81,62,188424,73905,114519
7480963970a3550a3edd972b31394a06,57,38,59177,15922,43255,49,36,49186,15210,33976
0586ce07fb84c19d72cc814f14ed263b,47,43,48147,20122,28025,49,34,51231,23955,27276
e607adf47e6ed20fcca70bc06aa24b2b,138,111,347948,116048,231900,147,118,378069,87152,290917
8d7c16f1a99609dd75c9ff1634ed0a8d,5,3,358,313,45,4,2,366,181,185
d9227326984184162f9b83000baebfdd,105,95,278706,80187,198519,143,123,364885,85336,279549
580290ab1cb2dfaff173b8d476048480,67,51,97830,34391,63439,71,60,93389,38367,55022
e4db79eb2bb3941e3b7cea0f6c989648,70,55,145635,45134,100501,77,62,136914,47034,89880
0466d7fc175e65b84874b4848075499e,26,20,13702,4063,9639,22,15,9352,3415,5937
43b88460809052d2071845db09b9ec2c,139,104,337665,67849,269816,101,92,238855,61993,176862
e99b03cd36721e31967752fcb786f347,39,23,19222,6972,12250,34,23,18476,5253,13223
b27cd4f09aa15ed090c02b9cb468dbbb,149,125,370728,84277,286451,152,126,483474,98191,385283
38f17b7bf240810ff87c0aab05611c94,28,22,15951,4620,11331,26,23,6632,4948,1684
823b80a44a63959b465e9308a9332323,23,21,15335,8523,6812,29,22,20325,7093,13232
1a826d429fc80afd9fe434c652f103fe,91,66,163869,61065,102804,106,87,214972,63318,151654
bb86a853062688ee1223720572fa4c32,56,37,70662,17650,53012,48,35,57937,19431,38506
323f721bae0c8cd8c9533ead1a6e65ca,156,94,346557,92064,254493,131,109,335706,112430,223276
ed1eab5362d75fe7de3c7bb280c2ccf4,120,106,364143,94635,269508,129,98,347807,122864,224943
0769d7e9fce3ba5814bdab1560742516,70,55,112345,23579,88766,61,39,117635,20737,96898
05489c8e9a0d314bbc1c72164ce8fc75,17,16,4464,1769,2695,20,14,3607,2213,1394
a095f339f5f2c8627a601ce5968b7de2,51,50,85440,24144,61296,63,51,82427,37253,45174
dd989bf172026b8533b2b3a78700df00,22,16,6776,3007,3769,19,18,6955,2589,4366
7d6d74a602a4eee646759dd864f60580,84,59,154480,44582,109898,118,88,243288,45896,197392
679b9f0a9b8a94ae903c30082a9ff638,130,90,348397,89613,258784,166,139,410843,103096,307747
b74dba706537b2d18a4505be00f85e0a,57,40,80345,33653,46692,54,38,101111,30300,70811
0d25abc054fa0358055b644d5adf522f,73,55,113654,31509,82145,82,46,80974,27133,53841
586ff049fee0d4707245bf64c43f4f70,110,85,229005,61119,167886,103,83,204303,57235,147068
eca05eef55660546876878cbcbe15953,192,139,450570,117465,333105,147,108,410841,108395,302446
157d8718a841651ec1df86c2a31b83b0,59,50,66520,30718,35802,77,57,104272,31970,72302
055f92af48806c75ab8e292d38f45154,141,100,560849,87180,473669,197,150,660939,135856,525083
24c7849f3642023ba9685352b75f60e8,35,27,40301,14803,25498,34,30,37256,15890,21366
31e5fe8d5a088889e9eae659ba11d5b5,111,93,252319,64686,187633,155,131,398966,76045,322921
799fbd8238938cdf4814b8ce21a2e55a,53,42,49821,25758,24063,63,56,73827,19672,54155
57f9ed893a287c7116847fd20370fac7,121,106,329428,78927,250501,167,126,397285,85493,311792
dc37cee6fa2807c366ff186a51ec4c9d,33,32,32458,14460,17998,49,37,50934,15071,35863
cde897ba5766a50ab75938be6164d861,64,52,136765,38193,98572,73,60,124215,43321,80894
06940da92fabe079f0ab7524009da8c1,148,123,455760,107225,348535,181,129,570585,127400,443185
691400b3defcfe874980e03f8edd75c5,79,56,128119,31677,96442,77,44,103749,27979,75770
78d1b9b26cbcf0e4fad7a189f70f0d10,135,86,276513,48243,228270,124,97,283305,54857,228448
9f5b978f59fc8191a4d50386008b4dc2,178,124,632897,121360,511537,173,129,815553,142753,672800
c540e5eeb38b56e4d9ace18bb4cb0d9d,38,31,21229,8223,13006,31,29,19315,8809,10506
67b10efe974482d9447cf5ee2b5dd6e4,176,125,365227,56989,308238,125,114,298526,76458,222068
a6384dde4180d0899dfb1cad24d88c1e,52,44,65089,22518,42571,59,43,69079,24121,44958
e9f4dfbbc359255c2df3f515754956bb,62,46,64717,46416,18301,92,66,165487,41101,124386
4d26a62e427abebfcd16ece7b22cd349,44,40,36162,15623,20539,45,33,37153,16719,20434
c932d96aff08f53b73620b56597ba7d3,45,48,44683,18550,26133,48,42,55224,14876,40348
e7a8c4769bec5f29bff8806fedfbdaba,27,21,9338,4558,4780,24,21,7357,4136,3221
67d1a884784edf550d2d99eec89ab63e,76,65,116250,47125,69125,83,66,155517,32557,122960
14e2ede3ea7a02690599da1ce1273a18,46,37,39390,15456,23934,41,41,39652,10939,28713
1aafbb2aa005a26677f0d451bc2c41f8,15,16,4285,2664,1621,22,13,7331,1737,5594
9d79f28e4ef3fd90912e84ea8922019e,131,112,315606,84956,230650,114,73,235810,54704,181106
5b4b1e13bbcd2ea8b0a56d3d8aa27726,86,62,121407,25667,95740,76,58,92849,31374,61475
c06b37cbcd39ec0231a94afac8384516,98,86,273290,86982,186308,129,107,356106,81691,274415
28960ef7f06ff848e47f7f652e75f834,19,16,3442,2002,1440,20,18,3626,1175,2451
47443c12db15c24d126bd689248a2e89,77,55,95669,26984,68685,52,44,63160,32992,30168
2efb81636abe5ab4c39e2f18c343e9c0,49,41,52699,27243,25456,47,40,55939,26954,28985
dadd6e21190bf3d13fe45b07cb6bea0f,62,50,157074,35007,122067,79,60,115163,51427,63736
c50328ddcdd836921b7d4e7924ddb17b,191,143,657145,98763,558382,204,124,570761,112872,457889
af07669dd7ce63115edc84d4b8bc63e6,140,106,342680,63716,278964,103,95,232123,78585,153538
ca1a1cad8004e5ad6b4c1e73707b7a2d,149,102,421330,91764,329566,146,123,547952,131175,416777
2b3444665aeff833b92441a90be52c6a,108,63,151498,24754,126744,106,87,168439,36445,131994
8294b1416a43c8c626d7fe2aa5adc699,112,103,376216,85516,290700,152,126,433430,134848,298582
99b7cd5afee7beb56679f926d9b1c3ed,62,40,62818,20098,42720,48,34,74046,23915,50131
e1f2b97077df58ae73ebeef995f4a54f,111,85,169588,28907,140681,112,93,184075,27382,156693
1c05048296eeec78863b9d99a7820290,47,39,38574,20893,17681,56,43,55964,12713,43251
2cdbe0cee2085f3b43c5b9495a5afffa,151,114,396207,65496,330711,118,92,344983,73976,271007
ab71d722c80528e43732d2474acd4316,44,39,52934,12593,40341,37,26,37841,10681,27160
1b964a1a8eaf710e142783cd11dc29c9,133,93,271603,53665,217938,86,55,163866,47973,115893
f13a1d364ce989e2593cd4f6b41f00c9,68,56,142800,45245,97555,69,43,136473,38584,97889
c2b629fca0fa0a7a4272e3b24d796c91,58,47,81443,24102,57341,60,40,47481,19014,28467
78306f42f1ce790a9a244ae9cc405725,76,61,136571,50996,85575,104,75,164612,38551,126061
0f6fe1cfbc0e41056c113b3d72b8f178,47,40,27686,14344,13342,42,36,34722,12459,22263
eb6717391ce0700f3d3aeb56a34d3d01,64,34,64015,19465,44550,64,41,53216,18959,34257
2827b836a5176e8872280920e0467175,99,81,371322,117307,254015,133,87,370563,102045,268518
8ef5e61296483c961253dee42e8206cf,0,0,0,0,0,1,1,8,8,0
9516441cdd206de5eea9c24aab5d3919,99,71,266173,70457,195716,161,120,412755,88073,324682
c5bbf1f0184eaed741300593581f3b3e,24,19,7805,2858,4947,20,19,8312,4238,4074
3c8ebc7508f3bc568dea72fb1f50b78d,143,97,326246,85788,240458,142,122,419297,72599,346698
208ab370f660a7e42cc073e234317647,27,21,14084,6672,7412,38,27,19075,7021,12054
2f258bd6cf71f9dd40b3705c99aa0b3a,188,148,645176,174774,470402,164,112,548011,133353,414658
82ddd031cf95917833e2460468915f95,87,74,125954,52819,73135,120,95,238786,46775,192011
afd71535558dd4c94642c8dbed678e33,45,40,53199,20932,32267,54,34,57857,17566,40291
090ef9fe8472dd29a1f767b54259daef,140,115,379599,81587,298012,173,139,464878,85102,379776
30ffd980ffb2c891ae15aa5dcd20e5f8,109,70,274639,63702,210937,136,109,314025,55353,258672
2d3593462052c84193ba567d2460afe4,85,74,196027,60497,135530,59,58,158263,46215,112048
2c96fbf22170b694a27bc2bc0e2dc62c,156,108,486690,72762,413928,134,93,323993,69763,254230
53b6b5a3b855f523932417bfb4fb8eea,168,128,362882,96705,266177,139,83,297690,69638,228052
aa7f52efdf3b7e88a7d30869daabe898,69,55,123929,38953,84976,76,54,103735,40889,62846
5c3d33a3db89651685d20c436574cffa,43,29,58407,22605,35802,45,28,66450,20248,46202
6b56cf23ca8e11a814aa8f692f0ea7b2,103,86,171444,45049,126395,107,84,166325,40800,125525
73c8a219c31383a873164627b92a2d48,108,81,164240,45837,118403,107,90,260978,44731,216247
3c5718ea7f23fbc7b0a563907bbfba8a,124,93,274311,60109,214202,126,101,405603,85860,319743
3d27ee19966a08e6419f2b23d77abd8b,90,66,195868,60643,135225,108,79,189413,76435,112978
c734e7455de4ed59492e042f1e72dc00,126,90,480682,88644,392038,153,92,387583,69616,317967
ae06f7fbcab3ff69b968337df1818275,106,78,227311,76265,151046,128,96,289717,61275,228442
f53413df5baa5ea122e2ec29b7e1640f,131,108,262653,37062,225591,101,86,196621,57167,139454
7c38d272f77ac47bc8de00287d1d9a14,25,20,11225,4263,6962,20,17,7397,2294,5103
1d64502a4c20923bbb74020df8d296aa,41,33,42432,19666,22766,47,37,48376,20007,28369
04d0d6003cd3ad8e357c5e26e41dc9f0,135,93,289819,50123,239696,155,124,301248,64314,236934
c100de3fafec095192b772985bc0f0a8,47,34,35218,12340,22878,49,42,36415,16939,19476
443f9124086207d25cea1d4ea079561b,105,88,214926,56364,158562,100,71,167700,44406,123294
ce3dde8a8d56f5708015fef654fbd003,40,29,35047,9930,25117,54,45,66471,17266,49205
3ed65344733b2a439d97b737d0fe4b02,126,95,350194,88254,261940,153,125,390257,84851,305406
bc582ee7b9fd01064f58d87ec8f00fd1,45,41,73373,26036,47337,75,64,68179,27174,41005
93aaec5414c5bb93ce88fd1e10e7d89c,107,54,182413,35204,147209,101,70,181747,41747,140000
c0a106f89a676711aba68937534d5f95,205,123,679405,153237,526168,208,153,745675,151861,593814
bebc0e69d0a6e2f6aad179536f4b91a0,148,116,371940,105737,266203,103,89,284734,87088,197646
7a14a7b12e410d8a568170b4b29c44ff,126,100,290355,61993,228362,108,89,235589,56781,178808
e10520042e19f384d3228989c1677fe9,124,88,311437,59055,252382,104,95,341551,54319,287232
e49fb6fa438e7771720db725bb349f30,106,88,223109,45564,177545,105,88,207633,58079,149554
f6d4ccdcbd7864e7d8b81cec7e08d3dd,131,106,486269,104537,381732,169,124,530277,142389,387888
2683513a829d359c63651870dde25fdd,91,75,163972,55075,108897,91,76,147935,56907,91028
3827368cd8c6f40f7972b899f52b6266,63,50,92154,27689,64465,67,47,80976,32261,48715
8288f1e3aa7fc7009eb3a5df45519b52,88,69,153244,55915,97329,79,63,145847,46097,99750
8ea005c13ff67a30aaef3f0a3d2db6a2,58,44,110150,23647,86503,58,48,67373,28400,38973
464f0c8f37f5aac26a7846a06aff3776,69,53,121752,38574,83178,98,80,138224,40601,97623
5aded8b8882ff4ed081776afb5f4b094,58,37,85029,21685,63344,44,33,37554,25404,12150
57b9e7dae875f839aeb6a5f736f7fac9,168,116,464846,130355,334491,150,99,482561,105582,376979
d938abd7f54feb964d54f13d8d6a462f,166,127,500502,91211,409291,118,96,428710,87411,341299
9de59372c05a9469d751894971b550fb,89,74,113770,23823,89947,84,57,117450,19714,97736
a73f36bede1d41ad3354c3e50be4bef5,129,106,335570,70710,264860,122,93,281161,69615,211546
33af54e5c424ab6383ec76d1c89c3edf,96,70,235523,61670,173853,118,90,251974,61548,190426
304b2e5bd568da9e9a799452c1c84b01,122,87,286808,64525,222283,136,65,328934,52103,276831
c685db4c6e3db242eaf3138e9d3442de,128,98,388268,94276,293992,158,132,555570,89802,465768
61a8e0302012222d39afb61fdde535a3,135,104,366300,109852,256448,195,147,546836,100398,446438
cc043ca1408a8d97fef83c25ececc2ae,25,18,15000,4506,10494,25,22,13398,6581,6817
dc21a74fc86b202d4e5ef16da49e0697,180,158,884293,206358,677935,219,159,830779,191444,639335
7d924d793bbd03351438ce08c0497b06,66,46,94235,22218,72017,66,54,93110,19009,74101
06e140c3a7c6c553af15340f4f2803a9,26,22,14427,4309,10118,22,21,10030,5994,4036
2b988ac06caef05f9a98682be1d7f693,36,27,26137,11053,15084,30,22,22135,8529,13606
ce06178ea9b6b7c45adc669ed366b692,60,48,65342,16561,48781,43,47,28561,20047,8514
89265525a3aed753827570630ca2d458,71,68,106187,49058,57129,75,47,119022,38837,80185
702746a6134ad5b5a67d9c500f3939a0,20,19,8180,1830,6350,15,17,4713,3784,929
7de2804d561d073b865f3a6f520f1b8f,105,79,177075,46186,130889,114,87,195332,30735,164597
9ec7074dc847e37aa8855357f32b16e6,86,47,119270,35208,84062,67,64,100450,41916,58534
80bccab3f51437f80a2d156661de18d4,155,120,388043,77871,310172,146,126,349467,69512,279955
1e278020ee21c963c0990c47a83a2561,51,44,41950,17170,24780,58,45,56230,14842,41388
bc65a294ccf0ea6096ff85ddb6c376da,106,70,223693,90344,133349,110,84,217774,97375,120399
15384dbd1d371dcc34c320b998107b25,174,128,410402,92489,317913,199,123,449982,91283,358699
7a5db4f030d22ddb3f44ee8b5e555828,110,91,213252,86937,126315,82,62,200030,57497,142533
9094162ccfc988a46532b6a268e93318,30,30,19775,13606,6169,36,30,36411,12305,24106
3d80f4a271a04544969ebe85da52bfac,109,80,387848,105734,282114,173,135,402793,141412,261381
ede2b5bda8cae7041988e2a71b187c52,114,86,334388,95040,239348,147,116,439322,89317,350005
23ca067a7b8d0cea81386bb75b089873,133,101,272118,67873,204245,142,104,371293,61516,309777
073beed418cb540dcdddc7594575a904,74,60,92900,38957,53943,76,57,121376,39154,82222
a10e908a5eb6053b922e0e58e8f6a6a1,80,63,144593,34118,110475,84,60,124697,31534,93163
9bedf2f29f0df6329e2e9325cb18bc27,126,106,300527,66659,233868,156,117,333927,58361,275566
429e004faeba935688fd3216cbb61fe8,35,25,24923,10465,14458,38,29,25808,10685,15123
369c7e8ae7c8d58066d322aea103893d,155,131,305431,62317,243114,139,114,311796,63801,247995
f7b7aa178efc150b43bf0161e9de7650,104,83,181793,50127,131666,80,62,149209,44361,104848
262db76494e2da1c9f281b4398bc8d38,178,142,655154,114005,541149,188,141,582075,110273,471802
2d63cda704f10653cd9391a5e098b178,97,66,201986,34417,167569,94,84,177993,54874,123119
7651b120cdfaf47ff76946f48527c7c1,188,135,840957,120658,720299,179,122,758869,125655,633214
13db19b61d1bb8c8ca89aabcbbf38aeb,169,138,624619,95584,529035,181,123,534925,85215,449710
9d432aa1321679a447e6d06d1ce3286e,186,138,487360,140706,346654,197,141,547880,114974,432906
21bcca437ddedc5a65809c33c7a23062,56,37,79543,20077,59466,85,59,115729,27195,88534
6f96f125f7b00695c9afb6077ffd2a0e,145,134,558314,170049,388265,144,97,495621,142004,353617
8b836027810c1b91961f129e610398c2,90,70,185568,59706,125862,114,95,244764,68848,175916
e0d5cd3b4221a0b9e179393b2fbd32b7,170,137,600274,133088,467186,156,117,412406,80846,331560
8379c6101c5ea2c8ceac6d0f73a432d1,150,124,460031,106722,353309,159,117,472741,71968,400773
bec5518203854825c7194a037a215f19,29,24,14614,5842,8772,29,21,10921,5486,5435
097ce8f2bcbff820d6dc25081052e350,55,42,58023,26839,31184,79,63,111570,28894,82676
0ad8b0edea4060086cfd71a7442d9875,67,60,114043,35021,79022,110,68,162495,29641,132854
1b53bfde5c624eeb0f79d6b0cd606984,32,28,22996,12712,10284,37,32,25851,10376,15475
42fc21ca6aae8c7e245ecdf1a32ac98a,139,120,411144,102185,308959,160,136,498793,79632,419161
25d360fd8f307be3b195507f07e3eead,23,12,4801,1811,2990,16,15,4162,1486,2676
bf6c9c191a78da65b14661ff3c78980b,165,132,719061,153022,566039,170,132,662141,138006,524135
a407e0ce419867e6c6e6eaf147df7df2,177,136,525780,112916,412864,130,101,426594,118573,308021
a13e12eb6e9735022b3c15f5611e79cd,136,100,266769,55411,211358,139,122,284548,48203,236345
511fbc4adcfaccb78df99edeb1d2f978,69,65,93158,35956,57202,49,40,66043,25499,40544
78158dd1edde69c40d665d9aaeaeabaf,105,86,266327,73959,192368,156,131,351301,82975,268326
2abf46d37f90569fa9b9236b7fdd0dc2,127,90,392620,89253,303367,162,104,576639,102281,474358
ea6ca851b78a0cbaa96e89e420a99e28,142,113,522625,110409,412216,176,149,513076,130641,382435
91a050d846856fee04570fb638611c93,168,123,432149,82872,349277,167,117,536344,87615,448729
57cc27789601f17b7db2cbefbbcb158f,87,67,148734,76991,71743,122,108,267226,71364,195862
d9b52b6a0d828e1dd40ce95b65735307,74,55,99398,31989,67409,68,55,115118,35523,79595
d4d22bb4c2833ad3fb4767069002ed82,153,113,481633,140221,341412,147,117,461695,87641,374054
d4e4e76ea3a175d0611f1542038c40f6,197,136,710135,125295,584840,182,123,529404,101119,428285
e7b6f7a2a9db2020173a2b55b488e262,142,102,388496,117495,271001,131,63,388267,97196,291071
36a8658c666f1f9da1d8aa724017640f,187,137,649157,107438,541719,191,117,665977,118441,547536
f9a7925293c0cb053a71d980dd45abc9,137,101,569686,83887,485799,166,126,658745,65554,593191
4885e12549746568a8762874a9309900,129,99,265665,56648,209017,117,96,221356,68931,152425
57c31cd4ffc68d1a2f16fab724a8c557,204,146,986067,206182,779885,212,153,872640,192130,680510
f8e3fc30ce2bb97e6b1aa286b4fa7269,115,93,245800,77982,167818,117,74,234662,69159,165503
bf6b5a4eab29ae1a8f0546bf8c7a374c,172,123,794172,134451,659721,166,137,648581,143451,505130
2c56c4daed6cbbdc25ff6d7e4c681a13,127,94,401675,68196,333479,144,118,347641,101536,246105
5f40925c88c97a1ee597a23888fd1255,27,21,22650,8579,14071,23,27,20486,8010,12476
40d90f67987ea31429703f405683af8c,127,98,360379,104055,256324,184,125,474852,110003,364849
b6d458eaf1a0a5f7ca0c3c6a374f35ba,45,32,43282,17743,25539,47,47,60249,20876,39373
25f10c1b76ca1bc136f407b4282af519,5,3,408,699,-291,3,5,699,317,382
6a19d43a00b863e03a51ca28d831ddea,10,9,1175,578,597,13,10,1606,623,983
59954dfc7a24efc41f007eebb1458d7c,75,48,97279,22451,74828,83,52,84175,25321,58854
15792e78991c4accd02d142c353d3a69,53,47,84051,27132,56919,40,33,56985,30367,26618
7e7c856b725816e190787651172cb19a,167,107,577400,197949,379451,193,153,729454,135787,593667
d71bef55f2811ac091b9a56d36032bcf,101,72,222208,61469,160739,127,97,280693,70026,210667
906505051b9925090af056a78ea63847,27,22,20738,7347,13391,31,19,26607,6104,20503
da6b13459120ea892ee303dbd7e893d7,228,156,1206348,271892,934456,200,150,1479744,238671,1241073
71485173a2512e98d8ff22eae4070db4,209,145,851595,101261,750334,196,130,608287,109466,498821
be04e5d3ed1c07c4af4e640020d43993,90,80,336055,110413,225642,80,71,362169,110968,251201
a34854771b62d3ceaac9b29c503c3a02,70,57,94204,21511,72693,51,35,75149,17552,57597
ff3638c4381672ae419048e5a6fe7e1d,52,42,82514,23540,58974,57,43,36859,26129,10730
983ad41f283d102f4ca41e85ebe41e60,81,74,105752,45261,60491,80,63,119533,51002,68531
7acb13f95bc2c388966a1cde268932c6,88,59,132879,35129,97750,87,64,114657,37661,76996
690dcdfdc057058f0498d0693bb3c7e5,130,94,220079,50761,169318,102,84,258548,58303,200245
8681c4fe47011c33a623209cc9535dfa,60,45,99212,37955,61257,79,48,121223,29816,91407
69a942676109b346fa4579d1e955dc68,55,48,70826,22003,48823,64,57,71796,24106,47690
672c731ff494de3ba1aacf4b0012266e,58,38,37236,16373,20863,52,45,72454,14331,58123
c65ff54fd04ddae089ba456982de9e0c,34,23,25608,8628,16980,35,26,16663,10325,6338
3b54977f51c63e487866635046d35322,72,62,114618,49197,65421,110,78,215766,38350,177416
71063d79d4f43dac2326aa35bc1e7440,167,114,758830,111956,646874,174,133,966598,127254,839344
e056149c53d48e27ca19f735ee370445,26,19,6625,4243,2382,18,20,5735,4400,1335
d622ffe8703f8bb898b39c64c00af271,236,154,912977,162815,750162,213,146,969997,139739,830258
91de440fa59df364e8c9b89e45e19237,109,91,211882,66467,145415,138,124,310214,59135,251079
00a22fdf94e403c9a0526ed8ba0c46d6,85,73,153993,38940,115053,66,55,92066,42967,49099
729c28d38c2aa931530231eeb15177dc,67,43,77870,24845,53025,58,42,82215,18134,64081
320970fbb3841c9555364c38c5c0fd15,100,67,199662,27253,172409,82,76,148104,54113,93991
bb7fc84e2eb931abd6d4a7622526c18b,91,62,156523,38591,117932,107,78,183148,31858,151290
33b0638af886b4033d85f1681836e0ed,201,128,870715,135808,734907,198,148,892616,179955,712661
fd5e7951b8922ed2e8656dba27d171ae,145,101,413944,73218,340726,141,115,388679,100583,288096
ff6b9079b0a22c05f673a5a26416a3c6,109,85,185560,57574,127986,84,59,138069,57479,80590
2d5aa1ed30f86ffa1a98ea4aab5fdac8,143,106,395559,57289,338270,140,114,307952,69382,238570
93621b3567b0f386a540a8c25aa3f623,65,47,86735,35411,51324,65,53,88109,25279,62830
446817e2a3b5cd64deae476e8915bf64,126,86,279175,75553,203622,128,106,230788,85568,145220
2896a6f13ca721c534a8af057b15dff6,149,119,524096,79138,444958,209,171,761917,102933,658984
b2b77f18cc6c75cb06f372eb0b66b93e,82,68,156775,40520,116255,109,82,263930,40023,223907
a1ce72a95e23defdc6112eeaf09b4bb3,121,105,251955,54954,197001,124,91,240276,54013,186263
d43b34378994e94fe4057086eeb63d9b,33,24,12818,7330,5488,28,21,18382,6770,11612
dce036086513021198740a60a350a0e8,45,42,44746,16270,28476,46,30,36620,13107,23513
97de173d6190b58b9d73e62e5a657d09,158,116,549308,85031,464277,148,124,519277,101227,418050
36d3f8f2bef9184fbf60aefcfda9e180,179,150,586893,70050,516843,97,69,261558,59400,202158
93b191f9b194f3a3f2550a6cf79efd24,95,80,205200,36504,168696,123,91,256463,42245,214218
d0130dc83c3ee85eb024921607e45130,121,101,524196,122834,401362,161,121,424284,114098,310186
c7f9ac3676259c2c6e44e635c5faa790,159,125,479348,64826,414522,137,107,314163,73151,241012
637c24c551a11f79001849765b9052b4,45,38,40628,16697,23931,52,40,38381,17279,21102
d0678aff6f37cb1d92e753b22b64aba4,112,100,332460,90614,241846,143,109,337089,90828,246261
5608bf24cb51eae5ca14817a97e36512,58,53,63879,17853,46026,80,77,117368,32808,84560
65563c49ee82f4ebc6684f5da355d5ce,24,21,11201,8857,2344,30,17,16118,4881,11237
221817597c44ee6e259ce6cfaea862e5,169,130,389393,77907,311486,138,114,312339,88026,224313
02af28f057cd3ebad28e86c0e28e0f10,20,20,10153,7031,3122,27,23,17735,5189,12546
1de75dc4c69168e3d7bc0e4af1cbe876,155,127,358530,90716,267814,141,104,309136,114087,195049
c1d9f4dcaa5f5278334c73a94a41f892,115,85,344820,56864,287956,145,121,348885,79803,269082
28e2e5fa249bd056c3ace36cf42be4e9,127,104,330513,49081,281432,147,137,455874,91543,364331
0aec926f158c1113c0e9ba795b834569,44,36,58852,17288,41564,52,34,50896,21379,29517
cca47401c2859f4261fe0f665ba178c7,156,143,716263,98256,618007,161,98,407166,82952,324214
e37e481cb63c90c3ef184b52b3e18eb5,170,120,1541292,125562,1415730,202,157,1059490,139939,919551
2e1143d26e64f69de6f4b5c8f3992896,74,59,108621,36030,72591,97,76,145220,31270,113950
2b24bfe255af7a8b2acf0313c9564d62,89,68,258407,79454,178953,129,93,310193,60377,249816
5db5fdfe5f3baea0f86b78436f6bafd6,200,150,706482,98856,607626,196,112,441626,67849,373777
53b33e0064626e2a06ad9bc42b79286c,118,102,192878,36487,156391,130,100,196828,37994,158834
0c1f4ec1c31b6ca3e5fb72245a91ed37,155,130,413966,58374,355592,128,107,446579,69603,376976
7ddbf42811601c1f037abf4cc608758f,79,71,169316,40910,128406,68,53,103665,38965,64700
dd8874d17a25c0412e40cc9c3a28077c,21,19,5779,3117,2662,21,16,5793,3592,2201
ef7e99f1e8d6c3a2ec4770c9182ba255,15,14,3587,2716,871,16,16,4290,3220,1070
23922c9ef85acf49abf9203ea5c9505b,77,52,90541,24280,66261,62,47,80276,24444,55832
a267b3ba408e62df456516d1fb106b79,89,59,247037,50287,196750,116,98,206003,64984,141019
41ad73a1ecef79ac5f3be3e0df47fb66,147,111,376578,49609,326969,141,101,298794,71502,227292
8c8fd6809840a54a193fbd5536b4274a,120,102,265755,54102,211653,110,87,234170,58236,175934
6cdc273067f3d0544040ce8ace138a92,106,82,286807,71045,215762,76,63,221728,50500,171228
802d86feddc33892d51f2b465d53f64b,33,28,25019,8574,16445,31,25,17547,7406,10141
7ed41f6c67f69404c7afb9fda49bfeb1,55,42,70430,27037,43393,53,45,76646,27502,49144
bc6814d88d26dd4f720ce7f8a632c8e8,24,18,5902,2948,2954,19,14,4875,3283,1592
bb22d105bc4d95cf32a7ee36bf23ddc1,125,75,199496,40054,159442,92,69,214393,51871,162522
fba34f8fe3dc91667da42edf2aff7660,9,9,970,900,70,13,7,1496,648,848
dcd74d85d1469378bb0b8afb5a84918d,131,101,360648,67069,293579,155,136,438297,75628,362669
c5964032d94d3f0f80de4100de27e33b,200,119,530142,92546,437596,155,113,505860,89960,415900
8d85d9221bbfc439677e298d034b875b,131,100,323671,111572,212099,137,109,331604,80435,251169
4d9316d8ff1fe12c9ac938237762e20d,197,165,649475,127044,522431,136,103,345993,100759,245234
f65bdbd2d156dacbc4f460cc48a86ebc,187,128,599718,99738,499980,158,96,572520,100489,472031
e9943f4111338d0203194c5b7287ce63,146,114,689308,67182,622126,163,138,519679,89964,429715
37c0617c5452739871d6a07e30dfaa45,35,22,24138,5960,18178,30,31,18224,7676,10548
3c3d287be68a07f0bfc6f1a7f8743ca2,139,118,378105,118269,259836,115,74,331610,71379,260231
27e5cbf98d132def3a2853ee6a3b3c0a,199,134,696417,159098,537319,167,117,583884,148330,435554
7e65568f98dafa75a0e05c26c3f48dcc,115,86,291869,57168,234701,150,122,361268,65781,295487
6f04a07be8e0c2610cbfe98333eba35f,73,56,128589,46768,81821,99,78,201839,46717,155122
b2007e260312b8a6b69e17c5278c5141,119,74,204600,63134,141466,103,86,232939,57676,175263
de04152ce86d621a6f77e7f12d5b0630,112,91,416804,83067,333737,125,107,381623,122123,259500
b6c3d19669435bcf1327a1f954ad037b,110,78,139899,20317,119582,103,76,129590,30921,98669
9b012fab1c66fea4cfb17721947f460e,56,45,54407,16011,38396,49,41,37831,12816,25015
3793263f2d4a1d2c9f02245682c42185,135,117,322849,78545,244304,141,127,358322,76505,281817
4f301c738a0a5e71bb2023a4c2b51200,44,32,37825,15742,22083,57,35,47256,19028,28228
82d7bc65c5753042f3a5a379298a6849,69,51,84887,31981,52906,78,58,102249,30675,71574
c1c50b62064107fe7b7cc3342f3a7b84,139,114,540111,182520,357591,184,125,721937,156655,565282
084de656d73a8cf72a01ff1a8f7a2488,39,31,55409,13612,41797,46,45,56039,24057,31982
4a31f7a4f0f8e7b4da31997dc731d9ac,113,80,159344,41367,117977,132,81,233341,36042,197299
de42aea5d0b304be01f2a4aeebac1847,62,49,78222,24095,54127,68,51,82905,21670,61235
1e2435ac7c6dec4296619a97f23b1654,23,23,12392,6499,5893,28,20,12821,6763,6058
33aa8774b3b1d4cd9ccbbdfc5ef42fd7,83,63,119688,21209,98479,93,65,128559,20859,107700
c2328f4713ed6d7001f480f288f10711,58,36,76342,13770,62572,54,39,48446,17280,31166
d5f98942ff16d8d099f908f26d6cc593,74,62,153152,35277,117875,89,69,119842,52665,67177
74e6403e587412c31371c2ab2f51345e,31,26,20917,8880,12037,40,28,15123,7728,7395
470ab74ee567f5277a57e6538d328095,36,28,40547,9154,31393,31,25,29343,10163,19180
a2a0858bfcde884bebe42672f5ac85dd,62,54,61945,26125,35820,65,47,83065,21745,61320
f0e1de494be49717669695479216691e,40,32,31328,15275,16053,40,33,28303,13680,14623
43f68547d5a506d8c064de51912177d2,201,148,1046691,285557,761134,193,134,1414679,246358,1168321
ea2b7cc0d485fbbde137c61abad31361,145,119,460523,110302,350221,147,120,469939,76942,392997
9678fbbf3b03d21d09160a60378c1a51,12,12,2091,1412,679,15,10,2279,1771,508
d9a1fd67422fe5712bd72a86b99e5ff4,50,38,45082,19938,25144,50,41,46456,16426,30030
e679edb7ac86770658bc4d9519c4b479,93,81,122990,42015,80975,102,69,122322,35236,87086
95bd6f1c45c2114078fa8fef6a80e43c,115,69,208834,36127,172707,96,81,184806,46354,138452
369d82e8e51efded9bb5b7ddb8acbf19,138,98,291880,47538,244342,106,82,178443,48981,129462
13b2ac8712a544b5c7155cc45a45d121,137,105,323845,66646,257199,141,115,334675,73625,261050
e634b247690d51c484b6717f0a4f9174,123,101,269899,71697,198202,116,103,237522,66716,170806
c8c18ddb8a7594850559865d76d41a7f,120,85,263891,83532,180359,109,79,232841,88937,143904
39e18ab87b8e554897eeae9438ffcae3,38,27,19643,8477,11166,42,25,17720,9211,8509
8c8f758f25769cd0cbc1f4700c839b1b,36,29,26426,11002,15424,33,25,19877,10377,9500
e7b08c5ec85820333dc1545e3a4f594c,88,76,156389,80525,75864,123,101,332734,61046,271688
400fcadfef1c55fd52d3e3f516947e77,14,14,4439,3696,743,19,12,8463,1971,6492
4aec7040b1851af5e9cff14d1235a099,127,94,506934,106747,400187,152,118,576907,152479,424428
7c87872b635d5f8ee5e59cb9b407cff1,25,21,9737,4291,5446,21,19,6640,4528,2112
bcb8e77337c1d43b10727d4451a86989,156,119,522320,77808,444512,146,119,414147,114305,299842
d26e02333b93eff1d4fc15eca77b6afb,78,60,134511,31778,102733,90,62,164641,23786,140855
f82df13cd819113413e3fb8b0f3c5f6d,67,58,119682,39052,80630,76,54,110043,31900,78143
8c56c0c754b472162633ec1af0e7753c,91,78,191663,58155,133508,127,98,286173,65299,220874
f0a941d566f49a255cf80d9ff5655d04,25,21,16273,5075,11198,24,19,9590,4803,4787
7428227b235a844ae7adb138e705ae77,81,62,139902,25338,114564,103,73,266090,34368,231722
6ab3edf32df0c00604fc6b37bbac4b1d,129,93,793208,132108,661100,198,148,956824,226451,730373
08ec00a6b0bcf8fd3f53a4bbbf8cc253,68,60,103144,23844,79300,87,55,124826,22986,101840
39b9b8600f1008881a2ccae57b36750e,54,42,84758,19207,65551,76,61,68756,31851,36905
4c2c77908a66d466eefac75023879455,62,51,92128,28543,63585,43,35,85331,32494,52837
99860ad62299af804b65682a9275e503,138,105,190330,41448,148882,142,103,226805,45801,181004
d8e1b7f10f8e0e2ff308bf31428fbca2,48,29,59459,15109,44350,44,35,50692,18580,32112
e9018217caa4f2dc544b8bec14d9fcbc,22,21,11999,3056,8943,22,19,7509,5575,1934
1d06905ff63f419788db6df34f99d093,88,84,183152,51337,131815,101,79,192912,46400,146512
37587de9e7c9ffc29a1340fbb6094b61,134,102,327180,76183,250997,181,149,555051,97062,457989
e40b70103699c5c8703ea98d105fd64d,2,0,150,0,150,0,2,0,150,-150
06de98f7fc77a91b5772d9a77be29a78,126,100,340985,97133,243852,108,77,254571,53870,200701
3f340b2cfa75adec80019b1bcb1ce692,207,137,626668,133284,493384,147,123,471308,101687,369621
dda932728cce0253d02db30a89f44d50,36,29,48488,21755,26733,39,24,56451,16456,39995
f168981c74e97351477548320bf8dea4,191,121,520274,104417,415857,208,143,708625,102374,606251
fb9e8ced2f7fe29e2b4ed5bb2d3cea5b,105,89,212411,61841,150570,83,69,163697,55648,108049
cdf75629718de0948545f783e39496d3,130,116,350829,131635,219194,88,63,232163,91663,140500
fd76a0209c11c833f7a86cc6c21f3785,29,25,10607,6417,4190,29,24,9023,6313,2710
4f2a171b7990500a0f0d01a82a9e7f56,31,23,12466,5031,7435,28,20,12914,5228,7686
9bd3977b54026cc6837a37ee26d42856,29,25,15662,7360,8302,33,25,21511,7236,14275
144045841fb48ebd560935a4fc64a638,111,93,299134,66363,232771,88,75,205311,61786,143525
cc21f6fc54625e528569358ebb1ea4ff,37,22,19724,8610,11114,39,32,35822,7373,28449
6f47a5c1facbb33527e56b96fbcd6d1c,16,15,5210,2937,2273,21,16,6305,2797,3508
5263165a18239b7528019218f5efa1c6,116,88,291986,65848,226138,110,92,253312,81387,171925
c26fb7e2e3c43956f610e7308624e472,28,24,10212,3550,6662,25,19,13842,3639,10203
8ef60b909ee7e8980e39d61395fb054a,33,25,24777,8970,15807,35,28,19772,9152,10620
a2de21a441847dab1a6a7aa5cd3475c6,87,68,90296,33547,56749,72,58,107812,28601,79211
aed5341d4cde5cb4a049d7781f11b796,133,99,269777,69533,200244,118,97,263493,84618,178875
56efcb716ba7004267ae60ad3b5dd834,25,19,10023,4652,5371,25,24,11116,3972,7144
5c27b8212a2875665a31fd20d6d3e9cd,22,13,7140,1973,5167,32,21,13280,3127,10153
8f6d99953581ac8cd6f98d3cf2af0ceb,29,21,24760,8034,16726,36,35,39557,7939,31618
efde6dd6d69c886d54cff7c4db26ca56,0,1,0,24,-24,1,0,24,0,24
ce4f9470bea596d5d7f8e1cb10a9938f,152,118,413850,97717,316133,143,130,383979,117738,266241
f1fb59bd0e6286f04e988c64cdfb26cd,197,166,842695,168566,674129,205,174,1002243,159390,842853
b6758e1b395ba79f946029d2159b8c2c,126,89,238045,53391,184654,97,79,223898,51547,172351
8767c471ef0238457b9a4cd1ce198b41,119,90,320536,66412,254124,98,83,188829,60782,128047
27523e9e8d3e7272419a229e4e4dfd44,163,123,487785,103935,383850,163,108,517790,87990,429800
fc59ebe702c6d0ba70a2b1aa7a9becb6,39,31,46814,18927,27887,48,42,63400,17844,45556
56d46434f3225051477253ec349a1954,102,81,170838,59120,111718,113,103,208345,54170,154175
b67b398f7ab1ba7a6dddc722a2ad1b5a,21,19,7642,3088,4554,25,16,8302,3663,4639
22cf15c780a9a4908e5379124b82885d,59,39,86905,29064,57841,60,41,98664,31426,67238
391411c80565805dc378b0468662d875,45,39,69426,25423,44003,46,34,43523,23397,20126
1393e1f6fc76fb084b3f147dec61c5f5,36,37,43850,22152,21698,39,34,45899,19983,25916
348c5c00812543794885004a1dae0598,124,81,219425,61428,157997,110,93,272976,67994,204982
4df755a0ef3437264c9002eb52a71a6a,92,75,150361,44055,106306,79,64,186973,45486,141487
984e70ea6bc3fa5ef0eae0c34e77c67f,86,58,92426,21583,70843,85,66,105544,25850,79694
226c183a0f7063acb3532da1536ea34a,178,134,492041,83572,408469,162,113,384255,76623,307632
42f45003bdc123f9b23ed65db93fb932,47,33,44458,15271,29187,60,39,50488,16135,34353
021e3ec9148c0972a74c243e968bf82c,19,13,9239,3575,5664,19,15,4855,3840,1015
28a55e3115b372dc625ca9439bee364b,16,12,4927,1437,3490,15,12,4408,1531,2877
ff41aa95ad242b7c038d1e6331f37420,71,55,120045,36238,83807,65,61,150657,30756,119901
8c204711da0fbea8f7269fb9ea6d5f81,114,109,351535,81646,269889,112,69,289167,69018,220149
d922f1de78c3a9b49e56159ba2098819,91,80,138932,39011,99921,63,51,137895,40942,96953
fac6896436b5638ac93c62b1f5704563,74,59,98124,48992,49132,67,58,139483,36438,103045
734408bdd2bbd3fe4c2292bce9921c92,15,12,3709,1839,1870,16,14,3171,2231,940
6041336dfacfa280c79f0d1e6ea7912d,74,59,102900,34078,68822,96,71,127674,31566,96108
f6aa7e0cfb8331b3992bfe5d12e33bcb,36,40,46182,21674,24508,54,44,61246,17264,43982
726628d9b0c280e7e07715ec39ef52d1,127,100,333930,65520,268410,151,120,399794,73392,326402
ad0282562a7402a38d3083f3fc62766f,166,144,357598,106126,251472,128,104,296332,82433,213899
787dc2146a8d53b2c45504b2f62ef17c,26,25,9949,5442,4507,29,20,18399,2870,15529
affb9fa49ff619af7673726f94dc7952,19,19,15182,4931,10251,24,22,10659,5777,4882
58e213ee511820f23ca36ae5b841c30f,132,113,281944,33516,248428,104,84,147453,40152,107301
6129811fd6f67c827dcdfdc48875348a,164,131,562108,99784,462324,164,127,564561,120237,444324
20921a250b937831cd2ab1c29e671370,23,17,8501,2941,5560,21,20,5087,5494,-407
8df8ffd05cd338c065a73cdce19ddcfc,88,82,207256,56747,150509,133,93,236461,64761,171700
39bd09efedb6f99edc19a82113477326,1,1,76,51,25,1,1,51,76,-25
5cbd4701c88d502cc8a7b2ea564043e5,59,52,71693,30805,40888,78,59,112536,23211,89325
c31c49c06fc2c32546b03eec6aa69a9e,31,21,21506,9787,11719,27,17,25160,6317,18843
52e452b6443a68165269277bd88300b1,153,107,265148,78950,186198,127,99,386473,66154,320319
37e406415e5933b3a5a38f57251927d6,126,101,289099,58426,230673,91,79,184023,63655,120368
74c5daad927a572029f25a3c61278f07,140,118,425704,97724,327980,150,132,496903,100597,396306
9ab171d154ca2945b5f20cd36525e600,136,103,472161,115581,356580,170,115,537490,103778,433712
949d2bba0010074c82cf02e4258affc2,26,26,12804,10382,2422,35,24,20934,6209,14725
582452593c347f20e157735c15c1b5e3,36,35,41239,17399,23840,33,27,40199,12189,28010
f60ccccfc88a5f1f72df2e6635364a72,106,76,158032,33041,124991,135,114,297767,46397,251370
b300ab0815d5a03ce92b641376904904,165,106,460142,129448,330694,220,133,731942,113146,618796
1163ebf5125ec54881bd17fe8a6c19a4,65,52,107589,26737,80852,59,42,55750,28843,26907
02f1484e8e50a21c186431f8492bf6d3,5,5,380,779,-399,6,9,881,587,294
339a4bcbb8d7334bd4ec19d23d11079b,72,62,86673,23846,62827,54,33,64624,23033,41591
ab2531bf40b59acfd4b7267e2ed7d1c2,51,37,40306,28440,11866,58,50,78711,17239,61472
6b884edbc77fd69ff88b5d48f790776d,17,10,5424,1065,4359,15,15,3475,2143,1332
34df28b801c506b65a9cd40661eda0c9,76,62,156153,52074,104079,70,55,141752,46962,94790
99fca1051ffd787164811e3713858588,48,39,67610,24226,43384,65,48,68746,27127,41619
73bcf532aee1636fb13b0302140c4662,37,23,32169,12647,19522,35,31,35550,19671,15879
0947a80dda977fd3e6f29282664c8197,92,79,180083,37798,142285,71,47,142007,23085,118922
73f104ecdce9546027440683c20b0e88,129,88,311337,61383,249954,173,135,362737,66010,296727
0cabde308ffcf2dcaee0bf0c5783abef,23,20,9252,6121,3131,23,19,20806,6579,14227
659a84631acfb37a65a8a7bb4ac80142,69,48,96087,26885,69202,55,37,54412,28596,25816
c71bda76659215c03f9093d50fd2e09e,21,19,8658,4427,4231,29,17,10935,3619,7316
aa1d955ffe7e3b02a231b6573a490b50,82,73,153868,53928,99940,80,73,126554,55162,71392
45704490b64f9a4ec81618c7d0715c33,26,19,14654,5647,9007,24,19,15243,6648,8595
d0212d899d72e8e83163abd246e19f53,72,57,122500,32992,89508,66,61,86607,33697,52910
3b0b55f92d253f30fd08907ab810e434,154,127,454765,85790,368975,169,143,566383,95402,470981
b19bba0a8766a946d96579ebb4d70656,103,87,236587,61004,175583,86,62,181660,55112,126548
8f100484f6344048c11665e775a84755,135,106,332509,66019,266490,79,62,161613,69351,92262
277f9a5d2a847a2cc29f91a9e67fbc3d,0,0,0,0,0,0,0,0,0,0
10163841d86fb80c9b48c83e59b446c9,100,86,162226,44809,117417,95,56,152966,36411,116555
897b9ec8e58b3cdae0e620f8ca0ac8b1,116,83,267498,66459,201039,130,100,282082,63140,218942
e40f10fb034b9016794822c97fbb8a9d,34,25,21168,7852,13316,29,24,19703,8539,11164
293db3f4436c1c546c2d2947c0b8b1c2,122,106,330611,105725,224886,156,117,646409,70621,575788
6eb01961250c8de79c3817e082095baf,33,23,20493,8063,12430,33,27,23849,7973,15876
d99c05ad24478915db4de2dfb5e9513c,25,16,10413,2427,7986,17,20,4907,3769,1138
3c95c21b262a5e97b15b07c7b5e9dcc6,21,37,4960,42000,-37040,48,26,64667,7100,57567
8bf76dc680fb2a6ccd761a77195ebb49,28,19,12518,6198,6320,35,24,24021,6175,17846
be1f43488718130ca53bf0b17d1ba643,15,17,2046,1318,728,22,11,2496,1127,1369
d9e67c6744bc3f1ecd52fdb6d231fee7,95,80,243173,47736,195437,110,84,298546,41148,257398
ffe79425f7b9dd9ee61ffb9a7c8d8e0f,152,119,403065,96463,306602,178,131,486603,71431,415172
e980851284be3731e91ec11ba78a4b86,77,61,111689,41108,70581,87,62,149413,27874,121539
3ce140921cd8181465cf7df14da09eb7,35,25,42383,11180,31203,54,35,43029,13082,29947
22d07ab69ecd30524d82560e85d64974,127,110,386536,129726,256810,166,121,601449,87553,513896
9e49b0695de1ba528a327659f584be21,116,88,287364,85673,201691,187,128,587273,74099,513174
2e2c6c3fdf90944d0695064c2b16dc0d,74,50,124723,35292,89431,98,74,188959,39758,149201
05ea42949ec2ce9fe5497e06b6a65460,55,46,88038,29059,58979,50,44,75030,27222,47808
197a05dcdcf3838cab9b50fbc64e6631,105,66,181569,37083,144486,115,93,264939,51629,213310
c7edfc73c6c9325ac1ccc24d1c5a6351,28,25,12274,5525,6749,28,21,11191,5007,6184
51f3d6fc2b8b2a8c2cc77dd006cfdfed,195,166,607611,161051,446560,186,131,596756,114925,481831
ce31d2714eb26dda9da2dd742c3945ed,188,144,523040,102694,420346,148,121,346280,98378,247902
55b5aea1e896cdc0b55fd66632c00d98,105,79,193965,44056,149909,117,91,218102,55473,162629
7c9a7b56c72ce1509b64d8bc5f4883f1,24,20,26353,8599,17754,28,26,24450,13521,10929
9be2fe7baf1989fe08858ff1acc6a221,131,105,393434,131519,261915,97,81,316486,100781,215705
96cfb9646965799a75b007fdca015563,145,102,326439,48967,277472,163,112,298071,64923,233148
d751830260491e78a5024db93d4df334,49,40,41783,24388,17395,43,37,51357,20555,30802
90e7a973b74b11c5fdfc386da119bc0e,129,94,294483,42645,251838,102,79,228428,54596,173832
5f2c6e4d8001c710bc7dafa35c389721,135,87,400988,95741,305247,124,94,333002,130131,202871
b98df7f50aa1ab6a8210300f9e2956ae,123,118,265731,71583,194148,159,136,393654,70001,323653
a2e849533b2a5b47bc852baec5a933fb,88,60,152922,32678,120244,65,50,103771,30889,72882
129af112dfbc7bf5ecb7f49d6fedc936,169,107,416162,93107,323055,161,115,592742,92578,500164
6c9499fd1814cd41ff08bc2a0e9fe73a,173,132,602325,114061,488264,155,124,471507,96473,375034
dac0a83e779872ba4a13e4ba10a3a5df,117,95,252164,50240,201924,125,94,256883,69051,187832
133188f7ffbfbfa9e8421f402dd7edf0,73,63,89783,39803,49980,96,84,158952,40390,118562
c52f8e3ababb1ba10a2a41edbbe3a8b5,79,59,126883,34323,92560,89,65,203097,45157,157940
15c61c5050a0782623e93d2c534f0c3f,117,92,313845,65487,248358,128,93,264074,69558,194516
c0083e32d6a5349d07794cbc1d90eba8,55,44,57285,27557,29728,44,37,58700,22322,36378
181787e01cd62e0af3e52b6817fa47ee,73,54,110825,53298,57527,89,71,170259,79340,90919
359f47120cf4dd44ac4730b37b2a947f,39,27,36716,10818,25898,29,23,18623,9461,9162
e1efec885a30c1e59a0857822e3bd84b,166,120,608865,92795,516070,192,142,506324,80839,425485
307b6561ee92e45b6a172d2668a715e8,73,59,101658,28180,73478,84,74,125706,31285,94421
4c914101da3373bfac2d93ad74e13f4e,28,19,20759,7448,13311,23,24,19359,8508,10851
f8d9e72cac8eb407ed6ca573067291c2,125,84,277425,94272,183153,143,107,445468,78873,366595
8da2b56e9f0940c52590b90f9ad0ea57,242,175,909150,183059,726091,215,157,1031279,215244,816035
bdec4ffab657034e3d4cee68219479b7,35,31,38248,13198,25050,43,31,29908,15784,14124
e4002809004d359155cf4f8dc931c259,177,140,580426,87699,492727,188,149,600244,98689,501555
bbb70445d4751fa49e051f9e8a5698ba,93,78,191606,53440,138166,104,89,177179,54550,122629
f1a10ba96681789d6c84a92fb948ca3c,51,38,62542,17368,45174,44,42,45359,21671,23688
a55e88f9863a27f89267287bedd348d8,100,85,187393,40371,147022,80,72,107611,40715,66896
0b7151416e29c4256816980e21e063f2,129,106,408191,78184,330007,149,121,369518,82561,286957
4d5426f5a1e5feed99ef72691eb71335,81,58,107770,24758,83012,103,68,123170,27167,96003
3241df147473028b6b92d235197f2230,92,67,139732,45320,94412,73,60,120703,46489,74214
34b88407506df42f78c77ce4c987dc16,116,91,189748,49363,140385,106,81,205610,61347,144263
ba9d20801f987b569ebae703edb4764a,69,50,95397,18552,76845,74,66,108498,23626,84872
8533b6c4601b5fe46d9f6e27714d66c8,156,111,589403,115872,473531,186,147,684130,139623,544507
9fe3b173bec5bd8dccd44e68c55fd4a2,40,37,36765,14247,22518,34,26,24545,10583,13962
dd8fd2e36514d80df78c07bde4b468e7,135,103,488682,123725,364957,104,59,272535,102341,170194
509c5f645e4e632910cc9daa52d4ed12,78,65,145635,48635,97000,107,69,213221,29879,183342
71732fde1094d95835880b613e40aa37,45,39,76145,25971,50174,45,34,61695,33015,28680
29108d27ec43ac730ac7a0adf66cca1b,50,37,62858,19559,43299,56,44,64134,14645,49489
928c712c59c20b58e46f060e9ce4a4d2,31,25,20279,5218,15061,18,27,10357,5950,4407
159c4d84b0ecaf43477a9d0a42479c52,40,29,30108,6661,23447,22,22,9548,4142,5406
ca8abdb427365461c08814f04d7f2656,27,21,28845,7138,21707,42,31,40406,10600,29806
41a8ecbd33b1f33422e8081da8435636,194,160,796291,114543,681748,227,144,871632,105695,765937
b881194db5e931a32c39a60963da7087,168,109,365526,69257,296269,100,80,197061,99426,97635
bf271e28d6f9a325ee8667a95361e679,58,47,74714,20283,54431,51,45,65929,17435,48494
2f5d4ccad75a5e7e01e03b30ab99e4d8,151,107,303590,69464,234126,162,82,256926,52940,203986
4158f454ae927066d1232c1774a75a54,139,94,432160,82158,350002,166,134,672502,89564,582938
88fd10cf20a0f108742152829885cdc5,127,101,269315,47883,221432,117,80,166829,39573,127256
2fb4dd4433af2094f29a27a12f7c3d50,147,104,453163,82657,370506,202,145,664415,86160,578255
0fbeec33396cf8df9b2eb6d6ea8797e1,197,132,645833,203103,442730,186,146,708146,197542,510604
f9c8856023ab287eabd76df510b1df72,110,85,202990,50698,152292,71,56,113669,38631,75038
33e4a3fb49d13a7d65b2033daaf5d36b,165,125,784922,191796,593126,166,136,724053,115769,608284
d19de8e38378adae13418fee4039d27b,221,167,1241931,228526,1013405,213,141,1050515,135159,915356
1317668bc80d4dc72719a23f6bf79bc1,147,130,539812,139907,399905,184,120,526367,114619,411748
04dc6772490c48e4df8b2ec6b1dab2c2,38,27,22488,7509,14979,33,32,23544,9644,13900
c3b25ecdbbc35c1c451dbc23a3424227,166,143,534706,122625,412081,188,130,544937,105508,439429
489f5950e3f39259464a4e308ce2bdf5,185,152,696880,165132,531748,178,113,712781,175267,537514
a7759b0f5d0b576bef70f0e48cc31852,157,116,549222,88865,460357,147,106,342126,96176,245950
6256f02cf7a0579c364ceeb18b0c419e,64,50,130302,44497,85805,80,60,118744,39628,79116
255232cd67cd4b03fc13169aa1143320,150,111,271609,64173,207436,151,110,347492,74984,272508
544c92ab6d316f6f2006ebe911b3a98a,69,57,99014,28541,70473,83,70,124035,40198,83837
6050b209124d7763bef6f3b0f1934c39,103,76,212550,58528,154022,91,72,199977,57524,142453
62a38aa8559a1dc2851cc19735793a29,127,97,268384,66474,201910,116,98,428081,65516,362565
dcb35e6890658f91076c682b3926142b,44,38,71672,13335,58337,53,43,64011,18436,45575
78033ab06eba60a5a5f42012aef5b034,68,56,101688,24369,77319,68,58,76311,28636,47675
099250c2ebf9f9ce943cad7f89a9d640,146,138,479267,105439,373828,132,122,421337,91340,329997
4eb2f3b7c4c3c38a137261bcebc98ee4,124,105,348700,61043,287657,127,107,240107,87621,152486
c419f6344c101cccc030c21419a69608,105,81,274652,76563,198089,125,106,289479,68149,221330
239233ecad1904d2dd4cf4ac783ba4a1,52,40,54416,16289,38127,65,46,63010,12138,50872
bc70011769e0238bfb1e0030057bfb23,130,97,278588,54230,224358,111,78,260621,44870,215751
9b75b5871fe9b61a3d068aecf484a57c,156,102,319037,43007,276030,92,62,147742,60076,87666
b7fc33e2824995cdb1d40515a7d42a28,94,79,169946,45902,124044,87,75,140569,53054,87515
d860eb85a79ce8bf4d8382635fb27855,67,52,142067,27220,114847,54,44,77903,46371,31532
5a357e601ebca6d196297bb2dcce06cc,144,109,539759,175054,364705,169,143,745462,155212,590250
66f12b07266b1ee8a5e07999d41a4cbb,163,115,484357,120773,363584,185,126,587699,101939,485760
87e63cea89a06d23c60901b6bdf1b41b,85,69,151832,54504,97328,64,59,143417,45369,98048
91d77e9251723b39800b97dad6596a4c,70,37,99913,20263,79650,44,42,64380,22630,41750
dbcd43dbb0333dd625b816e66e214d31,59,31,68686,18029,50657,56,44,68984,24280,44704
2b244463f8bb1c4ddaed89d6a558a927,82,70,107305,27501,79804,75,58,110902,35557,75345
7afc9b9968859fd2f3a81feaf79f9db0,83,50,146691,27580,119111,104,87,170049,52934,117115
70451e8acfe53b27ae319898c79d19c4,36,24,21139,8282,12857,31,27,16737,8322,8415
f8b3514235258dbfd2ff9f1c9766e607,7,6,1279,941,338,6,5,951,955,-4
e55e5abff1360108bd7bea050c2b1522,143,100,626560,106950,519610,191,139,675245,183486,491759
5c8793c92e37728d2ee24b4ae5a36eda,33,25,20782,8070,12712,29,21,24648,5984,18664
97061bc3cb31a5ee9a0974207790cb64,158,117,625651,88669,536982,128,104,323158,125458,197700
431ad9e1d0e8571c560675183ac0403f,173,144,543656,84797,458859,137,88,408453,86798,321655
5a2232f46b6d4c43260852d11d47bf7b,97,81,282892,72460,210432,132,93,279108,115088,164020
ef9935ff268b45f14114ba7594bf6320,84,69,153592,41729,111863,74,66,182525,36089,146436
18f46e20fd3cd469bf418b446ea3210e,85,65,103326,55216,48110,87,64,139839,41017,98822
6b90511b72a5595763c0cdd84d0005f2,60,40,84563,28525,56038,49,37,79236,23110,56126
6be66acb7a8a92931521d8dda780fcdd,91,77,132332,28974,103358,71,50,80853,23368,57485
7da6547cfb9dd2db0adf7b325e5ea6ff,25,19,10014,3207,6807,20,14,7751,1726,6025
e9ec6ec1a4bef774d7e245aba2ff182c,131,106,313004,63622,249382,81,70,205829,57307,148522
3dfcd4db186f196635ce0b671c8bd797,167,108,580884,87021,493863,114,105,266585,101107,165478
27843b6aeaa505e7dc6e0fd67b37edb4,173,118,841126,172337,668789,170,117,763424,162612,600812
25178083a7bd1eccf87d8a834fec17ed,123,86,307446,74997,232449,134,116,340820,89978,250842
3f8fb79934452cd89bb9f3a7d9fcd161,82,61,248232,69518,178714,131,101,315913,72547,243366
90d42a0cb94844119ca8ad5f9b6c673c,39,36,24171,9284,14887,41,26,26213,7254,18959
c69e27e4c02c9354c3b620f167e939fc,236,194,771230,136789,634441,137,99,487634,139760,347874
d9b1a4006a43bd7677b09777c53b14d1,219,166,1114206,208795,905411,210,158,1044955,184737,860218
d9cb65451df6c5711f32b2a192f0ae4e,162,115,647179,147511,499668,181,128,872100,194620,677480
1cf54fcd1e0e464534cb35d9f85b568c,111,74,288589,82182,206407,132,121,363050,93520,269530
127b3b8a602cb89046a02eb5ba82a183,61,43,85738,25090,60648,62,54,86566,27375,59191
525b61ce2834b6e458475ed6189c213a,70,64,101122,26054,75068,59,48,84520,19309,65211
1978dbcf7aa20b9381dd037c5b6f0d9a,137,113,302204,55002,247202,121,102,245800,46105,199695
70cf956c08ac87614a8dd3055e4b0e8a,185,131,689997,109318,580679,167,110,580855,128298,452557
712d2289747e104dbbd8994ec70c98a3,32,20,26571,9343,17228,34,28,30824,12508,18316
869364f5d352d0f25aae1a4aefeb8f3a,120,88,462419,66259,396160,146,125,412769,98089,314680
6ea85a85bd07d6b8eca6ef267f63a213,107,74,211734,45945,165789,109,98,200402,44033,156369
af5a48386a1d091f3b157ff1d51f9479,39,30,26531,8238,18293,34,24,19708,6841,12867
9b4d49bc125758aeda768e1bc340f4af,26,20,11822,2082,9740,26,20,7641,5169,2472
64101ede155602b680fbd3dbee93293d,114,68,191847,37823,154024,74,56,107089,44246,62843
c551edba5e3dbf1f02f615cf0682cb65,125,97,242322,77343,164979,141,100,275066,59829,215237
0e5ee0ed57eb1bd3c7c91fbc0a932263,200,132,606402,94842,511560,177,116,543721,63440,480281
baf4f59700bf6b8a0a699ce2cad9cf6d,103,83,192430,38641,153789,71,58,139043,44208,94835
378d7f4817f06bcec9f39c000a1a1e3e,34,31,19314,7906,11408,25,18,14577,4649,9928
13aba11a49d504f3959ca873ddd82652,104,90,187671,46742,140929,69,57,91415,34634,56781
c9088f792f47aa5842b2a488e700d2a7,82,71,115046,45003,70043,71,57,129713,33246,96467
71d14fd24aa71b33e474542dcaef1b8c,85,47,102966,18038,84928,78,58,109860,28507,81353
c3fb9ed1518a395a45b4fe5d0a6ce242,35,30,19834,10239,9595,37,32,25828,11937,13891
ebd7a0e137bf5b4b1a477564951f2ad8,139,107,362075,78821,283254,134,107,365428,87469,277959
4df2ca2e29bc501f7a7799c63994b971,42,34,45670,16655,29015,43,33,49642,13437,36205
3fe9d29d9ffecd939dcfc20bba3991a8,83,74,136896,48193,88703,128,106,251860,43022,208838
1491dd8b27ae79958c2d301273ee4cc6,71,59,115372,27514,87858,108,88,144814,32886,111928
3bda1e2c3c2784c0f30e5481f08c5908,19,16,7382,2634,4748,20,15,7787,2520,5267
df83708ab06a9dd0d1c0d1b5ab4c1cc6,33,26,25468,11821,13647,60,37,68761,13283,55478
6de5103da153997d6cf90a9e01beade9,185,148,494592,89518,405074,138,106,349644,81095,268549
16692aea31c1de5fa1a74bc3d9356b91,159,98,350356,116151,234205,176,142,426370,148265,278105
190fb9255fb9b28609e06b68f9329f1b,95,85,208500,52505,155995,133,105,253225,55437,197788
dbfb0acde4d41d1afbda28032b9ce7db,111,87,236450,48562,187888,120,87,233291,40621,192670
3d56cfa2ed1c888f6ee0ccc21fcb5d1b,237,168,815394,126798,688596,198,146,694373,160391,533982
2c07533ac713468f45f67fd019ffaa0c,128,108,305688,54632,251056,142,108,267666,48202,219464
8259dce25b4f600460be44700b6da9ca,56,45,115682,25712,89970,53,43,72271,26514,45757
c0c0dc93e1e2e7f8e69010c33dbf1b5c,21,18,16008,2878,13130,26,20,10949,3502,7447
e6931b596890c7220ea9b3d5f3d8306c,63,52,91170,34044,57126,54,44,74920,32786,42134
54923284da1c6298a3f4f8bdb4d3342d,52,43,70745,38458,32287,79,68,156830,28964,127866
51db1f555ff5f3b2061329aecbe5d6d8,58,43,85015,20038,64977,73,50,93922,20322,73600
6a45ed90ca6900a606b7bae70f039cbf,127,88,261293,72994,188299,139,76,257117,61512,195605
60cd6a6b7e5cf5dcb5722bbdaf57472f,159,122,400712,78960,321752,161,133,407819,91802,316017
5b1441a373643ee7aa975f61b1e1658b,6,5,1122,169,953,2,5,120,314,-194
6bd6751760a3fa2b49b01f2959e06e39,42,36,39564,11485,28079,54,45,52910,16076,36834
c6eb51d24f15a70080d1117547943347,112,75,279446,87555,191891,114,85,270008,77326,192682
62b898aead0919df00c62dadfd735b7f,52,48,46116,16866,29250,42,39,42341,17558,24783
3d7d55ee07cd0793cdbcd18e7b51caea,119,83,246790,47852,198938,99,86,215459,56511,158948
c1657d1938e657cede76ab11ab0011ab,125,87,563370,155922,407448,193,140,612294,166247,446047
f8855004e4585b0231abeb1924b2d698,156,110,369289,89761,279528,167,131,418276,101916,316360
fc6697a04857cda94121e9409dde822f,164,126,436666,113335,323331,166,117,556871,95171,461700
8e578d1f4734879cee922502b52b31ce,47,41,91641,25815,65826,60,42,86745,31165,55580
84257b63e33ca3a8f329bea8cbc215fa,108,85,195623,64898,130725,98,77,210498,42885,167613
6e616802db4c7b145b031b48ef72a015,56,44,78735,32020,46715,93,58,126816,31935,94881
461b938b002c46e9e266a1a9716bb722,43,33,56008,18402,37606,38,31,41276,19217,22059
8daf2813a3ec533e4ebcffbc1bd9225f,135,115,362000,105141,256859,168,110,388743,75598,313145
f9ea8bb14b2aefdef85a38feb994c5eb,122,84,187409,44084,143325,99,71,167346,37761,129585
a215ba5b11ce0541d25793cf15ea5c5a,130,107,311502,90489,221013,140,116,383257,100370,282887
dabdac84a33354ff1ebbccd02cc9cb02,61,36,88537,10768,77769,51,38,52539,19695,32844
9273c619816a3e383c780b93d710350d,118,83,334062,38886,295176,126,103,321447,60316,261131
d67df5629344c24f69d3db7fc347daab,24,20,7587,5134,2453,26,19,12721,3558,9163
762312c0801190a393cdd040a6002dd7,29,22,26266,6901,19365,28,21,10706,9590,1116
e048ba9e3b731a73b8301dddfad8910f,43,33,29688,17465,12223,47,39,44868,14541,30327
aa227013f8dd26fed56b0b8ca0dd74a1,40,29,64506,12881,51625,41,27,35329,24153,11176
207d38d5d9acb28c300c69455fda14b0,164,132,673438,98146,575292,197,162,741804,131318,610486
159d34cc64a609f37962b717f1f785e9,85,64,124814,25800,99014,92,69,120734,33155,87579
2b6e7d718e246937535107971a50b2b4,91,70,163823,38642,125181,100,87,199082,43438,155644
33e18847b070527d9c4b24fa55493e16,86,69,112741,43046,69695,86,69,197430,31547,165883
e5d7e0c04fc8b0adc42373687e9a498b,127,100,285236,36987,248249,92,77,179314,51002,128312
8c4ef582db54adc7a00e733ac502d1c6,69,48,127545,27932,99613,56,41,97384,33054,64330
71b9808d78166e55073c29b4d339d25e,169,136,534230,121493,412737,168,124,538877,98428,440449
83154d271595f896657ccf1144f4f0be,40,34,33531,20589,12942,49,38,63672,20010,43662
3259262e657ed6b9de888941da927401,28,21,14917,7771,7146,34,24,22773,6453,16320
d089730ed154e40e366a03d1d9a39c12,81,57,108043,21891,86152,57,46,63993,26583,37410
d31fcf9469b6da3d369fac52b1742dc2,6,4,694,480,214,6,8,786,508,278
1ff24852e80718d5932b0ebcd0b2ce10,23,20,4491,1943,2548,23,18,3644,1917,1727
4ef3fc29cf9f6cf02e89b9793eb9b4d0,34,30,28329,14589,13740,29,27,35115,13025,22090
78b296a8e4433d71aa5f62ed26d69195,52,45,60954,19691,41263,61,33,55985,17960,38025
331dcddb1db2eb63f6f2fcd05e9596fc,53,49,65019,16986,48033,76,56,73775,22687,51088
37c00a2b14b38c51abb56db003c85d86,39,30,41101,16849,24252,34,32,47641,13054,34587
800c7da283f8280e55efa579580a372d,88,50,145271,38956,106315,85,60,142746,55248,87498
29cc19e4e1eb4170c77820e1b2c9c557,58,44,71222,16993,54229,90,82,131877,27702,104175
97e735538143adafecedcc9986ec363e,38,28,35403,14218,21185,42,30,44054,15422,28632
5bb2cadc412fe84d8f2ef609a11e4bd7,128,105,397959,129663,268296,168,123,481189,119037,362152
020f371c667dbd7182845120857b7326,170,159,633100,125331,507769,135,109,509382,156007,353375
65286e58c945b6e2ddd70d9462f42500,97,67,126453,44943,81510,76,67,129938,46839,83099
77d8b9c0e8d2cbdf9b3b80f4f7a1d8ae,53,30,63951,19054,44897,76,62,106720,29259,77461
93dca2adfd4aa4561d8a920900608907,0,0,0,0,0,0,0,0,0,0
726b9b3bfe984214ea16a4ae70c81b2c,88,60,121314,27037,94277,87,74,118369,37203,81166
16f0239cea1aac9db4ba6922b836aaf7,21,21,12163,8072,4091,21,16,11669,5488,6181
f49170314adaba31f70e197a5053fa6d,98,87,241268,48230,193038,97,66,136336,51505,84831
e15bb6beeca484138d82d0f68428d913,45,36,49224,18064,31160,39,29,50887,16532,34355
a4a0c23eade09cf58e9aa44d35bab123,31,24,27451,8640,18811,30,26,17299,9228,8071
78dde007295c9ff2ab8e0a1fabf05fea,17,14,8205,1328,6877,20,12,8229,1494,6735
8f5b71e4f59132af2729bfa7550171f0,96,74,210746,42619,168127,84,73,168604,50213,118391
d06adec257bafb3551c5d204a1ab663c,142,101,403112,109028,294084,181,133,796715,105095,691620
9f5a4ad38c4000180ee07f3abaab0abf,134,101,240041,48804,191237,157,139,360059,69679,290380
b19c080321c1ff324fc4e0341f8b47ef,136,115,288414,89150,199264,111,98,190281,70072,120209
90e737a11df85b5d1b90bdad78f5befd,69,50,106657,48505,58152,98,81,220881,37907,182974
039d195ce57c92e26a55f6a60883bc64,126,102,430738,111775,318963,169,140,703505,157177,546328
c2fa07a8c2a3804f32adfcc32a28c23e,23,21,19346,6589,12757,34,27,28133,7611,20522
93f0ce4e54dfeabf377b7bed81dc367f,55,39,46676,18538,28138,44,34,45352,16618,28734
fb8102167c723c3c8b3c20b85c144d7f,155,113,347343,76227,271116,118,87,306798,71882,234916
6ba0f923f774dea111e0135b355193a9,108,91,207681,55328,152353,72,56,131185,63490,67695
6a8c457bd72192a10d9df8c31f9da01e,86,63,147657,36093,111564,97,88,192989,43327,149662
afbc07cecb2c9ebd8efd830f2a173f5b,80,69,146250,44275,101975,77,63,97440,49933,47507
e88cca08bee3eaa0a5830af035a0d33f,109,85,254971,67570,187401,141,128,349761,55849,293912
07363fda2744117ee5adefd9d6943416,77,59,101746,24810,76936,68,44,82945,18155,64790
0814f8bb64263ea6b66f80ab6cda3934,38,34,39982,18501,21481,81,66,101019,20774,80245
635f063f5521a6fdfdd1790e8035bafb,78,62,104767,34104,70663,65,52,98444,27880,70564
4fbaf17ce8fd90720b0a398f69412840,152,113,509589,138303,371286,141,102,473295,142576,330719
43b6d7119cf1acedf13ab70a8b5f5d3e,125,98,379209,101555,277654,183,147,571532,132208,439324
23f6263decb5d00a78c05e6646fc4256,174,114,476908,95206,381702,152,121,391473,100798,290675
d842c2292e3825d0bee5a33005b5b5d1,140,109,384277,54735,329542,98,91,267226,81093,186133
d9b770988f58e17ee0e4cae068322bef,121,82,415287,65054,350233,203,144,573294,75332,497962
4a848339c30a33922b3275dc7f49880e,161,137,443405,85711,357694,132,110,338051,107373,230678
34fc7c47be7f4426558cb10370677e5c,138,94,320126,62985,257141,157,114,442326,87123,355203
2b499d42513ea70f90de218c575eecca,179,140,685163,180128,505035,196,143,762635,143537,619098
8a141f59d29022a44ca0dc8a0f8733d7,22,13,7430,2151,5279,19,13,5167,2460,2707
a5a135ec241658553b06e5ee6fa9b0d7,6,3,1299,749,550,5,4,1051,1023,28
46e9a95223d7d4abb17c42ebd9e05c0e,6,6,1331,485,846,7,6,598,1030,-432
104ac15a0eb4841d46968f71f9154ae4,106,90,227883,62587,165296,83,73,188371,55305,133066
a3296bae25a6c8e254b08c289ff802e6,126,106,306713,64312,242401,106,88,225112,52841,172271
48268d8795bf421e0632b989aa4ecf6b,35,31,38508,18651,19857,36,28,39058,15587,23471
85d9df65d9b53dcb3c9a64f0714ed4f2,42,35,66295,27398,38897,66,52,107050,29667,77383
353a6bb21468cb3b7cd9bd8f358669da,38,43,30557,13699,16858,46,33,38092,13889,24203
6ad558bca2f3cc769f44698e74546261,21,16,7306,2905,4401,23,21,4973,2927,2046
4c33923326a5ae03df391d81b86c108b,81,78,161992,54311,107681,85,68,169647,42360,127287
cbc03509a2bce18975022eac820d9e80,162,106,817522,171719,645803,213,119,1009049,148286,860763
cd44d3cfadb16bcd39719f24b8f32726,43,32,30651,15189,15462,62,44,44397,15336,29061
2ff332ac1658a38e609a2e5e2519f477,80,71,119784,28665,91119,64,43,83955,19763,64192
519a497168b0dec6c36f70129f1235d2,123,83,293447,87515,205932,130,93,268896,93945,174951
a9ce42c6e759193485063a11bf2c0b02,11,11,1390,685,705,17,11,2200,828,1372
a41c0e246108b72aba482791ff73bbbc,57,44,102707,28806,73901,69,41,126748,25815,100933
039729e04c21a2cb4491a841f450c79d,12,11,2579,913,1666,11,11,2318,946,1372
8a60c6ea1bcfbfa4b4464f5c4b35c028,56,42,88899,21864,67035,55,39,68982,28978,40004
2a7031891b0e92cebf72819f590c7331,123,93,359440,97883,261557,145,125,433247,121651,311596
943eaa06fce2d8ca9e2a58ba614bd869,61,49,78052,21725,56327,55,43,66831,24648,42183
6340d7d9f77a95dbb58183e7c8999dad,89,73,202677,40451,162226,96,79,161515,29634,131881
6731b32dc1d25ac73b20feee0e9cd7e7,22,22,4863,3521,1342,19,16,4555,3345,1210
defe2b37fe02cc9a2aec9a9a7763c7d9,27,20,14266,3980,10286,33,33,18932,8917,10015
18a8fc6686f1e4756f0e298f568c8d7f,34,29,31608,14245,17363,36,27,35172,12420,22752
fff2bf0130ff2d5aa6031909ab619705,26,21,9836,4230,5606,26,20,9860,3950,5910
34b039c23b045b44a457f9b168304f16,190,125,700601,117929,582672,196,159,832994,195574,637420
b4446ac1cae0cd431de002e45d5848f5,55,43,56024,18763,37261,52,56,61419,24662,36757
20eef4c8b2e90cf10e2069f1746ee0af,130,99,401518,100641,300877,160,116,437649,93746,343903
239069fffe5519fa70c0c23ab39dcd3d,188,134,774206,168974,605232,200,166,778158,177849,600309
ee3ef397204bbee7e755fb5b50b0d481,139,110,311800,74881,236919,141,97,300749,83889,216860
e1a82b3012a3b1902a5f396c4d48896c,109,84,295118,135627,159491,165,115,519836,85353,434483
2d1d274291d3e2ceb3494504ab4db583,138,98,430011,106542,323469,176,123,492852,104970,387882
46abdee34e7e3022bb4d763746346ad5,107,89,254304,68055,186249,161,124,315301,73049,242252
f3680d57ad8af586fac189a99a5c28d9,129,100,360431,111534,248897,164,129,492193,107350,384843
808a95e35d2c4337b8e9b56f3e991b37,22,21,10464,4278,6186,22,18,7254,3010,4244
58129b2ea6b867d8c7199b1055a0dc0f,92,64,121175,33507,87668,73,66,108435,38466,69969
2866cef8a65e82ea9dc1d7b9a5a6d595,45,30,43535,11035,32500,30,28,29336,16537,12799
9a676e3b677bd4bedcae543ea00851f7,185,146,594056,118764,475292,153,119,472808,96634,376174
c3a0998282081e87af0b9377ce30d72b,109,74,301428,68622,232806,134,97,301566,80564,221002
b96ca0e94e6c2c05d89fba74b53cfb3e,89,70,198377,45161,153216,90,66,129323,47444,81879
9e5a949aad8379bfdb9df30dd0aafd1e,158,118,295634,73459,222175,97,77,243400,82083,161317
da47291fe521a07275795bf58664fdb2,181,117,630027,99469,530558,195,154,572974,116875,456099
8dfa327daa21102a0c42bad51e48e057,12,10,1325,851,474,14,6,2403,716,1687
f9142ba97892d5e518d3c5a48c5f2cb2,16,18,11244,4616,6628,24,16,13103,4077,9026
5aa8624fbc744ede6adc5adb6e1efb0d,109,66,185635,64761,120874,101,83,219570,87642,131928
a3799b57b9f7607c08113f7f6cc66834,35,27,49852,10282,39570,40,27,29775,14177,15598
e06ff158ae0ca00e9d77019f9c033973,70,57,138579,39540,99039,119,102,208968,55269,153699
4c42baa8effe2d9ee149617e6b38c020,49,33,56125,17848,38277,63,47,86423,23856,62567
18ed442f7da0823d11cf73b485eafd8d,34,32,33707,12195,21512,38,28,26129,11526,14603
73c44d9a5539e3b609276e5dfb8b9230,118,108,387798,117144,270654,153,118,405421,96831,308590
61619b9d911b7419d94cd2d6fc3e2375,115,81,294696,78184,216512,120,84,274435,72701,201734
5074edda275d6a8902ae346e490f866b,109,82,233947,69902,164045,101,90,230456,85891,144565
6db6139a0f3072aae84f102bf80fcda8,139,113,405668,123725,281943,160,108,422819,98754,324065
432cf7e137964bf402ae2afeec3c02e8,50,38,30676,13491,17185,41,37,31988,11591,20397
fa95626ef904d872f1950a3f1a1d5ae8,191,146,474585,128488,346097,143,97,411971,79919,332052
45402dffa37300fc3b7bb6806a2e6270,45,35,64546,20042,44504,128,104,239956,39106,200850
532465eb6a5dca84254f930aaff1e5a6,178,136,599704,125845,473859,171,139,562626,100158,462468
32b3a4e6575ab29843d76cb9356be043,129,85,229971,73120,156851,168,125,370228,84366,285862
1326b2a92fee10ae9d0d71c6f748b6aa,50,42,49610,19684,29926,45,37,41796,19443,22353
716545c9e47ebde4d3f6275173b52a25,62,46,104401,26357,78044,45,34,62515,30420,32095
c2fc3ee90513210d0299ed02fc7b5282,12,8,1725,404,1321,11,10,1536,787,749
f8a2cfffcfe658d734d4f4f9e456a5da,94,77,126475,31763,94712,92,90,163958,48910,115048
b065750fa919653bed15aee341975020,67,44,130352,27808,102544,77,60,126294,38417,87877
369731f777baf07143bdf56e24f65ce8,172,128,648848,146165,502683,180,140,701057,170624,530433
91431f4a26bd45bdf190f22830fe09df,223,156,937104,270729,666375,223,146,1015270,184362,830908
e1c575e13e0373b73817b32ad9b819a9,70,50,101145,45281,55864,61,46,102637,31528,71109
174abd35893475a97dfaa4ac909b8645,86,69,128780,19102,109678,70,58,79242,26759,52483
df263506ecbbce685b9686bc3a1c2fe3,14,11,4729,2284,2445,13,12,3799,2619,1180
1fe9370ff3eb947eb1614ac932665334,37,30,35385,18429,16956,37,28,36918,12624,24294
dc496fedb9353a3fdc5a823c31a05bb3,35,28,34355,11680,22675,36,29,33380,11552,21828
ce9154afe5da6234c8489afedaea67cc,105,72,217206,55656,161550,120,75,190364,61933,128431
d3486e51eac252f35bb1244fc09817af,42,31,54729,17212,37517,48,35,50715,19997,30718
a7e96576fc3d5c89fde4d1707953bff6,49,46,51853,24501,27352,74,59,84808,27132,57676
d43ede1d229012cb6b1db9408a735826,24,22,14629,4553,10076,26,26,16298,5579,10719
0a1244c6164c18d7058b78d9ce063353,62,51,100785,22418,78367,52,40,78927,21869,57058
bdf99c8fad064c90ea6f81f36f16248c,44,42,50033,13418,36615,34,29,25446,11108,14338
9a5d00f511ef12b35f87fb1b31a195ee,30,27,14739,4705,10034,29,17,9021,3812,5209
711b1da0e6f6c5e13a194c386e643668,138,106,405350,133037,272313,130,78,400832,88412,312420
70f7a980b2c9d2091c49cdab1ec65032,72,46,101641,35744,65897,70,51,118446,29469,88977
c754c196f8068d3f523cd2f6e053e724,112,84,166506,32456,134050,77,64,110173,36061,74112
6d9716578184a8feaf9196052187b5de,189,122,476353,66408,409945,134,110,344301,78708,265593
dddee145b1cb747eb07c9586c6a8726f,31,27,14383,9622,4761,24,25,17390,8969,8421
90a73da49b12d2661a25625f461432c0,41,33,36907,8203,28704,50,27,50281,6866,43415
f41ffeecce7ead5e7032b59a0ad00c5c,142,108,347899,63888,284011,156,141,408383,85145,323238
6c7f19ef5d959232f6adadf47604c99f,113,91,233894,56803,177091,137,112,413896,50926,362970
04a2546de906404f1a6a8c7f4f5c5412,97,85,178924,58428,120496,85,56,158826,62228,96598
77f6961062abd2f80fbc41f4baf0d560,29,16,16823,4667,12156,27,27,16780,6976,9804
ee273e9780d979bea344e9d88816a37f,37,30,63604,21453,42151,43,33,59858,18981,40877
b8521b8ebb385b3977d4ca549d7e4877,26,30,16489,10744,5745,36,31,22371,7491,14880
cdc5ef2e6d527b8977bfb2abbc76ba85,30,29,35724,11198,24526,29,24,21953,9707,12246
349d1b74d7a45dea4130666dd6dfd83c,234,118,485868,60070,425798,130,92,365833,87335,278498
f650439f4c66142ca125857783bf425c,95,78,157717,30712,127005,84,69,138984,38488,100496
54346ff5ee48d7e2a4b759ac5271540f,175,128,762493,168611,593882,177,126,1096519,158562,937957
c065417cf0e5b450ab1b7564200d9a94,125,85,294841,92940,201901,129,101,464786,79850,384936
e24b321a922a66946b8cbd53103d2555,57,44,65475,17732,47743,58,48,75338,20150,55188
7e168a2a8852baf215f8147f0648f3a8,104,79,183295,53826,129469,98,82,204319,45939,158380
078508e4c2928a37e365f7a2b46b54a0,142,98,275088,77186,197902,115,97,248917,88209,160708
177f61a91f5430b4c9b6297b09f8a1df,127,103,247164,63674,183490,121,101,267487,45523,221964
21a49b4d808daab8294bcac301c8f6e4,71,54,93026,38475,54551,80,64,107045,32595,74450
5ed9de08850bf8fb22e953d18e8cda9d,47,38,49011,18789,30222,64,54,111000,23155,87845
86a311b53bcf5b30f183a3a53716ee15,27,20,16618,3518,13100,25,19,15521,3849,11672
22a8fb934976e4cb808db59e93157baa,102,77,188696,46145,142551,117,75,204487,45807,158680
2fee391389e6aaa2ff53c012803bc6d3,30,22,19076,7417,11659,36,29,22780,6437,16343
cb670513d8d706db356237ad299019ea,75,61,132585,38343,94242,74,65,137012,46390,90622
4e2a29e241e348ee82fd1700746bd12c,111,99,200609,49797,150812,126,91,260909,50713,210196
1b56b50c0852a42a90cbfe1c8ac3b626,34,26,20004,8834,11170,31,23,20592,5643,14949
bcc238c35f34612a92ba4bd34aaf360d,97,83,207430,45912,161518,100,83,168024,49437,118587
b53f89fd12d1b2d6cd42bf00d8e6311f,40,31,34780,9293,25487,51,34,55483,14343,41140
b537df8fd5740754c53169abbbddef45,92,75,219339,69694,149645,112,90,255138,69765,185373
4f4028dbe8895072818dd444c0fb1296,74,58,137428,33915,103513,102,74,124096,31150,92946
ba10bcf3677f5ced6f4db7ef454b3512,101,71,190672,62122,128550,130,108,281219,59923,221296
9dcc099bae137000250156c0f5f1c7c2,95,66,136318,25068,111250,113,86,185708,29883,155825
0da582fcc2ae9a9ab66293df9901e5fa,31,24,23284,15621,7663,45,29,37455,12646,24809
947fdc2bd643892ce3b4492e94abf900,81,63,94626,23684,70942,71,51,88204,20212,67992
41200a54165ab291fb0aea540c8ba7e7,164,124,595493,121586,473907,165,125,595868,141337,454531
5bcce0a6d844d63852b82e7fa6202a5b,115,84,314976,91613,223363,161,113,387506,89935,297571
4425c2bb74ed18173e48732deb4aae4d,169,112,461539,50031,411508,160,101,393222,59308,333914
f0dd522aa0fd94c96b3d2e58c50dad20,110,84,448174,101366,346808,148,119,485900,105524,380376
16f2a6326244ef3b16b7fd3d5f682ff0,150,103,389221,62476,326745,121,105,271871,82467,189404
49c740fac4a89e790d770ff4cc516292,2,2,182,310,-128,2,2,310,182,128
a0503e7b6acd62befb8ca3466e0089e7,4,7,1036,1491,-455,4,3,1261,892,369
811937062033234c4595c193bacb2495,104,90,352747,95949,256798,144,97,312674,105266,207408
42a7b4d9d806b68a4bd3e50303ed7660,41,33,38693,12451,26242,41,26,27722,11949,15773
a92ef5c64cf1f89c59fb001ce1fc7f2f,52,54,56226,20246,35980,59,37,60836,16085,44751
429e11310adbeef774c54d95d68c6392,16,15,4765,1746,3019,18,17,3792,3009,783
2211e3c095ee9e0b39f31f6eed8c123a,185,128,530325,92111,438214,149,132,402288,140274,262014
64e6a913f9dbd61222fb305ae8356f54,77,62,119091,21643,97448,100,90,174581,27660,146921
96349ca135f7ffd73e041dcf8906a3d2,93,86,156801,46140,110661,78,51,160511,27127,133384
8d395c4a7807a15534c7c0d3b9b11ac9,111,91,227541,79963,147578,117,97,248857,67019,181838
12af35eabf76c3fab0b2b45d23dbd6ff,7,4,1523,1058,465,5,8,1106,1571,-465
ff21a03b6f06d44dccfe8b2535c2a491,136,92,251446,68769,182677,136,96,311615,59974,251641
d16794fd87ed1418c212d7398868f795,90,88,190709,72568,118141,111,86,252517,50584,201933
f0c23f67cffff85582dec91d5543090a,79,63,98219,24960,73259,76,54,87495,19897,67598
5d55cc8518dd11edc15ee1ca648b5419,20,18,9302,2962,6340,19,17,9208,3484,5724
edc435ded67b943aa70c07e805722313,174,133,518305,207870,310435,175,115,607611,165287,442324
7ad639321eaa531c3d711f0d41ce69ca,36,34,27672,11364,16308,40,32,19426,11039,8387
0f530bbcf805816ab58624888784db1b,187,126,703420,137549,565871,168,141,679784,153594,526190
369aea1ac362aa8eca4d0ed69e606134,126,79,275577,58546,217031,133,108,254815,86251,168564
6531db2850b78eb49a1e55bb76f842e2,74,54,113030,28560,84470,71,51,83990,31193,52797
0b75da48e3db07702ce637549d6e66cf,61,50,73688,26807,46881,67,40,108223,29890,78333
dd76ac3600780a643d00dc891084aad3,36,29,23111,7361,15750,32,24,18445,5274,13171
3d782f5b4c8f8383f13bc1d6d8af7d4b,50,44,54366,40078,14288,88,73,182133,27725,154408
129a3066400304825d1e264469b2f4a6,91,66,149990,33542,116448,110,97,183264,52789,130475
8fad41af56de29debb64e80a9561cde4,138,99,317927,79519,238408,138,121,360948,85915,275033
5abd275301de70ace1ef288300ba5034,38,29,16565,9783,6782,36,37,32117,10771,21346
0e5e2b7c99afc5d29cfc2c9ee8be9572,82,75,149517,37903,111614,91,67,127079,24289,102790
edfb6d83fc7e450fdf0c6f211cc450b3,26,23,19524,9384,10140,25,20,17143,7511,9632
0e07d1b015fc210725c54282e12bc7b9,102,82,143765,44204,99561,125,113,224695,57176,167519
6621c71db533a43bbd9867015e1fa871,26,22,23802,6922,16880,30,22,25475,8050,17425
979db681860881af2d6336941843ffed,223,180,1001726,254812,746914,167,122,939691,166856,772835
80da3c4a95d86c9f58416a3dddbd80c1,139,103,381892,80474,301418,152,99,336144,91911,244233
6136f8eb68a60fc483d153b259db709f,192,120,467013,80328,386685,136,105,330054,99325,230729
9553e50755c7862635b87ce429faef90,73,60,87636,23622,64014,71,57,90949,27263,63686
1bc09217a5fe77125e78c1c745c4efb8,122,84,198595,62694,135901,101,73,191685,50160,141525
bb5b901b86a37fedc68c0974a2a2bc5d,40,34,27893,13020,14873,40,32,25411,12999,12412
2f19eed37adbdf4edb0dd40a4d07bf7c,154,112,323764,42271,281493,126,102,281548,75491,206057
5051b26539365a51c2076cb69c974a4f,210,114,670474,96219,574255,210,130,495437,112976,382461
b0050c89bc5f89b1d2825bb0dac0ffa5,31,23,28953,9739,19214,28,19,15515,7158,8357
8e8ee7c4f8fcdd6c0e7b97df85da4ae5,187,137,528958,96230,432728,151,113,583265,90342,492923
cdc6643136508f8e4de283ea9dac13c7,144,98,344404,117334,227070,169,139,489653,158456,331197
050b82b2a3adf3dad060fee9153eb1c6,33,28,21692,8552,13140,42,32,32414,7030,25384
41b604632ad5e1e1425adb709c180393,107,79,172076,49632,122444,116,104,180768,61643,119125
f25b0e5fb867da8f984fca038cfd39e4,44,34,65032,19635,45397,46,31,53278,22771,30507
a9c7001f5d0f62e6f779417ed706ff0a,71,61,105683,33322,72361,58,48,74974,30060,44914
bff1f22755dbd35cae0c2e804698dda1,79,63,104135,23266,80869,61,55,82338,20248,62090
52ba8944faa4c9d01edf24692a609c51,173,126,449762,72089,377673,159,133,514801,102370,412431
bcf5a4ad7571ac8540db09fc3b1aa3c1,183,126,495664,112485,383179,196,153,531199,123960,407239
15bd8379cfbf68020b4eff56b8cb3ac3,147,106,352818,103169,249649,148,118,380503,93105,287398
e7886465f6baf7acca94980019f508ad,140,100,479061,133146,345915,129,109,496096,103705,392391
e5ae46ff592676e1b1586169c0bf115c,130,95,419949,99391,320558,143,116,415425,101359,314066
6d401caaae62cbc6f983a3c89ebea74d,187,144,689751,177179,512572,102,77,375673,126436,249237
8b9bb39640e76a0f5ad531735a7da95a,34,23,25131,8493,16638,28,29,29053,8149,20904
1c101ddd1899a8072b55e4787ae691ac,96,83,251546,62544,189002,70,54,218297,69772,148525
63d7ab1f0cac39ed9010dddc22bdc331,35,25,20182,7538,12644,23,22,12986,7382,5604
deb438bc603ccb529a67aa441c97df9d,18,17,9691,3411,6280,22,19,7926,5700,2226
4ede6f679b4c43d483ceb9b49efaa35a,112,98,253414,38596,214818,109,73,216591,43185,173406
7274727ee1e73f25338607a7dcd3dce5,44,32,61015,21170,39845,77,54,90909,18862,72047
117b72f06432d933fd407f29d2e46974,31,28,13790,9278,4512,28,31,21348,10010,11338
4fb01e8f4509caf048da98788c741171,60,40,113863,24420,89443,46,36,58268,29570,28698
8e2487635d6723dd57f2d67234211614,58,43,71902,21818,50084,47,41,49988,24970,25018
4914a0606007221a3b1b7496069f9b02,20,19,12407,5125,7282,24,17,9008,6050,2958
06b146ff04ecd5c623e3fb5b6de323aa,63,55,70312,20658,49654,50,37,56725,16218,40507
aca0db37847754b56c16a315bbb72259,33,27,23385,12070,11315,31,26,29678,11940,17738
b388d1c044aa198b4973e17a7cbcc570,39,23,56604,13151,43453,56,43,95351,26184,69167
0577ef20060bfab3800a146f865a4b52,58,41,106522,26450,80072,59,47,88781,34207,54574
5ed676be5937c7c7a0bdb1a8f7044471,120,101,341869,102292,239577,118,79,284202,79759,204443
e794aece474887283effc64c043cfb40,99,76,157876,30014,127862,84,75,115750,26469,89281
5d2a0b248f8227e8cd56ff6e698b5cf8,125,90,213408,57731,155677,132,107,255078,44668,210410
6d309da29b985fe5822bdb918bfcf12d,105,51,143147,30570,112577,102,71,168184,42774,125410
4c5caba7e9971bf2fe29f533060d7feb,67,56,96262,25619,70643,65,46,95770,21596,74174
dcd4fc1fc7c2feabadac1762f13bd6d7,130,97,355252,72480,282772,150,129,482954,98084,384870
73ab9e5111a0212cc391cd06b304d8b6,144,126,495568,113543,382025,91,76,322508,89126,233382
559703c43d02648fdd655c2811796390,60,50,96269,40528,55741,67,50,113948,29986,83962
243161868ac287e54be27cce043202d6,83,65,154873,61810,93063,123,117,309326,73128,236198
540a937519bd7a81c4986ab759e3d884,134,90,357838,101772,256066,89,65,252119,110382,141737
6f12acd6e85a6d03fea7c167a4a6f14a,20,17,5925,2063,3862,20,17,6634,2190,4444
351564d2fe692b6b36b9361250186515,134,107,471142,80414,390728,93,92,291207,107265,183942
b5045aceabd0cf97e2ec772319843e6a,114,90,374892,91513,283379,100,79,290438,99872,190566
b09541636f4e70bc1d17b53ae1a7ed7f,142,107,514649,139442,375207,182,161,636061,151266,484795
337bb2ab0b35d844a96d1ac0ba862dfa,154,108,376152,91372,284780,199,149,605239,132586,472653
5d8a8598bfb950a26cd0ecc6dfb8092f,52,46,59955,25526,34429,47,39,49183,21776,27407
69d038d256cec6f89dc19eb313243ac5,139,101,526724,81821,444903,181,135,505963,70592,435371
cf3d3574e2405312300694c55ad911ac,28,25,24822,8812,16010,28,23,24998,11378,13620
06501b51a2eca46cd3832619ccf1eb1a,33,26,24094,13232,10862,35,27,24001,10725,13276
560407a074c51e0dcd59de0594613e2f,80,69,172141,52335,119806,142,85,244194,54876,189318
07fa8947ef3620e50975025eed140c77,46,33,54023,16783,37240,37,31,41617,20841,20776
40aafdffa309cc9b6997ac35c559eff8,67,50,113498,28648,84850,52,44,76964,35295,41669
dc04428a996ce08bf8b59e4baf910a19,86,66,176744,37598,139146,77,71,146281,46790,99491
63a1de3ed6b26b260aeeb09217ec6e0a,143,116,426191,124661,301530,184,139,522670,112158,410512
ad44d9995439439af67737df71e7a524,29,23,16948,7096,9852,28,26,15403,6105,9298
af8e28e40c40613e20bbc5ce9fa5e5a8,124,95,292719,65293,227426,109,76,190612,87360,103252
3318fde7eb9c8179a27a3f4282139b95,190,129,578502,120681,457821,195,131,570557,120373,450184
af33971a76c59b8c33399ce031a272b9,48,40,49316,26273,23043,38,32,58427,19918,38509
5bd6d34c55dacb6207f70f827fa2d43f,162,138,523253,82454,440799,155,129,435998,98228,337770
478b4d911f394d071401a950e25282ee,111,80,198354,53429,144925,111,89,231745,35443,196302
f476de17a3bf33a69464528c11677212,7,7,1461,844,617,6,7,764,1461,-697
275fe0000c7e97b5099545ecd720ff74,131,94,348864,86846,262018,137,103,310036,85371,224665
e6533482acf0f60d17f37f67e7920c06,169,113,450069,65207,384862,174,121,579907,61267,518640
8324f1faa30a90e5251fc2bf366ba80e,26,22,7940,5073,2867,29,23,12793,4049,8744
6a18415ded38b153cd67ea7f3712b6af,68,49,92171,28672,63499,57,53,83811,29409,54402
bb5939bcb975887d4f3479895ef7394d,89,73,138600,52545,86055,81,64,116017,32330,83687
a153eef44298b60b6b8ebac1eaa14369,32,34,37017,18565,18452,40,31,33271,15558,17713
78718c89591b5fa875374b80a471e986,66,57,96984,32761,64223,74,55,102138,24025,78113
33665ab787ba631833628945e5f7a16b,111,86,225693,58238,167455,144,108,405322,47642,357680
a548c7e622680b698a7bd8f469b396cc,118,102,364067,60989,303078,147,122,430711,74738,355973
94da407d18b62ddbb5dab2901d2ab25e,120,94,281888,46430,235458,140,116,305896,37999,267897
c6dbd2e622a7390e7487d3fcac475981,34,22,38176,12821,25355,50,34,50807,15828,34979
b527fd0bf3b688603ad6d9e18c432ae4,21,17,8741,5847,2894,26,20,9968,5191,4777
416105daa21c62389254b7639098e144,124,90,301698,79324,222374,132,98,328309,83918,244391
8c9398d8432cdee31e3a6972871d7865,120,97,293079,95427,197652,155,116,440857,104066,336791
069fd86a2f06ee3a69841aef5cb32810,27,23,9941,6681,3260,37,23,17805,5178,12627
22767f2871c51048ed7737b858d6ca0e,170,122,736224,143433,592791,174,156,696364,186093,510271
44f493d2ea6372855aa3edd0ee31c528,33,26,18264,7903,10361,39,30,23408,7657,15751
fe84a5bacfe864357389eb4898bba47b,17,15,4601,3712,889,18,16,4812,3205,1607
0960941555f4331fd5d5b44af4ba69b9,23,19,11888,4076,7812,24,16,14973,3925,11048
0fde7eb33c1f6f10dd600f1a7d3cdffa,22,19,9469,3234,6235,15,15,3253,2714,539
18e27789dc67fb53d47301f85d13df28,42,37,32139,13844,18295,42,27,37534,9203,28331
35a0e0c193f6baafa9f56473329b1997,94,78,155512,32714,122798,115,80,201798,44010,157788
2a2ae536275983ee75eb2907512ad85a,108,84,194300,45237,149063,94,67,125212,45830,79382
0d38792ea0e601e9bd8b9fb9aa422e62,88,59,104163,31819,72344,77,55,86938,33861,53077
b75abc36fd905adb130b520a3ebbf9c1,126,83,293261,58616,234645,129,108,299647,60638,239009
8d1f24a1505cd242efe84d7fb29e0afd,85,64,154728,29866,124862,81,70,177004,39014,137990
259c5ae5c0633fe30879f59423bacb77,18,17,4806,3452,1354,16,17,4870,2928,1942
ca0a37984840e3adc94dd3f3c1ce730a,58,42,113743,20265,93478,40,33,49216,23906,25310
2bd6638b459c15a37ea80196959f46c1,32,26,27821,16564,11257,35,28,46337,11557,34780
913492ab276670a24e8dd055490e146f,49,44,83060,34534,48526,56,42,104841,26828,78013
8a6392687867d8f920708f0ddfd1a200,134,112,356070,92275,263795,136,101,396410,71487,324923
3664cc521e3b85c40850ea6827163908,19,15,4843,3267,1576,16,14,3694,1257,2437
7f4b07551a7f5405e1a3107dd2d07f20,73,57,130502,26785,103717,89,70,109287,31198,78089
9a9daabe50f31683061d73f1d69888b5,138,90,334546,71870,262676,126,102,328299,79791,248508
a4df2000867140cb88a672992a13bc29,50,41,42750,20842,21908,42,37,42656,16798,25858
7345ce4ccf660cc7c5f9a11734aaa4fd,49,44,76277,30945,45332,63,56,89083,30660,58423
4efb3216cb25173a3a8400387e2d1428,137,99,391612,68833,322779,114,89,214750,62512,152238
27779628cabb172e23af0f7546af59bc,34,29,27897,11566,16331,33,27,30745,11431,19314
d9a22355ccd349b5708a04cade6e2e4c,123,103,282008,59182,222826,92,72,194859,37008,157851
2164197fd3d697c560d2f556abef3187,140,122,466222,85616,380606,136,99,386356,99138,287218
e27e2ef24c14a903d782c4920d2974a7,102,69,166209,39725,126484,102,79,168756,52118,116638
102267a561a601481c6ebf7bdf9cae20,36,30,26039,10270,15769,36,33,30777,12585,18192
c7ce0a8265772a57f32b3fe706387512,30,20,10472,3768,6704,27,22,10029,3535,6494
1072385b7fb7b1a40be7374fcba711a4,101,98,160672,40885,119787,74,63,121906,39642,82264
c5781b2cf21a5a116118787d72e57686,89,73,106585,28062,78523,82,68,121937,26319,95618
7a23c6557ff68781da7f6934f8c8c781,55,37,55222,16526,38696,50,32,49610,12437,37173
bbae3c66bea50f8e632b85831807d479,136,102,498413,128248,370165,189,148,941780,164264,777516
afb0503c3527bcc6b22f0c9985bcdd3b,68,49,139015,21827,117188,67,54,98423,37654,60769
9c1e10778f4e07dc74a7fef159f34df7,171,113,529861,96829,433032,146,116,444871,139821,305050
9ae86d9002da1a20b874b9f1339e6326,21,18,10954,5541,5413,24,21,8206,6714,1492
608f66e35f2d29696f27cc2f792a6dbf,134,97,326986,60973,266013,88,62,192940,94998,97942
84e44af23e065d402147140b779ea3e6,126,104,269419,39509,229910,81,61,123789,34499,89290
a503d795d398947da0f26c5e0664986b,145,104,296985,71184,225801,141,116,416802,99276,317526
daa7876c447cab94212b5a79f510071b,50,38,43573,13147,30426,51,31,44184,14857,29327
e5cfddbb6c04f69598a076473dc74e9e,129,105,262680,63932,198748,144,104,280546,66717,213829
32ef7599eece3e0fe444e4727e82ebb6,43,28,40098,12274,27824,44,28,28976,15871,13105
9c8218492503436bd189c419f429484d,204,119,673007,109167,563840,179,89,603701,90812,512889
b319a02b6676508784df1e0565ab4d59,98,70,187873,50300,137573,126,105,209485,60234,149251
73e68d775aa8551f3fc4a4f67cc867a9,31,20,16497,5513,10984,30,27,15149,6680,8469
a237c6ae4948af6174e9b2e086b5663d,1,1,48,252,-204,1,1,252,48,204
cc4179c86fb40ad2b48cd154c93f9f4f,141,97,376454,66799,309655,131,100,319963,87808,232155
0bb0752b3dc9262b183af473bee352db,76,67,86179,28713,57466,82,48,133779,37342,96437
0e5366bc84bb02eb472c92398c2b0442,189,140,679471,160487,518984,196,139,938226,228524,709702
cdc8001a88741a92069fea3a29955720,49,40,63630,25428,38202,71,53,97263,24661,72602
7c658922856ded5c04d4bc0747feb2df,127,85,254168,77054,177114,150,110,402159,72749,329410
929f51ffe33c70d908972cf4415d83e2,79,58,127320,28068,99252,66,51,100547,23526,77021
9dcf4bfc4c71e45fac42e0d3a85d15e8,20,24,6267,2271,3996,27,15,4989,1249,3740
58c2a0ddf7126312d42b6f67f74f7412,195,156,744981,103948,641033,139,100,479882,80694,399188
8416b5a2e86524342f710c46f4aa5280,23,19,11470,5591,5879,23,22,9676,4366,5310
dee275cbeb6bb62f6a194bc559f74674,126,83,229021,47084,181937,117,94,239745,44483,195262
a9569414eba95117856550810effb6bb,91,66,112055,19944,92111,72,65,69104,21073,48031
cfba4c2a7a74baa6f4b4c68411644b7d,41,32,44381,12495,31886,28,20,16975,11653,5322
4c03f1e1f5e6cccbb34a8d7cb7df8c4b,192,156,1104384,167366,937018,195,154,943361,206494,736867
1e2b91ef545b6ff6d7a154b59ad9be24,138,120,539185,129880,409305,191,153,613789,134848,478941
584f37b1f49824d2e3edc5b8b32e3205,108,76,242699,50765,191934,99,77,199578,64163,135415
65d138b91cf48b9d7cca5bfc3f51f502,125,94,331319,76965,254354,96,77,166339,82498,83841
ace7ee34351f651924e479661949aedf,2,5,252,639,-387,6,3,815,428,387
f43a790112cc3d6f3e9da502c1c878ba,138,112,291408,62366,229042,121,93,250851,68308,182543
2d85ec0b05079fb1aa639f0af9645fe0,11,7,2131,1260,871,7,6,1890,1185,705
ce9c6dea32ac8bca12d578da963ea827,170,129,623293,173692,449601,202,135,591938,150400,441538
8d43ee1cc7bc2df48bb339607fcca9b3,102,82,192275,61146,131129,124,84,172970,61973,110997
c1039cc4ef8bd85750cd6becdd169091,102,86,306109,90957,215152,112,77,249184,82992,166192
58ced1ca68ecaaaccd8e62ce704066f3,18,19,3035,2047,988,19,13,3952,1443,2509
2a03a732f92c14a34b5dfbe31a46284f,163,98,291494,50951,240543,128,99,262123,56480,205643
de5bf1b80648086be0ef3087ee037394,41,37,44090,26836,17254,56,41,76904,18717,58187
e1ff44816a3fb47d920f726216e711b3,27,18,14187,5589,8598,27,28,11337,8200,3137
7f37d0aec58dba28fc4e436cb18cb1e9,18,15,5313,3858,1455,24,18,10488,3383,7105
b37ca56e6084b49ffb0b14ec747200f5,144,95,480978,85646,395332,113,98,322278,125690,196588
4e5a4f761b11cd4c9842c7b4822f9a4f,20,19,5010,2464,2546,25,17,5417,2728,2689
44c8ca7106e35e4656637fe29f07d817,63,43,40902,18919,21983,57,37,50424,16320,34104
3fd8fae8708ca3db4705fe4c987d93c1,96,78,171188,42756,128432,108,90,226650,42336,184314
5fed957e1ded32edd6239d5a72b224b6,85,62,101649,26283,75366,93,84,138765,34023,104742
38ce17645ac734338b906c8e004c388f,86,75,181034,58179,122855,105,89,216417,62629,153788
33f00a53d3f9e3b85f77f2263fa9aeec,44,31,36708,7433,29275,42,41,34808,14177,20631
1b195d8b573141312861492980ecb3f6,18,14,5745,1975,3770,19,15,4403,2028,2375
7771323036a0d56f96ae5bbdd86d5b44,126,105,263141,45794,217347,107,83,188096,38263,149833
f0743d1798a9a01ee0b2b4e9408d355b,76,56,130478,35599,94879,94,75,137383,56569,80814
afaca0df062f8cbabe93325c90dc50aa,151,121,491063,164211,326852,147,106,385838,106251,279587
8d66f3b267d0a5936d4045339441c292,34,27,36441,19619,16822,32,22,46280,16333,29947
cb122de613ab989a53c009b4bead720e,20,12,6755,1596,5159,16,9,3202,1525,1677
33870d81f4874acba3547e4ef457f4ec,84,75,137608,27441,110167,81,66,132455,19538,112917
1f41bb01ad12ececc36aaf14fdff905d,152,122,266795,53436,213359,99,82,199082,51198,147884
559f63bf5af281b12e2f713b7fe20957,52,39,65216,16657,48559,49,41,50662,22929,27733
53acfc35a230a4ff9b926e80dcea56fb,133,101,328381,83761,244620,147,106,381686,106117,275569
f9ed4d7c75cc7734b93feac1fd09fe68,184,136,531341,77623,453718,161,134,505932,93099,412833
1cff752400bca5ca9cd099af4daf2c83,77,59,128279,30279,98000,74,48,119502,25183,94319
3e2196d141fd017c51aebffa0c9f050f,66,54,69256,22879,46377,47,33,69058,19016,50042
1fa1421f5cb1b295096c48b86d2d33bf,187,132,527697,85309,442388,169,142,434444,125480,308964
bfddc76859931f6794f3b3f46e0bd552,5,5,455,465,-10,8,3,635,215,420
1284c4ff191bae0b033f49df327acf6f,93,70,174804,45469,129335,104,92,178087,49646,128441
210d63136e951c1c0e5b208a69327b19,81,67,127389,43965,83424,75,59,159108,31403,127705
5961db22842cc89857d183e65441333c,34,28,33724,11288,22436,30,25,32490,14373,18117
39d2b916d4b75c2a50cd89a1f7671358,52,40,75299,27594,47705,56,43,92782,27644,65138
3f31a869dca3ba51e03e72cfda8c6637,91,66,169253,48164,121089,117,88,186027,50220,135807
e3879ee865e306b631cff3c019375492,17,18,5939,6460,-521,22,19,12253,4711,7542
4cdc77b671e06e3877263f8ef0f1d6db,77,53,185338,26153,159185,59,41,86567,38460,48107
0a52bb00b1c7db914063b750a475ffca,30,22,17370,6838,10532,27,25,20816,8563,12253
ee5c254b1c662403cfc86028acb4a121,102,89,175249,61569,113680,82,61,132829,44193,88636
5f9e8dfb658d3e13081062178cc4b725,47,36,52274,19094,33180,53,31,49310,14609,34701
f6eee5ac8adfbd3a172911cf46fe55ef,150,85,268831,95554,173277,111,85,239486,63168,176318
957be694e83ebb7a507492c2fa49c65d,51,36,48965,12622,36343,35,23,38997,13247,25750
82d6e9f4e72dbac7e5fc1a5d89ead320,17,10,3322,604,2718,16,17,6883,1568,5315
148bf1a9dee4a374326ea6fc0534eed2,15,12,2283,619,1664,15,8,1582,1278,304
a73b6952ffaa2cabdffbb00a01270e15,63,43,80599,18543,62056,52,40,45641,25386,20255
535c1f8c85f78ca9063c6b75feeaf0f9,70,57,229492,74399,155093,130,86,239838,63147,176691
f3682f1604ab0830d112c3e33074f270,202,139,1108396,170833,937563,197,139,798675,212822,585853
6d08e6844a75a061e567017701eb9f1f,90,56,150017,36280,113737,75,54,153067,38298,114769
53a866eca762860bc6da6ec274f592df,66,53,147099,59087,88012,115,94,254286,75876,178410
448908692aaef16efdb7764ebcc7d1db,60,41,78595,16340,62255,56,51,55042,23776,31266
59737eed5ff126e90ff3d4b786845ddf,125,96,348625,95233,253392,136,117,414655,69113,345542
d95ced14e88ef7e2ae38f6865f11ca24,222,149,1075646,164052,911594,208,145,908042,195829,712213
0861c769adea692aa6cb192a7e1192dd,152,102,297675,88248,209427,111,57,279851,72135,207716
bac3ff6a333db87494c0115ed8a4391a,138,107,332246,92843,239403,112,99,249468,76584,172884
17d404a72d249e684cf3d8ef7823b2da,115,96,251686,59433,192253,129,133,321175,70271,250904
68922bfb43245102f635310e50a7560a,149,101,307129,34259,272870,134,90,231012,70090,160922
3a223d0934af63d8a8e497e89be39e93,208,153,942693,129009,813684,201,125,770048,159135,610913
38c8d6c04c752916c5fb35a525780956,129,105,285154,83937,201217,171,133,537940,81095,456845
0827c168d77b74720cbe5b7c55b428b4,19,15,3383,1441,1942,22,12,2931,716,2215
5186e2debca796327eea58aaab2fc393,117,88,223073,51809,171264,81,61,139040,43962,95078
b2a9bc97b82a81b721d264fd0ffb7f81,221,165,764680,103129,661551,185,143,595650,121393,474257
8ab4277e5801c7320a966ae3ccc6e498,189,146,1106980,220117,886863,221,179,1211322,212483,998839
5dff9e5c59061108ed8aa87fea11ca95,59,54,120678,27223,93455,55,46,89550,40896,48654
89778884074860deac8a890772d158ed,83,69,140293,34556,105737,61,57,72535,34348,38187
19fb30d9dee4d5b9e6cfa7be76c31f97,63,52,65532,38522,27010,66,54,87159,30508,56651
2b332954e41695fba0cda57b95e4022f,47,31,31932,18252,13680,44,36,46018,15381,30637
c2a3b0058346b2e089225109a037190c,9,8,1006,758,248,11,5,1201,253,948
e2a8ab20255aae8ebeae17af40d6be9f,26,18,6176,3275,2901,26,19,8549,3604,4945
8e929bf54cf82e9648059ea87ec85b3b,82,67,122976,32295,90681,87,75,118761,41955,76806
1cf97a9438b21f7844fb13d57bdcd420,27,21,15833,5633,10200,30,20,13055,6707,6348
e628421a741b6bae0a6fd9ea6ea8529e,76,55,120964,40505,80459,85,67,117037,30689,86348
83f285f8d8c4d345ed4bba16d18284d9,124,105,338636,89621,249015,138,95,346350,79649,266701
c64cd3fe912885d62ecc8d72573a58d0,68,52,125809,35095,90714,49,45,81187,39193,41994
3a49352106768f246bf1ba370b42d156,132,74,196395,57231,139164,126,92,256718,48064,208654
afc605212b93556c8e21452f57d53b83,137,101,371801,69656,302145,176,141,507251,92571,414680
2e8ead9e15ddcbddbc07cbaef5300e60,47,38,52567,15517,37050,39,34,23268,17555,5713
eeae50a1f2545e3bd326af364021dc94,116,87,249424,60901,188523,100,76,221106,45072,176034
c3c7190a7fb985b97ef7fcb53aa158c0,112,86,155202,50677,104525,120,75,199501,33610,165891
6ffbf9ff845a44f2adf3fa77057926f8,19,16,3313,1977,1336,18,15,3383,2081,1302
f998bce562679c640bceda4ed45b87fc,108,75,276656,71259,205397,119,91,326126,99097,227029
7cf88988355bc39e52cef69870fcb659,31,22,18573,8377,10196,33,29,30720,11317,19403
c97d40f4cbebdd987126eb177e00d981,104,94,211583,79655,131928,147,126,349403,58177,291226
483fc48769610c626fe4e5379afcdd79,71,57,106043,48843,57200,90,64,144884,42041,102843
8d5c5ade93103c18ad24eda122ff194e,167,130,531161,144677,386484,138,123,927011,198697,728314
5e5d1f04edc9172a3f3d9fb129a197d9,27,31,17473,7625,9848,30,20,15249,5574,9675
1c92d5cfe94a73722adce53148fc347d,26,18,8941,3681,5260,24,17,9292,3679,5613
80d54afb3bc183ccea070459dbd3a150,24,22,11444,3551,7893,25,19,7113,3957,3156
f3e03680fd28c6821d60ae91f7bcc760,175,141,557366,90203,467163,174,136,437591,138130,299461
ce512250a965640d53826fa026b06ccd,131,116,292812,65226,227586,119,89,207700,55774,151926
1365deda8352c25d62139215937cacae,119,96,354165,95622,258543,138,105,391319,96729,294590
2dcd4f1b0a1c6cab94b2c1c60905d0e4,41,26,41530,15895,25635,70,45,82618,13836,68782
fa8a58df114af6f4b342484383eb2ebf,137,103,393317,101084,292233,123,87,330790,93391,237399
fded8dfb65bd6450c4a47efb903d67a7,46,35,49435,17272,32163,70,48,79018,19507,59511
412f4a1bf4a60fddd29c38e665037b00,14,8,2423,772,1651,15,14,2617,1874,743
0e3b13fc25d2ea22a4b25e69d82b1ed9,61,40,84258,18515,65743,55,35,78700,23062,55638
234b4eab4f7ffe9f65eda41c910f869d,150,104,322469,73815,248654,136,93,288684,86774,201910
1cf981ec57d2cb625dcb051d9cdc624d,110,84,302017,52338,249679,115,85,212141,69534,142607
20d7f41c7c8102b873454db521b6d442,121,97,261420,81996,179424,143,93,309168,72494,236674
64ffc3bbc20041ead765e49b11e958fc,85,71,123974,33315,90659,67,52,115143,30222,84921
8d9fa8a3fb03622b6850224fd01bb74a,105,65,186160,41473,144687,123,99,248366,48650,199716
73487e2697f6f4de8c71b81c88f00b6e,53,33,66855,23997,42858,59,45,96788,25878,70910
9930d848073959227d8d1f6f787fb34b,134,97,396304,105189,291115,178,123,519467,81107,438360
f959534b68b118366d5d7ff149def70b,126,94,204395,39168,165227,129,107,226524,43319,183205
2eeeca0c8dd0c09e01781a1dc6070db7,58,43,105646,31877,73769,78,61,96645,31254,65391
b5d533c85cec0c6deddd710f174acefa,40,31,29786,13572,16214,43,35,41731,14361,27370
0affabbeaf50e9c38c76f1115e88745f,103,76,195015,43762,151253,110,89,168844,55319,113525
fdfb34362aeb37d0879de8cf00be986f,130,85,358361,47681,310680,133,107,280543,70303,210240
141241f2cd2315ae3a6b3f25f142a20d,36,26,49230,17559,31671,91,79,167666,32514,135152
78b51c367042309a776e0b5f519a48b8,157,108,588021,93637,494384,219,150,766404,104047,662357
f8c00bc02cd96e2ddf3297bcf0eef3ee,76,64,132211,28468,103743,57,44,63479,27672,35807
e486b964fbb1b19865864852e565fdc9,194,140,525785,99185,426600,127,86,405711,77196,328515
17e6cb655a9e363d7a684b4408fb4a49,108,66,159969,37627,122342,60,48,116692,38939,77753
18217095cb84a04ca31ebc849515629e,60,40,79440,18450,60990,60,54,67287,25821,41466
c2a8b64dfbba281b84146c7d0c07d791,68,54,63102,20939,42163,53,44,67844,24529,43315
36622150c429a7965d89d2f27505529d,145,100,311042,53719,257323,91,74,164097,73803,90294
293bc1447f13f3cef5e43ff1eccb76e1,212,145,1397331,162454,1234877,156,117,774853,146556,628297
d6b0a0a9e1af8f33e3c9149dfd9ce7d6,71,66,89353,29150,60203,55,36,81648,20465,61183
b51a290324882ca610c802611eb39cc4,39,32,34982,18715,16267,62,48,63445,19339,44106
5c2890b20b8d27ecf1f46c71f737a86c,84,61,120659,30831,89828,85,58,118406,33328,85078
1d22031867a0f43f1c7a2fb857ab2442,89,72,187625,40003,147622,89,69,171514,41932,129582
16bef7b2fe4ed132bc472ece890b262c,165,121,378226,94530,283696,143,98,342304,100179,242125
3ea48d267078e6e8ed78376ace179493,188,134,1034668,112528,922140,151,124,687071,95704,591367
e164346a32b8d2cb9b42477c9720cc99,78,65,104680,48243,56437,111,96,182177,46879,135298
6ea1fe01eaf92003b27fd77b48f87496,44,34,70972,10062,60910,38,33,30326,15368,14958
be38082623120212cbe9de92cf9e74a9,54,49,75021,31408,43613,56,42,84922,20228,64694
7bfe5de576b5a5a064a6e2d50a95589a,113,67,198525,49099,149426,150,94,243065,68509,174556
aeba00219b4ba7e94d82ccdd225255a5,144,113,361357,69543,291814,128,99,275566,68627,206939
de2db2ccfdfbf66c3a5f6239f9df5557,93,70,216708,56924,159784,100,79,200692,52561,148131
36e241af6cae9a2b85ce364349d710f5,166,115,419208,147507,271701,191,125,538681,126767,411914
2e62db8fc6d40f27079f144ac216e845,114,88,302422,40211,262211,109,96,192167,68232,123935
936f9e7fc1fa495776751d7112fba1db,143,118,433086,116499,316587,160,118,445148,73614,371534
d592870bb8c8d6a1124ecf1e42211619,23,21,13028,5319,7709,24,18,12962,3817,9145
6fa563b44a12b24e87ced115d2d0eb8a,85,67,150915,44958,105957,94,71,168167,50402,117765
021dee01bb713529a8b181a91ca855d3,133,97,442606,65090,377516,122,111,392167,82798,309369
df96b432b5e1e49b4c8fe9c86f17d911,61,44,120968,19394,101574,55,39,70724,16637,54087
68157129b66388206600f5a00eab4131,104,93,172276,52473,119803,88,74,219373,47868,171505
695579e096a5cf8e532eb2d417197eba,39,27,30489,9292,21197,30,29,16619,11843,4776
38d4f390d4dd7d404927251cd06f783b,90,57,116347,35561,80786,81,68,104960,42042,62918
0736098bc683c719ad1b5bd49bf5f28a,201,150,560471,82876,477595,129,104,301428,85030,216398
a4a81a04a93b99f434e173bc75bc481c,74,62,121004,37342,83662,57,41,65945,29597,36348
cba56e077a2fe3b990ad8f301f56b1b2,47,28,68680,14727,53953,53,56,71965,27364,44601
a8c651632959237d6abcc731b66edcae,9,7,1827,882,945,7,6,1190,1288,-98
9b2001e0b286851904705377d97bb114,165,120,498362,96651,401711,181,135,587062,93642,493420
f01e754fad4b017246af9995f8c9fc08,51,42,45750,24905,20845,63,44,80497,15316,65181
88d93c972d15a2cf99340d3dd624863e,152,93,302633,42094,260539,142,101,239853,62198,177655
7842412805a3a6cc0b4a226c2f474fa6,100,83,238271,49753,188518,107,86,198934,73368,125566
ccb4652edb22d8ff4d48db5ea68f5c52,30,22,15834,7814,8020,26,24,20935,8711,12224
367fea7e422d44c10337ae92d9cf0b15,115,83,210464,37952,172512,123,100,226440,43242,183198
adf5d33d6235cf7e89d33ef1d8ef4bae,168,145,434953,88349,346604,149,104,362127,81798,280329
97c7ce320bd55f6fd14c3e9167e3c94e,22,21,8044,3725,4319,26,21,8613,5243,3370
0a00525948757b1ce9802f77a79e931a,52,44,84715,28848,55867,75,54,112786,27092,85694
679a619941d15d87ad67e48d858bb08a,136,107,292786,61080,231706,78,60,183107,66732,116375
72d4b0db99836d7408f62ae12551ba72,205,154,1020389,237950,782439,215,171,1350938,223065,1127873
37d88701f82548ee641e845cbd8c0ef0,188,135,749704,145877,603827,185,142,674099,183275,490824
56bc9c81f444cebccd935b1b2c3646a2,74,49,128294,30009,98285,76,62,94675,34790,59885
4325705b7966fecabbe55389fb3755fb,131,104,257078,36718,220360,120,101,191551,34471,157080
1048f093ab1a193651723864a703a03a,183,146,527831,118687,409144,162,120,395114,84626,310488
028656316a9ca5215227aeb00eb99ab2,110,81,232036,70719,161317,94,76,220607,45458,175149
d033c3f37fcfaa17c37f7dca96646f47,147,118,250582,39347,211235,135,111,242485,39196,203289
da19378ab475fa7e0cb37e46600cb085,177,127,574383,79501,494882,139,111,454256,92289,361967
484d7e0571456d4504e7ff45bf16ff9d,183,115,1135462,139799,995663,199,143,1006418,167380,839038
8412728458279538c31740b6c837d9cc,42,31,28250,16938,11312,45,33,46585,12321,34264
de2df4e9fe2e3cf10c22070b84c0c272,119,99,204308,61316,142992,126,105,322270,55601,266669
1ba23c061274ddf2a4094eb9d107bae5,49,37,62652,20995,41657,67,42,76818,17883,58935
8c49db28a5678c9b76941a07ddf6a663,138,77,442976,83901,359075,184,119,474924,67332,407592
0c5771f004b77e9864a4f6e53c691e78,130,91,276937,64322,212615,140,114,407113,58625,348488
7e972d6dc0ca8b616fee992ad023231c,88,64,180460,28921,151539,93,78,122989,33058,89931
b886e890c8475cb04931d8164ade66e8,37,28,34277,8292,25985,45,33,42714,6001,36713
cd4f13004c36f665d7a47ebf0cf3c401,124,84,266051,91560,174491,85,79,190081,60387,129694
30ef6aaa374efd22ad6a0f620f18bebe,159,97,421541,107773,313768,131,108,399052,166153,232899
6ff232bc0eb6d78abe20c076506426ec,89,72,158606,33383,125223,93,64,144147,29918,114229
93b5a4931b1beb7b22268ac0148ae6cc,163,127,389897,53497,336400,145,126,380758,46348,334410
bfef8838d0ada3514c8bfa3827a8e95c,34,34,31032,16695,14337,43,34,47568,13162,34406
7d541c429dfa41c4d9e8f437a595266e,125,84,223809,43273,180536,119,100,239353,48564,190789
df651c9e0feab7f7d424f35b17c21006,17,17,4234,1372,2862,17,13,4052,1745,2307
a380dfb841c0c59036648f167acbd919,55,47,58254,17078,41176,41,34,47729,20747,26982
1410b96f424de0bb75beb9ce1562f926,107,93,300699,69039,231660,101,87,179768,46105,133663
34ad4288f9b17409a8a21e234964cc15,68,42,50481,21670,28811,55,43,53629,24333,29296
bf34c95973806c40310712f06cc71a14,63,40,92001,32385,59616,79,58,101484,27297,74187
03a5571950ab160fe7de358cb646e9f5,48,41,53383,20665,32718,40,31,45886,18911,26975
24d124dbe01d07bf7132a384945c99b2,109,89,215790,64593,151197,140,109,337364,73355,264009
c8a23257827b4c7530f3b14a436b2788,34,30,50410,15808,34602,35,23,38837,13076,25761
bd33d0ff67ee2ce89591c592606379ff,62,50,76708,24437,52271,47,42,69475,28609,40866
5a9524c00aef25fe6c618233892587bb,147,121,337277,56366,280911,136,115,278249,83223,195026
2e1663dbc71314998b378c0707feca54,67,48,94866,23085,71781,54,37,74231,17589,56642
0a10255c00bf2b51fcf9f0085a9e7512,37,23,33207,5963,27244,28,23,19084,7179,11905
defab66ef6a8e397758b03eba978777c,41,32,33718,15333,18385,43,36,45926,17253,28673
c1bdb65bf430076ad1f0353317632204,127,87,253669,63033,190636,82,67,181080,49731,131349
d9ccf3936e3b50f7a804c27f6d46cc85,61,42,63116,34632,28484,55,45,64379,31940,32439
d9e9751964f130918cd81b09c9b023fb,39,34,46967,20778,26189,51,42,44851,15083,29768
1255be2b791010d51c68fa594593650a,85,74,173348,34958,138390,115,83,176959,35004,141955
33b2654a6dfbbfa648a137840cfa382a,19,13,10553,2965,7588,22,17,8278,4320,3958
2179407385be8c386d31389855be8d0b,17,12,2354,653,1701,14,9,1429,738,691
fe19a564468eca3421fe985a452fc736,95,70,215098,73893,141205,95,73,210349,74288,136061
7a7ea27e05127b1fc09ad1942fe0302e,91,81,238951,47943,191008,100,77,212400,46573,165827
8c686a862e138addd11196c7b936016f,68,53,94678,25282,69396,87,62,104408,33758,70650
da28f2d4e53c8243d2548ae4bcc6c556,47,39,43117,17382,25735,39,37,48973,19308,29665
e793379293a8b24d67b9e3bcbc8db747,31,24,23212,11294,11918,38,28,51168,11140,40028
708ed79e1f8808a49d597b6d29747632,145,121,430213,97374,332839,163,119,472632,101016,371616
5e2ba82ed5804fe0138b3bb22f134064,152,128,458024,135138,322886,176,152,470921,103543,367378
82218d0ad1e5947e80a7541eb593d883,127,91,329061,50834,278227,130,100,301755,69341,232414
b13778b4ee626dd4b6caf46613fd837b,148,99,377776,106511,271265,199,124,391691,93888,297803
d272e5bf9b83938622300820df126480,83,72,136699,44547,92152,125,84,212116,40307,171809
e9575d484cca6fa4c31998220444fa91,124,86,209518,36154,173364,86,70,88215,47498,40717
f655cf66ea1f2e53d2495a271a8a3c45,100,78,185901,40942,144959,114,83,213832,41890,171942
44f8e34c4a8515775391f850109f7ec2,215,169,1491689,216468,1275221,237,186,1621475,264244,1357231
941f3166467664ea25ece9743805d831,141,110,347527,72829,274698,135,99,288747,64973,223774
ce7b54aeed9ea3131f4d179ab068a15d,96,77,204568,63419,141149,125,100,287532,77548,209984
f01573d52731cc6d5ee007531f67cf29,140,77,284978,74191,210787,144,98,283675,107510,176165
159ebf587ad316dea04784d278bcdae5,146,125,387475,152807,234668,164,137,645800,130763,515037
39ba005bb6d4db37fbec3cef308c698c,157,104,536162,104824,431338,180,141,535413,101615,433798
1eae266a870b0cc7ab5395185f8eb769,49,40,48982,24822,24160,59,40,73003,18964,54039
6f78fddb7c6e31cdce342d876e85fb77,49,34,37068,10465,26603,41,33,23267,11313,11954
bb05a17070dea9fbfcc3a63edb633572,45,34,29745,12919,16826,37,32,29850,11500,18350
d6cf5853d40fcaca827486a005e67164,87,65,220864,103854,117010,162,128,367286,75187,292099
c58fa9d0fc1483a2fe8b9ba7feed73e5,14,10,2619,467,2152,11,6,1647,980,667
7ea2f9826c94db2643161da5654c653b,118,106,308643,95118,213525,161,118,341165,66412,274753
07bc6bb544e6fda63adc0650d72abdc0,37,22,15178,4992,10186,24,27,10915,5856,5059
ecb33e9c15596d5dab883d2f96732b36,23,24,13892,5884,8008,29,21,13254,6139,7115
79cf8ff8acac188196298295820e29dd,103,91,277994,73169,204825,121,98,364511,73712,290799
3d7be2bc5fd6b12a5104e73b8c2f5154,145,106,471852,125665,346187,161,135,601312,102500,498812
b5b18c8558d413fcf4271e126ee927fa,72,49,84926,12398,72528,89,77,115916,27821,88095
a9c84965ea6e7cb7b6314c595fec61fd,63,52,79233,20109,59124,50,36,45228,18626,26602
4992be75be67ad0e2c8b370c294e9b94,137,94,303162,62850,240312,141,95,311400,88241,223159
d88c9b0f4e644af04c49e5cf27b6ba72,24,21,13958,6640,7318,27,21,22042,8284,13758
29d8bbe61bb126a9f4e83df102190acc,65,45,129826,38892,90934,87,72,146079,50836,95243
61c28b170be77d21aa841e7a8a493d79,97,76,217805,52922,164883,113,91,313337,53244,260093
8a5effe0c76e1a62e6ad81e2f8618ee1,178,122,508515,58962,449553,164,115,400922,70267,330655
2ecec9bb2ff5f726a366f5b168a497c1,62,47,70074,24287,45787,75,65,117020,26777,90243
aedbd64604b95ffba4e5168df5df97be,116,90,266107,104510,161597,113,78,267664,100288,167376
4a87cf2e890c94fafcd3e097f4ea52ed,81,74,187989,80079,107910,78,66,211267,78583,132684
9ff9599df3f568f660bf2eea95454b25,100,84,182587,51765,130822,70,54,144612,34462,110150
cac3beff75927713da667a2004ced693,44,33,30498,11027,19471,40,29,26240,8931,17309
b3ab4540438584440b5abe89bf798274,122,98,317677,58577,259100,146,100,254377,52743,201634
3079ff86901e9d46dec2e834e47dd450,151,114,388552,65694,322858,122,95,254167,75846,178321
763b656801512a4c96bdc594cb396997,143,111,474354,94491,379863,153,120,563267,104932,458335
9349ec3f826fb21470e2264d57e8a374,26,18,12891,5444,7447,28,21,17124,5573,11551
362a4ff327e929dd444d0fe4ea9266a3,81,52,151901,57860,94041,77,71,196478,50684,145794
16adf09f2407139b11f9f775355e2f7d,76,60,169075,59644,109431,133,126,365432,73699,291733
7b928f4813f179eff73d0487867ae8f5,179,148,660383,134153,526230,158,128,657539,126504,531035
f3932902a1a843a5519e57e1008ed144,87,67,161152,56987,104165,78,57,175128,54304,120824
17a11cb5ba51ebd80794f5f583e32eb7,58,37,73498,28886,44612,64,36,79282,22312,56970
f8005c693391802ad376dd43910874ec,30,19,14656,7721,6935,24,21,17142,7453,9689
11f920c3f061163a0176576529c1c003,163,105,413129,84920,328209,136,104,249394,87119,162275
5202c36bb43bf598be8883d96e27f8e4,89,48,131340,35747,95593,110,88,219436,42812,176624
de04deb70745d45f0d09b0f6cb797363,129,101,308414,74327,234087,124,96,277477,86380,191097
656332f03fdb9bda12fd8fcd02477dbc,47,37,42667,17832,24835,47,31,37952,13454,24498
2e0da726aeeeac727418b8fe9669eea7,0,0,0,0,0,0,0,0,0,0
1d6e10e9e8d63d67aa54a477e7429a00,66,52,87774,35671,52103,55,37,131894,20362,111532
113f5331a88299149934a7f79ee11fc8,29,22,10382,4996,5386,26,20,12060,4770,7290
14aa4801d1c524a7784af0de855414d3,21,19,7123,2993,4130,25,17,7803,3481,4322
a9bf267db24d11860fc925398d4544c4,96,75,218157,58064,160093,104,76,221235,78436,142799
15043b0ebac551e724aecb8769854cb7,44,40,33616,18204,15412,43,37,56378,16912,39466
108a857966aba2581f91dbb892ff1f89,62,52,67497,27127,40370,70,51,92345,25255,67090
9e06dbf13ea7d7878db95c879f6f7e88,6,6,941,510,431,5,3,972,801,171
603b6b88be4918918eeeb98476665f68,57,46,68342,21687,46655,52,41,45199,30141,15058
da7104c20428ecfd99d8ba609d2fda0d,77,59,161096,30015,131081,77,58,122862,35715,87147
a608b96b66ad326899eec959ab2d1564,60,42,90611,26723,63888,59,59,88444,34549,53895
20404bdb4b6147b5caa2017e6d3a8598,78,72,92244,47059,45185,105,71,141310,37454,103856
f6f535cc369667b3a9d8141277beb1f7,69,49,135632,44520,91112,86,73,122591,77014,45577
924013bdb6a39aaed8f02a5b421adcfb,102,71,232597,71895,160702,128,100,284164,103671,180493
82b9809c5b34851188b5f0099766b95d,175,124,768879,123091,645788,162,109,715299,120683,594616
c47a1016b2d5397201cc9404b189b0ac,94,84,127572,51045,76527,118,86,161785,37193,124592
e3e0bd99269a725d0472f228193ce430,37,34,43534,11613,31921,51,32,55817,16366,39451
71af925bce5b3e305777961d86a547c8,152,106,416604,75583,341021,145,107,383986,97214,286772
694d954f716ddbacf72570de24635371,187,131,833836,139331,694505,185,136,821565,148677,672888
c1debdbb536b973f763ab9fc54d149f8,14,13,2771,1664,1107,16,15,4282,1442,2840
ec7e1679fced176bd9d007ecb16d0dc4,101,74,188021,96377,91644,148,94,319031,78346,240685
eeeed465bdb8c513439c8f34006117ed,150,110,510817,146569,364248,136,96,522810,105713,417097
c7c608743aaa16b203030df235b2a025,163,136,1148248,196157,952091,176,136,557279,235149,322130
41f41384d545bef0d72724ae2521a083,140,108,488291,117111,371180,167,123,533305,109070,424235
48f754453c4a8e166aa8f3f41d027699,31,27,28223,11433,16790,29,23,24889,9760,15129
a72e7edaa891962e30308dca98d14ce4,49,31,32163,11611,20552,47,41,32592,10428,22164
e9829c0df687d2bc8a2bd280e502ee2d,166,127,721401,204466,516935,185,152,1174216,216962,957254
224b6d8b5bb589ad46f11291657c0fa2,27,23,15668,6603,9065,30,19,14443,5101,9342
da653f28a68985383a6119b941fa1241,92,71,170325,44369,125956,91,77,149516,49027,100489
7bf29956c06f51333b5bb91c6469cd80,117,90,292788,72048,220740,125,91,313234,50744,262490
7fc3772cd612aff9bc02865e470a9e62,155,87,429922,92579,337343,139,110,378746,92454,286292
b071f998c464d953c5586c079540deea,182,145,1022064,133037,889027,141,110,821342,193726,627616
561d8107af2bb393707a0ccea6b918a0,66,50,116811,30675,86136,53,38,69872,28527,41345
365439ca9bdf698323660b5c17a3f009,155,104,388482,72234,316248,158,103,439530,72162,367368
27c008d2622165bbbf8ea3dacc74c604,115,101,271165,89215,181950,120,88,264590,70581,194009
50a393250373bdede6f90b4fb770e738,185,111,517439,92878,424561,131,94,449723,81936,367787
9c6b58e79e0d04d088b8a4f6ec6298e0,55,40,114712,15565,99147,35,29,45174,29205,15969
4cd73b5f62948725f40bf40c2d5c7726,46,21,64246,16493,47753,56,41,88962,16613,72349
e0f33fee1ff290db7f759e83fb61627a,145,119,519784,149715,370069,209,161,882543,156768,725775
8fe09c8a847ae3d9b1be26da4b88c8d3,108,83,176697,36210,140487,106,80,181600,38291,143309
80ad262f9b19be28bb1908a0af9c621d,26,27,13665,5223,8442,34,22,17097,6392,10705
5211bebc3dcd515b9d388115e3e9beb3,147,120,365739,97247,268492,131,104,328899,77356,251543
f6b738068275505294e2a00733507e22,54,45,34833,12162,22671,43,29,38490,10000,28490
889f1e66d930ab8971dface0514f9fcd,84,71,245114,93337,151777,149,108,336771,86769,250002
d7fa09569164b5953e568ff30fdce862,53,44,91183,22789,68394,59,48,70948,31873,39075
d6e197d1cf451f141b8d0ac416796f20,46,36,45471,16971,28500,33,28,29245,13961,15284
17dc8ae6981349a6160544524aee1cce,134,108,264480,66549,197931,127,106,363013,76469,286544
29f83113afb2422998eb4e567946454d,32,24,11847,6528,5319,23,20,14440,4100,10340
35f688d42e245759b81b5f14d21f84c7,187,117,501822,108633,393189,167,123,571348,140566,430782
7385154d83b6062155a23c79af9e9e8b,93,82,145302,24493,120809,98,88,149135,46894,102241
6a726f256586b4c77b71aed9356be254,32,30,21885,13011,8874,53,44,34823,14441,20382
deb1e0fb3e9b36d5ccb453a3f70b7158,19,14,3694,591,3103,15,15,2148,1601,547
45a59c22c73b4487c476af1f01f9cb54,137,106,486652,71553,415099,170,121,408223,73318,334905
9c6f37760d6f859df6d718d5d889c2a6,127,97,334885,102819,232066,134,108,327949,114635,213314
eeb5d192894de51c1a6da88d646a8583,121,94,198957,65843,133114,126,75,184288,45729,138559
a45bc81854dfb46eeef33aff88cb6f64,196,130,487801,80852,406949,131,117,319965,89189,230776
02d98090a414283bc88a958b95ec051f,151,106,827205,149689,677516,188,164,816694,173200,643494
1c103b51cadefee427ddeedd322903b3,57,44,79554,40170,39384,57,46,108213,36216,71997
574ec16c68a8830cb46b7ae77e9d4c75,107,75,184916,59925,124991,126,86,235157,73202,161955
413b6e3ac0204551255994c2dafaf644,213,150,918983,121310,797673,195,146,812303,136075,676228
1c895118254e637739996ce36c3be3f5,99,81,148766,39351,109415,55,55,86453,38101,48352
2c49dd58cf7b934433af221def0d64f1,80,56,137218,23203,114015,68,48,90572,34315,56257
f56809d8bbb7bbf116f31e0edf3bd987,42,41,44114,19417,24697,52,30,55242,16501,38741
07b2118115b96739403685734bc19ea2,44,36,44268,23645,20623,49,39,62405,20539,41866
ffdbe54008a448f127e1f8e83250da91,126,120,286142,83154,202988,194,142,622942,72860,550082
d640540334b4194328beb8732e75661f,132,104,288152,51445,236707,85,65,153457,46040,107417
7eb1bb3c045f8f45f1dba8bd538fcb60,149,103,403760,85425,318335,165,115,488651,91843,396808
d6c0b3884def0aa222ae1fb3391276ff,116,98,166591,62789,103802,110,92,219259,49997,169262
8c8ec17d1c9395bb5b81df3affeea3b0,49,36,86711,20790,65921,63,52,90806,28251,62555
219b77cc055fb16c7d74d4c3a04becec,108,71,242007,39735,202272,103,85,173143,81500,91643
cea2b881a510aaa34883b4ef49f3aed4,134,107,346147,68360,277787,116,89,278684,77623,201061
f20de0470dc05590b08b96eac5bedd09,51,35,54281,26680,27601,47,34,56345,25682,30663
5187334aadf5d3263194b43a0bfc34a3,108,72,197001,47224,149777,154,123,338607,57865,280742
bd1175e9029c66a08027c487df069c82,118,110,307655,60705,246950,131,112,306961,61141,245820
76baedeb8edf1ed2389f709fdf7ed96c,65,52,92203,31435,60768,64,59,95988,41065,54923
ef75047eb9c3fc9824a09dd320c5f329,88,67,239501,54705,184796,116,97,315910,66067,249843
4db10ec4b208f0f3ca17f23aae45462b,23,14,5299,2670,2629,17,16,4968,2298,2670
af359b820ff63a1934850fdccc7b009f,102,76,192606,53552,139054,150,108,329155,42564,286591
d3bf4ebc4759a52fc15666083c79d257,143,109,351896,61073,290823,152,128,418642,81192,337450
853e33e35482d400cddf9ab8577e4aec,126,97,297594,133173,164421,155,123,352427,119268,233159
09b67e06a304b40e2178012d04aa5a34,143,112,661478,125454,536024,178,135,611456,146678,464778
e05efb15987606c5bc367d10772f4fe1,112,74,193311,38213,155098,138,108,227295,39533,187762
edc3bfb59ed07702a84e5a9595f241fe,48,40,57782,17216,40566,47,27,38960,9956,29004
58b3585995dd0701127e3a553699e3b1,155,96,694628,185811,508817,193,143,688252,157512,530740
9e2cb90d7fc49abe7112039327a1f86d,115,101,270663,75189,195474,92,80,183224,82622,100602
41472e1f324c9866bea2cb29be74a380,13,10,1821,1469,352,16,10,2539,1173,1366
1dab3076127d68e0b3740793a21bd13b,157,117,375528,76361,299167,152,129,387024,98371,288653
3674ed21554599c030c7bd0b0f319a79,108,95,291411,52342,239069,126,89,190632,63215,127417
ce121f245805b3b9cd155d6a531f749d,48,31,62237,17868,44369,46,30,54197,14324,39873
ad4ffed70304a58f1691c9e4a16da6b6,76,71,159494,51251,108243,112,93,215158,40857,174301
82416da5008b5dc335c606e515401d8d,60,49,69143,16611,52532,49,44,34511,20136,14375
5e7e4e02faa67665784dc04b6c23fbeb,88,65,143098,20771,122327,74,70,67565,28051,39514
4f2fa8e9c4c94c6437bc72fdbfd15a4c,24,15,6154,3280,2874,21,19,7306,2886,4420
d7e60df72c28aa5e33b0d31885e6df17,37,25,30675,13003,17672,48,33,60646,9961,50685
d7d703664f8016c765b37309e4ee0f34,101,88,177695,43798,133897,80,66,143051,38139,104912
1c909ea852b01696495b56f7e97fc9f6,49,40,48715,19414,29301,41,35,42176,13094,29082
580f04a3f0eb32518669da277cf513bf,90,70,270254,59550,210704,110,84,232912,64570,168342
a5f7874671ba912e9a15c3d9691024d2,252,163,858462,189751,668711,217,170,2110334,215609,1894725
60582334404aa57faf65a9f7ac77a6e1,50,36,62239,20786,41453,56,48,59348,21365,37983
5f8514760a86341bea47b8bb5bee0724,25,19,6945,3090,3855,23,16,6616,3023,3593
8521ba902b98160b498e977a17f84b64,62,49,170377,87331,83046,101,72,242573,89768,152805
3fc23f1457284867a7880ebb15226ad4,143,108,305807,47439,258368,116,78,220537,57617,162920
47401024b56c911693b08b883a73451f,77,48,88363,32084,56279,55,41,85152,25730,59422
94df8b11b5486cb65aa9be0a3082cf0d,124,112,347095,83135,263960,112,76,229517,87977,141540
fb65d6ebc7caeeacd25856fb12188ac9,138,103,414589,102249,312340,125,81,422867,118719,304148
21808d3cd8130381bf3553ea146ef39b,126,107,260005,90402,169603,141,98,272879,72241,200638
9fd03461b19babc323edacb1aeb904db,188,112,1125353,185052,940301,186,134,1273602,212614,1060988
fa66b9c9bb0b459a200f37d4bca39af3,19,12,8283,3623,4660,19,18,6171,3214,2957
64572d00551aa16faf2e8b03d7c69c64,38,30,62637,14869,47768,65,44,84054,21120,62934
8ff7b44c0abf98bdf62e6ecb9e325d7f,68,52,126844,32146,94698,81,72,199783,45954,153829
2df319b84ab4d6573bb1d0aa19e65973,35,32,29828,7756,22072,44,28,21790,10439,11351
43018d5869c480324607e8a5b2d4d453,35,23,38075,19082,18993,41,31,66077,14200,51877
6e76b62b14eacbe19cab2f176b5e996a,112,76,252457,63956,188501,89,64,220941,54622,166319
6eaf5c908808a82c54acad626fc87e17,217,161,721057,172165,548892,167,86,520422,110553,409869
ca49ecd09ce98fdc983be2a90409805d,20,13,7678,2055,5623,23,19,5315,3445,1870
30175ed987d0b5980f5eaab0ac4d040e,34,21,28912,8737,20175,45,40,42173,14879,27294
f98c55dd192d2d5202b3f16d29dad5ef,122,94,505615,136302,369313,123,99,453757,129267,324490
7a9480c1996bcbd21153089723fefbac,111,82,184394,35130,149264,89,76,137244,48546,88698
12121f82821d715fc73f60f29d278c2f,165,119,517902,64686,453216,139,105,393266,105245,288021
868dd61574f737f31623668e2e868c8e,50,42,49521,17027,32494,44,39,64748,16107,48641
82c86589ab1d308b26490b5ff85d8e21,123,72,301590,83696,217894,148,122,398081,110415,287666
18f79159f8707318ee7d3fe01873fb6d,207,171,930875,94208,836667,190,186,874053,165134,708919
afdf54bdd6587fb28962ccd8fb16adc7,60,45,73912,20911,53001,53,45,52611,21386,31225
61bd7104b58835331b6c272da93817f7,27,27,10879,7775,3104,29,23,20432,6372,14060
6166eca4b3a9ab47d114fc81e5cf3bb4,115,95,368744,99685,269059,135,104,312424,125587,186837
1545f3d03a53cb8a1c32234bedf638eb,84,70,174895,50636,124259,50,44,100790,55774,45016
2dc473dd0dbf381b4768d383fdb5c244,60,58,97922,25838,72084,53,42,51549,25160,26389
c8c9a73a9185dad780422bbdcd5be115,52,43,71810,13811,57999,49,44,54851,26236,28615
c7e213acc0637f83136e54af21df9570,26,27,17801,8144,9657,33,26,21590,8565,13025
9b43f196354f2851e37674f794a448c2,93,71,147851,40712,107139,87,56,126906,41427,85479
0ebfaaa745f02bdcc3c8b0bed4e0ac7e,80,71,124563,53156,71407,87,69,182431,35066,147365
2483a5c27cf0c8629e566280012414da,67,54,92372,25657,66715,103,66,149639,25280,124359
63d1d7c660f56342961d008a4ab58eb7,71,56,159906,54724,105182,87,69,180190,51702,128488
78f98c9828358cf526fdc2863354310b,129,107,532384,113634,418750,136,117,481660,127950,353710
2338481d16932082caaab4e847dd12f3,44,33,45541,21771,23770,42,36,60575,16454,44121
352da2c097734bb4d385e07e6b2c8784,134,98,279037,58733,220304,137,97,280227,59819,220408
9bcf3c98ad269cad4609297114ef2923,4,4,720,529,191,4,4,529,720,-191
dfe8b96983d5c0770c5143f91031e17e,95,64,190427,45249,145178,82,65,165682,46003,119679
85166d791b8693e27c96b7c521f4cb73,53,38,55472,24846,30626,47,38,54915,25181,29734
45f86ca860299cc4ecbee4e2839d9ed1,86,71,173110,28362,144748,91,76,167592,42250,125342
d913046166270096efeb733aebb76b3b,182,136,732440,156191,576249,188,138,745738,147951,597787
3ba31efbfaba8938ad8ea73e3687c6e3,99,81,229533,58676,170857,64,54,114096,36430,77666
fc7d5581320cc3776bc2f5c43459174c,149,113,424841,88900,335941,147,110,393600,88959,304641
64816a7d3446cd99750c5db24d38f0b1,106,91,308288,75008,233280,147,113,347968,75680,272288
674c59527b86ee1dd6b2682ba94ef70e,181,112,463814,106120,357694,174,123,467996,140022,327974
45b962526b89cee0d39d26f5ba83fd32,112,75,189023,33858,155165,108,80,189452,47303,142149
3ca98f8d29a9c1096f9578cd6ddbe9d0,141,96,345406,106687,238719,196,141,460959,92445,368514
0a0231281aaf76a846cde9615d6991ef,111,106,316501,106014,210487,166,122,413814,81484,332330
b16c7f08d812e0944429c01234c6d683,90,71,160522,37579,122943,65,50,106952,45938,61014
7d2c20496b94389f9b5e3cd2579176a8,104,95,233838,77156,156682,108,78,252776,51281,201495
d1443bd133acd7a7df173ae6cfc15932,30,29,19167,7165,12002,34,27,24315,9234,15081
c4360cafdc04bbf5e1a245e514c96b4d,137,118,462371,149508,312863,141,106,493132,126017,367115
6c74697b7d4c98a4231b41857aa15be1,68,52,67910,22974,44936,54,40,66185,16320,49865
3522539840e19d56bb9fa7d3530aa289,61,36,72095,16744,55351,57,43,60689,18789,41900
1cd16289d37de9ff55102c8c3dafccff,85,78,111180,27899,83281,77,61,132637,33214,99423
2897f609ad6e103355b067bab2d9261d,65,59,85189,26053,59136,69,46,84393,18251,66142
3d62b2a91e976b180ede27e623db1bb5,223,178,1030198,212505,817693,183,132,840414,167246,673168
8726e92844116a123de594e8a32e4e3f,16,15,4110,1610,2500,17,11,2690,1628,1062
0f06bfc36b73c2f536afdc07e822dc59,129,105,399635,98456,301179,178,153,688240,119833,568407
bc5f5efb6ae50160a4cd51c6291c2a03,94,80,158869,63237,95632,85,63,181506,44892,136614
6a6148db40ff421ac8ffa6b3256b2256,147,115,524538,98276,426262,159,128,508887,92493,416394
05a9760bcc9a1aa2ab394fc6527a40cd,10,11,2457,1562,895,13,10,1919,1594,325
d62745c82ac326bfb98719f9f90efbcd,104,74,212692,70235,142457,127,82,213031,56129,156902
8b52c4bd2575cc309b849a029fc10cfd,91,66,151321,30249,121072,102,88,184526,38116,146410
67e3544ffda3ec581fe4483d219bf910,88,44,122355,21792,100563,56,46,85276,22582,62694
a6760728340e2d97c13fc05954573b8e,95,62,165627,42311,123316,64,51,107724,26490,81234
5dcba7fb3ca2f01abda3e6ff6a0d1d6b,161,118,605495,112817,492678,147,125,514605,129092,385513
d2a815d15dd266ba5b345f9c680f4035,95,70,141961,37765,104196,120,96,242460,27907,214553
5720edc6e8c2f552d4a4af857117e4dd,138,113,327903,60829,267074,116,101,265698,48457,217241
ab00213e2fd9f72de85bb8d20380501b,87,69,164799,64277,100522,115,82,219042,43227,175815
cef02be62192ecce763322eeaec186f5,25,20,11070,3970,7100,24,20,8365,3540,4825
3a29b296b9acc5e97a4b4ca50dc0d909,69,51,105360,33990,71370,78,66,118171,42921,75250
1a5df9b01a1c1e23ba6ee838c9fc1a34,90,78,177668,52470,125198,124,93,297941,43067,254874
573ee27eacf6c1b5dd6943aa5d520550,85,64,164815,30908,133907,71,58,134153,38497,95656
084c437793a61b3e806c29069eb18b27,61,54,79174,27957,51217,59,36,80245,17408,62837
0d8a754ce3c8c6573f27796ba3ca3358,33,22,30778,8782,21996,33,21,27619,9869,17750
824de83681e2e96a56939d723f771066,149,117,368639,124248,244391,131,89,313782,83874,229908
56174487dc5dc672d16e509228e93ec6,52,31,105984,21145,84839,51,37,64483,18879,45604
2755145dcb86de941f1af97ca0e56721,87,60,167064,29406,137658,88,63,159036,32712,126324
56f6c04d5c96a232c831214f2e3c7142,37,31,20988,7872,13116,27,23,21141,7747,13394
b6820e9d8a254acfa228fbeeba51c37d,39,31,33052,17997,15055,97,77,144258,20446,123812
b0985447a5e18ae33efb5adcc4dadd3b,64,51,111807,33187,78620,86,58,140935,31824,109111
21f74073e609f6e220bfcf1febe506b2,93,68,186971,27081,159890,102,89,160085,36301,123784
20407251a74892ee6e46504a9972f7be,133,95,389977,122560,267417,172,129,458567,108819,349748
b7ee4a09a74c1c701df93a70e89fcd72,88,61,153112,36240,116872,102,71,174434,32822,141612
15f425a0fc68e1eaedece5fd23af35b9,36,29,26681,7512,19169,28,21,14535,8840,5695
a2acbc4b27fc2bdc603ddef2b07b34d9,101,92,382748,165403,217345,155,111,587219,141375,445844
ad152113dbbc3495188746ceb13555cb,88,88,224310,39632,184678,81,70,104030,37026,67004
4877e78ccedc78356c6efb13cad67402,136,102,404689,133647,271042,148,125,445430,105234,340196
2c99779479b17819309402de30b62813,132,103,372836,65120,307716,151,129,356705,70855,285850
68432836627e141e3532d8578a2c8f6c,59,49,79721,36099,43622,58,54,96119,34675,61444
a5c00ea976589120a4f34b1711e045f5,113,87,319327,117074,202253,133,95,406556,88108,318448
af5ae9ecd85c8f3cfc80da5dc3b99fb8,144,110,352380,72011,280369,152,114,344371,94494,249877
448d0e4ec841150b61419d1386545ff4,27,20,13810,3467,10343,17,20,6071,3870,2201
c19e4c91a065b920362cc7034055e939,152,103,482216,134505,347711,153,98,495384,100213,395171
6349dc8f89b9376819711d77194235b3,190,142,2387218,195027,2192191,245,192,1254219,294419,959800
2e09c03d7d81c0bbde55c58dff7f279d,98,68,224163,56542,167621,96,81,227708,56879,170829
ebefed87d4541a851c250bc462cf6d7a,155,123,606093,96779,509314,185,123,656453,89830,566623
a11fddce6fb8f7fdbaee6d2e41125396,48,31,73886,25372,48514,44,33,64762,27316,37446
756e07b687ed990a7f05ac5efde2b637,122,97,281021,84507,196514,147,114,310089,53235,256854
3953b6246055f14c05d3a37334181a87,170,142,707901,89678,618223,147,125,499474,104108,395366
92dcedc101ad5ed3f67830ed68e58380,159,106,464510,109236,355274,163,124,502133,164993,337140
a1efedfca33e112d80001302dd717086,198,155,713086,146409,566677,170,117,603682,123428,480254
6a94bf00ab89cddcfd956a2271ebdcd0,72,57,140374,52119,88255,79,62,161967,37957,124010
bd6327e8991f33df61fd004e2db8cd2e,76,61,123193,30212,92981,95,75,104007,36609,67398
813b592f57f8994f139b2862151f82e3,160,132,497192,88666,408526,170,120,391807,96458,295349
79ff15253a9385eda17fc76c2fe88247,140,120,329707,65758,263949,99,76,167613,50333,117280
769dadd4ffb058680b44067161665dd2,5,3,519,604,-85,5,4,742,434,308
7b5a4899e312d710cfe46c19df78c26a,119,86,228253,57138,171115,97,90,138723,48458,90265
4fd7e6167a14236bcb1702f37dc436e9,72,59,92208,23778,68430,48,34,63144,20335,42809
daf7058854d74de854e2505e2965eb40,88,63,134698,35548,99150,100,77,170151,30620,139531
c6aa3f8cd078f919aad0a0d14e0105b7,56,41,71923,21335,50588,72,62,131385,26009,105376
7888eef191b0531ad1b34a0d4fe83e04,49,39,66620,26913,39707,67,53,72458,32066,40392
be263f185535422fae97527be554c5de,63,43,108402,20392,88010,70,51,98792,19036,79756
ca448e63fd76874514c7248a12e6f6e7,14,18,3891,3698,193,23,16,6799,2096,4703
819630fbcccc032ece238538d822efbb,95,82,230924,49071,181853,108,85,249822,56598,193224
c2d993eaf7cac27ce2c3529a47404d31,45,42,89521,38506,51015,74,57,139296,33803,105493
ddb7673b4850bad7a6bb768817c5217a,97,64,155188,29824,125364,86,64,145689,34360,111329
281663135ea36802c1f0274c8c2b25d2,77,55,109308,22607,86701,105,66,168702,27689,141013
eb3bff9bda1a18af44f04a2dd7f88008,116,98,280741,48772,231969,139,112,312126,55676,256450
20fa62c75057c1a369d4c3911069c788,139,119,314424,62281,252143,109,90,223176,54994,168182
30f1e482cc4c17908df664328aba7bda,42,31,42065,12860,29205,40,38,27281,18178,9103
16f7c6ad8c5c375f77612a1fcfb11454,54,44,41613,13342,28271,38,35,27388,8650,18738
dbf3c8d1ebf566bd7cd25cc1f805538b,6,1,939,52,887,3,5,151,673,-522
2b28ecaef28e247ad1d80636db399712,101,74,159872,45916,113956,94,65,165400,41172,124228
25cdbeb0ed7bdb0cf99c8648315eec6f,91,79,207310,105189,102121,149,115,410355,53331,357024
aafaac0dcb88a3b8c220940ac37f01d7,158,137,405692,96426,309266,226,193,700832,107872,592960
42bfc3a9975b6bd54c6ee55d060662f4,144,103,376406,86010,290396,145,127,392753,91909,300844
7f54efef645672b74d6acec7b01b0835,32,23,24670,19549,5121,50,39,65497,16790,48707
21ea2797cc40721bd1e7857a1bd207c5,64,45,93625,28526,65099,66,44,104364,29381,74983
558750cc7a7083f569dbcb2e1fc4b07d,77,56,128654,38874,89780,84,67,150835,33869,116966
e841ed274be3d4c476563b302d23ec51,64,44,66074,23942,42132,60,51,69251,22425,46826
d2d382da9917725a7eab9f05931167c7,138,116,377143,95500,281643,123,81,308263,83376,224887
afa78e99136361cadc7391ff5ab86278,32,25,34727,15404,19323,46,29,43162,15355,27807
46249f00251d805800f904720276abde,31,34,31744,10612,21132,33,25,23487,12410,11077
fa756387008bbb40e75c05333e63cbe4,68,54,113824,35386,78438,52,41,87539,22371,65168
3dbb35941aff2bf4d641dee0a212b2e1,55,42,61420,15302,46118,84,58,110128,22401,87727
bbda293ffb5190879f2358345f960e42,78,59,113203,35088,78115,75,62,83326,42633,40693
2e81e07a890dddd676e023ce53b2c71b,131,98,376608,90066,286542,169,125,447168,64229,382939
299a197d0c303b31fee063c8e4bb114a,104,77,180233,72006,108227,101,89,268864,49321,219543
c78403a50977adedeffe36b19446a9d4,102,76,211468,53212,158256,115,95,246336,59491,186845
762ceb6c8ceb74a14a5fcda2e983cb03,104,87,215888,44987,170901,127,110,262108,54401,207707
1c12e2e71bb2562c16bfc3bf4291ccbb,36,27,50555,15257,35298,37,25,50213,15974,34239
1b37e89f2c3bf62bba743d6309ac22fc,190,118,492935,96473,396462,174,129,557878,99423,458455
e53732ca9ae2f4bc7a0bba8b752abfd4,43,24,25063,8705,16358,33,26,37322,9949,27373
62d0b208705d7a7ec1c7c3aceeb73764,16,12,1993,1826,167,17,11,3612,1092,2520
539e17691500d1a3151a1341bd388fab,176,114,540749,113503,427246,144,106,441815,115223,326592
ac81bb317a4d571b47fc6a9d0feacb16,135,95,400484,114390,286094,181,148,520816,116377,404439
305aeb58d6fa50e9fb49fa2bf60876a1,143,113,553979,85211,468768,146,127,561406,95872,465534
e07cb6b83e826b92ad58699692d12b85,15,13,3404,2133,1271,19,16,3994,2451,1543
a04d29d469840cd391297c93b760d867,78,69,121960,59378,62582,111,57,147410,26108,121302
8efd6697f4a2bb487e571faee3c2a596,68,50,100037,34649,65388,70,64,105602,40328,65274
481e78823b56578217adf3c1faed2b0b,132,111,316070,61475,254595,137,107,337169,62314,274855
c89d5c5318e88143f9e1dfd78dc440aa,193,151,1597217,190754,1406463,221,182,1383406,302775,1080631
653a8ea8ed93ba0145685a35452f353b,177,126,481936,123314,358622,136,96,411824,136277,275547
f4293de92bf1d6a588f88273d382ab76,189,128,902071,196118,705953,201,162,947169,229803,717366
56f643daeed6fb93805948cf7d69d918,26,21,15491,6910,8581,23,20,15976,7768,8208
3cf8648d0326744076fee59862df8626,96,71,118995,26331,92664,72,70,92604,19899,72705
b44d9c553acc0d35406017c3ef06492e,151,125,478275,88672,389603,172,133,548563,106156,442407
98cbf8d5c761b6340a9081c963d0aead,31,24,21997,6627,15370,27,22,9901,8923,978
a95f54ca5b3a68497986300b1433cc1c,5,4,498,210,288,6,7,651,343,308
27dcb583896b03d195c7071151a4ced8,32,25,34537,7360,27177,33,30,17795,12950,4845
a1ffeab8a96f3fe9e28f9ab53fbe933c,81,50,136402,30257,106145,85,86,115958,43119,72839
f1bf7c7546fd9a0da1314380349e842e,77,58,124908,36908,88000,76,57,129836,35230,94606
fc34d74f647e3823dc2eb06f884337bf,75,57,176139,52096,124043,81,68,196888,42446,154442
11c33c706c140031d7374fcacc3fd4c8,78,63,105016,39649,65367,93,88,136365,39055,97310
b4ceac7551f0a828eac67c9807a59272,70,58,105698,26250,79448,97,84,182877,29348,153529
b073c5ac657b9e85fc95709962c2a3e6,156,112,324490,60549,263941,104,78,208450,63802,144648
1f0ec879b87f1b6eff5014f38eb026d3,76,56,119086,49669,69417,85,63,162944,37061,125883
e1b11f2bcf42d6dda4b7120f80b201cb,45,35,46543,17849,28694,46,34,46838,15600,31238
df68770621cdecac300ef677f421c982,99,79,149700,55236,94464,90,75,170895,46559,124336
0a2664d955797a3293089e65affacf9b,36,31,19165,9999,9166,41,35,19993,12287,7706
297159f6bba7c7eaee9c1badf853f0a1,18,21,7019,4607,2412,26,11,14785,2086,12699
0e126251c4211015836aaec245ca476a,162,113,592105,83760,508345,156,133,490204,113286,376918
b1ca7e3fc9bd7abfd4519f42302ff6da,25,18,7091,2986,4105,24,20,7119,3021,4098
7a302e2a71f9f5d9566fe23fbfbe9303,70,65,119556,35911,83645,83,57,141293,37605,103688
9a82b2af41aed02d84fc3dcaece77097,59,50,87771,38628,49143,61,40,65031,38181,26850
0cddac59f9a25526513b1b733a453732,52,45,56611,26683,29928,74,56,78503,22393,56110
30d7fe6bd804f3f5229922d0654c86ed,146,96,311764,76775,234989,113,97,306943,124374,182569
f340e7f37fdbe0476e97915911675014,130,77,307076,59036,248040,166,95,387475,69897,317578
40d7733d497ee6b569c6e55674f2ea41,33,27,31802,13321,18481,46,41,49990,16567,33423
dc13f050b49588be76850e7f97b91efb,144,136,370689,67530,303159,169,131,416168,79630,336538
09d49f791285b697f9d2f173a3aae21f,163,128,535652,117693,417959,148,110,410445,97716,312729
bcb0614cac15e8460abacb3f8bebfd9a,66,56,102834,25473,77361,81,64,136016,26794,109222
e438f5b4d2a25082ff1384322076fbbe,146,116,512783,132381,380402,198,155,591960,168070,423890
450b7a231eba92819ab7ed425f54b15f,43,30,57640,13062,44578,55,38,62617,16152,46465
35d9fa2dc12a048599dbfcdaddf560c2,117,83,254694,74999,179695,109,85,222000,75914,146086
6f54b224a460fd319b9ffa9a98d53e25,84,69,164245,51160,113085,85,59,174986,39242,135744
d9d5a5043b8e575e6b1c2063782bf95c,107,79,198415,37543,160872,113,97,216397,49406,166991
d2eb353710fc0069a798819db1f4d0e9,30,28,27687,12359,15328,39,32,25492,9184,16308
4d910ff4f8c9f76feb45e7c7faee4ae1,127,103,256349,53425,202924,90,76,164523,41266,123257
526233810f611fe2c97298c836e93d13,83,77,173763,45218,128545,72,64,171425,44725,126700
f62ccb739f230ca8d9fb3edd80ba520e,146,128,463993,114229,349764,179,108,417246,138618,278628
dc5dd6a46168f522e0d171deb31e0536,151,92,339548,100117,239431,114,81,202019,72579,129440
dd14c782377fa439861b7c2f54c2c88a,4,4,488,119,369,5,2,234,105,129
fa2d49c24a46ff463d30f772f1efa762,91,67,141645,42454,99191,110,76,239583,33461,206122
b6887116e0942f4e86818869dc4481d1,275,170,976525,170196,806329,203,160,1019997,160130,859867
08262f2edcef4151c54810c3c50690af,136,103,321925,49621,272304,141,124,329325,60508,268817
f5d9e053b41389f2dbe80dc71a4ddccd,27,19,8802,3099,5703,18,17,6194,2646,3548
6df812a7dc432e5ad0e112a358d85c5a,33,23,39738,11946,27792,33,22,29514,9759,19755
90ea39081b6e38195644c5cfe275e46e,101,79,161987,39189,122798,103,90,230296,48495,181801
3a7f9872fdb6f568936d7894df8dc951,26,15,8628,3845,4783,19,22,14110,4427,9683
baa0d7750637c7c5e510f98cb423adb1,155,78,251904,67138,184766,172,113,409371,55511,353860
217426d02d6bcb3fdaa1c313cdb9de9d,34,28,23549,9591,13958,31,26,25314,8387,16927
54ea583008c1d4c672deaa80d44048db,124,110,389406,96404,293002,132,109,380211,73370,306841
5ee170d4893e5b6b01c86edab85d9886,87,73,170906,45044,125862,122,93,207043,42937,164106
1d10566a3289381e84f19a7b658f51f8,147,103,316703,79277,237426,166,135,417047,104841,312206
3dc324a3512b3352e6cd99ebc7f1903b,85,71,218006,81082,136924,126,83,313681,81492,232189
a2183d31bb5f2aca63b7415b4296b918,103,83,210055,75881,134174,155,117,467672,69022,398650
7a0b240256884dcbf6bbcb25126b38c1,149,116,401871,74778,327093,158,129,424045,60902,363143
c780323199f72c68b8392a5df4df6552,129,86,328136,64334,263802,130,113,301331,86824,214507
efd1e6ec02e9fcdc3338a95146980384,40,35,43876,20592,23284,49,36,49454,21920,27534
757240f762336108a9603bd15d2df3ff,124,92,283820,66557,217263,151,124,374955,78291,296664
546fddde2d9b303296f0b0393a8bad0b,31,25,22145,8394,13751,34,25,32621,6324,26297
8346ee67216dab3a13aeb8b8b2c1913d,62,39,55763,20366,35397,64,59,79363,25353,54010
6adc04d91477975d6e65dab7b3399eaa,114,95,303016,54132,248884,114,91,247743,66119,181624
2cb4c0c2846a6b330fd91f44d8c7b128,157,112,421019,52855,368164,143,107,315565,64049,251516
98ffc3025069efcb5bf8478472cd2ffc,154,110,385788,104379,281409,155,128,505577,116993,388584
a95f6dd399d484884a1f0f3fe04bc325,25,19,11153,2607,8546,19,17,5590,3378,2212
19d33489b63181d5d6c6fe1f168fe157,17,10,3275,1333,1942,17,14,2981,1939,1042
a812c6d8751240e42f6fbba8b31299bb,159,115,558603,97787,460816,174,136,616096,115243,500853
1ed9a723e1fc67f3eb64908c75ea7164,76,52,143868,49653,94215,62,57,117536,48395,69141
24ac28e6d40531caf44985d352624cb6,24,19,12085,5601,6484,23,18,13800,3234,10566
c02d39f7dcf8e7eb314c13c562af378e,106,82,160029,47048,112981,109,94,192416,38853,153563
8a356377ecd4d93af2bd4087155c5bb4,49,27,40649,11535,29114,31,27,25654,16111,9543
3ab38a6b5ac14a16c1280a6512a2db9a,122,76,340089,75356,264733,140,124,383446,107439,276007
12e9abd9da4b0afa901063d0c9380383,60,49,100717,42952,57765,88,77,138926,43691,95235
91873d19b034c43b766ef6109f4b51e8,91,74,151545,25746,125799,71,64,97334,31633,65701
708721bdaf0940018d59c4e3deaac6ba,20,18,10032,4534,5498,30,19,21778,4476,17302
baec44c80ef8a10fc4f8d977200edac1,88,58,139394,52313,87081,133,83,241674,40036,201638
126a73efb241eb73f7942c28a7cc7c34,59,44,61466,24929,36537,80,41,91023,17240,73783
0b1b1ae66291b83bb3624603309a75de,33,25,31654,14268,17386,41,37,52217,13112,39105
db9fba61ac9c5d36f4dd041db8fdc257,74,65,123825,32056,91769,56,42,65965,20807,45158
62e4ed6bd2bae7c3e51a93915b40774b,66,48,113791,36720,77071,58,41,134857,36655,98202
bc4188e1f32f76cb5ca2258b426403d8,28,20,15901,4586,11315,22,19,8058,6045,2013
70665c46f41807670726adda9e798255,79,55,145664,19991,125673,69,52,101488,29555,71933
93de837f0323b3ba2e733b1848cedd4a,186,121,556040,108901,447139,173,141,729976,102020,627956
b6049fe42b160a1e807a839791188458,112,89,256805,66945,189860,112,98,303622,73662,229960
a402b14f260c2a18ce3d1fc1d50d700f,39,34,35375,10698,24677,38,35,46519,12690,33829
4f99afd67e96865d6cfc5babbd3c91a9,87,62,214797,56914,157883,56,53,105998,63330,42668
d729b6ff82584fb92f21ee2eef057773,68,39,87944,23018,64926,69,47,112706,21558,91148
2ff0f059c08ddbac100ffdca1545acef,75,57,123403,36434,86969,90,80,112187,44723,67464
cb3ae9fd7bd8df67b0eb3e4d5465ccf4,57,40,99628,21396,78232,68,46,74914,20511,54403
e27bb5cd6a51a9eb93800296e9061a8c,61,50,88446,24053,64393,74,69,84275,26054,58221
d281c05999e2b92faa68c299b60f55e5,81,57,122218,59805,62413,103,76,220024,42729,177295
4688c54b9fb382acd7e18a731652a0ef,35,29,40687,16479,24208,36,29,39237,14419,24818
64425e1c780b830f6516b43ec84ec6e6,29,25,20755,6927,13828,28,21,16197,8028,8169
77138abbc4adfed2866f856bf900019d,121,97,335193,76687,258506,127,109,290923,82670,208253
a00912c223ba801d9aaceca17a65b566,0,0,0,0,0,0,0,0,0,0
5147705a230855e250ee3c08ccedb096,55,44,89643,19586,70057,82,72,105973,26421,79552
4c1330d6dcd94a61577b9a981bbf7f78,14,10,3500,1981,1519,12,10,2853,1748,1105
c225a2092c55f66fa5909323727423b9,37,29,35984,8175,27809,37,30,20490,10228,10262
cea72a2e53832534ee764523a60d3d55,36,29,26030,8924,17106,29,22,16269,5766,10503
4ab241fde0f15c430280d457a650de67,62,49,109847,32788,77059,74,62,117193,38436,78757
ba682de1ddf25012ea7e35bb99dd9a17,58,29,71017,15880,55137,69,54,79580,19051,60529
46d2c341404a1349fa6c93e8c870ea03,123,78,389890,98249,291641,133,86,356937,82085,274852
c74d902126f5c681f76d3fc9ad272118,138,112,673121,186730,486391,184,141,916458,258886,657572
8160d15f96cc6063a282f21c8004f657,91,56,160593,44605,115988,107,72,169244,59537,109707
ad7a90f87296b49fafb17bfb339389c8,22,21,11025,5473,5552,30,21,14914,6248,8666
1b031a3f8ee973a14ca76574b98ea52a,77,53,166793,26954,139839,75,81,146371,33194,113177
2b6b2aaec28ce90b695cfd9b06fcf50a,59,37,53580,16947,36633,40,32,44663,18004,26659
6490eb2f3f345d0a3a1d3f73bb2f0f75,82,73,137603,38959,98644,81,58,108996,39500,69496
05ed9734e7ab007db62269e795516a9d,144,109,377081,76292,300789,167,129,431028,75519,355509
bfb0a850fb37403cf7a90c748d82fe85,17,17,3821,2510,1311,18,11,5274,2019,3255
eb3ecf45c156a9678ea9e42a054d924f,69,57,101212,32551,68661,52,43,98643,24765,73878
230cee17486d6719c268dc19d4afdac1,154,116,380630,64260,316370,153,113,438682,69592,369090
c3ac4601c5a2e33a1b5ef36c5ac0a973,32,27,31185,14156,17029,45,28,46281,15031,31250
b23fa378d6b0c7d3631db76ee0a1476b,58,42,67438,31190,36248,65,63,84273,42941,41332
79dba5790806cb3e86bd8dfe03042b01,33,20,16247,7669,8578,22,15,17120,5458,11662
1df3f404e36c5afb9b2475ccb7802130,94,84,201148,60884,140264,99,79,187809,61725,126084
15fe268017ea632afec6fca063e85683,49,43,38176,16059,22117,46,31,41985,11407,30578
2e78c7411e26906bcd71f53c194762ef,112,91,360937,117976,242961,153,90,419167,80761,338406
d84366dd19d73d0f16cd722ed0723ac4,70,58,105384,23584,81800,83,66,85564,31677,53887
d097b2ddb2ed12a81f6622ec31d5aca2,57,43,79789,25839,53950,58,51,78066,26743,51323
4497d46f4ce0689ff5c36d8c233f9151,53,36,64559,19032,45527,53,38,71467,20964,50503
7e05c2879640998ff14964d46a3dfb4f,30,22,26457,9346,17111,30,25,36785,9962,26823
65867fcfa67ed48bed4f214d9a9cc6b6,119,91,302402,52138,250264,85,69,148465,63212,85253
3505181c9dc8517301aef55742694ecd,137,103,392746,76086,316660,144,103,473950,84022,389928
38d58a3e2f0a300000a2b4967018e41b,114,63,150153,18940,131213,82,50,118447,22061,96386
083a579e527206a86042f21a2e6c9f62,172,112,448973,143662,305311,169,150,516256,114682,401574
42d55a0ec137178a3041acc82433344b,113,97,324164,88470,235694,134,93,309401,74753,234648
2e89c6394399a1f08a54d8c1f7628c79,73,59,106177,41051,65126,77,68,121916,36251,85665
de2b83b9f65dd80f8344bcfccafcfacf,121,92,296265,67984,228281,147,106,313525,78700,234825
e85d3ffbcd8711ec93716a84852bf8c6,47,40,58520,15972,42548,36,29,47970,10095,37875
66e8e934dd827479c72a3b2e768d597a,78,52,126314,51404,74910,67,51,149473,45427,104046
9faa9797d5d7c4954c769cd975004064,70,44,79978,27801,52177,71,44,84092,27791,56301
66312761e8e4aef6372a1b33bf9e3994,96,78,198429,47854,150575,90,77,168181,59367,108814
de2c645698cc8e0e7f34bedfb1e5f615,168,107,613899,112755,501144,209,152,658776,106063,552713
54ac0f488749ab54dc6c58de921737a6,45,35,72727,10316,62411,42,40,42682,20286,22396
19107db6d5e4c81ab38aec16980667dd,25,22,17301,7587,9714,36,31,17238,8596,8642
40cd44845692c4e5bfd66b7c218b5ef3,98,65,136874,43721,93153,97,65,178574,44453,134121
cad77d002d6aef30482c6f5cceae4ffe,113,79,151945,35279,116666,106,82,144782,30642,114140
b2f4ec715ecce0f237f97ffbe60539ce,4,2,401,522,-121,2,4,522,401,121
4d50e3720bc91e6ee5a5090dc7a59b68,4,3,507,349,158,3,4,349,507,-158
8eb2077abe0a5e1dec3f10cf8e20588d,87,58,74563,32478,42085,63,41,67626,24522,43104
afc11fbb2084a6e69543411cb11df739,79,56,177562,40525,137037,89,74,161888,42631,119257
9e1740207346b55281d2b83c2dceab69,65,57,92282,30445,61837,53,31,78352,22939,55413
c8d049506ab39cd6adf3e4afdb02daa3,94,69,186057,42119,143938,97,87,161279,59090,102189
709308a90db9e0b0f962bd2eb273a94e,104,75,186510,41026,145484,121,99,211730,54693,157037
29f564bd40e92589ecc7bbcef9115913,82,64,126708,31599,95109,99,62,109321,27207,82114
352ef21030516daeed510fc729a51f00,51,39,61247,17730,43517,40,31,41271,21107,20164
0f74c09700304d56dbd188725e00720d,40,33,24878,12474,12404,34,25,25002,7351,17651
7a7a1f6564de21cfd2507f5f299c82eb,146,115,327540,70802,256738,114,75,214125,75759,138366
aafd277fcd20e6f70ff44e76eb12392e,106,81,235552,36329,199223,90,70,170243,37990,132253
2eddb351489249858ecd45db1782d23f,52,38,52533,17066,35467,41,33,33309,21132,12177
a05e907bb1b271d4a05208e4cfc583a1,6,10,953,1884,-931,12,8,2474,1008,1466
1eba6d3342dee5125e8628be4c74eb72,44,32,41940,21111,20829,54,43,67250,22608,44642
9139c96b1a475d65c055189a6e93bc7c,18,18,5875,3648,2227,19,18,5250,2632,2618
eba7bfc66ee39214b48644dd6f96b5d7,3,4,390,522,-132,4,2,522,346,176
77bf2ff80fd4ae336a61528a8c34b780,51,38,76055,17092,58963,45,39,55531,24058,31473
ed6f8991f713aa08d5e9d8a38fed8b46,96,66,122545,27349,95196,95,73,114743,41677,73066
d166adf57ad8f85c4f37f2200e7f7a85,36,26,30157,8536,21621,33,30,26698,12169,14529
d0dc850cfd4f7e7c65ed94ccdca50953,133,94,316476,76078,240398,123,88,296892,83377,213515
c2444f875972467fe6174fc260ad5d8f,103,77,237379,46306,191073,109,85,226513,64042,162471
24963914d33abbaaa622b3c547300d48,30,24,17114,9161,7953,36,27,16850,7584,9266
93abd0c9d5bf8adf0c7d2c7673d00ef7,23,18,11339,3139,8200,27,17,8759,3566,5193
bac0ee93140c962164ebbedbf4116a74,78,64,198093,83949,114144,136,104,317079,77452,239627
1d2283d764295e4b5177764a00f73f73,34,23,14182,3590,10592,25,23,9047,4199,4848
4fd54204719a0ee15070b118f911268e,102,68,242727,56511,186216,95,64,215454,74443,141011
aecd2be49dafddf58b5fd90fd8392c1a,24,21,10562,3509,7053,27,19,8536,4391,4145
20bff0dda9f46dfcf52777372d517c7b,48,33,63609,17818,45791,71,64,78245,27954,50291
87460c3110067b2102e549e4eeb807df,30,23,30218,13419,16799,31,23,24189,13408,10781
de9952971ed3314e01d077cd03582fd6,151,111,426710,71341,355369,175,149,652656,79472,573184
1f0dc448c05a65449969752d26ad50bd,59,49,65154,31698,33456,44,39,56135,25694,30441
f77528353af22654946d2f2daa306104,175,130,722351,132506,589845,186,148,762238,121821,640417
fe8ef49cc8826213dda10ea788c077ea,107,81,178356,30077,148279,92,74,172677,32716,139961
117ea1060abc499d673544ab4b1e41a2,150,121,570173,75804,494369,144,110,409186,126753,282433
fce00a4dc9695e6c9082d4c27479f272,29,20,25803,5937,19866,33,19,34871,7946,26925
6ada41c58976f9133bcddf26234e7e57,119,85,183695,57354,126341,118,103,229369,58916,170453
d0ab4380dd244bd2dc76ec94a72f1391,153,138,380429,106511,273918,150,102,326654,91078,235576
b6c1f40991d35231472fc560b5ca7033,86,68,213049,48754,164295,124,99,333930,68680,265250
2e57bd4b3e71ea71dfdc13c7b49957e8,53,46,93945,40656,53289,61,48,135879,33971,101908
18d937e2be5531c0479962cbf7a5e2fc,39,28,71911,16854,55057,70,50,97345,25139,72206
e278df9981b8f592775bdb467f883621,87,67,155807,52179,103628,93,65,186012,40399,145613
a0ecd7db6e2f4c83b7cd078fc1cc78fa,88,65,135272,49333,85939,96,77,152940,38614,114326
f3e8a0434db6a02fff8f69103463d27f,44,36,24402,13701,10701,36,34,30795,14882,15913
21f5b63d1301f0aed032938ff313356a,27,25,24642,11433,13209,33,24,22175,11346,10829
1a4779d5e995f344e7d8c35c313d8f87,36,32,35238,11531,23707,48,38,38584,11731,26853
c3e51e23a37fbfbe6cfa0c5e13431bdf,98,74,186354,51974,134380,120,101,292122,55361,236761
68efae09dab65921426d09af6ae296b8,83,72,176074,52800,123274,83,69,144460,54773,89687
c594774ab573dab00f50ca1404acf222,147,99,376970,84618,292352,193,150,524207,107954,416253
b810ab8c5afa34c332228f7fa6d04ebb,36,31,21608,8610,12998,34,28,20149,9190,10959
8a15e781591863c3d57305d8f7ae8d5a,167,102,639265,147494,491771,203,136,693961,128730,565231
0d2f944023ec67f92a1976d96abd08e9,201,103,418291,57225,361066,145,93,317733,100233,217500
735c87e7dae65e22a8524b04ad1cce51,71,55,130635,62003,68632,97,82,199257,49977,149280
91a0dcfe234e6e9ebec5e239e99052ca,61,53,136773,79881,56892,132,108,342504,65808,276696
4f8357bef0b5c10e61a5a2b898ff5d2e,100,81,174312,34936,139376,102,88,236304,46222,190082
9d0a3ce51ffeb51d764550a94f097168,82,66,120381,38052,82329,101,74,145333,42517,102816
7e43a316de40b0ff8fe05cb3249ca356,127,100,263864,83363,180501,148,130,424763,74557,350206
9099f7cfcc988e70d69ae4d9786f539c,73,44,113967,32451,81516,97,69,123772,48051,75721
49efa381004c2d66b2379178b08a5abb,4,3,640,118,522,2,3,106,628,-522
50476ef49223b4f024661a9169295b64,98,71,178527,40013,138514,88,71,151273,38411,112862
dec57a989aac5fa4eb091c8c6cb8a02c,55,50,90200,32111,58089,64,45,81559,29102,52457
c973f029f8fc86ef08204ff210e4ed5c,86,76,147662,40010,107652,83,66,126262,32628,93634
9f1e46676606cc85542e38283142f126,171,120,451062,87488,363574,173,113,515348,88997,426351
30aec9a36d6f992662f8efab721cf7f1,41,38,42870,14969,27901,54,41,50170,13351,36819
a073139884c230466ba9e2b84ea11dc8,9,5,1634,321,1313,4,4,342,535,-193
268222e6a00ebf645f88a80d6e95670c,189,118,447644,98620,349024,147,121,493010,105966,387044
cf4f9a0984f6eedf8c81176b13c3909f,81,72,164275,55415,108860,76,65,112794,48143,64651
e2ef3c8eec20a351aba6a8cae78a7c57,66,59,141520,42810,98710,86,60,110366,26149,84217
8ceb13023ff61d93609dd3a3422aa52f,153,129,421278,52965,368313,122,86,212396,60340,152056
419d57a9ad2b95762302ae02cde24cec,65,53,111408,26236,85172,56,48,66970,23756,43214
2778a0353e05c18929328d4de8ba7c0c,139,79,219673,72676,146997,81,65,160674,54993,105681
518c8afa038a9d014e29d9435d434bf3,28,17,11329,3926,7403,29,21,18619,4471,14148
b0a0139c53f62c5ef1b93a36bc535a4b,172,132,539396,94157,445239,162,122,483154,117223,365931
795eb68245ef8b9b83ac713a0b437be7,32,29,24283,11905,12378,41,36,34116,9458,24658
f555cb53b706f3088b271ceb5312b31c,82,60,135546,39204,96342,60,35,105022,36381,68641
9d76fec308fa3d20087b0bfdfe0f8297,34,29,30025,16950,13075,40,28,41597,12307,29290
fe38137a10641f3e1924c253937b23f4,51,47,83142,18341,64801,70,45,70577,15625,54952
1326df45a57e578d70413ae97a725d30,47,38,57505,18109,39396,41,27,51871,13463,38408
91426d71360b0569f4f5300553fdcba6,35,27,39001,8399,30602,34,24,33495,7457,26038
2f87a81bafb10cbcd4357a5eabc1be7c,99,76,216785,24908,191877,96,83,129317,40234,89083
e695bd7063d2487520747b4aed87f3a9,54,39,60507,23897,36610,75,55,103619,22806,80813
90637ec4e3120ff73b50153c311b1aee,34,35,34445,17576,16869,36,28,32789,9133,23656
b8d9c2c7ee21c8ddab1c2ddd20fb8107,64,35,71147,15836,55311,69,48,81402,24776,56626
a13497a17afecfd98c7b833425d1a909,234,188,1205238,276917,928321,174,140,1829955,185023,1644932
f267196312804f800a56966b747c24a3,33,24,9620,4838,4782,23,20,8232,4797,3435
6d83f62d6b66bff9fe3f5f4f0c4bcc16,119,85,271504,50616,220888,125,87,276211,40767,235444
f768dd25c4ceb0ce56ac0290b85564c0,136,104,245312,96705,148607,187,136,436282,87006,349276
59ca0c284263f60583286b44ed111660,27,21,12011,7182,4829,32,23,15767,5230,10537
3fa9641ecb11c9deab0dc9c168f257f4,22,16,6626,3549,3077,25,23,11974,5084,6890
a01bdeba79414eb8d0e9636aa6ee7a36,14,12,7352,3100,4252,24,22,7535,3543,3992
57f5a3775ca6a1e3c2068d296be8e67a,99,83,182429,36170,146259,74,62,99262,32782,66480
764f950fa1cd5fe3a1a219fa844f0bce,96,77,198887,44088,154799,94,81,165718,55664,110054
8de68ccbdd2b91f86cb5201557392377,39,31,26093,14038,12055,37,28,25895,12847,13048
d73fce53e33737d81001464072918c3c,137,97,434814,106881,327933,149,119,402145,75135,327010
c3977280ecfd48aab12322dc5065198b,140,103,393243,119314,273929,122,87,266260,86985,179275
53402f1d30459fda0ef69e287cb9fe27,107,93,252381,67365,185016,85,64,146823,52853,93970
f797847f8a939f5a5ae35017586d29ea,160,137,563528,108029,455499,174,125,654228,88718,565510
6a46c28248e8e43e16509a0092f5e25f,80,64,134228,36296,97932,66,52,128428,32562,95866
b167d30f060663169a3f8a8ad6bde72d,212,125,611874,100678,511196,162,132,452498,129319,323179
9f46382307c412d705f3e98696eacc6c,109,86,242108,85149,156959,131,84,312720,65516,247204
7f26d3cea5cbe7c75f919179e11f61a0,161,118,486316,100009,386307,179,146,588959,90427,498532
4d1eda0c665f6d8e0659cd9709118097,87,52,166721,32919,133802,92,76,175669,39589,136080
b31dbf9b38a8962f8a038b6b08c7f71f,110,86,467572,92621,374951,140,115,465989,96359,369630
b380eb256a54ff6aaae3493ad51fafac,162,117,398679,63893,334786,163,133,397390,74750,322640
a52bd2253fa135d60bc4bdbba5fae41f,64,45,106726,28648,78078,75,55,107383,25019,82364
4414efd8dd363391840b1d13814fca5b,142,117,330735,104226,226509,122,113,286132,108647,177485
8e39d41bb7637a3ad3d16a8a14ede8d0,141,121,579386,101533,477853,157,103,580763,94653,486110
56c7586f531636abb7891081025cb063,189,163,573498,98061,475437,138,94,472764,81044,391720
fcf3a3de7573fbf5dca909d664c0a5ca,22,18,7247,1957,5290,15,13,2657,3200,-543
f977186e602acfaec612f7ce06f5df34,52,45,77418,24560,52858,52,45,57753,35718,22035
2fc62a0e77e91a848e2f7a2eb11133d5,170,117,329074,61909,267165,166,114,497125,46585,450540
aecf39c9e09c29708514c48bdbff0506,238,154,865379,75511,789868,170,124,711283,84691,626592
371d141f1e1ac5d110547eee7e05d13e,65,41,70714,19240,51474,88,78,113124,26714,86410
1b00ecd062ed135da33113b6af065f30,88,62,94075,23670,70405,61,53,95545,23178,72367
bd7b7e8ab48f4295ba2afc02910f24ab,74,63,111535,31395,80140,57,49,80678,36594,44084
cc2e545a172028e99eb55f1e535f58c1,136,95,225627,76302,149325,96,79,202853,51457,151396
382ba3cfd9e3d892c8fd86c7c5f75a74,142,105,316725,44459,272266,113,79,257777,37308,220469
3b3a6760bd685a209b2fb1740046e915,71,51,104389,35398,68991,70,54,107497,35840,71657
97f1531d6f0d055a983141da2df17814,24,23,10066,7232,2834,45,31,32964,7277,25687
67b6e6e81578e29a6b13a4a166c70ef6,84,50,133372,47941,85431,80,68,138214,42936,95278
d4c080bd3a10ce7d7fd3dd34941ac235,75,59,168520,61609,106911,127,116,331282,60575,270707
7695711b0d6296604efabd07d2727f60,174,130,534840,147525,387315,157,116,548530,151850,396680
d8492447a61a77e7f54188b669d7c3db,168,137,604890,134645,470245,150,127,582292,134216,448076
7006f685e2260624d7054c8806a36b3e,27,25,23233,8772,14461,30,23,19448,10990,8458
ad7deecd17f7b2e535459018bdd676e9,115,76,215319,50003,165316,111,71,174165,39916,134249
4412f9dffc9c3ab621d49ed228ddf13c,167,118,406555,109539,297016,114,97,256941,86710,170231
75b40b9beba4c5d7b77569fa042f5905,117,78,227329,84455,142874,177,123,379661,61886,317775
c982b84b12158e7bedba0335b2f6f0a1,41,36,61750,30329,31421,46,35,76879,25336,51543
173f0b96f45a6632b58d876667d8b328,33,24,28533,13631,14902,34,29,31492,10789,20703
cd4952f1238ba1ada39ce5d6bd50c5c8,46,42,52237,15516,36721,42,30,30701,13358,17343
374997bc63c1059098918c62c31cfd9c,113,69,224682,57675,167007,161,98,307971,53913,254058
a8a09f71586e7ab4e7626d85d921ba21,167,134,570012,92313,477699,161,96,432204,56258,375946
f3397d252a3d03a6392e1426147114d9,193,147,603649,99174,504475,156,87,639371,79624,559747
026fde302f131f26f14bb3d5a6d38b26,160,110,450122,114319,335803,140,104,369158,103003,266155
211fe95da7b2b38f1c05286671d40a68,188,142,466844,80093,386751,209,140,506641,84662,421979
5de00fd16142ab69bd34db7396d436d4,118,87,311260,67479,243781,169,107,438706,53972,384734
67d2cab5260518f9789c0b7037f83b28,195,141,704741,149493,555248,224,151,745623,123049,622574
04a84028311411cc94377c5d182d7607,122,103,278717,84270,194447,98,71,261250,49831,211419
f4f772321a2ae36a12a4d0ff7eba5dc4,41,29,33017,7398,25619,35,20,22335,4539,17796
aecb5b8dedbca60c04673abc0ccb46b5,63,46,80458,24630,55828,63,59,96838,32660,64178
1c1dd70f4e773fdc40907e5b3e3e0e8b,106,89,240869,71118,169751,147,111,396078,62456,333622
cd58d849a47c4415f28e22ee5913b999,46,34,62155,14169,47986,63,54,89278,19168,70110
af04939d2bb3b156b5cb98e8b4219b18,59,44,74425,17229,57196,60,38,72030,16374,55656
f879dc255db84928998b8d6120351d5a,148,93,315474,64418,251056,121,73,268439,67430,201009
0e445d705a2a6d3dcc961dd249526b9e,27,17,9099,3539,5560,28,24,15492,3258,12234
86aa2cbc46af30dde4555a50bb560b7e,26,19,9400,5490,3910,27,16,8616,4890,3726
e9afe4dab02e48fe5e751b5ab6f0ab52,62,54,107442,46441,61001,82,60,130273,44263,86010
ed01b286ed34e40d0a93e212dc7d65fb,47,34,41770,14009,27761,47,35,33706,13515,20191
132c73ad5ac9be97b439d92d5ab8e127,33,25,28096,8447,19649,28,24,14553,9877,4676
b306e413bb2596a7d69db25c2e9337bb,23,19,11718,5789,5929,26,22,15883,5639,10244
6ba768f20d3de571547e6e297f733c64,104,97,208103,55560,152543,138,114,355331,51704,303627
d7cb69959823ad136b6d71f5b211277c,74,55,115819,34326,81493,80,65,118946,33643,85303
217a8088805db205bd5d977137127f8e,183,120,488992,69203,419789,165,94,383775,38808,344967
0578c2651b03546c7627051ef090c8d9,76,65,112251,28061,84190,73,51,90437,24426,66011
498a3085edfee0d7854d23c712d32d09,109,86,283429,78518,204911,75,63,158049,100149,57900
6bc6bf0ea58eff1de7e981380383e89f,139,94,343631,69092,274539,93,68,204646,73755,130891
ef69d06cf88b523b4e2f99553ce49519,33,24,30524,9245,21279,35,26,29307,11698,17609
7e750ed89f6bafe9e2a5dea4a1336399,31,26,27971,10730,17241,36,23,22204,5283,16921
daf02c5e06ca1d31727bc31b93c6dfea,144,91,340904,62667,278237,137,108,320709,59044,261665
eacf06418c16ed6570816cb07b2b78cc,75,57,100857,29910,70947,106,77,128188,45501,82687
4ed70af1f187d29889dd0cbc14e8e221,2,2,566,506,60,2,2,137,150,-13
695392c1efce8ebb1a534c4e6d796f63,90,67,114766,35068,79698,104,83,153557,52147,101410
cbfdc4296e0a0e35589b194054d0efb4,134,114,318273,72536,245737,119,89,276554,70037,206517
162a4f4be20b94e223a06af4ae2512f7,117,90,254575,80111,174464,114,79,284390,72114,212276
960e40a8f8be08b2c1da81a2006becb0,21,14,6773,2627,4146,19,20,4732,4525,207
65bb6774a31a9b51bbfdf6371fb0e3f3,72,46,113775,28169,85606,63,51,84157,41622,42535
146063ebba77df5c3cc72d5e48f53443,165,123,462738,74323,388415,131,108,351699,84442,267257
205a4fdee635c58ab484274e1a212024,12,9,1675,770,905,12,9,1336,1032,304
52b470f2f90a7022c02815803f272d7d,49,37,50848,20586,30262,61,30,68450,20147,48303
d293e44178f30f23f66eb2f22f6ab2d4,177,143,529310,105640,423670,109,91,268105,104096,164009
aab59450f7e67dca38a8b34df72f157e,40,46,53924,25593,28331,52,42,65647,24709,40938
e45b9b1200bcb610a19f1ddc0009115b,69,47,65008,22872,42136,68,57,68653,17416,51237
6fe5dd02a6468475ecfce718a7f7c06c,148,114,354141,74872,279269,151,108,369598,80312,289286
17a29913fb7952d9e23d99158039bb10,86,60,134426,32824,101602,121,104,190233,37440,152793
b420ffea963087bd4c795ce51eed6b35,122,86,230337,57892,172445,86,67,189229,53022,136207
5afe7785eccc39e38b84e54455cbbc46,70,47,117658,32002,85656,78,66,132044,42236,89808
e7867b109efe3fce3f5c042e42f9f897,181,131,807199,117944,689255,183,147,634253,100290,533963
79c035a6bf1f1ee1143743f1bc878ebf,149,116,359667,108902,250765,71,57,193621,91330,102291
4f98984e2e58f29fc0032a7d003638b2,141,97,616121,220154,395967,210,159,955043,209210,745833
d19f1b40487820407cd90d283f1e2909,76,61,133740,42267,91473,81,73,150698,42326,108372
8e43160e0f3f0a5da336a15eb69d18e0,66,52,128605,40290,88315,77,58,140341,37604,102737
fcc9ce4765b7705367e8f23edbe2f719,35,30,26101,10305,15796,42,34,24476,9733,14743
cb5193c7edfcf99e1d4374dc6764d462,114,110,240728,72139,168589,140,110,300817,61824,238993
0eda04a68aab2ff859798c9a559d2b41,75,50,110056,48183,61873,73,60,125320,39696,85624
b4c8f2b501b2f5a56b5a5107f195b962,31,26,13332,4945,8387,26,23,17201,6294,10907
55b3b1746d673a61d684d9a9e9100928,110,90,236849,66904,169945,145,105,298790,71131,227659
0820944c500b3479d8922e94c9a120eb,46,32,49506,20437,29069,50,35,66841,22168,44673
1af41016eae73cd8e54a8906126c6b22,48,40,56875,16640,40235,48,41,40034,18071,21963
d5a4ca4d3150e7b18d585ea9f09bff5d,146,114,504165,117021,387144,220,156,743520,90618,652902
d27c05cb0859364f2d8c6ebd35a5ce89,192,135,542846,104977,437869,151,110,459362,111972,347390
2a51083f81edd500ce37f5a628e9ec9a,46,43,45135,20551,24584,43,36,35019,21125,13894
0265b732a1a70fd94d776436e050b51e,31,24,29168,11845,17323,35,33,39527,14076,25451
70893e98bbc4717265a0de42666da58d,66,48,110392,19627,90765,57,51,57738,22934,34804
895020b7ac289f69f4d8e8d2a2888907,126,100,228787,39799,188988,104,76,154516,36547,117969
884a98231c984b443aece5f88f0b967f,57,43,83274,22814,60460,77,53,69522,29885,39637
2372d3e8f9caa04deb52cdecf3f45d18,99,73,156642,51362,105280,87,69,124913,56260,68653
bba8cd85fded3d23754e2f683f042139,118,94,271165,98640,172525,147,111,398471,59220,339251
cad058d34e1f003218c1cbd3578a1cba,99,59,142184,31675,110509,82,69,129868,38242,91626
dc2d8e32e3d7a7a5243f0c61b0ab69be,124,97,286253,85404,200849,130,102,390508,83612,306896
e84cee3a98098941c901a34c54df16d9,110,72,336362,80761,255601,80,81,309066,119954,189112
442a06001229df4f05ef198981c3097b,96,70,189243,29596,159647,94,69,127141,39878,87263
df3991cff7817301160d7f08fce85af2,125,91,334092,70826,263266,151,114,420900,78657,342243
1a2d9f2057f5a70925f83af464ee61d1,33,24,24779,7393,17386,28,21,17646,10776,6870
c6ff10f1a7b08f9dafb50a66ed262ce2,122,93,272299,51335,220964,99,86,221502,64650,156852
9402531241729d7720068d82f133c234,111,87,170721,46300,124421,96,70,182075,59001,123074
44668c11271f8dcefdb1032ca97b5be7,120,85,175686,42061,133625,62,60,76337,44196,32141
f5848b7c0ecbc4473c10be8c077adc91,42,37,41666,10423,31243,37,31,39343,10557,28786
0f5f152d59a6c2c1c6a56bf1e5c28424,39,26,22958,12466,10492,37,26,27685,10864,16821
1719187b2fc3f355bab6d11b3517ca8c,80,56,161520,37831,123689,77,55,104380,44505,59875
94250561fb0efdc021a6f6699e1d0e7b,112,92,298621,98213,200408,175,110,434236,95647,338589
8d536291ba23e53e876530d90d58977f,26,24,15326,6758,8568,23,16,10075,4093,5982
7dfb40b95bfe47aa23f4185cdace5eb6,75,60,104988,29349,75639,66,52,102167,29672,72495
230f02b503f313fe95ef4d2578f5b99a,39,31,43542,19700,23842,46,38,40748,23717,17031
49cb5e6f9b63bd8803d25fc9c0a5cf35,119,109,253500,69963,183537,100,73,178321,51086,127235
062d4b8d12a1673822597980997d3492,22,17,5359,1897,3462,18,13,5349,2422,2927
e4157ca5bd17ba3f17262bb0c38840e3,51,37,59346,20103,39243,49,33,60342,19089,41253
a1bcac4061db49896c3b6084d71ac188,38,32,64216,18196,46020,62,53,75321,24688,50633
bf795c882b9517aad3f52b3afd07bf4d,84,75,177900,44307,133593,109,80,201335,49020,152315
6fa3a90464e7687540351c55568c3d39,62,41,83526,18775,64751,66,59,101801,30800,71001
f062f9e56e637d6ff4a62d3b45319d01,46,44,77826,25230,52596,68,59,94974,33237,61737
5fa3210c2f8e93f3beff0d2477da73c5,25,18,16109,4531,11578,30,21,18086,5713,12373
d769a2507e0d4df7ba96a28189769132,130,96,267397,58241,209156,127,87,213367,45876,167491
e3d600ce6ea52b23bb84dfc20011da3d,42,36,46304,18680,27624,46,36,42096,18010,24086
4de1d92c751db6a895d8d0f2dcc2d58a,95,82,169850,49897,119953,105,75,182346,32956,149390
0f6ffd948e6d7c2cedbbc0626f3b3b61,44,34,34448,9869,24579,39,35,20261,9728,10533
887bce2f94f53d497beb3a55630b75b2,31,24,20027,10022,10005,36,29,31593,8786,22807
0f2a5b5027ba6d4e50684a81d0d3f13c,84,73,132086,53182,78904,76,52,89373,47970,41403
2ac4a1bbeadfb54ed8b0b1f5c7fdaee5,180,145,427467,75356,352111,135,110,298390,70295,228095
49355a57282339674189eafc859363e6,115,83,188105,35049,153056,115,109,172131,48614,123517
09778e72c9f36ecfb4690c9fe183b379,115,72,191972,37240,154732,117,98,212069,53441,158628
5dba41002314f5ce7b6d00b5be9ce8d2,115,83,283225,76347,206878,144,85,269159,88068,181091
d10596202d2e4be2414af0e3127f550d,79,54,147501,36013,111488,92,73,141593,54010,87583
d00075b8f9b8376c45ff0c3e75dc5ad7,106,87,293466,73456,220010,125,119,318685,94358,224327
b1e6a9b5ab6be73c9941f8c69d08dd13,33,29,28674,13049,15625,42,31,32234,12978,19256
19e92cd199961fc14d934614f3759c7f,84,66,161630,32804,128826,49,41,87258,45944,41314
8374d9a4cd1ea020e0b36db21322f074,77,62,192487,67895,124592,135,115,311297,68138,243159
834536e284939c110fb703448672774d,156,103,341884,64429,277455,138,100,256093,84281,171812
c93aeaea38df427136b2d131e7af6369,18,12,3817,3567,250,17,16,4297,3120,1177
079dfeff9d8f475c7b0c8339229bd620,27,23,15625,8315,7310,27,21,20667,6568,14099
fbc4b18c5fefbaa05a2831e2a3d13c65,123,81,280645,56339,224306,132,84,216547,49165,167382
eb6404a9248d902b5d29f1a1a878ccf3,157,121,435392,70681,364711,159,111,386513,53499,333014
bb86b14af17d846a71a4b2ee23f2c000,132,102,339197,65008,274189,100,81,311297,71023,240274
8848e1834c24da7c43fbcb2ba5cb0874,154,116,418643,84248,334395,144,124,518748,117382,401366
7723aafa55967e41b40c144dc5ed193e,37,29,20325,5755,14570,27,28,16325,6393,9932
d72ae480153fba76575c3eeb3e8a6154,122,80,335495,74650,260845,147,110,439813,85131,354682
4c9b757299ddaca918a336a733b10d2d,6,1,513,139,374,2,6,192,513,-321
3c70c72e5586654292bc029b21bdfc67,24,20,11793,5419,6374,28,21,11308,3822,7486
e58a35acb5392a1d3e7936f23e984f93,96,63,182054,54647,127407,128,84,232782,49366,183416
f7db8ae804fa55a17b007e3a142403da,95,75,123841,37310,86531,92,64,114337,24658,89679
51880d109b742aafebff00424f6b0777,54,43,56621,16095,40526,35,34,34466,20768,13698
1f256d6d52fb2e151da6db7a06593ec8,73,60,126853,33776,93077,58,41,80892,25447,55445
9caec5bde8e3991156d8685f594c2f45,22,18,6445,2694,3751,21,20,6481,4597,1884
5eb5f620642b3bdb891e1b9928800e46,217,163,1073848,196439,877409,231,171,1439474,218738,1220736
109e2801f9cf8a0bf3ab38043560c1ff,55,55,73993,16182,57811,49,40,67300,29890,37410
5ca27c2571fe868b21c5354f79bfa337,65,46,98382,16516,81866,52,44,56564,24001,32563
4e9ad95551dda4dc0efca1870627c69b,85,69,138370,44275,94095,97,59,169912,31700,138212
ca713524011e7bc3dc6e47dbc5dfa750,109,77,204970,36165,168805,81,74,153696,48318,105378
82e1cf58942875987059537f358f0412,40,29,37421,13993,23428,40,34,41476,15668,25808
d3e66bb7dff6006262a3ec5b2f880462,69,60,121901,36004,85897,62,49,101842,35981,65861
aacfe5e286967bf33d1b7b3270b2d054,120,106,249905,51571,198334,112,97,255589,45515,210074
775748ccdefc1f4765252c90d337db38,71,62,157574,43352,114222,108,85,203903,51461,152442
0df15df364ad0bca4feb0513cb0a9576,84,66,179627,55216,124411,90,76,188632,53424,135208
2733eac929149630798b020d9fe78f50,29,22,31724,8920,22804,29,29,19350,10396,8954
23dbe36d11180a469b38d9ae00402bad,110,100,283117,100020,183097,115,68,282743,68152,214591
f51e66e24d883904aa130f336cadaf4f,44,34,69150,17313,51837,59,40,93149,17295,75854
d585c9edcf26892a2990f1183dd90f0d,51,40,63622,18416,45206,39,33,53283,16146,37137
f11d28658b4b5ff042642549522487d3,101,70,190229,58293,131936,96,69,192098,60480,131618
79ba584b7aa790eb6d5a6a9246de5d20,180,135,426763,121292,305471,151,115,509590,108408,401182
87423e4ec82230b5a2b54be82cf65947,45,28,28772,17711,11061,40,34,48238,14365,33873
d5608d1dca6d0e45c7e8458dfa46607b,162,109,473925,172024,301901,218,131,770341,184106,586235
8f34f9d15f9a08ff4968f990a6e0600f,191,116,689854,91371,598483,192,131,556483,94116,462367
8b416a03258b183bea2f5928bae8d05f,95,75,212485,97763,114722,140,101,358409,74881,283528
09a86b035456c78f567344a98c8c9048,89,76,165109,41802,123307,129,105,234336,53701,180635
7f11d05a9391381ac3e0e50836e19780,107,87,297902,80007,217895,138,111,330032,73645,256387
ee7597efa80f29055cb18d798fb2d30a,86,77,152799,33023,119776,93,68,130217,33050,97167
ce0918c4f169d3aa5102657bb084e222,70,50,117261,25015,92246,64,51,87273,23288,63985
4de7bffe6e719ad6f04126f5f0bb8650,15,10,2026,1472,554,15,11,3305,1389,1916
436017fb8540786e2be996d922ef21eb,122,86,284980,79974,205006,136,92,291897,77759,214138
e49ad59e48d74d22543fc9b7f86db668,183,129,761209,142072,619137,228,180,785511,175292,610219
025f40514d87f342638b0eb27e267628,68,63,110499,39525,70974,98,74,134713,42561,92152
dadf851a225ac17e408d68bbb2012f87,138,102,435212,85622,349590,122,106,352605,70322,282283
ee5d823b81611b1436cb4c2a8af582b2,59,51,69176,30256,38920,56,52,104903,35759,69144
5ff7e7209e9d385ec50bf290f05c7dec,89,64,184349,41870,142479,102,78,178792,49663,129129
9eace2ea0f34a371376fe1893bd0fec7,42,35,48837,26516,22321,47,32,57225,23549,33676
11a5f5b6e1404206d6d1ddd6ddf88b64,137,118,333897,52060,281837,127,98,276294,46075,230219
c63640cc72186cca8e55640ecf5f092c,119,98,307590,80205,227385,100,85,274306,78889,195417
f72b34c35241b8ae3712b047b0b07d8b,16,17,2350,2215,135,15,9,3381,1289,2092
439da3e513814d5c0eb7bf9f16db3318,9,6,953,814,139,11,8,1406,730,676
aa5007cead6d4e8ded8bf331186fe6b5,109,84,184592,36832,147760,81,61,129535,45525,84010
58b909cd96e570bc7bab8beb1cf78197,103,55,156189,38815,117374,92,57,164617,35854,128763
a71cc663077158503cd1f676c4e56ebf,127,106,267800,91988,175812,115,90,269223,60013,209210
aa11c5987b2c5fa5e9781aabc3c9a72a,53,35,76485,18279,58206,56,49,61406,25759,35647
ac0fe699f95789abff6ef54b022956e4,115,87,294001,72011,221990,131,116,358797,72251,286546
66295208cf9d818a9751651bff83b88b,91,64,191659,47972,143687,111,90,224564,47948,176616
a18a0996a5a41cdbc348877d158d14e2,175,122,740103,147855,592248,197,122,732426,213519,518907
65f306c1897b83978b69d0870ac24f60,53,40,52005,15560,36445,67,46,55194,13306,41888
05c9200adb0a4463358757a6565db8c4,61,49,40678,25744,14934,71,46,83531,18080,65451
ce9f3be143a27a3f554df2d77a3e4d98,97,89,154850,37092,117758,119,91,183491,47111,136380
2f00203dd8069a49152066259e315f87,136,108,325156,64744,260412,125,93,255968,51271,204697
48081187009e3f1d5a616c3842e185bc,181,135,580437,85131,495306,126,92,295609,71434,224175
f1916b3d99b07a0186a96c9e8d312645,173,120,479539,117155,362384,161,148,490224,116162,374062
198e0b1d1c5f307714e22a5e320421c4,43,38,48483,13966,34517,39,26,32851,9751,23100
bf1d13fa05c0ad626e0cd356b67a16db,65,55,97204,32498,64706,70,50,101695,27501,74194
78b9dbd3d66ff0347b97d3b16a27fa04,61,37,64517,18174,46343,57,40,54542,22888,31654
fcca7df928da72bd92ff51f705195a90,165,104,667528,105924,561604,134,106,490186,160130,330056
fab2a5af0cc5d13eddd2b66762dacd7e,163,125,844762,190255,654507,155,125,680391,184540,495851
ab10bafbd768a12ab68b73ccf4d5619e,27,18,17704,4342,13362,27,27,12500,7118,5382
3addf0e0c7da216e109cd0d1573964b5,70,52,144457,52857,91600,99,82,215938,53064,162874
f441f936bcf7dfe5e10f4348cd32f249,71,62,103809,45900,57909,82,73,124461,28302,96159
7a0e390fbfd28033fc55863cfdea81d3,209,148,1520210,283359,1236851,236,169,1112362,263688,848674
6f7e772d34670c4accd1280883e9b194,27,18,16841,5025,11816,31,32,20275,6516,13759
bf35556523ad3abb332eafd04c807b1f,43,43,35807,14626,21181,37,30,37384,9817,27567
b3596f545d17250f8e74967c709244b2,96,82,238947,66929,172018,163,120,432205,68458,363747
fc09703bb8d68fc7ea24a541939a5df3,151,105,380750,83703,297047,123,85,336496,61207,275289
0acec491a16e8318b743b97b4fa1df02,8,7,1066,1083,-17,7,7,1083,733,350
a443ec64f24bad6569822edf8a831f66,153,102,629975,111017,518958,219,137,756259,141382,614877
fdd048083c258586c1601a6ebfc416db,121,91,268384,45450,222934,143,102,322403,51286,271117
750cb56b66b98b0049424679ce9db72c,48,40,53531,13398,40133,48,36,35415,16368,19047
ecd50a02f20ceb26456d567ae9fdea2b,106,78,277738,80593,197145,123,103,424715,119018,305697
1c1605cabe0ee061be5cbcaca5adf6d5,109,94,231277,70845,160432,100,85,231315,64981,166334
289b361dab07ea370f9cd3594e065341,99,76,238049,31231,206818,97,85,197528,70370,127158
f72f8ff255d9b2e4122644b1160d6862,28,25,18661,9288,9373,41,30,31543,9235,22308
266f7d71555cb1916bdd563506303a28,49,31,63744,16209,47535,56,39,51841,19724,32117
a90670461359c6219eba2a7a191369b0,54,39,59446,19720,39726,59,43,62493,26281,36212
8b33197554d2220f43b57d06f3f6202b,23,20,10543,6432,4111,27,21,14342,7254,7088
14f32f459addc89cbde8f64707e6a4e1,53,53,69162,22424,46738,65,48,78360,19108,59252
892c41874144adf4cbf1afa5526516ec,58,48,86934,16870,70064,37,30,57241,11566,45675
497cf539bfef8b2a73ffba9dcbb4f606,87,72,130659,37802,92857,133,85,247077,40652,206425
8f04f7342b23c141406e43c0420616d8,186,141,564785,139226,425559,157,116,478417,116014,362403
f7fcdb5149702d3b7355754397bae847,111,89,245702,69280,176422,109,91,325055,68972,256083
d92ea5790d3fce3ad1f10256376c949b,58,41,112106,33073,79033,50,40,77272,37742,39530
30d7ee4a9c4185f7b1a2cdc6d6c17d09,34,21,28772,11116,17656,39,28,29614,12291,17323
b82c68f8b3bbba7f2c7615fcf6c15b03,150,88,312429,86903,225526,156,111,383029,94491,288538
af79f1f9cc135824aa790d4dcb2c54ee,103,73,135878,33215,102663,86,69,124938,32515,92423
4591d436fb6ea0d4036e8459150289ee,186,116,628635,87062,541573,200,132,655989,82475,573514
dda646c8e91b0b262ebf9c1dea3ebb0d,34,30,33757,10705,23052,50,39,43696,11032,32664
8701e27b5ef577c9a9576fc8c4869146,131,116,269190,83793,185397,102,68,230529,52805,177724
61f0bdf375896dbacc675729374b3f9d,43,30,45190,10064,35126,57,50,63566,17143,46423
4f8dbd20ccb2d8b349bcd6705c5984da,96,73,159404,76556,82848,146,97,260041,49626,210415
62e0d7fb0d4fa68c341b783e2b917363,29,29,50403,16752,33651,28,25,37908,19770,18138
bbc01dd298159e0c79dc78a715721c9c,93,80,174424,44450,129974,114,84,226232,35353,190879
082c504fba527ab89dd99da08c0cb408,72,62,119121,32073,87048,51,34,65258,29586,35672
4101f200d57cd19d237237bd75eefb0f,161,133,732600,214063,518537,204,134,737510,162134,575376
7c622a0c163594eba13dc592759da9f8,78,72,169906,65552,104354,117,101,182022,69400,112622
3c6a5398de19f073c39a3ebd30d1c31f,160,130,531905,96827,435078,99,80,301893,78132,223761
1562fe03666551de9691cc8b08f40663,28,20,15639,5114,10525,32,26,17816,6830,10986
2075ad5aa184fc815c618328f524c750,88,66,222712,59606,163106,96,75,187773,52332,135441
494ab2068441040c542131b1bfeff1ed,138,106,396343,80543,315800,194,137,669451,69171,600280
eade62bac99aee79a1f9d09bd83710a2,123,73,169007,31430,137577,111,86,156345,47212,109133
eb4544b820c87d68f85f4cd8f1ba71c5,52,43,56320,25626,30694,61,51,85577,20795,64782
9909e70e415f035c74f6524590b07f1d,54,44,47199,26189,21010,79,63,126255,31961,94294
e55394248116800dda54bc34cc9d5cca,27,25,23423,14920,8503,40,27,38518,9743,28775
49b8b9e14877594e8b059f3eba4d92c2,120,98,253894,58944,194950,121,87,177183,36712,140471
5ba5c0f077c83e4f584c792d719de1e2,31,25,18499,8603,9896,30,25,26682,6568,20114
8129466e44c6d94d80f6f0bed8160f5a,32,24,21782,9992,11790,27,22,22971,9715,13256
02c251aa8e5de8f1707a6aacea9ea936,137,108,340308,78146,262162,105,85,252197,74292,177905
3686194f40731d23455d0ca8da4bdb69,76,72,104673,40362,64311,60,43,68013,25794,42219
b3972c3140ff280faa52be16c7ceac63,126,93,399026,96621,302405,153,130,409153,85934,323219
2135b2733019ecf509540b41b8b8b3a3,50,40,98827,27875,70952,74,47,97691,32633,65058
8d3321276d2b66f6323d08022de9619d,30,23,16754,8884,7870,26,27,19499,7418,12081
c3b698c5fc45fbcbca00c03280762dcf,157,143,568297,159365,408932,168,119,521172,127967,393205
a343d1864b7839739a5dcf5cf55f3917,30,21,10809,6021,4788,33,28,17151,9871,7280
0d13f5568db4707007124b60e414c6e8,189,144,570973,138378,432595,158,112,495434,133115,362319
a29005b795aa2530effd88e06f01cebc,120,84,190718,36905,153813,107,93,173513,51858,121655
2dd65589745baea72b2244012fcda481,22,13,5786,3438,2348,29,18,10571,3433,7138
5f49ff33b7ba3057201d6cd5c77e413f,23,23,28674,9314,19360,23,21,19258,10948,8310
7ecdea055d51dccb25ae9ac3ae5cb03d,113,88,219459,45459,174000,76,58,114038,44438,69600
edd7dd8075e453901f7ba48588d9cf00,23,22,6529,5120,1409,22,18,14297,3880,10417
cb7c39260fb176f9e07e941f6366e679,86,67,188097,61016,127081,119,91,212854,77964,134890
abd83c32dc52ccb6623501d727b78421,177,138,600585,168075,432510,182,151,656880,133059,523821
974fbc9546bf19a6253123a83875328a,44,45,80582,15727,64855,53,40,66148,18557,47591
fd9963bb5bd8edbfc06a57a40297a721,88,62,161690,43068,118622,102,77,152861,50820,102041
9088cad666ec847f8773212a50533996,22,16,19765,6052,13713,31,22,26947,6937,20010
dc5ca8c1897f26c3be9086c51dfa2c5e,19,16,13995,3283,10712,23,23,11105,5603,5502
b1259dbd78c0e36cba45c2f567c9d3de,219,160,901258,149708,751550,163,142,907465,204474,702991
fdff2b948d06dea31d7d420690971f87,114,90,164107,30611,133496,65,58,78873,28539,50334
c6dd08eff7ee8c8ad717574367461546,140,100,796839,87696,709143,161,128,411437,132658,278779
42e5822d83b76aa145ab6ee36c1ff6c2,153,108,432598,87626,344972,177,121,641829,103629,538200
725f908729ad27fa4cc9c5ad786ff99b,72,50,97022,29192,67830,66,56,85172,32711,52461
b3c728a8c76f31b8872b8d05c3a0840c,113,92,315692,69292,246400,110,89,305201,65249,239952
985c80637dd2f6d81c05092e984c3811,59,52,69980,26516,43464,50,37,68443,19119,49324
e0f57ec903b085b357cc6c740c4f4945,76,56,109710,30815,78895,84,65,87744,29703,58041
2bb60c4fe142267142b74203a7646dad,169,134,367925,51765,316160,110,86,251139,47518,203621
3a3b009e6273dcaadeffd4e6b8b0cfcd,62,41,62342,14540,47802,57,39,73801,12559,61242
fdc96fef86b538917a0bed5a92ffbb59,150,96,328896,75131,253765,129,117,309306,121951,187355
760b87314dc699dca6ca28678b7a6c85,68,58,74318,25778,48540,89,66,131977,25278,106699
4e23fd7b77aa4f7f31a787c8c3b5cb7f,51,31,82817,19711,63106,75,68,121682,23912,97770
bcdb8e0a10cd8b2911adc4c72048b64a,59,52,121015,53401,67614,154,96,230334,40219,190115
0ba98f26ecb75cd52541457a72c6e246,107,93,219398,69464,149934,126,93,325433,40479,284954
2f2789fc8acd781108bbcc404101c346,55,31,53067,11946,41121,44,41,38197,19310,18887
b7562bbf4e5cca332f69b04cc0265a34,55,47,57429,18919,38510,39,30,40799,10621,30178
db27efe90135b2ab225deb356bfbfc9f,167,100,429532,85531,344001,172,119,590724,117988,472736
5c8400ff5be330e7e995f148863b0c9a,101,73,226467,56857,169610,130,100,192622,67374,125248
eee4c5caaf123eb7aeccae51fd19287a,36,28,42171,24493,17678,39,34,59147,21554,37593
9e9a82f23879fcc765b06a763dd082da,89,75,159215,47792,111423,89,75,124809,45776,79033
2aedd856733bef239fdce24617e7e60d,175,141,375343,68431,306912,98,84,207492,81377,126115
5b70e9017a9f654c490404560a119b3b,181,123,611075,94203,516872,169,129,532994,139401,393593
1cd5d2afdad35d2db48dacd22468348f,115,98,326361,73743,252618,116,102,280929,77353,203576
a2a826dde5a230f163e5d913722e0dc0,5,3,287,214,73,5,1,476,97,379
7a86d0e89285640c533808b205296b96,164,126,518863,89622,429241,175,126,463838,84028,379810
69d4f27dd1dd13f59ed66b3c7cb76e44,156,127,404760,106953,297807,150,129,526448,100917,425531
07e2e45eb2210df6d76f5d7375138f0a,121,93,348446,109654,238792,165,127,631717,127600,504117
844faa6c574cfacdf4d3d99ad6ce54cd,135,104,301468,91277,210191,137,92,398230,80217,318013
0ed8becad03833090cd6ce12da4c6682,95,72,199862,39842,160020,97,60,175323,46477,128846
920e326d149fa0e9410c89296ce00920,48,36,42688,16123,26565,44,29,43835,11217,32618
7d19f138c15caa3c1cddaafbb195da4a,101,73,161970,41874,120096,91,73,122658,38104,84554
ff1ca635784dd1c8e79efb66ef459a20,51,47,36813,15270,21543,54,43,45906,14753,31153
d0157669b1d00b90b0f3200a7947185e,48,36,49200,13332,35868,55,38,56543,21632,34911
e05b950aabe38fa8a89b0024c7ae285b,186,113,402321,123492,278829,113,92,380083,86174,293909
2d614fc477feda1cda26640697e54619,107,77,209961,67937,142024,159,77,313010,86136,226874
20d9211befb1c93f0b83795630663749,64,45,81341,19082,62259,47,35,67119,13682,53437
ad6b6ec1a456b4d37ad09643ea5089ec,68,51,72499,43116,29383,77,62,133954,36227,97727
b46e94952e78113f6b27b4cc674b6daf,54,47,62879,31536,31343,56,50,76709,34591,42118
ab908c9261d1b94f29ba834d0267560b,84,62,166694,40297,126397,119,107,196103,51932,144171
a849ee0d7c79629d6c9e89954a6facc3,78,60,165294,50985,114309,138,113,315182,47483,267699
ced3ceaf2d9dc7e3061a7ddff6ff767d,58,37,63555,18574,44981,48,39,56628,16277,40351
f68eb7d3481e6a381b1ed731219f2ae8,46,37,54008,18388,35620,60,49,75246,20811,54435
29c6a609197e088683517cd6ac4f49ae,44,42,41785,14018,27767,50,40,47658,14292,33366
244a623a59468f9b885281a38c59c9aa,44,37,51843,13730,38113,41,27,44278,14090,30188
f693f3983f020f14c1acba3c77c597b3,94,72,192067,67304,124763,110,93,238455,65996,172459
1f71a6773641aa28cfc5d00e24583989,23,24,17859,6405,11454,26,20,12914,5294,7620
d6f1b7875657870ed25bf06b0cd2840e,22,12,3041,1253,1788,17,15,3692,1359,2333
d2b58d737d0d199ca902fe4faa630421,94,83,239094,42606,196488,91,67,153651,53687,99964
637115061dd8d5639f5c0b1e7c7fdc0c,101,92,222769,59375,163394,98,82,221652,48707,172945
7c8ffa80433d06475ce3f353de8e859b,66,49,89032,30140,58892,77,47,113232,27285,85947
770854ae4b370253723d7ae12080f192,72,55,123236,36470,86766,62,57,73331,37414,35917
9b9dfe6d1f103b889358826024160fa0,114,86,322076,81319,240757,129,106,382746,104494,278252
56b35283d9c2a88ec75319b17a38e83b,88,66,148870,32012,116858,85,85,154318,41614,112704
d59753eecbf3959998e79ebe34d78c54,71,49,174837,53913,120924,128,92,312369,53895,258474
d7178f5dbb138a6eacd2ecf37c7b182d,169,142,639061,95291,543770,175,129,464457,75284,389173
c61f89b4fc60d943fdde219375bb210b,43,33,62565,21825,40740,41,32,72080,15096,56984
964776dd62ebc5db9a57bb9fe6cd99d8,99,70,284455,81616,202839,150,125,400077,98411,301666
f4932ae215e44c4244bbb25e46368c89,156,112,404796,104629,300167,166,130,434952,87383,347569
070bcc897a58735a25901caa0e28f0c1,125,97,369135,78752,290383,175,142,700533,101968,598565
3888b41fe5a6052e869786f838311872,123,95,272550,57580,214970,98,88,240239,66277,173962
b504ee4b50ff3b93bd2dd46a63fa6732,77,57,92076,25168,66908,70,41,66381,20272,46109
88d35fd4015053f92651c740549c94e1,94,64,180274,42734,137540,61,53,101047,53366,47681
0ec541810cd4b0eb66b746bc58a98e71,143,114,496092,104065,392027,144,118,435324,76585,358739
e2818d5fb063ec0c5a97773b07b559d9,40,28,37320,23108,14212,42,32,59250,17512,41738
704414dfb587ba57ca6bf2341c07fbcf,112,89,199955,66353,133602,98,81,218057,55648,162409
3f14c3b8d6ea19ba21bdbd925916eb08,184,119,450634,71174,379460,160,138,370198,97731,272467
9c7910965513e3e06d6c3ea2091d07c0,49,44,85382,37954,47428,77,55,153218,36565,116653
97746a6bb15759bb151ee664e861958d,72,67,125042,35714,89328,99,74,120084,35722,84362
a02c17d5fb1f61f9c184f2d5fcf4143a,31,27,41300,10835,30465,29,21,18410,10216,8194
dfde56da67ddb1dcc8f723c3e3583792,70,59,110041,25559,84482,81,54,102163,33072,69091
8023851d77df49fc5577ba82685b048c,165,118,469055,73117,395938,155,122,368934,117369,251565
b483df02e6e7b3ac795860ab9356828f,178,145,675837,129326,546511,145,112,486156,101204,384952
7daf06ac81715bb0b56533f2c7816cd8,178,122,885080,140101,744979,233,165,874786,157276,717510
67e9685677959ebcab31caab6de1c6f4,20,19,11522,4324,7198,26,16,9118,1985,7133
6765559e29fb0113fd31bace52c647f6,124,99,339771,87898,251873,198,147,487713,68955,418758
16f87c78554f9aeb17eef75dbe001f4d,132,99,303155,96745,206410,164,131,518986,85259,433727
d6100e1b4c00c5703721418e16fa6702,162,140,574466,123433,451033,142,106,453353,121348,332005
912906e1d6206e1c76d0f25f54583dc0,19,17,3438,1720,1718,14,16,4554,1699,2855
b5794bba9a1437b20c6ddcc4d7d278fa,180,146,1093054,178915,914139,211,162,1285295,207053,1078242
04b7b67ed9bc6e8a124f083148ac2a71,182,120,606407,102508,503899,204,149,756232,117381,638851
9de6397845144359bdf5368b8ac1d852,105,84,149140,39149,109991,91,66,161568,34592,126976
9feef9eddeb4f7785c79c6bc9cac9e9e,58,39,72433,22185,50248,57,53,47603,22279,25324
641ef52c00ee3723b3bc59724e5e9e37,180,125,962137,141902,820235,156,116,680296,151936,528360
4fcc31d956030c8219b22770fe8edc2b,50,35,59409,17063,42346,39,26,49610,15562,34048
d25873fc45b825f7f646a6b5c440c0c6,79,62,211206,35740,175466,106,66,227388,32523,194865
4144b6f4cb85616ca296c41c29ad5d1c,39,26,21002,7014,13988,39,30,38969,7636,31333
0f67d9598a8f51b84356042c6de182aa,136,110,455037,187634,267403,173,120,975655,130716,844939
d59ea01b49494e3b9d5a21b409bee24f,24,19,7381,3800,3581,25,20,10142,4915,5227
01f9bb78bf2bb47b3b9c3dc25e87c619,158,113,332549,62502,270047,117,88,228431,104754,123677
441e00123ce00e14f74a87e17a38da55,144,98,351704,101564,250140,114,88,318213,101699,216514
c184a357c42e55d9363c724a1fe9d203,31,24,21593,7141,14452,31,23,19364,7983,11381
cbcd29cc54b1f82ad17e319d5dbdcbb4,163,116,489746,80264,409482,143,127,405552,105202,300350
4678768dbc9b72f2c6fa1f1b2850ee2a,101,78,163918,31297,132621,88,60,137099,29933,107166
f7a0c0c2e282ec30de91ece0771119f4,88,71,122351,50221,72130,76,60,109681,39243,70438
1f43db31b83f89471c4d2f3095e39b2a,29,16,19347,4882,14465,24,25,15828,7287,8541
c2714d24d7467e4739c91796f9aab919,150,120,432599,166094,266505,208,145,642590,110248,532342
a6700cd02f0687ccd9c076e82c336c9b,33,26,24137,8376,15761,43,41,37772,15359,22413
d0c2ff3d8af9cb9f3320331c3ae19750,135,98,263588,46623,216965,134,105,271066,53746,217320
4fc3deaeb42d132a84c45009ca809825,122,76,333932,71068,262864,112,90,259287,96106,163181
b0b123e106106ff100190117cbc5ef61,118,85,293737,61570,232167,115,89,247285,56149,191136
0135c9b618e373027ae9289b29c91f6a,128,111,426729,96436,330293,132,113,403474,105419,298055
3a92d8fe91e28a869d87bed8e40dbc6d,99,82,219957,23641,196316,68,53,84429,22946,61483
8945702099ec4b6ab22278c36bb70d12,35,24,36610,17452,19158,40,29,46582,14059,32523
0780ccb9dbcf9ea82af039c1ac5a96e6,37,30,59737,19283,40454,47,37,57768,23606,34162
e4f23ad7aed8871c24dc5ca02cd9a123,183,139,641460,181408,460052,185,141,602432,154449,447983
3e90007a495b280c43d74da8a358a7ea,123,109,463392,149931,313461,196,135,730233,110757,619476
3594d764e91fd0e7fb457da4d2f38fa5,100,91,224917,51659,173258,99,76,262456,46625,215831
730dfd0f97c86c8bd7673becaa7d6d94,22,16,7237,2147,5090,18,16,3470,3617,-147
15c2925453975f5c8dcee36d970426c9,117,82,261969,52054,209915,90,79,228855,72443,156412
32cdff7b640f279b4320e1a91782b30c,40,35,31379,11999,19380,37,33,22362,13986,8376
27c17f0016afe7d9877c64dc09dfe215,36,21,31640,10365,21275,43,39,33568,13784,19784
039bbfd45d6947945d77ef300ef54154,28,22,12469,6197,6272,27,19,15659,5365,10294
e3c30a714b5a6b93c43a546f301eed4f,57,46,88878,20156,68722,72,58,60971,24316,36655
f26ef91c43cc648d4bb98d788b201b5c,52,41,49785,21661,28124,49,38,49631,21733,27898
82ad6e1eb8de8f60f8483ea9382e4a6a,159,107,444483,84671,359812,119,91,339584,97056,242528
fe44b9b4fcb66af8075c69cbd2c94dab,155,107,823510,188624,634886,176,132,925249,172609,752640
d05fc7cf86f1c9f299334c8e142af408,52,41,56687,20129,36558,56,41,53619,20448,33171
1da158915f231f27483fad73f87b6bad,159,128,515563,107654,407909,193,142,588880,89961,498919
f2c751b4acf540d02e4e2b57d86b9a3e,140,112,418525,87867,330658,133,89,324891,96504,228387
b755a5cc667687390d26617e1400416c,10,9,3647,1107,2540,13,5,3308,772,2536
aa6ec957eb32d7e1d305e7f690fcd401,92,74,230561,62055,168506,100,72,266530,62215,204315
080b0fba4c2600c3e60ad19811c6d8ac,80,68,134207,51262,82945,86,78,155583,46945,108638
e6339c9dbbee017f9eae5e3bbcb7f983,28,26,20388,10768,9620,38,28,27329,7258,20071
07dc492651bb8efbffa8a125e7446e5d,114,83,204786,61233,143553,148,103,273787,61101,212686
45f368b9b3b307294d5a3571faf392ff,68,50,107704,30911,76793,58,48,80514,23416,57098
91f7e81205cdc96a2f136b8dc311499c,27,20,11290,3932,7358,24,16,9401,2589,6812
b77be98b55aaab2ceded9dc2b2028308,138,94,305026,45864,259162,102,65,162947,50169,112778
db048d4a7e25f3c9db1180357ffb59f5,115,83,232672,59895,172777,104,81,206771,73847,132924
bce28fb3ad8c8355e18ad1076ec0d4e9,95,73,212861,51388,161473,110,93,231519,66262,165257
7a678497282bc7b5783fc6f47f0c517a,62,40,70494,29281,41213,61,52,85242,27462,57780
634bb5474c00a827a674177f1a2e60f9,10,5,1504,306,1198,5,7,406,419,-13
605d6d1365f9199efab84defc79e4b32,104,77,183270,71374,111896,119,105,284460,64743,219717
8ab29be7bd3c70cdb66b841ad0b13dd8,127,110,287133,63008,224125,105,87,201297,53638,147659
7705be10d3869f693aa7e20abea36981,162,110,486155,85157,400998,153,131,421940,89390,332550
b0dd11300651dcd632efe56d66e1be5b,39,31,28792,8368,20424,25,18,17584,6452,11132
da5193100718279ea044a5ae5e73c54c,42,26,32840,9433,23407,36,21,26606,9489,17117
07b92922d024a86e8a3a01ac86a7e01f,177,128,674601,119448,555153,168,159,661097,160254,500843
2863ec79cd4a66c3aaf24ad0063a0c8c,11,10,3012,727,2285,9,13,2241,1204,1037
2bf998d89e4eef4eb555623abf6e9ee5,6,10,794,1110,-316,8,7,1897,779,1118
ee2e53734e6396141b48364fc88523cc,119,93,275585,70052,205533,133,103,304044,60997,243047
f0b8e3a5b72bf481ce85558add19e530,39,34,32908,23070,9838,55,48,76856,21974,54882
6ccb997160f44357926fb632beb7961d,176,104,580321,92467,487854,181,143,553560,119184,434376
6691190e9209c45659397d33def119dc,76,60,143244,26039,117205,53,42,36230,34041,2189
7f651cf95332647dd40aeb0446f0e2f4,42,26,15718,7260,8458,28,28,21655,6380,15275
1ee2038895bf051599e6df5b2429ec07,128,105,316868,83781,233087,139,88,334080,56684,277396
b113408836a3f97a283c5fa6eee48b24,137,88,347531,62139,285392,139,105,270202,80955,189247
1894e57c1038bac251af925f0869883f,126,102,345479,89383,256096,129,110,371882,100962,270920
0ac90c78fc56da66e9ec23b0e531e3e4,104,79,181037,38955,142082,114,72,146630,37180,109450
5761a21aab66d79b01e1398d1bbae216,128,103,376031,50719,325312,70,41,152432,47232,105200
80e3e6eec60b6cd522ff8e47658433ae,105,96,194410,64340,130070,91,73,196767,50574,146193
74ae44c972182d2cb5a7c7812156c902,54,52,128366,36238,92128,49,34,81097,21861,59236
51b7978f6302630f513175f160db193c,133,117,420432,85259,335173,143,104,388480,82602,305878
026a5957564f879188f463107f077ea4,106,77,244065,58612,185453,91,74,169891,73768,96123
5ed125f65819cd077a1380a500aea354,14,14,3431,2155,1276,14,13,2506,1591,915
f3be9a209573e80fd7cf6894543aa109,53,32,72311,14447,57864,38,33,45317,14960,30357
0c8321bcf93fe624e82ee920f92a35fa,67,56,127936,58338,69598,70,52,128428,40313,88115
2d451f1b7ad44d605ebc77177e8e6872,144,110,392153,71565,320588,148,99,316024,105202,210822
ca87f6c70985215fe424a6374d7c4146,18,15,3442,1694,1748,19,15,3345,1775,1570
14015fc618902f7b5860185c9e6e4847,27,27,11072,4537,6535,28,22,10516,5042,5474
dce7abe16278de3c648c5286ebebba96,134,118,464839,100945,363894,157,117,400741,102967,297774
505296dc3d842e88fbc9ee3af2b7996b,30,21,20303,6425,13878,28,17,12690,7301,5389
6f29d910630d48a60ea25c151e4fdd93,93,66,161912,44192,117720,100,64,170368,38295,132073
a0fe131994c7b8efc14a6cb51f967f50,143,104,458395,67841,390554,166,138,544761,86780,457981
b3f5e5c73908e55e5683b14654a90ebe,214,142,788514,129949,658565,182,141,732935,123645,609290
3519f0489c6a732287cab5ede43ff367,86,69,158556,48971,109585,91,76,160051,45403,114648
06097fbe4f54eca68053107157bc5ff6,175,143,651444,122483,528961,164,132,492328,135246,357082
794f8f7e78bfccd606d78c05bcd8af34,129,99,343505,90006,253499,120,90,336750,101574,235176
65d85a867ffa19a1a481d4f0a2c7d386,195,134,798388,128449,669939,205,162,841994,144383,697611
352cfe519aea7681a688189b18f9f290,86,66,164227,62120,102107,106,86,193864,76519,117345
7a701dd54b241e1eaf70cfc7811a48a7,65,50,140882,40508,100374,90,79,173518,45704,127814
416b0926668d8692059bac7537e0894c,20,19,8021,4934,3087,25,22,10937,4491,6446
8abdc6d57151634ca9686036f1002d33,59,48,90237,33512,56725,99,59,139165,24807,114358
702bb6d81d57a4276da78af1dffda59c,113,90,555846,117252,438594,192,131,700477,97099,603378
515658ef41f774395c0db7a7970f9c29,66,51,70888,22171,48717,61,54,81216,20816,60400
3dc02ba7d15bc06b74267301e751761a,121,97,249496,49040,200456,85,62,158614,47811,110803
e2cba37f91b64b9b84ec321c182cf5ce,162,127,571918,99424,472494,185,147,622666,107814,514852
9dfbccad9f63bbf443813502a3de670c,110,90,250465,51557,198908,132,106,269869,47956,221913
8d544831a3947679b8879b7d7a4a3ced,71,57,207482,79563,127919,112,109,346056,84329,261727
58748c792ed48c71d1f56ff0ad010e23,46,31,57901,11646,46255,30,22,29249,15794,13455
598d9105e17c00e1cc25a32d4ca8d86f,228,174,1219268,211400,1007868,237,159,1332274,243796,1088478
7a8220bb546a518c60205b449bf0293e,25,25,15645,7970,7675,31,27,18074,5473,12601
422f43d953eb4b2614c7069cda24b9a2,138,100,385427,83996,301431,129,104,417213,123894,293319
fff0dbe1800b8ca9b24adbb8eef12f2e,121,81,576673,135523,441150,196,170,715414,148924,566490
a9ba7e55b755b8d90e13a1ba363dc146,90,74,183080,51686,131394,130,85,263687,43745,219942
a73b021d741ee8de1b3085ca479c1c2b,75,54,92215,31579,60636,81,66,100439,38661,61778
20a9fe28678f333ccab8457aaaf3a4f8,66,49,51117,12118,38999,55,46,44570,16592,27978
850fa19b87d8964cc774e0330e9ac06c,136,115,482550,131272,351278,150,137,650635,135477,515158
34a213900f699b10185070eafb0bae65,44,32,51943,12245,39698,43,30,31144,18269,12875
0be614a1b2ef64ac834bb8281a59087a,33,26,21470,12188,9282,35,32,26084,12627,13457
0648651b76c0426232e00bad693f1d71,24,18,10191,3950,6241,25,18,10527,5088,5439
13cb726b4576631fc0934234c4bbad63,156,113,598958,184595,414363,232,176,767551,160196,607355
25b6009d53313fe56c6e59686f8c6fcd,59,49,91709,26248,65461,65,46,78913,32706,46207
777c4e606502c3ff4cdad6c7bfde4acd,113,108,381852,85947,295905,129,107,406444,86409,320035
711da7b124cedf520ef1c2379e0d143c,103,89,194725,62031,132694,157,119,334042,105554,228488
f803c48780ff7d7496318c935a125743,83,71,154582,57126,97456,90,63,213445,45358,168087
4286a9a8ad8793cbf39c6beff7221d8d,138,101,336436,56693,279743,111,92,181084,61154,119930
7bb9534aac607f1c91958e36f098a983,22,11,3624,600,3024,13,13,4086,1563,2523
77b5831271504429cecc72eb9fea5447,45,36,49551,21435,28116,55,49,88174,21712,66462
7d7bea381cfbccf4a9c3aaf9f94f95b0,115,96,320223,73737,246486,152,114,426008,61897,364111
4f9a2ac7ec48fabd99c2fbbc8ba6edf9,82,64,126406,42573,83833,89,65,118743,42832,75911
113b64647bb2139677a8ee4ee1161ba0,34,26,23612,9849,13763,24,21,23754,8236,15518
293bab4761da46722392de997d461ae4,146,114,439436,156774,282662,180,126,492619,94218,398401
d34a91533302d62c92b5998f9a69aea6,193,128,586003,83855,502148,129,108,424853,113712,311141
ecd0e157e369a7183bad9260f0a55141,74,53,100120,31005,69115,77,55,109059,36557,72502
9773627e4dbcdd80f8fb05f6868521f0,30,21,19066,7009,12057,28,22,17809,6224,11585
aafdba327b3bf3548a776c552a820cdd,64,48,79120,37108,42012,90,80,138688,32344,106344
8eb50edcb9606b1258cbea55b2dce161,149,125,925872,203605,722267,217,160,978017,171565,806452
c7323efb22edc8dc736702fabe82435c,48,42,57487,17008,40479,40,33,52552,15908,36644
85e64413dd9e6533488c7714ebacf225,15,10,2861,1497,1364,8,11,1409,1993,-584
4491f2518e3e3a59ab6bb2be1ad02a85,169,115,363924,78747,285177,148,102,333778,70680,263098
f20bcab6656df113da441d35bec59d4b,91,82,216101,61100,155001,99,80,215902,47695,168207
3506f83c31971f442cd0185a8f87d35f,104,80,252598,47949,204649,115,92,291910,67748,224162
e8196d41535cf3c6948474a4342eaaa2,24,19,14828,6154,8674,32,21,17561,6840,10721
c44c01d85052e393bfd3cc06b01e0abe,106,91,208234,65158,143076,97,74,156201,50552,105649
90009f382e129056578b51a7afdca1c1,41,34,42382,18007,24375,34,27,42795,16418,26377
8c0b65a4102ac0f584e4adbc5d436ca7,153,117,521648,103108,418540,149,120,663977,127464,536513
ec7355a5de43a31573faac0f284ccaed,48,32,48575,10436,38139,29,29,27360,13782,13578
2877163ecfa2776a8b3b1814472a0a13,28,22,8735,4898,3837,25,24,12186,4485,7701
dd7f74c1b6e30c9027df3af3a75821a4,34,32,30132,14645,15487,42,34,41783,12895,28888
835904230a1457c5057bd5d8f8d1cbbb,83,63,164387,89015,75372,87,77,174733,73578,101155
c39f09a413ebb960eaa9a7f61c237d4a,94,59,203403,43415,159988,159,132,376632,78676,297956
dec41c6b60a62c9002ae30125af2e793,206,143,690593,85576,605017,174,146,576252,111061,465191
7686c89edd878993985cdd889b499bf8,150,113,511788,106576,405212,169,141,564147,98138,466009
61ec6f29a18985aada236010c663c8e5,168,111,437197,115612,321585,160,123,387438,136748,250690
3560ef1334c98995f823ab1e09b79ade,118,94,250838,44140,206698,97,81,176966,53939,123027
d28203441f95b856962272213a6767a6,57,49,71268,18854,52414,54,39,56669,17999,38670
76cf04c38ff2e496aad02260fe61424b,35,26,24457,5751,18706,29,28,16140,9075,7065
4e1f60716d00568c695f646e5f6b3126,97,61,138747,39924,98823,86,73,125888,52957,72931
962f0075c8bf3c722c278ae391551c59,23,20,12341,5082,7259,27,23,11387,7179,4208
5de10bbad5441c2f1b33051f5e5da6e2,46,42,41396,20230,21166,44,35,52221,16148,36073
290191e76ee93350dd144562bb73277d,27,22,24959,9107,15852,26,21,21089,8393,12696
93cce2b5ccf42538cc1bc5650e8048a1,21,20,4679,3933,746,20,13,8412,2169,6243
b6413cd0851e8178e373433b17414161,54,50,173799,14977,158822,43,30,152540,13423,139117
5afa1f65ea2e3d1e1e2c4c8d78a3640b,162,138,572787,128863,443924,146,128,546090,125802,420288
0a8e04d39bc194318fc50b7ac1612e98,41,32,42769,16105,26664,31,30,44922,13463,31459
6c6a63803788886d74fdc25c64d8d8b7,75,47,140264,36164,104100,62,52,102325,52267,50058
ef23b4e75e115a4cccf08734cb70fba6,161,124,408494,89891,318603,120,94,341946,95728,246218
321e888bf2a477d43c849f0143147308,26,25,12436,7711,4725,30,20,14394,5709,8685
d98d8f44c25e7583ee54942df0b7d3fc,23,16,19866,3686,16180,34,33,30217,8481,21736
67c86edc73b80a1aab9c8139ec14bd87,172,133,618781,145897,472884,196,166,811783,146129,665654
86d93d345644925538eb42303acb530d,40,27,28101,10980,17121,34,29,20453,13961,6492
0f09545f7d60b0f1af5942fac8a39f1a,145,87,689294,120761,568533,148,114,478705,146049,332656
92c892d023e516703f144fccc6d9320d,60,48,153583,56697,96886,122,96,281414,71090,210324
0e26c0333979dea7a146704ac77e25ba,25,19,15755,4278,11477,24,15,10193,4297,5896
afc4c794fd508fc958ddc457e4fc47f5,133,101,593800,95544,498256,123,110,476837,172448,304389
0adb8782755ca5e18802ce8d6b979807,154,119,434052,86095,347957,160,105,462658,64446,398212
4280cce9454ddc99ab41294e186b4dfa,39,37,25312,9212,16100,40,27,22958,9433,13525
0812005c507a4061a2147f24ad5a80fc,150,122,772167,277376,494791,225,171,922023,200080,721943
ca7ca85836b6fa95e8cce95f5ae0bd15,186,154,798062,129100,668962,182,123,644038,143993,500045
33d0199b31eaf653926e00c111382d2b,77,54,90720,29490,61230,56,51,90746,28726,62020
1f1e914255397a1977a0d6da27dccfd3,39,34,46762,13984,32778,32,27,25335,8762,16573
738a784b67853849e2fc6f5b7c244370,26,21,19247,10267,8980,27,20,22411,7396,15015
eb947addeea1b9b698bc93ac631edd87,45,35,51534,17222,34312,37,32,46361,17860,28501
431cb5c920778e32c5aae24914d55861,124,95,279246,93576,185670,139,95,358409,67233,291176
37d8198856d886a691267828ee631b08,167,135,462082,87172,374910,118,93,415886,66038,349848
018276c7d5d497228ebb174597a40a77,25,28,10085,6127,3958,28,18,10909,3230,7679
51e970e2d29bd347d00674ec322b5226,29,19,10917,5053,5864,33,23,14628,3274,11354
213f9ed1c652b13bc6e99a995d9e4e45,154,123,585384,88050,497334,191,142,614326,80957,533369
4dd62a50449ae4b1439f29c1aac93bbb,73,38,155549,32207,123342,94,58,182728,36249,146479
99ff5f170891ec10b436741ac3aefef2,49,35,34634,9445,25189,38,29,20462,11805,8657
6215c91dfabedb44ea41b7a9fbf1823a,110,84,213244,46870,166374,128,94,283201,48094,235107
f005e2976930881578b2af864b1b6dbd,225,154,1386131,183913,1202218,233,178,2098662,192412,1906250
04f4a52297b5172b30c2c395fdb004d6,67,49,72642,23779,48863,86,52,69499,22451,47048
d0c4b5deb4df198542c70fe5913e30b5,47,25,54661,10814,43847,33,21,30930,9916,21014
86034dd1b703f4ecb8fe9007ec9c0061,91,74,122955,34045,88910,106,76,162623,34155,128468
385988181e96b823108b69b33b433eea,53,45,73228,28431,44797,74,59,101641,28066,73575
cfb64a3cde53b018ab6308c50fa8cf42,40,21,25677,7017,18660,30,26,28717,9985,18732
e3087cbc5884b8a8ce4f5ac469a653e4,96,75,143647,33509,110138,91,66,126042,30905,95137
9c291997634aa111cbeea4a4c88a70f6,198,149,1045658,233002,812656,216,152,976006,225887,750119
9746545630183ea2561d0a66517be4e9,115,75,213451,80973,132478,118,98,294564,62755,231809
450900e754455a4cd02a4d320e6b4bf9,140,104,486701,117331,369370,125,115,478190,83486,394704
c50570e5e50cddf5e54626162c499a95,52,46,64304,24731,39573,53,44,73568,17456,56112
bef1975b473b6f90e44c084abfb7de61,146,101,344914,91258,253656,148,111,435004,82314,352690
f02c6ccfb572d3e602f1ea1a4bcaea40,194,117,666271,120369,545902,161,131,718062,129720,588342
6319b6e573ad0143ef8667f49be14ccd,76,58,126054,34904,91150,93,75,127973,43050,84923
e3b1fa57b9420a476d338d7b0a56ecde,175,144,519767,164470,355297,138,111,559551,135638,423913
835706e13d1a596e766863e022b79360,47,44,62851,27021,35830,56,43,57673,23096,34577
a2f6f5f03fa700f1b60741da6cc0d428,96,77,145171,34580,110591,81,67,103229,33441,69788
fa570efb395d67369816a05192e32380,64,45,81268,29110,52158,84,71,156449,35464,120985
6d84a18790809edb5c0dde0e131c2ebd,147,108,313623,64277,249346,139,103,279483,51385,228098
8997c10a7899b4ab8ffa0b25535a217f,156,117,552438,82282,470156,137,111,363953,73718,290235
ff0573aba09092cd802764e062781821,83,71,133642,43837,89805,107,78,129565,45244,84321
b0dd2155e212c8ef884a8c7fc6792089,182,127,655588,125448,530140,168,139,854714,158796,695918
4b017f16817a4dd0547a5ddb3d179763,19,10,3602,849,2753,9,9,1339,877,462
35b625bdc385def459c351821e5b6f60,205,123,429761,79110,350651,176,113,363958,124213,239745
a47009f441d713b1b37594853b7d9db1,81,57,153311,33401,119910,72,49,82993,46690,36303
af93e7c996aada720daf8e5582c33425,23,21,6480,3223,3257,22,17,7045,2902,4143
beae9764152616a8a2d8635b6faeb845,66,47,87475,32433,55042,80,66,146944,30449,116495
0d1b4aeba2113149defa5c5fe127338a,76,63,114864,41616,73248,76,58,117583,25794,91789
c7ac0d7eb61fee943c53ef01420fd9da,151,120,423296,118117,305179,173,123,555541,163667,391874
c640d600024569a94aa8e9335a863ed5,28,21,9829,5285,4544,25,23,13272,5899,7373
b456a20fb76bd76682f7058f4709a4a6,99,78,148812,42520,106292,116,81,174948,38211,136737
6d07c3cfe7fb63b06c600d882d2db5a9,19,16,4505,2165,2340,20,14,5152,2657,2495
1d5d98c049a6d47afa3d19707f98e763,22,14,15122,5045,10077,25,22,14002,6166,7836
e57c3d24f5ef2787a1d9b55368cc3861,45,27,28713,11482,17231,33,27,23702,11964,11738
bdb20be4e6f2484b24c08e2c6e885952,27,23,18049,7436,10613,27,22,16134,6672,9462
f91ce739bd59045f94a04f02ac2be832,35,30,22355,5664,16691,40,33,28896,6991,21905
f7abbe6c260b707912e45061df334807,112,101,357147,67745,289402,151,114,495141,52763,442378
9dc785f2f98d262b23883e1ec6bcafa2,129,107,354284,130255,224029,156,130,469023,108909,360114
43e5f5586ebfdd91759ad07615f60dc7,120,92,302941,121350,181591,104,78,206402,86773,119629
4674ba3616e7cd7255cb584c2bd1a117,39,30,44777,18001,26776,53,34,47966,19542,28424
17ecc9a88a784136b2256e76db497c2f,61,49,79441,20598,58843,87,62,153844,26651,127193
d68084999586b50fa211b9baab811572,36,32,42153,21099,21054,35,31,48540,21880,26660
b40239d9dbe9032f8bea1f9d8dc05f6b,24,18,7068,3005,4063,22,18,5158,3590,1568
320af1dd47cd6df33f3db29475346081,1,1,105,34,71,1,1,34,105,-71
d1761113793ccb7ebee002d8566fc32f,133,104,411262,77210,334052,170,123,391885,95985,295900
3df95986002cf2d9064be8a6835c26ee,127,91,311191,98693,212498,122,95,362335,160463,201872
930e04d5d2cb6de7c20c4ba1f15375f9,3,0,415,0,415,0,3,0,415,-415
b491196690cd3323b9d36740831f36d9,73,57,95124,24907,70217,64,47,63327,18388,44939
255cc648c7d13c83403f49e6ddc33445,20,21,8429,4121,4308,25,23,8560,4728,3832
967c90545b7cb821b9c700158104dc40,0,0,0,0,0,0,1,0,12,-12
d99efc37533a1ceb0fda8710727b852e,7,5,839,757,82,7,4,998,698,300
67526ab33e646badae7183c8d5691538,29,24,23634,13558,10076,33,27,26234,10806,15428
d9a592b1b93f5f683768e97cd2c1f363,85,70,125121,41384,83737,64,61,113159,37205,75954
99a8152add9c2e4130eb6cc598d25e5c,28,25,16033,8951,7082,28,23,18199,9254,8945
358c1a8c6ca417eb4ab0eab484c30c6c,139,109,327815,58365,269450,115,79,218127,48196,169931
abb4c77c1273a39b668a3db90031501a,140,96,368768,88130,280638,160,115,368573,79050,289523
f3c55bc40b159224250f21604ef20431,42,31,45842,12156,33686,52,39,66690,17785,48905
cdde7f062a5605345e92c10b03ec7e21,44,35,41271,14858,26413,38,29,41250,12322,28928
26583886927e70997113f1afbbb90457,97,67,194113,55729,138384,120,88,256874,46281,210593
f44101669b31c680747c75b335ee4c96,97,66,172262,40540,131722,81,48,105680,36163,69517
665eac637cfc8230f9b07db972b9bd15,164,100,476845,82942,393903,146,93,371887,92561,279326
4ce567561e3bcf4f975a33e4d3441482,169,128,706240,195171,511069,250,166,887968,187120,700848
9f27770b6d1648ac752f746ed783907c,55,41,72033,33153,38880,57,39,94187,29811,64376
3f7b7fad87926cfbde8dcf02743cefe3,87,64,182824,39872,142952,61,46,85224,35710,49514
3ce2aca61f8296d1aefe10350e233421,44,38,74675,19725,54950,77,58,76678,23511,53167
e8d86a2104a9a2b7458bdece528be806,174,120,629210,166091,463119,171,138,528499,110856,417643
895bae4835a3a2a7f861901f7123f32d,16,14,4669,1126,3543,17,14,4383,1801,2582
52791a4267b54bb6cbd7c005533f437f,74,52,108104,28420,79684,88,59,79585,30224,49361
4a463f8ade4045501149a2bd5fa3ec8f,66,48,123764,30569,93195,56,51,98698,22197,76501
6c5b0056a33e9a650a2824ac384c7afe,139,110,357659,75819,281840,103,85,215179,92962,122217
fd27db730bde8bbdc4943a25c240ec6e,98,78,150457,43192,107265,67,60,99187,39048,60139
ebfdea7e857901a9b14822158f8faf78,184,143,563085,214700,348385,139,98,513031,179313,333718
d944d6956f2e1cf73fd7a07219893fbd,30,23,14535,4819,9716,28,27,10952,6921,4031
45f2ab0cbfcaa9f02a44aaad5a9de043,31,21,33412,7377,26035,25,21,20435,7633,12802
d85ee209895652eded7f6943b3ebd43b,103,72,168510,38965,129545,83,67,126588,46712,79876
e307041ec5c6afb936051967fd90906d,162,107,498390,113004,385386,168,147,523899,121907,401992
bab06f124ac4cf94895f2631850cf23a,120,99,222224,71871,150353,121,75,191863,73615,118248
56b8976a3f961b669b9c294e5e9e1ab5,188,129,615010,89053,525957,209,150,657574,99401,558173
c3baeba795cd416cccfa05a0f97f2c1f,74,55,138993,25827,113166,80,64,101566,44215,57351
79001dc29063a4fe5bf16a1ca20550ee,99,68,173526,69442,104084,164,121,331179,62454,268725
66c9d2b735634be8b7222429b115fbde,23,19,6847,5281,1566,24,18,14207,3612,10595
eb6b64740397c89651b70da0410d54ed,30,20,22273,10286,11987,29,24,24892,9166,15726
032d6e3f73e54d00b5d93c3c08bfe35e,100,78,187623,74605,113018,125,100,229224,48018,181206
a9f5b625c17a367178322b47dc3cf18f,102,93,226028,60624,165404,79,65,123716,44645,79071
d3b2b529f410cedcfefbd90d791d6bdd,119,99,291638,101647,189991,148,118,432691,92163,340528
b76ae0bababeb62ca06630ff17cce60f,37,28,48407,12387,36020,33,28,33791,20112,13679
ee6c9a410a8182c5904ec75788bf9e85,106,69,201038,45565,155473,86,56,229118,53483,175635
565d65be01e5a36c142685e89afc2e07,181,151,470359,75316,395043,108,79,221550,77749,143801
266c12876862f5def87699c3ac85f15c,61,40,69576,24233,45343,65,58,60440,18551,41889
ed1a781eb2e1df6e2122029716b80bfd,24,17,6178,3747,2431,26,22,7818,3131,4687
72b08e6f9f7807d1cff5c2ca3c6358b3,13,6,3147,347,2800,6,5,1104,1328,-224
0ff30b34d5e63b8aeae00452731a3ece,109,88,207735,41340,166395,67,46,112872,31683,81189
97be67bb244958d29bf1217d930b9fcc,38,31,34343,9605,24738,59,29,42419,8723,33696
cae61440f0b48116cde27cc5c7c6c187,162,109,379595,80004,299591,148,117,422308,102064,320244
85ec57f7c2512f4311907a54d01986ec,53,36,64805,10714,54091,85,78,98009,23128,74881
5183c801ff8fd299186dd9824c3b2c32,58,51,102473,28181,74292,64,55,110055,29736,80319
fa5becaea86098f18f8e1b7f686c7d72,67,52,89806,29528,60278,59,46,69361,29128,40233
56e29b215465d8b76691c5bdf3b9690e,54,44,84613,29890,54723,70,50,110841,25865,84976
44e99c48c41900ca7843c1f279716b8c,114,84,305626,74970,230656,119,90,296006,84980,211026
f064e611baaebd9b6a8648eeee6db113,42,31,25417,7229,18188,40,31,32720,7377,25343
335c4ce191da31926481b32288d14eeb,150,79,321033,73842,247191,168,119,397204,91470,305734
cf275c0af081d8fb9cfafcf01dd82ab4,89,61,177444,56727,120717,137,114,282872,62474,220398
dcf6f9db1c99db7dc786700eeacdd8c9,120,95,247275,49749,197526,137,121,344848,55096,289752
70cc9627eaab5ca6264f7f6a88673fab,19,12,5386,1857,3529,21,15,5366,2794,2572
2b407e8ba39a1bddbb49bc576e38fb0f,14,11,1503,732,771,14,13,1498,1191,307
236093f23d1e16e04cee52706345f02a,192,151,712611,114881,597730,150,122,604221,158172,446049
630661e7e9b63aacc73bfb1fd1b6a063,86,67,141178,43221,97957,94,73,134608,38459,96149
14cf44f96b68ccd729fa1b3c3cea2b32,167,118,821193,163260,657933,208,175,853108,183703,669405
b14c2fb93661582f27db694c101b4ca8,155,117,470353,144375,325978,130,96,370633,144629,226004
7cc7cd4e626687af2c9a167d077e600a,145,108,409499,91364,318135,126,96,412819,86455,326364
c9a812a54b8a8cc95d089088bbef1d89,75,68,130605,37471,93134,75,66,117980,42510,75470
d623417194c32226bf6c9a4b99e45067,33,20,13295,2926,10369,21,21,8277,3415,4862
5352cad1ea8a0166e2f5343f03eb070f,17,13,5218,2248,2970,14,13,4356,2317,2039
06df22010c4aa8466d0cf8a057c8ce78,38,32,34490,13804,20686,56,39,50609,18337,32272
73de32a8d4a08527a9a606b5ff690c58,82,64,125016,42517,82499,99,78,148990,44298,104692
8b336a7ffd3d8d74a642d05d31789ae6,111,77,240882,71806,169076,67,64,180321,63432,116889
1d9b77ee7eb22b631572aab18ceb0f5a,49,40,53479,18423,35056,38,25,54179,13769,40410
6f9ebc703cb087c599d2f538c19aa70c,48,39,46517,20350,26167,53,39,63814,18466,45348
e05bb55678037d66e59afef93ba695f8,63,46,71361,33235,38126,49,39,80439,26130,54309
39d34e9f4de7039ebe0afdf4fe540e7a,147,102,328157,47867,280290,147,100,313144,47301,265843
b0f81651c59275b6a65f03c137170459,199,124,566360,116142,450218,164,120,538413,124246,414167
2c78e8bde5a82dfb87498a7d8d3fac6d,47,38,50489,15790,34699,67,50,69231,15803,53428
2e640339519e1d1249d693239275e19f,102,96,229446,68051,161395,162,111,307342,53077,254265
d5d25fe7986fed31e457f75378a3ae90,94,50,69117,24490,44627,59,58,68482,21931,46551
e531887472030e8702e04897444f518b,4,4,617,194,423,4,4,257,592,-335
16018c5e44f960f86c12bd51b79e2b8a,105,81,175848,42592,133256,146,116,239583,53378,186205
e6368f4077c5d821f1286867f6d8d4b7,180,136,671234,85046,586188,162,128,554851,93442,461409
235a9000657b48d8ed296299bb40be88,55,39,55515,14343,41172,54,56,62175,18688,43487
e7e11d059218d3c20dc236a3e0902e4e,99,79,222194,48477,173717,90,72,202949,50634,152315
7b4f910d742e1d7f27e9fb21be825734,47,33,45437,17727,27710,36,37,50354,18259,32095
8f40bc694741d89c66f9ca5b73c8c241,137,116,751210,174248,576962,193,130,1033097,140759,892338
caeebbc4078fc05e6f45dcd80fb80660,28,23,19400,9174,10226,37,28,18488,10709,7779
da1c77ba9d64ad85dbe03fc4d89208a9,143,111,385972,118517,267455,149,124,447593,83301,364292
7aa4ab9c30e43e62d8149bc231487baa,24,19,6111,5330,781,27,23,12390,4682,7708
052f0223f17dce6b53a35cf786ada7c2,52,45,100553,20439,80114,69,49,92017,38451,53566
1e3e0699aa97b26d35c05d85ba9ea0ff,2,3,434,202,232,3,2,202,434,-232
efbbeb02692adc22ebc5f45ef06c343c,48,33,58370,14852,43518,33,35,41617,14474,27143
9b8d50f2c6d736db55262bb067661cc5,144,114,339877,90615,249262,76,68,232081,79003,153078
6d2083670175dc60adaa4d5074838dc2,43,33,79510,19137,60373,49,36,56076,26885,29191
f85a4500bf29da003665f60000eeff5e,117,97,236567,91905,144662,105,78,220762,76552,144210
05bd3863d39600a737ea1bf2b2f35151,164,115,465377,103412,361965,158,127,460447,124140,336307
8b57a8526e25ca534805ec9ca3ec96bb,35,30,27760,13595,14165,37,26,31342,11346,19996
4442730bae2c27d85233a709475e0d75,93,84,165345,52743,112602,60,50,132533,36694,95839
1fa6035a3047a9b6187ed9744723fd36,53,48,68591,28794,39797,58,48,98663,28921,69742
9cb5509f97c54808504b3e1a2c2db778,32,17,17804,3815,13989,28,23,9649,9340,309
caa1fda0c4a1a4cde80d49b88eeeede3,56,51,59294,28965,30329,64,54,82489,22785,59704
de9914f8746ef5361fbe763bb5d21b96,153,102,340656,76284,264372,141,119,452878,87237,365641
c27f7f9eaefd63fd81ec4a827a9bf25e,89,76,221258,61818,159440,113,85,269259,42571,226688
ccc448e1cdc67eaec483a9b09de52f4b,115,96,259226,59485,199741,111,92,219644,62431,157213
b00df70d33038171d197eb8f91c2a826,179,123,491060,88856,402204,149,108,357900,143271,214629
ed6ba0dcd2d5fdcb4627f869c696403f,88,79,118900,32695,86205,61,51,69231,24345,44886
abff138bafce3ca47a83d957749e6005,65,56,84107,29886,54221,62,46,95123,24304,70819
a845b8bb590308e3adb212b4ec48ac81,108,79,410333,106470,303863,162,140,607806,159579,448227
34bbb88a773c2c6bb82d26f67824276a,108,76,175451,27682,147769,88,65,103578,36460,67118
5ab7670dd223a5d30aa17d57bd514063,59,42,109648,28537,81111,65,53,110596,40506,70090
4a8c3dac749a5397bfbf99470d9a8e7f,98,84,200942,77268,123674,112,85,244525,52069,192456
0b1503eb467238bda82a8d2034217f11,42,32,42693,22802,19891,52,38,80746,18157,62589
63471811cb4cdd50e32eee161f65d17c,236,175,761161,193710,567451,226,173,1399145,164835,1234310
1c093e423ccc868b1e2a1c154b8e95ce,19,16,5133,1925,3208,19,19,3770,2704,1066
67f0cd18b9f37f4dd871bec35f787f51,36,28,29933,5485,24448,34,25,19800,4031,15769
27d03bdfbfd0e37e52111f709c393e8f,48,40,52033,27172,24861,60,46,80363,28756,51607
679c9eef3d65f54cb342cab1d6bd20e7,78,53,179159,46971,132188,104,84,287045,58489,228556
d393a948550299661d21e1cf3c8d91fc,65,47,60860,24318,36542,62,38,63301,23227,40074
0562e8cd7c291b40faac4467f894ec0d,94,73,210028,48717,161311,78,71,161112,53459,107653
712bbe708cf236262d4b3ebec04d487b,119,85,326827,84466,242361,152,125,417718,91375,326343
f2e4322c97b2373237e5a2a06dd0ad45,83,61,136561,24530,112031,76,72,101602,47255,54347
11a233a182ab72d42bf63be1837e9dd7,129,110,405560,97963,307597,132,101,356530,94293,262237
74bc694d2ae26533182bc8f9ae761e7e,74,64,117681,38894,78787,61,48,100701,46153,54548
cc4586b296190698904c2451547e463a,26,18,9623,4312,5311,27,23,12694,4505,8189
5896aa22fed3d2906ac82672cb5e45b2,72,58,119443,35672,83771,82,65,146508,32235,114273
18691438ca88381c7c4865b30a6b2bc2,45,34,55407,22696,32711,49,46,71876,26731,45145
9e625b6c6e8489e851667b469d74028c,19,18,10590,6429,4161,24,19,11592,5621,5971
3d4de43c981ff65cd5e53ff3e52a135a,196,130,769623,132657,636966,163,118,672698,144963,527735
b32722eb61823949a04171e5f3cb5a0d,43,31,41028,19349,21679,57,47,100076,17585,82491
a372921e6f0c29fc77fef41a0587df4e,136,114,265332,74829,190503,86,72,226956,58545,168411
a142bc0a8f970aefebbcbb2a0aa0b553,97,68,135672,37381,98291,129,100,221249,44404,176845
5a42bbc77807d5db77fce7eb08fe1ff6,135,110,321627,70710,250917,138,106,338202,89871,248331
5c301617adc01a56d4b34f779e2df110,148,114,434172,139767,294405,205,136,509019,139052,369967
d01a781a00a3b71597f363abbf6a372b,58,43,140326,38357,101969,97,73,181927,38764,143163
4b8857912a8b545be6a67cc48b60d6b3,115,94,343073,91082,251991,146,125,456122,96444,359678
632a7b259220782622950acba531380f,94,68,206686,50710,155976,112,84,279371,44035,235336
2789ecedabfe94fc4b02f83f4f38510e,48,45,58677,18837,39840,39,30,37234,17405,19829
cae36f9a0fd5d71ed2fcad1249aaa522,51,31,48723,10534,38189,58,46,76362,17947,58415
71015a487c09f2ea78d281f28f6a2925,147,110,341842,72719,269123,195,127,381575,71047,310528
a9707cf2535a5d2dc45fb03696b5d55b,118,119,250761,70011,180750,77,60,141445,61492,79953
cc3a92df8e04535409d2d428b073df04,43,41,45057,14149,30908,43,35,30942,15709,15233
1902f0a5e4e6986641274d628ce83cc6,103,76,275259,44145,231114,109,103,216616,52652,163964
5df1ae7751e398dfbc7cffa6124bc962,0,0,0,0,0,0,0,0,0,0
028dd1bec512f83908f23b8d9c620746,37,23,16380,6637,9743,29,22,18656,5708,12948
5b0b17ce68b956701fc733fc48936bfd,30,24,24810,6144,18666,29,20,12015,5368,6647
1bcf6efc807e68aa244d566f136a7927,22,14,8103,2472,5631,17,13,7103,1584,5519
13379140b677d2c91c4f0ab0c8bcf3ee,41,33,28630,11141,17489,38,26,40470,11566,28904
4e0ca71dad21279590a9e5edb2dc4c3c,27,22,7631,3445,4186,25,22,5480,4609,871
36cae28b41fea706e7672f9259ff15ff,117,92,224519,46361,178158,70,66,99467,61849,37618
6a7792b536e48672f9f90bfe0a7ea708,25,20,10375,4663,5712,28,22,9444,6383,3061
6e0440726eb7e3e38d9f3a4b12c1a3d7,72,52,110356,15580,94776,86,65,88678,23196,65482
7b523ba928e97247b463372050888e67,82,73,229255,69224,160031,158,140,352304,102517,249787
a62dddd06c9f25b964e04d32812c60ba,145,106,628802,133410,495392,217,162,714818,141645,573173
ee92dae701205e044d7904497c7e0d5b,80,55,97994,33492,64502,88,60,144328,26787,117541
f17d6642dc5c2d87225f25ec60fb8af3,40,32,27873,14737,13136,42,34,34965,8673,26292
86af70dfde0d613443795150f480e17c,44,28,37813,10204,27609,32,29,28192,11398,16794
608ea5d740c8e9ce30f2f6a0116ac4b2,63,50,90210,37894,52316,60,50,118933,36002,82931
6211cee45f6f80552c249551879f685d,18,16,5727,3319,2408,16,14,5343,2585,2758
b9f79cd511295d870b64cfc9dc0f3407,38,34,29702,15004,14698,39,37,31806,10744,21062
55e215bf89bef7db44f43eef7eb19cdb,22,20,6943,4102,2841,22,23,7064,4347,2717
b2f92ce827e3ffabeb767ddd6a00d1fc,146,115,440651,89988,350663,136,99,406432,74983,331449
879e7d8e19dc48808adac1ff0a9dabd7,118,91,189382,42247,147135,115,94,184165,34250,149915
3407693315468c883cb58000f1265ba2,100,72,205413,50631,154782,109,92,195695,45452,150243
b7469684632ff25967573a2398eb3876,45,29,65433,16420,49013,57,40,80885,21453,59432
37e152fa9a5860007d52a0eb4417cfa3,27,18,20779,5237,15542,39,32,32182,8062,24120
8250cf9ccfea4cd7bba7aaae0f7dfc96,196,128,439320,73800,365520,153,97,307391,81965,225426
2418f4bee5b70dff5a751b3337a2a275,136,109,464067,95060,369007,133,111,384435,94147,290288
f5eb14ecd6176988808f6c4797ee564a,103,77,230006,50290,179716,132,89,245699,52459,193240
aea278ecf2102e6b65f9c5f326fcbfe0,193,125,523836,97427,426409,154,107,651993,79676,572317
506f8d27e604ad0e592ae880f7b56d6b,121,89,396952,86873,310079,152,133,508804,142311,366493
21067580b1df18c0583b1e1b722aa96d,112,73,259679,56970,202709,148,97,295616,45431,250185
ee2190ddb2833fff7e518f54250ef089,236,168,740240,143832,596408,199,143,797896,152330,645566
9018f6272c2e5cc6d3de172507a64f5d,128,105,213330,53384,159946,105,92,241285,55772,185513
c6f3a0a6a3eb30c51c42161986c8fa8c,139,100,452633,112478,340155,200,157,752234,162365,589869
bc70ed99260db6406e7c6924129a66ed,27,21,20472,6044,14428,25,17,13836,4975,8861
92a485cf0111cc3385b97e1c481ce292,19,16,10363,4576,5787,23,20,15552,5143,10409
160fe90801bcecd20a36ce41ba7980cd,41,33,50223,19350,30873,36,33,41588,20149,21439
2dc37fb07e85d4161149daebb7d4a261,80,58,161063,39543,121520,64,47,85507,44063,41444
e084d1d6b96e95d4d07ac1267c33c630,29,21,22307,5125,17182,27,22,18133,7619,10514
2e02db3b7985e727665e6e5d9ec4bafe,152,135,493037,129991,363046,206,140,568081,104032,464049
13c4b2d88aedb1d0e3fa45d28fd25ba6,65,48,117207,32553,84654,82,63,100879,48171,52708
e85c16388b6130dae02394f7acb1013b,161,111,445045,116386,328659,181,149,619745,113479,506266
8da61a84633aebdb32c9873cfecd9c73,38,32,18461,11230,7231,26,25,23291,8120,15171
f02410cd7a7170f297389e115ed3c6cd,162,109,381406,87258,294148,130,107,387262,91832,295430
eca8106ac7eb3db08003ffd004fe85ff,131,98,387049,134575,252474,157,130,660389,102397,557992
cc3e68bbcd034604a90f497a62fd12ec,152,118,523991,97351,426640,151,117,499370,107441,391929
c8cb3fdd86e93f47bfa6d21c3cd1314a,47,36,34482,12825,21657,56,38,31708,14972,16736
13ad2b42048da9b9e5641991f3b2341a,182,134,504815,73883,430932,178,146,579035,87950,491085
7b1f6e1816e5e874106a505cd10ed819,140,106,360720,64966,295754,104,81,271407,83404,188003
e209ec6eee67425bd5cd3d7679589a44,90,60,283544,58630,224914,118,93,320283,66332,253951
c456ee0e63040ab6a00350e5bba23216,28,24,12930,5756,7174,23,19,10045,4331,5714
c4e32b885faad710e778d15203907d66,21,20,10082,3027,7055,20,17,5845,3276,2569
149b565582e49f802b896d5f7eb0da47,172,114,718455,95924,622531,198,129,668330,116237,552093
f7a99baeab72fc0c022ba08f7692d605,25,14,9222,1773,7449,21,16,6618,2596,4022
577f72b94426ee6a868c75ed892f73c9,68,48,119302,22994,96308,50,40,92311,25205,67106
45115a09a6d7f114c843bd4f61625ad0,145,113,444852,101090,343762,157,122,387301,148700,238601
3f7172db4f12f100c411a3ca977cc729,86,71,140133,49670,90463,87,69,136099,46571,89528
0e3d5d85d9b9803d6503cdc22ceacf1c,27,25,19222,7959,11263,27,21,19752,7834,11918
a633f0599384bd7bf0c3eef412ee63a7,171,127,456654,69878,386776,115,96,332250,95433,236817
f45ab5f6c22564d1285dd26333af7936,108,83,258920,52461,206459,133,95,278564,45696,232868
4c11220a8642d4594d7322662a62c5e5,40,29,53684,13471,40213,54,49,67859,22547,45312
53a7f5998ea6f4edf0630cea2c8b3578,107,88,247814,60407,187407,125,92,303144,60156,242988
5c2ba32eedf360dbac399281dce1212c,81,53,138046,27425,110621,75,55,123335,32492,90843
dd0be81c325d62d19918a7b1613afae6,88,67,145182,54570,90612,76,60,144146,41692,102454
84b059ebbb4de478fb5e6c781a39aa1f,127,86,331326,73267,258059,115,97,311960,111423,200537
93c71b2a933308fa39652ad0e25b03a4,106,68,243746,61580,182166,124,97,305266,49864,255402
72478f8dd71c9544bcc2c4fe7ddcf74f,20,19,5644,2427,3217,23,17,6323,2705,3618
e70447acc06b54a94c787b9787bdcc96,104,78,279533,97158,182375,152,127,474266,88256,386010
f92dc2d3aa45282061df9ca430e710b8,147,107,391497,54199,337298,94,75,191904,71357,120547
5fb91d4dc2d02aed4e1ba5777bf93bda,70,57,94246,24644,69602,75,49,92148,21258,70890
8ed90ccf97a449511adccf66389bcd6b,36,32,31464,13657,17807,39,34,28346,13710,14636
93746a95d5f6af5be740f56e1c8550a9,134,117,312416,89019,223397,124,115,369329,72527,296802
d74c723a099a6ad102141034e11c001b,54,42,49225,18359,30866,49,46,42272,20869,21403
0f822a659055ccf96e96f9a81c2868df,46,35,58781,19153,39628,36,30,48620,18316,30304
b01d169b847aa4e26b569218070217fe,56,46,49937,22501,27436,42,38,62706,21819,40887
f5b398486ac2cae3e7cf04cdb66eb5fb,101,76,177069,68827,108242,86,63,245035,57959,187076
d48d0130880087ce51c175056ea35e17,53,41,56376,17931,38445,53,38,48972,25521,23451
2dcd5350c1db97e45cb41744d1e49564,176,167,548529,103593,444936,156,110,316763,74407,242356
b37dd67d92bee9502ebcb762f51e1c76,27,16,6918,2398,4520,25,21,6959,3431,3528
5e24dd02571de30d207b7d1e5c1c12a8,129,97,290302,42675,247627,149,117,333816,48314,285502
2deacd214c7af080b8563f11e344e4e9,97,65,207123,71202,135921,108,79,208295,82236,126059
ff80071353ffab324cf55f36da53e44e,115,102,212535,72351,140184,141,108,265251,51253,213998
5777ff4ab3d201ce3c776eae57efda81,90,67,230492,70857,159635,102,83,264074,65241,198833
ef22669ce5dc39934a5e5fa6c400921b,61,47,106759,28077,78682,57,46,60292,35877,24415
28ff7ab0755cefa4ef20707bcba439ff,25,15,6047,2365,3682,20,18,8555,3063,5492
7c4d04b7dc7ef776e03e9db306afac2d,133,96,380424,79220,301204,124,111,307177,73476,233701
6d2e57f01112044f4cc84b99c67a6688,56,41,67946,21969,45977,40,39,53698,18362,35336
f85cd89f6e9caff0e13e1134819bd488,70,47,112615,25660,86955,65,46,77782,28571,49211
5ce01320224ce9b42724d276019a06fb,150,112,531368,110126,421242,162,135,701427,119876,581551
4d88c4dbbafbd7b94aef5fb0dba1fcaa,46,31,41296,11703,29593,51,38,77002,10350,66652
f7eb6cd0e4da851fccf77612dd6b92d3,93,69,159054,53014,106040,68,58,115282,46566,68716
7fd75df2c1d0ee38b340a3d28683b15b,72,54,63436,17347,46089,57,43,57679,17710,39969
ca929813f81056b415a1e6b255da808c,79,65,112621,36308,76313,101,83,204380,36422,167958
9f280ccbe2ac5af3063cb7eb636a9ea4,63,44,68846,24838,44008,68,48,106951,25640,81311
72df929995e59898ccb599e6fd79077a,93,68,226946,51147,175799,111,88,236481,42472,194009
7bdbe3a74d2d38003c34f6c899b9dde5,41,35,44697,15122,29575,34,28,28417,14780,13637
6034742cdadb229addd3e8b3b796f970,95,82,177072,43639,133433,65,53,98215,47950,50265
40afb6ca516912f4820176e16510f843,12,7,1153,664,489,11,11,1701,690,1011
466c3c7e983d9ea790a6149e8265cc21,132,85,243218,53754,189464,116,78,203202,57481,145721
c136103940d734bb4313a6c809658124,26,19,11029,4043,6986,26,20,7232,4810,2422
5fb28056b3e748145dcf184ee714838f,48,35,50773,16798,33975,49,32,51296,15589,35707
a79dbd5a438a961b1616e7386509b8eb,150,115,414706,90365,324341,177,140,579653,99544,480109
21a307e46800186c39fea6d788aa5fcb,42,31,62144,23124,39020,44,34,68931,23498,45433
9de19c9675a6e998d450b8bdef88007a,84,64,97055,23616,73439,64,57,76354,31432,44922
bc896ae02aff4c02aee228f6deab4012,206,162,1019015,160956,858059,197,167,1045143,178683,866460
437f9cd347ac3948c6955f6992e0459c,35,24,24929,6605,18324,42,36,27067,9951,17116
8e5a664b0fda6fb5ff69f9b99977157c,191,144,790123,163443,626680,189,133,724041,138285,585756
c9fefb4834a5da2279c7e2268f033040,48,28,39135,11602,27533,39,26,34486,11917,22569
96423f7401644ad7ffbea90b8a8f06bd,127,104,282141,81887,200254,123,83,326889,67370,259519
162cdcefc7ea9a555a6cc2583bc9457e,18,19,7156,3469,3687,24,16,8265,2477,5788
a6d0dfefeb03b58811ec3ab0eab12c31,12,10,1236,568,668,12,4,2269,379,1890
52966bd49bc8bab1688b509358b800d0,62,54,110559,35672,74887,111,83,161716,36191,125525
0a8da0ebabc7b0fb497c9bc18226a63e,50,40,49336,12904,36432,43,34,32124,15064,17060
fbb8a4891f99f476d23fd04aefe48e6b,42,35,35297,11877,23420,35,26,32476,13565,18911
4487179c6b7e061bc41a25a895f6ae02,59,39,85423,33737,51686,65,44,94152,25311,68841
2ceb863f5fce498c9af5b073cc438175,121,97,274771,45979,228792,88,76,130976,42088,88888
fe97175b1cf191fb6713314c154ed59a,48,33,59559,19626,39933,37,28,32833,24225,8608
58db26832f1755ebc08a20171321ae78,142,107,333475,99910,233565,136,112,285667,83627,202040
b07399fc90cb15da10b502222f8029d4,105,91,180243,45978,134265,84,62,138183,34595,103588
4d1905da01326e8131cca4664308d35f,53,45,66188,27175,39013,60,49,78622,23888,54734
fc36e3e00c6976f166bd029cd7aa582c,154,115,508899,80225,428674,156,121,351228,110287,240941
756222c4541657702b26e53f796eaa4c,59,43,64544,22597,41947,71,48,66107,18974,47133
c68b1593bddf90cfca50b1cd89f6d5de,75,64,104574,31333,73241,66,56,96543,28672,67871
6538c7148f641e88f1ab9a1be258fdf5,9,7,1082,766,316,12,7,2145,217,1928
b1450e1637491ba8a840360188ffb463,120,90,272872,62471,210401,83,64,168741,83170,85571
f3565946829f1ae51e8263fc5eafa5f7,46,33,45616,23194,22422,46,32,64091,15316,48775
8de5d31f4daa8b994b02ec3fee2b86a4,29,25,21217,8045,13172,28,23,15044,5770,9274
6c61887d7240fcccdd8db4dc87dd0e07,169,119,678740,140628,538112,215,142,1378828,136919,1241909
ce55aaf146d7701cac76bf683f162822,137,97,463407,159158,304249,196,114,729161,150836,578325
8434216ee181a9a99eaa0ba113702b4a,75,60,98711,20208,78503,42,31,46655,16182,30473
4e9c9acb9c5e6176b9cee10147368f85,117,103,245698,39106,206592,94,80,182146,58595,123551
9de82aebbcb0ea9facdf3ea8c8eba6bf,90,68,134500,32137,102363,80,57,106291,37186,69105
0d0cd4d7f308daae241332413d0ece13,83,58,118865,25913,92952,68,52,123806,33277,90529
7780562be98dee125fe642762c5d7903,121,103,236430,53025,183405,99,86,185531,45050,140481
43818ea2294fe8f9777bd83e5bdac76a,101,81,190408,46982,143426,80,76,142575,56414,86161
d51f9a7c6cdc1fbeeeb47fffa550220a,24,17,18415,5558,12857,25,24,20472,6573,13899
d0a7f3ec8b9b8cb2728e5fd6b751dd4d,101,77,286285,84196,202089,137,113,340290,94263,246027
5462e616d6a5cf09594e22166f1f0970,28,22,16538,9084,7454,29,26,19789,8775,11014
76db9d2f5cf8330ab521d6f39d10aaaa,133,115,288504,71225,217279,110,94,263835,65373,198462
6cf4c1910e3d322b5cdc49068925e593,51,31,69133,25030,44103,51,32,62534,24881,37653
8ec18cdeb03491728c4e88421021d642,129,89,298347,89935,208412,131,115,356599,82875,273724
ca62c0dad6720d6829bcf2161551ae67,123,92,195330,57550,137780,146,117,279117,39914,239203
77d655b9291afe6fe62e3de72004443f,37,29,33982,11992,21990,36,24,19052,9933,9119
5d02537742d3e2477e066cff886cf956,20,22,5553,3734,1819,24,17,5180,3046,2134
0ecf1ce92cb3d53a5bb369361427c9c1,65,49,86443,25521,60922,69,50,68958,22819,46139
ae9e07ae9ce316d5ac69e4355ad5fd9a,178,129,790111,288434,501677,199,163,972820,150027,822793
562d9b5f42f665abc735a11602f78d41,52,35,41847,12511,29336,34,28,36371,13887,22484
8b9de285d7748fba82a8e1da0871cbb2,59,41,69230,21410,47820,83,64,87214,20916,66298
8b5023656be6b25df348f2ca434e5580,36,27,26478,7934,18544,37,28,17943,6968,10975
d112e5b7f1e8e7d4ac943556451208fd,24,24,10768,6400,4368,30,24,13164,4785,8379
662293514b0bedbfa213931eaee7e6b1,121,86,331392,67239,264153,143,113,444430,105723,338707
4a220c458d028c4c6cdc49cfdb0e300e,110,76,311987,95370,216617,145,74,338112,81496,256616
05b7ab867bc38f0671db7b9521090a0b,83,63,221049,77613,143436,110,99,278529,63764,214765
9afff247b62d592b8a8c6a44adce5299,51,38,45814,15294,30520,45,41,48564,14348,34216
809f9d97397a6e0731b7f6f294dc9e8e,189,155,741116,134141,606975,234,160,663545,127583,535962
064f131970aee55e4754aac44b8b5507,70,64,75384,29758,45626,77,61,77282,26078,51204
f76e083751ac2459c375cd06972a1b9a,123,82,426660,93690,332970,130,109,520275,92511,427764
7897e2d1f67043b23ff806f7fb6ba506,84,68,147186,25546,121640,70,61,76652,41691,34961
a90f319de612a13a3f592378006197d9,154,108,406707,94481,312226,135,83,356955,100063,256892
ead3241171d8578a06e6d4dc9beba4e8,38,27,48822,14106,34716,41,36,47094,18196,28898
1b333c1b302f922342d102dcf547f612,148,98,333265,75176,258089,127,103,335505,81239,254266
532cc0c682f604b543a468ec060c79bc,74,54,109251,33787,75464,60,55,98410,36805,61605
57da465db08b58fdb696e4667e57dee0,78,47,132866,37570,95296,71,52,117780,31586,86194
2cfc8f320e42f4631d14afa4d17ec541,148,99,312732,78669,234063,165,107,429268,89123,340145
398fc633a0e0a30e025d9e978fd713fd,153,115,379028,115322,263706,119,94,341940,99211,242729
9952666f06d529fc0876706ea68745a0,128,97,262263,87274,174989,89,77,229832,93183,136649
9faa5e74a5afe7f0e1b265eacb1c29a7,160,114,743767,204128,539639,188,166,1078700,198545,880155
c4c52b90bce2a2e6d30b300a1953383a,80,55,91835,40183,51652,85,66,183537,33338,150199
577808d2b398dc3444630aa91dfebb12,123,90,304541,42103,262438,137,110,436800,59904,376896
4b636027ae940702aacfffbf12a614e6,127,103,356365,86734,269631,148,98,308411,92032,216379
6b7134630bb9026aa12e8e78b1947d6b,25,23,22221,9167,13054,31,23,17695,10917,6778
14453b4c8c07d06f2037581d94b1295d,1,0,45,0,45,0,1,0,45,-45
a4e622888007ed5baa3e2f5b14604502,142,90,347477,76798,270679,125,110,328107,81106,247001
0e69cbeb638706dcf2c5afcf3a257ad7,155,126,377879,102638,275241,120,102,250015,71431,178584
fe3cef078671749f8a5a622313f37a20,52,41,72495,20270,52225,60,49,86166,28111,58055
b0e182ff0a11b1ab62f9518d59161315,68,63,143524,43738,99786,74,68,99613,36358,63255
5bcc40757ab87bce72d30afd1f9c0b42,144,104,603241,186113,417128,172,142,1412197,201065,1211132
0caeb9c8b82c01ac08933ec7b6e787e2,4,3,379,246,133,4,2,347,294,53
4808f81f0d8203233e1c1e9335cb24d5,85,70,185434,56986,128448,128,105,267042,57284,209758
a9cd9d0eb07f29e2e7a7878015780343,117,83,234183,41154,193029,102,73,208701,47813,160888
f734f5ba3eb3a36353707917f99530e1,175,126,597096,88469,508627,147,99,403813,110115,293698
a7ad77afb4417185436fd1064c7489ac,119,99,233650,32587,201063,96,81,164922,39504,125418
7868c6a6c0c4ead2ef05bf008e223bd7,24,21,17187,9889,7298,21,23,18240,7095,11145
c024ea8cd4fd4800473e94adf97b7748,153,101,458191,93811,364380,169,115,507037,93516,413521
80a1538431c9319d5aba8e07f5374543,66,47,98198,22451,75747,46,40,74470,35378,39092
506f1e2b79fb529b73023d896b16a8d3,157,116,507490,83854,423636,169,127,584345,93093,491252
1f86504e3353c257dbd153651fc20760,85,69,153597,50164,103433,76,68,154289,50738,103551
c452ebb9bffc18be8d18a2a935eaa75a,15,13,3178,1372,1806,17,11,2734,1468,1266
92de190aee1bb4b79f9ff745189ad52c,69,55,68846,24988,43858,64,56,71958,22742,49216
6580398b345bc24c9cba214c3bccd3c9,86,64,175500,57358,118142,81,63,132407,48133,84274
4085ede8d588e6046e89d809af454ebb,125,93,240161,57491,182670,94,76,156075,74456,81619
fe9bd3d55e337d6d204d29f9f0c5bd99,133,114,462531,117419,345112,104,94,304775,104079,200696
04f208d858c71fc06400bef1b6eb3bac,181,125,519497,97739,421758,109,82,334623,87773,246850
35f62200c49d7ff7fd16ad61cca40b9b,131,99,259434,46361,213073,129,113,208163,73495,134668
85cf4db4b4c82edcdbe962adf16aaa2c,137,84,308921,75435,233486,197,101,455049,72337,382712
77b1e1e69e700ae19f00975ce586214d,70,60,143599,46020,97579,64,49,106001,56167,49834
b8afac4dfd583af8673d1a098c6c0871,129,89,291890,68415,223475,164,119,360986,83916,277070
405d68cbcd13df6a3431855c47871145,127,103,319974,57012,262962,133,102,358141,63824,294317
caef8e2c701f02e2a6158611d0b1bc69,171,125,708762,111850,596912,139,115,483074,91551,391523
1f83d3cb91e4327d44346f509142c2d6,69,47,130109,26207,103902,76,68,92936,41149,51787
545ad7694161dee9ccb136e3497fad6a,52,29,45681,14224,31457,42,29,38378,11464,26914
0981347f5693fcd0d0261b5011484a2e,100,88,247825,64664,183161,148,105,388874,50418,338456
69560efa46baae298ab6a4ace9882832,72,52,73605,19102,54503,70,64,50051,29385,20666
87bfe4e200ec0e680d13748292dfc669,96,78,165924,32259,133665,93,76,158472,45224,113248
d47fb512ff8b47f06e29c52d3fffb674,117,81,172163,30710,141453,73,59,133018,32684,100334
b0f156b03494b0a28498be44f008c3f6,77,72,125664,55196,70468,83,52,140051,36154,103897
f95686c2d1a0862f52d17865e8f62162,78,67,169574,67004,102570,110,90,253277,62395,190882
1b8a720d0c51c22cc0b065120ab27608,69,56,95362,48586,46776,112,78,182454,45947,136507
f2121a998d7352247c92078f5b5d6677,89,75,127554,23261,104293,60,41,73098,30410,42688
11c4b4f30316f3d2e3de69d629fe1f65,139,112,520786,123697,397089,201,148,806847,85848,720999
330d081e269317ee586d554eafc80460,23,15,9562,2856,6706,15,17,6780,5171,1609
4eaab5acd429429a4df73d4b8d327378,6,7,350,781,-431,10,4,1307,390,917
8da0dffffcd388d08cc9698500c38172,40,30,27512,12667,14845,26,29,28121,7973,20148
62de84630d443b70fd2e64d632ac5d88,147,112,368192,92683,275509,141,111,468545,104887,363658
cf2531b616d2603d76ee3fca9f349924,186,132,586008,103962,482046,172,144,581614,140770,440844
565b430a011b7350049a858922e6c46f,83,69,160214,50224,109990,84,78,129287,51230,78057
b03fcba769dad2b647d75713e884a996,134,79,296670,44740,251930,151,108,365805,61101,304704
eed85e7e66ec079c2087d169221215ed,134,104,390659,87952,302707,159,117,407472,73800,333672
8441fbef4726026ef55a32758e83a8be,45,34,42584,15522,27062,41,36,32214,11978,20236
e6d71df778a0cbd7654f56d1f38ed21f,117,92,273346,75253,198093,137,119,340671,98301,242370
5e20b7a1fe4132765af22e09d16ec128,66,60,80966,25169,55797,77,54,81758,19324,62434
21a4fe23017ec0b8b6b150b39d864a3f,198,126,517878,124620,393258,174,130,559757,162228,397529
63bd3904560fd1b73fb228d8b7ef975a,156,113,410366,92846,317520,161,110,425882,80690,345192
a8d0177e131ce5374b7a6a5e77ad91f7,28,21,13034,3082,9952,26,18,10126,5970,4156
18e3dd62ade140f7b5020e35e624eacd,186,149,589834,92941,496893,190,156,628434,127790,500644
33b2645f028d60fc2d8c5f9fd90bfe67,82,66,195517,87382,108135,181,119,573286,82661,490625
fede418b653ffc48d548b9fe936218a6,132,99,239090,40215,198875,97,61,147450,37336,110114
0be8d96afd7336efc479e6ded271db13,126,91,288138,65875,222263,151,127,355895,77414,278481
b51959e66b40ef9fa80c93d79060fc3e,74,57,88166,36311,51855,62,49,87213,35226,51987
bd52d14273b2c8b8c28c2ebe6a1579e5,158,104,362606,107848,254758,126,92,286827,140079,146748
bf66de227af5035314a57d92166e74ba,55,35,53188,18788,34400,61,42,52585,18701,33884
03716c04b8d8a063a71f0cb1f6b823d9,58,36,51985,13417,38568,44,41,25383,12312,13071
58f72ea8e00b9c9b573b0dd4de233651,31,24,28374,9083,19291,29,26,30547,7516,23031
79eb5f0ae7e65b5596a9f0490696f41d,69,48,112309,28573,83736,57,40,61345,23064,38281
dab150880d497d1e30342153b8138d15,17,16,3313,1819,1494,11,13,2062,1394,668
1a2deb7ca20ca410173f27f76687731f,66,44,104286,23374,80912,88,74,160729,36986,123743
020f1ff42e0c21ab5a0dc962f60db879,89,78,187503,58564,128939,120,98,277026,87247,189779
3b86542ac27991b5692fb015fe2c179e,89,73,171370,55685,115685,92,81,164691,66974,97717
6330046f4b975e59c81b7e71388b5aff,145,104,412524,111015,301509,219,129,600159,104209,495950
f60ed3bfe1c00416f9703bd8537f835f,82,66,144273,37965,106308,111,94,201916,39751,162165
5cc8ecc412782554b48feb91f0e89c5e,4,6,393,506,-113,6,4,341,391,-50
8b5e6ed18c740a46be9bb755422bff7b,66,54,111213,30112,81101,49,38,84413,18278,66135
c0a91e858d6c20cd72a1b660aadb3345,154,142,542589,103290,439299,125,82,318003,106833,211170
dfd93b7950f962d5ccf3983ea5b4c913,141,100,380495,147381,233114,159,130,538343,90006,448337
48b7075871f76fd2fd170d6afc2f7762,28,19,24598,3785,20813,25,19,15930,8670,7260
09bb00eead7b178881075173bc7a64f3,126,96,323595,76329,247266,125,95,223551,67742,155809
66429b51f5e0beef3671f4862b4de138,40,39,31901,15063,16838,56,41,37481,11732,25749
ae92bba5754f1ef29ed9476ce4ec290d,107,76,292899,87602,205297,131,102,364230,99224,265006
34b1f295ca1a843c8ddf852a6a5b50f4,111,93,242344,52564,189780,97,74,173777,50557,123220
67fec8d237b8caf90bffe88609a3dc2f,104,75,192324,52505,139819,155,125,389530,59378,330152
8290996c116cd3c1df1a49f3f1356bf6,34,25,41905,12529,29376,43,42,52097,19263,32834
c49a4d0eee60b2e56dc11c193f02ad6a,138,109,312981,69738,243243,92,82,199520,63601,135919
164064206d1ea90198299f7e28b080cb,181,122,367437,96712,270725,180,138,614088,96174,517914
e503e541190e62a31ba8554ab73686c2,168,131,544301,98331,445970,134,111,429963,78974,350989
32a85cc9790979941efc0c583cdbf8a4,59,50,92012,39382,52630,106,76,183064,35837,147227
c490f148f4d2f358f3d9f7e084515b14,111,91,274230,64941,209289,138,101,281176,60660,220516
02d61aa1d07113a1d93e33ea478c7aff,117,85,214551,44492,170059,126,99,293091,50859,242232
909c4446a54e4385450a24a0af7f4657,135,109,359777,69901,289876,126,97,343783,80392,263391
c1b3e6835857b3e539ed62c15e6b8641,3,0,735,0,735,0,5,0,783,-783
facb22a0ee993e5130496a2da5712512,41,34,47212,17979,29233,47,37,53496,19174,34322
1f26b4e7da9938edd0eb625016b782d2,50,35,65920,17232,48688,66,43,71265,16198,55067
5302dbc419f24eee6e4ee48dde078f6a,46,38,69978,26812,43166,54,42,69551,22481,47070
046767eead8d4f534138b3f34835c2f3,38,35,39403,24317,15086,56,43,61106,14973,46133
7aa901f3e7b1c51bbac20611d50f23bc,94,78,138223,39714,98509,69,53,126356,31924,94432
8ca1f9be69b214e0c6426ebb64e6e6a3,63,39,62945,18141,44804,57,45,49064,20892,28172
618bd8e58ccbdd80b01ba458a2be29bf,87,88,153083,36141,116942,82,69,90895,30732,60163
b4e4fdb4bbb1e7ca4b2e72817e423823,145,122,494168,71736,422432,214,145,603884,80481,523403
c3ad8cb75b50334ab99f99795b308d82,105,74,201934,53572,148362,119,96,198341,40662,157679
e6a5c967d13a60037014862ac54d1db4,101,72,149662,43169,106493,144,97,257218,48508,208710
1a422a90e7f0ca701bf12fe29efd17bf,155,117,317152,50030,267122,120,90,206989,64378,142611
defcff30e63eef84b58944b0d7f2fa02,93,75,167571,39859,127712,96,83,200516,39434,161082
0d2c479dae14eb7703ab775db5f3431b,112,95,192774,39960,152814,128,93,166413,35110,131303
59e0beaef6af0a01b7dc9db49542ceba,161,112,753758,148388,605370,193,130,646014,120758,525256
88ae29bffa3b23cc795ef2ca6f01be90,75,63,144969,29172,115797,81,46,79624,31826,47798
4f62a392d667c290fff7428e6511de16,102,79,274338,59612,214726,85,68,154209,62220,91989
4dfcbe5e2a9c5ab5522288ed71307431,120,88,306336,43407,262929,101,76,178584,48882,129702
e491e9b9014f00194fa2dc0134f11951,132,96,347211,62506,284705,181,145,455636,87272,368364
6f6a13c9396a3b488ea2a1be406c4c90,63,44,77180,19040,58140,66,48,46278,25635,20643
f32b1bb7f3bcc1c6072cb6847d6b7bc3,145,112,274945,55273,219672,165,126,265742,66391,199351
baacae411961e54846a37f2172fad6b6,147,103,369825,99727,270098,133,109,370332,134461,235871
1a5f94ad3c018fa34dc7b2a647b83fb2,19,21,7822,3467,4355,21,18,6450,3812,2638
8333f66e6aa0c708c6ba5c84e932b3cb,19,17,4299,2694,1605,21,15,4264,2597,1667
515e14910de9d4cbc87582c1264a9128,162,124,602584,134464,468120,139,106,459358,122023,337335
55b54b8637de62f55463581ed26958c8,82,61,118216,30265,87951,89,70,121293,27094,94199
f1bdaf356358b8e09a331e1f8eb1e967,53,45,74831,24742,50089,45,41,54473,26110,28363
22800ca4247ce821bb458185bd553e3a,71,60,103260,24417,78843,60,47,63627,31982,31645
b3beef3557aa86a0dda782f8a9de70df,138,90,297687,66324,231363,137,92,253562,59202,194360
a84bb1123cbb853e845eeea14fc10984,88,73,171851,44717,127134,113,82,177876,57604,120272
7fd35486caaa1a03d688aa1e76ed9af3,24,17,8957,3110,5847,27,22,9101,3321,5780
d13d28f2e3f889dc3d2d612cb43207b9,140,103,446476,74412,372064,152,105,357917,76799,281118
c6fead2129b78a0e141b74e49a3d1b8f,67,48,79203,29819,49384,59,45,66660,23382,43278
677446931ab2aae512354f38be0a6346,127,97,266098,54963,211135,104,72,197255,50911,146344
754a0f0c9460186df97710201b9a50a2,22,16,10843,4070,6773,25,23,6996,4890,2106
871e31c15da5c9ebe2532cfbd318584e,63,51,81529,20750,60779,59,53,66440,23875,42565
3ff0c8d6ed45197192b67d4cd573d696,100,77,192842,45542,147300,119,92,269536,59568,209968
1359a82807ad1f42ce19725cbbc3f75a,50,36,52635,15349,37286,53,41,49668,13018,36650
c3b3294ba93bc705ad44049a7cf94de6,46,34,70891,13636,57255,76,55,89256,23668,65588
8cd1a4a242571bc3990003d7e7b9b9b1,5,5,564,528,36,8,4,1169,262,907
ba317f79aa239e78bd88069ebf651c7e,144,93,372712,117020,255692,175,139,545774,118356,427418
d16d4841f905b1bd9e822025a062f2db,84,72,179253,60699,118554,105,82,239617,54922,184695
4f1263c10b836c9ac39b22d4c8cd4da8,64,60,119643,36737,82906,84,68,115396,40715,74681
9464395f9b10fbbe8db92e853724e8ac,170,137,413951,125024,288927,95,65,283089,115582,167507
cdcd02a63e495e7c84c8d8582865ab4a,39,30,38823,20703,18120,38,37,30455,17467,12988
7e34f25ee5437d39e23c8e5d02d0cab3,168,139,451506,88085,363421,175,112,505326,72464,432862
adc9efdb9ef728b1366f4e12a103935f,65,50,101852,32049,69803,52,40,75905,34503,41402
9f9d249181fce34d81c551586c453f1a,121,90,237525,51066,186459,118,96,247304,52849,194455
32836e2d3c14a966b82907179713517d,80,61,101833,29163,72670,87,64,94136,23180,70956
f1abd8208243b7cac004a0542e8d72d1,85,71,147031,34339,112692,80,57,98909,29614,69295
6dae7b1c3152f55deeea66a1e33199ca,169,139,715624,159339,556285,182,145,832227,153405,678822
6d0f745eabc223e8578a19f2d85938c9,198,120,642650,148763,493887,162,132,535589,145619,389970
e889b3403ac6c717e40b6400f011685e,109,95,219148,46187,172961,139,115,237442,51290,186152
737d3b14bdb8fa25d510e426314071db,29,22,16633,5716,10917,31,23,17010,5750,11260
073ec9e89ad4a984ea70e98c7e98e3f1,70,58,117020,36606,80414,61,44,110698,35157,75541
996252034ac78750702a42bb49102f7f,129,107,253898,61529,192369,85,75,130460,43503,86957
d0a3ec01af6c8538d58aaab4144df530,28,22,16558,7395,9163,30,23,14987,7754,7233
47c3c33c325d88b72539b041df64540c,80,58,108985,42828,66157,87,66,133987,32983,101004
14a680b2a910e55d4d316c5783675dd8,142,99,333095,48797,284298,117,92,259104,76272,182832
e09221b079889f12ab6006db329ef326,79,63,141320,25242,116078,69,49,81490,28400,53090
cf2db951916b0ec3ac21b9d873816a0b,165,119,381508,113212,268296,159,102,398005,109297,288708
70fa606d6273fbcdd17c22b0d00e2728,40,30,34918,8161,26757,41,29,28478,8843,19635
88c47f121cb0f3f5e0bdc01ade70758d,71,62,140292,36254,104038,70,64,110578,43353,67225
6f7cb8216a5bdd8fadaf7c5dc9a80797,84,66,100645,36596,64049,125,96,169091,29306,139785
2ab252476885df8c2e5a11aacc2dcd93,62,41,121665,33649,88016,97,76,169681,42763,126918
8c65c9d460c996fda743aba2fb03e19c,150,116,391614,85304,306310,126,94,322842,86003,236839
8ab0f31c132c4f0ee04f583bc489ebbc,1,2,82,214,-132,3,4,292,277,15
cb7d3f0e27481534d4959314c973214e,154,84,389117,66041,323076,182,130,504132,82892,421240
1ec379502aa38eff56299f0019e6e2ac,93,71,134141,25369,108772,60,62,110075,44988,65087
547904a62a5e23385332bc901a261ea8,68,53,134626,37889,96737,77,68,164989,42562,122427
1cbbcba5378803aa104e4e298fc20b9d,66,59,85466,22604,62862,50,40,56359,20439,35920
26efea99ca0f9f34095170b50b32db01,63,55,115218,30415,84803,56,37,75038,28081,46957
8cdfbd003011424c17bbab82ea61bb4d,109,77,309585,124644,184941,164,94,410015,92021,317994
e82b97d0f71c2c034b1bcd3f6010c015,149,120,572853,137755,435098,197,130,660824,142410,518414
354ba6085d80b68d9323ded334453234,144,103,377865,79762,298103,197,128,457453,74129,383324
b7065306c2f04a904e8f35a08c8ddcb6,58,47,77371,26054,51317,71,47,102395,25203,77192
6ce723e55d8186f789222b3a162757b4,104,92,184925,56612,128313,96,71,210767,49249,161518
627c3d106c04e2a4fe9bb4a05393770c,63,47,108160,30501,77659,66,54,82640,31916,50724
04feeb1967ba8d45523b6a10fc7b4733,1,0,26,0,26,0,1,0,26,-26
968c9f3cf9af9a99b0aed4e7276820c5,98,83,226196,55048,171148,87,66,171153,40358,130795
aa8f85c7a9e1aca127a28e96bd7956c3,27,23,13168,6423,6745,29,19,18183,5578,12605
bd78036b0fb7badccfcedaf4c8194f95,140,121,414259,101249,313010,191,140,506809,96386,410423
c9a4aafaea3d7d51df2a484ad835afe0,96,72,124205,19887,104318,58,45,65636,19262,46374
254df1fbfe4279a425067899b019ef3c,19,19,8017,4536,3481,24,22,10739,3955,6784
5bc3d3341d35f306012b7a3f80920ceb,37,26,34973,17221,17752,31,28,46892,12611,34281
2bf018451f40073704e8408942a7cdfe,162,134,500040,83514,416526,157,114,399612,78176,321436
cae2c3f03fb83df2e367f7707c56908f,70,56,99798,22080,77718,51,39,44750,24326,20424
ea06556f4ea7f9177df62d5ccaa841e8,143,97,273822,69264,204558,159,95,256982,70302,186680
0b1cba9aec12cd56444e4db424e1af33,173,126,390080,81701,308379,143,121,425172,71148,354024
f4311ebd33d2f0c390a11d19a295ccb3,105,64,110889,36456,74433,79,60,150192,32179,118013
db847739632d914a18e55cddf430a739,54,48,65602,18633,46969,76,61,112223,24512,87711
78d0a096f15fa9f1372612eb4df7f686,15,16,5291,4531,760,19,13,6286,2837,3449
10912762d70f76ff6332d23f77083c2c,179,121,407005,55823,351182,133,112,346524,59680,286844
2efef1ea11dedc0b2aba482c95a8f330,122,77,282719,75334,207385,148,101,361963,97979,263984
3c263410e7d4792ae01e5f06c532339f,46,26,36361,11039,25322,28,25,27907,16117,11790
9979e2575d03ca05cb0f421bd63c9427,27,25,18786,7044,11742,27,25,14654,5342,9312
598776b154ddc7cb6391ca649bb6994f,101,88,168841,33692,135149,103,82,180886,40713,140173
df3cfd4714fb21a6d4a6c7b55c4572e1,110,88,152677,41486,111191,140,100,266133,39695,226438
991ec9be6b37adb193796b0149e832ed,107,83,237269,59588,177681,89,71,176437,75322,101115
8f5440835cf3466f0cda3d59a92d3a79,17,10,2728,1101,1627,15,12,2175,1176,999
f7f1299793b3a40731ca00731530065b,62,51,77864,32898,44966,86,62,157064,26042,131022
2fb90e372c1fb1ac4fb6d97f94fddcc0,130,110,293866,77507,216359,142,117,366999,69866,297133
83052e24887094952ba865a8b3839d33,108,85,287668,91626,196042,143,111,458246,72856,385390
11b044db8eca6e7c39ff1b4e6e9d54e8,38,36,37212,13046,24166,42,27,31686,13403,18283
74b347bb2a2e9e9e0f835b79f4fe9da2,119,96,239648,46416,193232,131,96,194023,57178,136845
d878ec94fa7da58780a4daed89ef39df,120,86,216343,50595,165748,124,109,242366,46314,196052
ae8cb48b1cf1b5b18dab7e7e4097e4a2,136,73,213427,49665,163762,113,89,226164,76538,149626
39346774c3dcd627102bdee1e28bff34,12,8,1120,518,602,12,6,904,550,354
0257091c565c6331980e01973b2655a7,131,106,536478,101709,434769,180,129,504358,112535,391823
cb2228b8f6de10090d95a0d0b0f52c9c,27,16,28982,6835,22147,31,23,22771,10678,12093
d06f351daabee482617f572baadbb25e,46,40,48108,14540,33568,38,30,28772,18679,10093
375ccade5b4bad5c8b1f3ee653f03261,93,77,194432,36138,158294,117,95,207372,44881,162491
0ed23e79013cbd6bf82871fff6c516cf,172,109,730638,166707,563931,186,141,915188,185232,729956
200d6d7be3e1b200abe89fc02ead266f,31,23,12660,6149,6511,28,24,11110,7396,3714
c29de2993f1f3ad74ff00facea0f33f1,20,17,15403,2822,12581,12,14,5732,2909,2823
dae97874078456e5734b475d2086262f,87,57,128155,34198,93957,83,72,167026,73681,93345
31d8cc7e8aaba2692f41ea73410cd200,95,72,163108,28990,134118,75,63,111933,28823,83110
8536bb5cb5cc4fa5b45c24c8d46fda8a,185,134,469422,82016,387406,148,122,435455,96138,339317
30ad06002d9cb363aa64cbe090201170,41,29,37522,11130,26392,45,41,30477,18389,12088
09840cebdacc507d04d802e469af0a86,53,47,66690,21622,45068,77,73,84326,29023,55303
b050bcf8c569227ac4108e1ecc9f2342,103,79,271005,41762,229243,114,85,251149,55720,195429
08c0946af15432a9374bce4ef6caa88a,42,35,52398,27239,25159,61,54,107139,25858,81281
3032d5a055010c346d104df8df7a8a0a,94,78,167877,40157,127720,82,62,114103,30749,83354
a18f646945713a20f93abd8f658d7b46,141,117,793959,141719,652240,205,153,893456,159871,733585
11a056f13cd16e71c34b4776a8e27bf5,54,44,72859,26602,46257,69,55,127508,31938,95570
62d59bf6db6c5f02b8f09aad5e8c8475,71,60,126959,35983,90976,93,81,157110,33131,123979
911c82976033e1d650974ade3f88a04d,34,24,26363,11546,14817,33,25,27842,14237,13605
2925b800d64dcba9200130d37fb3e203,72,48,101081,55993,45088,98,56,157991,35802,122189
291807f81aa06348d4f41143650fabca,97,78,183379,46979,136400,71,63,91259,38658,52601
8325481821460486f3935293c788c6bb,64,49,112109,33791,78318,51,42,79923,23687,56236
5e6046aed174040d0d252a0ece66bec1,9,7,772,1379,-607,10,6,2253,593,1660
7ce439c660eb357ab72c6f10d3edd800,31,33,28688,12732,15956,39,30,26476,10284,16192
a60bcc630fc1b18f1e29fadc776b869c,7,6,1026,1015,11,5,7,959,945,14
5b20e7570030767737b1709cb6fa1e2b,79,68,200990,44731,156259,104,91,205463,47088,158375
879b89eababb2be2db68c0d3da4034cd,29,22,20037,14712,5325,37,33,44417,12301,32116
d1c78e0772516810e979510082d66df2,49,37,52209,13745,38464,45,35,36460,19314,17146
eb96ae3881df3cdbcc7bd8fa7e03a0ad,84,63,140057,46831,93226,76,59,130220,42526,87694
8bbdf3c388687b121ebecded2aea7bd7,9,6,2002,1346,656,12,8,2399,1411,988
fcb2258725862cb298d27886c5a755d5,62,47,81424,18729,62695,29,22,46280,14359,31921
c1310ef023d2646985f3f95f009a605e,82,61,130169,25639,104530,67,53,80124,27495,52629
86ac6a23c0eda6f3a8848bad8348fdc5,45,51,42377,18122,24255,47,34,41450,16596,24854
3c8d80be92fdfa71e455fcd95f012808,108,75,235412,74330,161082,138,106,350172,67196,282976
506da828ccf691a034a2b02e70e8b29e,84,82,130469,29036,101433,78,66,141875,20124,121751
225090741ef04432aafaeed1e4dd0119,96,80,179474,49966,129508,93,77,172034,44900,127134
09fde2d12ac717c1715301fd7fcef875,27,20,14514,4007,10507,23,21,9189,5458,3731
230476d56f31c443501678c456da7c93,26,21,15225,7414,7811,35,29,20849,7110,13739
b3855e7f8043d9c6bc82200df18c6d17,51,31,52147,12161,39986,34,24,22364,10590,11774
1ecc6279cd30c485ae9caf69eb4acba3,73,61,140398,45236,95162,87,71,122115,43491,78624
89687e4fa3f48e4c4d718778ca33aec3,77,65,125149,36140,89009,73,50,103818,33114,70704
6f5122a4698fc719f2908eae4613d3e8,130,114,324503,63477,261026,152,112,333770,60473,273297
da07f207b4da6097d07f81e91783f675,140,96,521807,74662,447145,208,152,900276,69607,830669
d3f72de2b62cbe8fdd7167548abacc89,126,102,331533,88144,243389,101,94,285598,100599,184999
d659746602ae6bfab4cf9878e935ad65,49,40,63081,18201,44880,41,32,38011,17460,20551
bbbf0aabdfe43a78726ff0ef7c1a89d6,187,125,528756,98542,430214,180,124,608985,94209,514776
59b7c2886916ebf3f61dd1d408235765,23,13,4939,1300,3639,18,16,2874,1744,1130
c8cd41d02abbbbf774ed3465eaa6d871,137,112,440730,93186,347544,153,115,498291,70446,427845
b76a652d54a5cc016608f01364bcea0f,107,89,305742,64393,241349,140,91,359582,76880,282702
ed85ca32fdc8fb70229907884e429f97,31,26,18739,6765,11974,29,23,16801,7912,8889
8af29ad69f485692ef123904f514fbf9,35,24,16882,9282,7600,36,20,26520,7218,19302
ac22e7c38530a0c9081ec63888e5e744,142,110,342104,48402,293702,90,72,212412,42512,169900
b9b29a70b8c632e7369d059795cd0fdb,189,122,584560,103740,480820,203,140,694913,150666,544247
eccc7c6f969144da3b96848a1bf167f1,16,9,2224,1350,874,15,11,2142,1279,863
3a1319462898e2a555e8edeb986e9fce,130,101,346029,125446,220583,103,76,328458,95333,233125
0b9a621f5cdaa582ab82f900cfed3337,24,24,15235,6854,8381,33,27,12981,6734,6247
27ac03a48d96402c74a91b6471ee33ff,71,47,119067,27576,91491,102,78,161854,42477,119377
4c4b10ce273d0baea10c23574d9e90a1,66,56,146871,45814,101057,101,71,211552,52683,158869
514ce5d743694e69ab7b9a7da5b4e100,66,47,148269,31192,117077,66,45,88516,30324,58192
b5f53daada0c855e6d8dc20c4d0e8a98,109,100,210113,79198,130915,115,81,207563,42321,165242
a571edde626b5f48230d466250c82122,105,60,188430,85633,102797,140,102,287695,97554,190141
eb1c758e6b7df3c62fe1347dcb35730a,30,23,11582,3920,7662,25,19,9821,6602,3219
a35f085c4cb5e4c3b796638494fac7f8,79,66,167994,37052,130942,125,81,215818,53553,162265
1045da3e1f77ba974df1750c543d5ef9,15,15,3577,2029,1548,18,14,2914,2006,908
290e9664e3cce74e78ff17abbce2c48d,39,33,30550,10772,19778,46,32,32664,10017,22647
610d0ec37ed296373508c9fe4e522782,46,37,52841,19069,33772,41,34,38325,15662,22663
425af6db82567cc71378279197fee629,18,17,9698,3022,6676,24,18,7636,3841,3795
bfd43c3fb27f767e12ac870c2afe9433,35,28,31331,10104,21227,31,26,24415,9189,15226
a4a6779c334c1304a56da9628ba9f614,85,69,138890,35550,103340,91,78,145393,39442,105951
ed8e418edd8cc6b5bbf777b53a4ae20d,162,108,442190,65939,376251,135,90,324180,70808,253372
15fcad5897cdef42b192c7893ed93175,38,28,57035,17522,39513,30,19,40013,15090,24923
cb28efaa71ca4a854672112ffc42df7f,86,52,186195,38881,147314,107,85,231141,63902,167239
93fd5ee8077928f2008ed55ed1c3d828,99,84,232522,58957,173565,104,81,210880,47588,163292
d56b2706b2178dbff10a8f1abcccd209,90,80,179101,47828,131273,113,105,211600,60339,151261
1edb3d0b10423ab8c20fe66c1cf57699,201,139,438093,109245,328848,171,105,397765,106650,291115
cc44e7c0c5b4b2848dab666219921d73,45,36,38770,11499,27271,34,40,27130,13779,13351
0543743e40bad2dcd0bf820638547866,122,97,403176,79679,323497,149,133,453442,90387,363055
5c9de3b940f6e108cddeb2c1fa4cdab8,28,22,20595,6208,14387,30,26,22576,7405,15171
b920d2d5060e1191389692333dda8c22,85,59,146784,28490,118294,107,89,184826,51091,133735
edfa27642ccbe2d3d1226128437751f7,15,9,4766,866,3900,15,9,2070,527,1543
a6444aafd4b5f0aa8288ed8d48b26aa4,26,25,22559,6314,16245,30,23,19081,10288,8793
7e6aa02eb99bf22f52e4e82f2e81c939,220,147,985872,127753,858119,157,114,1067820,116059,951761
034c800f17ad14d9ab0b634b1dbd073b,73,67,108044,31028,77016,67,64,89045,23187,65858
1ad1e8e3f59252090b0a2b1566b33cf5,35,26,53437,17943,35494,41,34,55162,18817,36345
f25f346d048bcbbe02d698843b83a748,130,109,308377,77697,230680,125,120,366565,70588,295977
cd0ddaaf078a77034b8d4f59a38e5992,167,135,549435,105068,444367,175,132,598817,112933,485884
1f16154f42221e5a80236caf5d647fba,171,130,444694,87194,357500,143,101,370502,69351,301151
75e8b085313dba70704415cfb7beb658,102,81,213310,50451,162859,127,107,250464,62462,188002
107c16c020a60b3de80c250480aa7a9e,41,27,45236,14396,30840,39,26,48895,17369,31526
2a8d186e273b9294054683cb4aaff372,161,131,661559,168103,493456,167,111,585475,143763,441712
d1bae91abbe02beb4de8a8446450c437,43,34,49422,18548,30874,35,32,43010,18020,24990
b3ac205c9d1931df3cd2f9c758d72a03,47,41,32126,17864,14262,43,32,47041,16713,30328
7b9af6f91e7b4ef4188d990d22094cc8,71,61,116116,29692,86424,71,62,107770,23602,84168
67d0b855b83d555d6a0a8e3be83d4436,30,20,20916,11089,9827,31,26,25525,10271,15254
e6ee7c5afe373ba51aa987801886bfcb,196,137,788717,132961,655756,140,114,548048,139364,408684
7a25cae6cb85630ded120c3834d1be1a,49,43,81248,20726,60522,58,46,60477,30275,30202
564074a436a01623a90bb0f12cab7ffe,28,22,24336,7066,17270,41,31,34173,10909,23264
e50c7c0231909224ce89a8f353bb3ff0,93,73,75601,27595,48006,54,47,72295,23080,49215
be3d6c3d16820da4a659565f774b8d42,53,42,73351,16091,57260,39,37,42951,20193,22758
1ab62cf669fff170aa9869f1cb6a0717,105,95,183960,46132,137828,128,96,210128,42056,168072
a1fa7e3a30cca54396a51a5e329f2a8e,59,50,85900,37505,48395,56,48,95714,27511,68203
badf03ac5ad9b8331043d0a44faa59f7,140,105,389081,82386,306695,129,104,391213,82394,308819
ba52c4d478968b81fad867b8a9027644,31,17,25689,10861,14828,38,25,37342,11300,26042
2247046719a29247f19b4e6c7173dcd4,134,108,486964,105122,381842,138,109,503361,123890,379471
efafff024d7d2efd3acb9259a3ce5b8c,53,38,60613,22126,38487,77,55,81511,23694,57817
5fb50e73d1a9a00c0f3f27853da84727,109,92,256838,68820,188018,122,98,247710,54993,192717
d4056325c48f223b326cb01805a0a8fc,100,76,290290,88287,202003,155,106,348174,120469,227705
e9dc0f88c8bf024b655ab7f7337add2d,189,115,418120,91318,326802,152,106,394593,109406,285187
7bb014e21d305795b5d48d347605d7e9,118,94,307733,55869,251864,133,102,334706,64499,270207
1c436b8244576b651fff780af28222eb,29,19,15134,4033,11101,27,25,10995,4941,6054
6eace6d421fd0310e0bab5863d073e42,18,11,3521,1068,2453,12,11,2623,1486,1137
8281f4089070be2568ca3a950e849066,136,113,264710,46965,217745,106,89,241584,61479,180105
0ed62402ac2ee300264c606b7d15bdfa,28,22,11756,7165,4591,34,32,28112,7154,20958
299b9fd64c8cea5ee6c351a95208e987,198,154,833939,117253,716686,154,114,627331,129261,498070
546d8151b2adb5dd3238bf107633a2c2,115,86,326994,84694,242300,153,122,457547,126931,330616
affcd87be0a74a93a0940dd278169aff,128,105,329949,90186,239763,135,89,389189,101432,287757
e728affbe1ef364c1a9ddd1450e3751f,146,106,453316,91382,361934,220,144,642760,66777,575983
044c9af37c2303c8e40782d75e53c0c6,198,118,600282,129730,470552,185,148,621517,176117,445400
d1674f11320406a11c09591a5c9ba0a7,111,73,258070,90201,167869,116,85,272196,79999,192197
bb39a3b7d2b0429c26e322633d94f0a0,18,16,13677,3565,10112,32,21,20814,4809,16005
d6187bebb76ba0a19a7679c5fe579e84,33,25,35598,14147,21451,50,30,50814,14836,35978
27839c5c5323bc61a51690e83dfd1d58,13,13,6102,2417,3685,13,13,3717,2959,758
ee6ed740bbea9161d8ea644d87b87e1c,62,53,113702,52508,61194,86,75,203482,43684,159798
364522341f72cb7b711b7142ee379adf,112,87,250352,58992,191360,115,99,243136,64569,178567
bb25200b5ff7a0ec199ced18c6f71c55,44,32,55207,12929,42278,38,32,26779,12967,13812
757d008ebca762fcd54b815e7426150a,59,49,72921,17972,54949,40,45,42334,20262,22072
8cbdcb0e6db168371de92419b4c8ce0e,136,104,320612,113955,206657,150,109,397083,87489,309594
987ac69b7080c099134d8a3a2882b9fc,127,89,335152,60570,274582,129,107,269357,60382,208975
c55fa17000b4d1160a2276f5cd8a39f8,38,25,40106,13675,26431,34,23,30423,9464,20959
35a7dec776c7a3a5c1cf25ce55d5d9bb,44,25,56230,15357,40873,35,28,34040,15467,18573
56756cf38d4c3e7f630ea76bb3a901e2,158,115,555016,114778,440238,178,130,583636,82867,500769
ba95cf13dd046e6628dd6251bc3a5a97,94,72,141298,37538,103760,137,117,269924,43360,226564
f99049346977ef204eaca1d8bef11b6c,61,55,96998,39809,57189,90,75,145923,39504,106419
ae1bb8260f17c1aa8cc1dc3a59085da6,158,122,435606,94820,340786,149,115,423811,70588,353223
5bfb9db39147cc6dee89da60b50f4a58,90,77,229901,56838,173063,93,75,197098,49674,147424
f8a2007f8bad9d3c6f15d50486231c07,68,47,83028,22424,60604,50,47,67906,26873,41033
cb252d2a722a11c38b54890985ae48da,140,113,360104,82647,277457,125,97,266788,92521,174267
c7a9b4137f19b8c2c4f2155b96ed558e,61,55,97072,28735,68337,62,49,92065,21819,70246
85108d6fc55b2b029cccc6d3e031bd32,53,43,57415,20345,37070,57,38,58809,18948,39861
ad28fb3375688818ec38d8dcd806431e,202,162,724480,128395,596085,170,137,888134,133404,754730
16d53b38f0097f61b5bc36cb5a1c06cb,55,42,60096,22922,37174,82,53,82861,26258,56603
07783c8a6c55e312f21a8048e980f790,44,32,48655,17835,30820,49,45,70321,20980,49341
03d54777f2951ed853abae87785bddc7,181,119,786662,113820,672842,217,152,747660,143198,604462
9a0aa68e700b080f6afc93df1254200a,137,98,295068,58238,236830,110,94,223952,79141,144811
010978d6692424bd673be932f7f8c5d0,115,79,191735,27915,163820,84,55,154135,30638,123497
e46d7627cbf3324637412f2d7046df0b,66,59,85893,43007,42886,73,54,96389,45638,50751
23ac6d6ca65be4fc84fd34cc648ccb9b,26,19,9185,4159,5026,23,20,9796,5219,4577
e9a7469b86060939e4d8b69332db52f6,20,18,4890,2642,2248,21,15,5329,1815,3514
cdeaf1404dfb4157406e8e6658f9509d,87,57,152803,33378,119425,95,88,173597,42647,130950
8521c808d3767a14994f9e51a212882c,125,90,330074,96516,233558,89,82,263674,112065,151609
50c5754f58198598f4f476b56c972809,36,28,21439,10856,10583,35,27,28119,7889,20230
a7db0dbcb02e1391cf9492b39d14f9af,174,131,586422,146213,440209,210,149,622373,155786,466587
3d5215f277842dc68d16574382a35997,29,24,19045,7263,11782,30,25,18812,8737,10075
b6abbee31b5b0bd91148339dcf8d2711,121,86,368560,104345,264215,181,134,593342,117586,475756
b8b07ee2aa99e2bd8ff62f7ebe35791e,131,97,501722,120214,381508,172,132,535359,129852,405507
a1e66f0718c015e43cf84a9a0de4a565,42,31,41309,11283,30026,42,27,36763,12247,24516
e2fd3397c65887f16efc8a183f00b87f,43,27,36709,17263,19446,39,29,44563,15063,29500
ea974a6f9a731b596aa9201b55e3ef74,91,77,186167,43189,142978,114,103,180035,33396,146639
b0783fb6399f44711ef0bdd7b062c329,79,55,111260,19814,91446,88,76,133556,35237,98319
783086f506ebec4c707872a06ac56404,102,90,210374,50037,160337,95,76,227543,53517,174026
78d1cc295fd5fedbf96cda2e210f0133,59,56,75845,15631,60214,73,69,69989,21494,48495
e2fa65df28a5ebd48bdce396b200a066,153,98,387863,74554,313309,140,102,363493,61459,302034
437d22e55891e705de576b7c09117d34,232,143,1125773,117834,1007939,196,115,720552,162711,557841
168c9924512ab3b65e5ac1cd85cfa83b,121,95,231784,42398,189386,115,95,171709,49331,122378
01395ed8a6ffd2e0777cb0dbd659d4ff,49,41,44084,16913,27171,43,30,47514,18292,29222
ebb986896c5da8cd9ed70170e058d2cb,109,79,272964,93555,179409,180,142,389410,132762,256648
e2e93fbd6bddec41ce583be96d9d3cf4,31,25,33181,14573,18608,32,28,38831,13193,25638
a6f0e5082c24f27ed1911f4920791f88,70,50,91156,18593,72563,66,40,83324,19277,64047
a57de88da8b65c3e46da96781a97d9e8,92,64,122001,37380,84621,120,92,146394,44178,102216
30db39ec8e1e3e12d4d713372cab5404,95,78,210545,82078,128467,129,105,358616,62205,296411
a1025b970b0b73fef8a19256c527ad7e,31,33,30173,11650,18523,28,21,25757,4444,21313
a9db31f41a25615d68e088a907151547,118,105,304661,85638,219023,124,101,267151,62762,204389
f8cb2786cbdfdcade1d36e1091b46231,125,91,378078,102937,275141,104,90,321774,120036,201738
8007635bc96ff1ae4f4b8439f2a4082e,78,50,104095,31145,72950,53,47,83106,30728,52378
717cd61ee959346d1f546069762efc19,43,34,43096,13301,29795,37,32,27581,18316,9265
30dec81d6bae15d8526e6912e7a64387,12,12,2783,1486,1297,15,11,2655,1455,1200
a7ac25a94aeea637efba990391deef45,134,100,274239,88825,185414,134,115,380059,72852,307207
160075fac2fd37ee5da1583fde554231,49,35,69193,14264,54929,50,44,57855,21045,36810
a219c50aab1077a69d9a717b970936f9,32,29,14662,8228,6434,40,27,24173,7063,17110
8cfca5d66016fdf40f125b88f1279236,58,59,76797,25027,51770,63,38,73803,17643,56160
92da9f0195c0028d9031d3186b0091bb,141,108,343176,68753,274423,180,132,393427,85427,308000
74192ba90015a086dbae7c55186939ba,67,56,112038,27245,84793,59,54,76961,40104,36857
b1abb895cd519ec07cf7ff5e2cbb5c42,43,34,43556,14550,29006,39,41,36252,16394,19858
ebd650bcda88a4b76b2fdadfe6371fe7,136,90,345660,63385,282275,162,110,319521,64270,255251
eb837ef1a0b8904e42075505821d99c7,137,103,343429,107776,235653,104,78,289213,115244,173969
fd00ccf4a71e003efa1c4da339f97ae4,113,102,331748,98559,233189,166,135,411228,89129,322099
483d03ed2e88f1ff76633321947f07f5,135,104,488431,103948,384483,144,93,559935,99203,460732
a5c02c28791868badeaafaa5664f007b,152,119,527682,152783,374899,153,133,508738,127302,381436
c1be0c0323c93ead5271878838031d7d,113,93,335499,69068,266431,104,68,231334,87578,143756
b21602038eae374d606aa49530712c3e,65,56,78971,19522,59449,77,58,84018,17103,66915
27638b5ab9f4446db597e631325d854c,150,112,481526,131429,350097,161,122,585615,110453,475162
3e2af0e5c0e533a8fa586654895253ce,109,76,178446,77996,100450,105,80,236083,61789,174294
68749e36a36670b0601b045a4f8df0fe,78,49,78962,19799,59163,67,40,74158,21991,52167
7eb05fa5a12e8d1585cca451a66ef0cd,55,43,66051,28679,37372,58,45,71303,21564,49739
8eea2ca8d95cf960f8bd5450b464117f,166,127,405820,113497,292323,115,91,298450,84299,214151
3cd30c45befee98129a08c56fa6e835c,178,108,510591,90917,419674,159,125,581886,140639,441247
4a83405971c364e5820ae00035d43ebd,73,52,124246,28845,95401,92,87,146813,44355,102458
7ad53104076d1a075ced3fcb794aeee6,168,100,453170,89596,363574,139,112,384077,93364,290713
594c3154583fbc6f694d496e7b63ed52,133,95,314392,60683,253709,116,91,315957,63315,252642
c569993cb0fa87098b1713cbf5b4fc63,39,34,33973,16685,17288,35,32,39057,14343,24714
0bcd1fb13727a95bbee54b0ee47d72db,65,54,95309,34694,60615,65,57,73793,38521,35272
fbf89c057352a881612e8610424b7313,124,97,264537,45076,219461,91,72,164929,52007,112922
cdd7799c758bcef0b89f85988aea05b5,129,92,226932,57553,169379,126,94,278629,47565,231064
6ff5f977da11b54654515ea5f7731948,155,131,430922,115367,315555,136,114,395500,104396,291104
964dc0d518a4316142fde466b12c238f,34,25,32015,8927,23088,32,28,29031,11098,17933
f0c8f4d7b341067e96c3316a74c53003,31,29,27140,12617,14523,29,31,24675,12853,11822
264408c82fca3b71774cc2c293f50eca,128,88,309814,92549,217265,148,104,427836,88027,339809
26c585abd12ec9f8c1edd734f9e651c3,46,34,37755,10015,27740,35,26,25898,7651,18247
069e889d3f4b0d5d2c08fec9fa89a232,5,2,662,314,348,2,5,314,662,-348
ff68c10321b6c08269c23e1439db0172,34,23,27652,10562,17090,25,24,25660,12472,13188
609f3f59949645571f633e99ccc175dc,9,12,1739,1443,296,15,7,3811,825,2986
2dd5b1c64f786fd47325328d444c4333,25,21,13498,8593,4905,27,20,19433,9406,10027
4dd739f353120c051f25e697d8c51089,131,94,364419,78138,286281,109,101,261793,79729,182064
47633d28c94109a016cbc5001783ce45,98,72,192009,63633,128376,123,89,204563,52752,151811
8f21e4e7c5002d6e5fa5992bbc6d4e52,106,58,171554,30793,140761,71,48,103902,32849,71053
d1f516ac0867aabdcf8ed4216754d346,190,132,1014435,162970,851465,212,136,1236476,169413,1067063
b45cdc0b1433e0b3c288277906ce5f99,25,18,11527,4104,7423,22,19,9625,5183,4442
e6ff2503b9be83fcdc3c966ea0ae3995,185,130,689439,144857,544582,193,129,530550,222002,308548
0ef9a1ece60ef7dd2f3f87615528a119,43,29,31900,15684,16216,59,32,65136,12217,52919
06f078c4975851b7480bb3db729769c3,156,112,466144,74427,391717,143,104,443162,89621,353541
89e6a2d6591aedfb81c2efa303a8570b,26,21,19250,6583,12667,43,29,32694,8278,24416
1457d475e4ccf11dd60855ae3b8c5543,15,15,4056,2703,1353,19,12,5153,1383,3770
06adf2003eefd13266274717b022fcda,27,19,17455,3268,14187,25,26,10359,4295,6064
25bd5a40769468b42fe700032655d552,83,71,152860,31502,121358,92,71,129348,40170,89178
efba0f6f8dd534753fe5c1aac89e9911,51,36,44729,14367,30362,50,31,39689,11894,27795
0307714603cf83eca51088abd3cd6277,99,74,266355,55381,210974,120,87,268451,58567,209884
2f3dc9e4830cbefb87d352a398847f88,154,121,305344,70712,234632,155,132,398059,93752,304307
018bd4196187ba639d1deb52df51d7cf,72,60,98150,24146,74004,83,64,120248,27034,93214
92f0e0614286f4a3c9ce1b25d9b7d9d5,178,122,402840,105566,297274,167,124,427376,93715,333661
37db798ea69d66ad662b681ecc8ba217,124,100,331099,75727,255372,165,127,416945,81711,335234
6fe79af08bf73d58ad2044c8b2ebd6c0,147,93,277451,47354,230097,99,81,219823,65579,154244
493ec9df59d0a1eb74db65af73f49d23,104,83,199672,54627,145045,100,89,243134,74298,168836
92aaad83dd9b6398d4eb293b4a4ce7e9,151,90,277269,54383,222886,99,71,161646,62183,99463
50c00f0bf2899fe79bd7346660a669a9,57,41,75709,22921,52788,44,41,49966,22227,27739
5c05ad3e5e6dcfb4dbc02a81d0c98237,66,56,132023,65898,66125,112,89,231359,70584,160775
c32140ba4ef7b2cfe572988cc69172d4,213,157,625968,100801,525167,183,128,743544,87543,656001
5e783d1b97d43f24f2733906c3ae0dfc,165,132,423048,81841,341207,100,84,256117,92739,163378
620d13201e799ec2ec65ee37351e6037,35,28,27482,11148,16334,35,24,31029,7596,23433
5a31737e7f6384359770d18c722c6567,11,12,2096,637,1459,13,12,1339,1785,-446
575520e0cc43860e60800dd4c9ca0bec,21,22,8873,6006,2867,28,20,14535,5095,9440
a2b47c082412c251588ccaae5011ad06,28,17,17200,4734,12466,24,20,18646,5689,12957
991218ef579c913627ed47a8731618e7,34,24,20071,6880,13191,27,23,15110,7673,7437
bcc3880233781e0c5a142435ac1e760d,28,21,17842,7349,10493,32,31,28042,7232,20810
4cff2c981aaead8f531d4feeb1091380,103,76,238234,39741,198493,110,102,200155,55369,144786
3d2e4be6c40e93810043f819d79939b0,94,63,152032,53379,98653,101,90,204660,61102,143558
611e6545a2a8f1f2b9123dbf3b66b329,167,116,500013,95022,404991,149,127,554632,121734,432898
0018cef85bfeaaba640cf986a2b5784d,103,67,208618,45601,163017,78,59,133644,43529,90115
ef65600db4b0965e570c227499307c1a,42,27,29215,10309,18906,56,46,58816,15375,43441
a7fc10e5b376221f30a0cb67f475cb01,195,121,1096482,186907,909575,253,189,849509,248085,601424
e8fa28a98d3387387f5f473c34245d69,107,68,254470,60033,194437,134,88,277398,55547,221851
985614f577ded04b3fd68449aeb2d60e,34,25,19267,9775,9492,33,25,21609,7774,13835
4821c49e247419a9eebe20b88f945642,164,89,501700,62930,438770,129,106,377779,91673,286106
13cf088eeee43450d4d8ccd6b664f447,136,98,569819,134821,434998,169,133,739703,128666,611037
19305cb845813e9b88cd64317fd243e8,200,146,942483,113599,828884,213,120,556113,113658,442455
21be7cecbdf5216ddbf17ae32560b8aa,127,114,365046,90990,274056,118,75,305899,76483,229416
2a22802b87a9773dd9da068839594717,106,84,242621,50066,192555,91,73,182844,36928,145916
d9aa836a1d7a5ec7719a7f82cf944dfc,16,15,3997,2466,1531,18,14,7955,1620,6335
13d1bfa26d54d3004729152d7b8d9c70,84,56,101949,27274,74675,88,49,112849,24765,88084
7187ed0c3c00892b192fe1e7cd87b3d5,148,87,345800,139240,206560,133,83,365714,107701,258013
2d5523c9dea1a53660664f174ef63bcf,93,67,303140,86065,217075,189,154,515690,103502,412188
fe5b43c1aed64c19bf475f511961eb47,102,82,189583,43046,146537,101,66,202643,33242,169401
49c8564a7256d6c61127a51fa3bf4f3f,130,115,324188,81565,242623,115,87,268032,49158,218874
11ed40f7a2edee5c29540f65c7e31e22,144,118,356317,69473,286844,118,74,255531,73877,181654
5a32ab3ec52fa458f59bc41a06b4a7ef,142,102,406541,116528,290013,170,138,546667,111670,434997
2eeabc1466578a4690afa2361b8f6a74,61,50,73669,29228,44441,65,36,61441,18007,43434
3c6609a66da5ed265d1df20ed02a16c9,32,21,24490,9646,14844,28,19,36059,10587,25472
6a418c902ab11e19daf1ab4a7d316ad7,24,18,8856,5546,3310,28,21,14662,4430,10232
4796dc8bc35df18623d2ef77ff77c547,61,48,141357,62480,78877,129,115,267411,59309,208102
10159c9d28d21bf4639fba5b316cbba8,102,93,241580,55821,185759,90,80,198456,64931,133525
e12e0ac635a3439ae9d5ec9ce5607167,90,76,155657,41904,113753,82,63,146260,44336,101924
d7f6599388281dc1e4dd1c56f45a15d9,100,80,191303,45141,146162,94,80,164043,45872,118171
61b5ac1fd3a58f937b0247e0492f5722,59,48,86227,13197,73030,50,41,44029,20111,23918
a809ea92f12438d36392543e3f2bfe93,103,79,204368,38358,166010,102,69,174761,40985,133776
88309624c38ddb0b6a4321ab6aadc540,122,103,291212,63496,227716,159,103,314277,47208,267069
280f87f39fa8ec107db9491be2716147,134,82,304801,66671,238130,132,107,294899,81109,213790
a8e59ed24a8c8336fe5281fa29f83902,169,136,585113,115334,469779,202,118,584207,101351,482856
96b94352abda08e8cfe2762f62d97624,105,77,182710,52193,130517,111,80,199873,41144,158729
fe48f7a01f1e99e7c53a485b975c4a3e,145,109,305123,54169,250954,134,101,292107,56177,235930
db34ec0abb6364ac0e8a38792400896b,144,94,287595,111646,175949,143,99,317549,89805,227744
736a1f80924dc1c3d5885b6019a3738e,21,18,7307,3951,3356,21,17,7358,3934,3424
55726ffdf1972208d267cbccf18be5db,68,54,122853,47031,75822,89,67,136024,51505,84519
faad2b6eede5aa1868af3ef961f0d041,48,31,45429,11965,33464,68,51,67396,14017,53379
05eb6c94c8e834d64179487c4099d494,89,66,130975,27733,103242,97,68,109069,41552,67517
ac605925de67da0eb8ae18b13d68d8f0,41,36,66131,19888,46243,77,54,62286,25443,36843
b1516c68cf7c7816b6fc48b8b25810b5,75,44,107648,24239,83409,59,41,62678,24540,38138
665734e9499302e818956fa70386bd93,116,102,223541,45585,177956,113,94,229403,36882,192521
e4cebf7dde3d31f01687d5f138835d54,72,58,117353,38008,79345,69,65,103326,38934,64392
f8d58d4c5c1e29e85f4610e416b01b8a,37,29,42165,9527,32638,44,27,54948,10841,44107
eef4f2f6198ebb80b0ad30a7694c1ef5,130,97,223196,65483,157713,167,103,298579,57506,241073
64df582434121b057ceaafb684a4c5dc,158,119,385612,92217,293395,132,104,421443,70906,350537
3b618b2a42428e5167ea7dd8de333b48,126,90,169468,27959,141509,112,95,182465,40983,141482
fcc6dfd62b210f4fa19e508550d75f3a,48,38,56704,18061,38643,50,45,57921,15364,42557
529caf038e02640be9c4bb0298843b27,63,63,117768,30032,87736,84,68,111995,43100,68895
6e69b5715d2b0e4718ef955ae61555a0,124,98,279837,52581,227256,86,62,137256,68240,69016
a1636ee29a32ef4c9d1ae508c156e2fe,46,40,42964,13034,29930,45,33,36909,9435,27474
61c41293bbebf0f5b4376533c7d918bf,137,115,344845,76992,267853,114,94,263875,89955,173920
9e82e8df829970e59ec301d59a684a37,67,65,104449,43335,61114,70,47,81992,30306,51686
a99bdf78215b0ed95be61f528d8c5cf0,55,41,115110,41770,73340,73,49,127121,40112,87009
66abe248acf8414fbac01a214d1d6d30,71,58,78716,22074,56642,51,44,56875,14387,42488
9c0da44e754c859fc9f8a9d4af93806f,179,133,904744,232508,672236,227,156,1237474,215613,1021861
4ef7addab7f8a8ad407c52626357972b,31,28,30442,14096,16346,23,24,21615,9471,12144
68ddd3c1cf8ef1a51ad229815147355d,70,52,137670,33715,103955,81,69,107468,36772,70696
52d1b8aedc15019dedbb2d77ed5356b2,3,2,416,511,-95,2,3,511,416,95
d2cc5bf4c5f42ae46bfab6e3cad564ea,26,20,12413,6515,5898,19,18,12539,3404,9135
965fddf80d6adbaec0d22a92275e3915,39,37,26624,12892,13732,45,31,23458,13030,10428
ce67f0afa7a72aaf5c87c1912dd6bfe3,204,127,815459,104517,710942,209,158,680642,160619,520023
62dfee4f7d1ba2ffbb59f51a4f437c5e,161,141,670777,164746,506031,198,160,744231,119989,624242
a96a96a548bf475a833dff13f7e014ff,147,112,327147,85724,241423,160,126,492030,69464,422566
2642f453d032206945e373722fa869dd,164,127,517992,76422,441570,162,114,696510,84658,611852
38dfe41f218e45733fcbbe0c3b6d752a,27,22,22141,7267,14874,35,29,22850,7179,15671
53a72927bebe2da1381adbd31b5f26cc,176,144,556540,93950,462590,155,127,466132,97381,368751
dfcb685032d6753efc29a4dfb3c3864e,103,59,186496,43202,143294,137,107,278971,45408,233563
d160fad64f6f8ad7f52e78ea2be66c4d,95,62,159893,43055,116838,84,73,124023,43285,80738
20ccddf3ca91cf2307595d3f0f52a898,47,37,38474,17481,20993,42,35,39831,14575,25256
4376778ddd168a65dc083a02c4474649,143,94,406996,64829,342167,102,88,264476,77809,186667
d87c410a167bc8a4229c176446a55244,143,103,309721,73971,235750,110,89,258696,64649,194047
f6c9778fcca54e78ab91c55b11f9de08,27,23,14338,8007,6331,34,21,21565,5141,16424
b4f82bde47239c765dde1a5854310c97,100,81,227062,92611,134451,157,110,409317,93519,315798
96e1dc447331879b841ee954a7f0c802,88,68,108972,48852,60120,91,74,190276,40867,149409
f99885945904b87f1776eece38aedd33,200,141,956615,135021,821594,188,154,629171,156705,472466
52590d183aeb4e0b9c41db8206373a15,125,105,456673,106232,350441,187,137,452336,103272,349064
098417fab914a5d5652d1ec0af941f52,78,60,138553,34124,104429,82,57,111478,36662,74816
467d016465ef37180325498e7e45d3c0,168,126,476884,94208,382676,199,156,597787,95331,502456
eca3535408124d3dbc3fc23ccde21991,40,39,23970,10657,13313,29,22,20117,6872,13245
8f889d0309d485efc5d97fbd9db9c18f,27,19,23492,8282,15210,34,27,32399,7441,24958
c6458017caef2d057b1c71e78267fef3,50,37,64462,20583,43879,46,37,58729,26184,32545
e035fb8299a44b2f4915277589ef4b74,47,29,50156,19690,30466,53,34,51691,21579,30112
7548045b6651d33d0b713d7b4d928453,161,130,604535,217168,387367,189,122,840753,109500,731253
e28d6cf48228dc5618493ef1a6a99041,52,42,57692,19260,38432,54,42,68045,19463,48582
dd9cf0649da1ff4422f40d892be8c154,80,61,107736,35908,71828,83,66,116939,47334,69605
4dceeb6647a17ce50057a82667aef1ce,106,78,172844,44768,128076,120,106,301657,46771,254886
0f5bee99aad7bbcafaf830a5a13fba17,60,52,77867,26170,51697,59,40,61707,22412,39295
835195fb64914ac1b7aa51d886eb96e3,106,69,220454,46850,173604,126,87,227140,49157,177983
12b73871f979c832ca9cc35366cd4910,130,81,205502,62454,143048,129,84,232054,57659,174395
8eb6bfaed21e34654a334c4f907c0d03,69,47,83585,22400,61185,55,47,50194,29991,20203
2d1c5214e7e347ed9ff1404e70bd446e,117,93,214682,36296,178386,119,90,154611,43318,111293
f70b3ea57fc73db00ae066fe3ac56ef6,98,77,139206,35592,103614,86,60,124989,32253,92736
7b9628999902c5950e99a070ec8de4fa,117,81,336402,57271,279131,103,81,219769,69204,150565
3be289367e7769db192ec60413ff2155,45,37,51467,19184,32283,39,34,47290,14834,32456
fafb429bf058246b6261e07de7f6a530,31,21,20018,3475,16543,32,20,17101,4601,12500
9938ed916746cae3771e1b212342bd8e,5,4,861,737,124,4,5,737,861,-124
648893feefa3740c4d68c698d1086fb2,93,63,184250,43126,141124,135,105,381993,48033,333960
1b56478d6e0ead4b335c5bc85c6b004b,191,131,837583,123494,714089,205,164,1073750,176495,897255
10ee3c6deb1f80fb57dcfb22a0a1f123,191,132,712709,163945,548764,171,119,599989,131286,468703
989badb16f3652b8bb5cd48e95282fdc,152,133,567442,136165,431277,137,109,503012,134222,368790
fc76dd3e564c03ef352593dcf73c7e29,150,124,468983,107345,361638,155,114,541244,104459,436785
96397142c577f544817bc10c22ad9024,112,94,225838,85569,140269,124,94,419728,60412,359316
c7807ab359047b45924b8a15c3ab70a8,105,89,317145,91636,225509,113,106,319376,108087,211289
3ecdae1f5a9e0c1d4a8ddf8a8f73d429,49,32,51577,10105,41472,50,38,40849,17530,23319
2974e2c25482cff4dfded9b74d7f0de7,45,33,58831,22699,36132,60,41,66803,25751,41052
c7a9d8e281a0fab595c3dfb2ef0093c3,37,25,36636,13102,23534,32,25,28868,14609,14259
6e88a1ed4412cf60877dc33957024c65,85,66,133312,35616,97696,97,87,198789,36275,162514
8e4a34e238161e5cdaa93128e01f82a5,58,42,64590,25988,38602,46,35,59477,21799,37678
231d92f4c146826fa7539ed7aa12fc47,35,32,42051,15617,26434,45,42,57988,14948,43040
f1f7dc6354867fe451b21041c1ce827d,71,53,116745,38164,78581,70,58,121043,46513,74530
fe29dcf6306fef9b13812b1b2c255cae,26,30,19762,10257,9505,26,21,18134,7883,10251
9e7a963f30630f7cda6752d2730383ab,101,82,151301,29673,121628,81,65,101534,34942,66592
c9308520ccc6f2012f0525981e8a8c37,80,66,159004,47696,111308,91,81,141009,47452,93557
993528b979286262e98da91a6c5ce3c9,161,125,463107,73790,389317,181,128,518114,92363,425751
e83a1be86236cdffc901a93ca83b68f4,31,23,23716,8612,15104,26,21,14588,9654,4934
015e44dc05aadb9051ba7a59f3fcc8c8,31,21,11200,3565,7635,31,21,12022,3285,8737
d4a5d8cfaabd500a13c4f1c3c7bc1c29,156,136,466313,86314,379999,109,93,299751,80588,219163
309566a1b2822c101cf26b54b6b6965a,115,103,195529,50672,144857,86,76,172782,50399,122383
ec54aa1d484265419ee1a025ff5f6803,143,98,259321,63384,195937,111,92,224548,73786,150762
c68a568ddd67504a6c79f24d854be84c,146,115,248249,62800,185449,109,75,163176,51641,111535
c39d506a270a636bf9a58024cd9a9a0a,194,116,902266,99827,802439,188,149,700131,129398,570733
6ee7bb5ac0005afe8ddfc6f1f1bae08c,35,31,27295,7028,20267,25,21,13794,6797,6997
4f920b7913a0f688e254c36a50ed16c5,32,24,20532,10416,10116,34,28,32913,10942,21971
aa6e148465b809460b939d2704dc447f,53,56,59669,18519,41150,56,37,42498,17517,24981
4b3897e74e0a443ce3a54e4d9ce8df03,166,134,590784,153165,437619,174,130,709302,129460,579842
95cc27eb808d18e7422343b64498cd16,110,86,251577,82655,168922,117,86,250610,107770,142840
23a0a21a363819e83ffd2b4cbf583b44,22,15,5117,2849,2268,18,16,5920,2738,3182
0a10eaf7512f6e833a15fd2e3927fc6b,67,49,48021,16708,31313,54,60,50124,18021,32103
d47205f0e13a19271e8e7e5a8abdff62,146,112,696790,176017,520773,172,151,646165,207511,438654
6e8abc86e6dc1bcfc1373a4597651c44,131,115,333125,67978,265147,98,69,239252,45007,194245
8aa2bc8e4a5658c86298e8931d50b35e,132,96,309417,69042,240375,125,95,241672,87205,154467
33b98ebbb015189c4f72f3b208078eaf,90,68,256598,93787,162811,175,129,677126,68275,608851
3b14711f98e383ce6a4e3a70d753253a,28,22,24171,7578,16593,20,17,10466,10121,345
6060eec3b39c838c27055f1581ef60e0,99,70,197148,52053,145095,128,88,228117,54539,173578
e9aa27ef732633af62cc87b94d40f545,104,72,145826,51345,94481,110,77,189105,45953,143152
a1593d8abeacbcb3f5984b1619f96ede,150,90,327272,63849,263423,154,125,434208,89382,344826
e947322b9e3c7261882c05bc4f918ac8,90,61,154116,41237,112879,93,66,155546,41365,114181
9542761b324701112538e1a4a1b8eb00,126,96,274230,66019,208211,98,80,201476,73434,128042
8f08be84ee928297d538d81925665f75,137,88,577394,128886,448508,118,75,367069,147494,219575
49d7981a8e453b6a8c2f01bd58693452,19,14,5182,3081,2101,16,15,4227,2701,1526
e6ac1fd47044a7823d317465513900ab,148,108,411377,79408,331969,153,93,453292,81685,371607
08b36df82ec300e509bf0e994239b264,157,128,678043,101098,576945,189,154,816244,102717,713527
88bfbcc6931ff4ed409ddc2fef6a8dfd,52,45,43494,19855,23639,48,41,54196,15023,39173
7d34daf673aa9989a0ba51323887e64c,113,98,285014,60349,224665,132,113,321449,72780,248669
fc1ac518cb359c50e298e78a99804e3a,131,93,270782,48723,222059,173,108,315766,41556,274210
5178654948f231256730681e3c5da809,113,100,241820,61112,180708,98,80,223498,68718,154780
db438300b6a9131c102f413f69a9c409,96,78,192448,60254,132194,105,71,176935,42106,134829
701a53dc8eb48526a6edba51aec9796f,61,38,67034,23351,43683,78,46,74860,24255,50605
f351907766abd45a68ba212d760403cd,43,33,25063,11930,13133,42,27,33133,8835,24298
935618a8d30371841d1053774575d0db,135,98,353515,77215,276300,109,68,184653,72466,112187
163fcf03be925a952f5baa1b1e31c467,103,86,276106,68507,207599,128,93,287065,68067,218998
793eeca1c6fcdfbed22ceabe5aea280a,54,47,74739,23452,51287,46,42,58380,17328,41052
b197df9ba95bd0cc2ac1aa1cc6fc2536,55,46,88530,19776,68754,61,47,90634,15912,74722
21dbba068cdf310ae9e42765d99760f7,47,52,51917,16600,35317,77,60,76439,16126,60313
e2febc741394ce5ff99ef6d6feb4a623,34,25,33342,7770,25572,37,27,29644,6163,23481
fd23abeb72a0ec25332618b5b17ae9cf,123,110,236013,83109,152904,123,94,255295,46354,208941
89daf5c68215fd2ec7bf0c42b0647b55,48,31,60055,12966,47089,42,37,36703,15962,20741
6dd5e3141318eeefe7958517f6f89fd5,73,61,134975,32853,102122,66,52,135762,38975,96787
e5ac16cc03749b378bb2af2b228583dd,122,91,209963,40877,169086,84,47,138940,33237,105703
2de986ecefb91467257a8012715ab4d2,135,113,621659,109955,511704,177,132,699273,144127,555146
82de3ffe667ebb296542d0efa1874c0a,205,137,534592,116885,417707,163,120,601710,100776,500934
ccb07a6b0688bf2a206d7c99a39c8927,98,70,140009,43830,96179,122,96,222949,61420,161529
07483e329e814ede45a64fbebb93d610,122,85,292609,65413,227196,123,90,271101,48944,222157
8fad01887edba4d0fcfe313990230f77,125,93,320143,70381,249762,174,124,512691,84392,428299
3d93ed70a98a5da17ec309e5c3606dc7,57,31,38084,10210,27874,54,40,33443,12750,20693
22e0a17bdf975507b2e1873015859e5f,72,66,137107,45993,91114,111,80,241120,44381,196739
03d41861dc5aaecf83f5f2209180f7c2,36,31,32026,13062,18964,39,36,26762,13313,13449
a6f09232bce9cb1b273cc51403132abc,17,9,3489,2568,921,19,10,5102,1689,3413
5ae2e6a3095bd1b44b56c5d82170ead2,107,94,141870,29994,111876,73,52,78802,33581,45221
faf755668a63cb071c0c98e6cdacc775,77,57,107400,38173,69227,60,50,99361,36028,63333
552ca66828673e160e4ef23815a41220,152,120,489146,139276,349870,185,134,582146,94484,487662
3e852841b0ec3822a7241362cb5834ac,162,122,452301,87695,364606,146,110,471621,50553,421068
0aebb41e6fdecc49ead279b3b1c4bdbd,158,121,537130,145601,391529,193,149,627358,158293,469065
ef3cb4352aad25560f71e2ee510fb107,24,18,16292,7520,8772,26,19,15588,6873,8715
6000d53bd4b1a0ade5969990f78cd9d2,162,130,735399,143535,591864,175,139,611633,136793,474840
ebd0a85485988479261ad9e037c61174,76,60,143728,45466,98262,97,79,181688,39139,142549
cbe3084a4a2327aec4c8b83a852eaf78,127,90,316200,91385,224815,137,92,259573,81208,178365
2383cd6b44c92d4e90b0bbe5623f4a1d,86,61,133374,33234,100140,103,96,182022,48207,133815
0da117f53e451c0d01e761ae13ffebcf,24,24,9111,4695,4416,21,16,8445,4699,3746
ad8be8235854027754485184c6c43eff,139,115,366833,80824,286009,149,128,372711,71614,301097
f36a4818a0c9cfa4d56c31234f06a273,130,101,273153,38050,235103,96,81,185462,44158,141304
9a5da0c32302cef4831c2e68f49e4b5d,135,87,288807,68362,220445,121,93,288871,93262,195609
fc5b4a625d5f39bbdb1fc6bbd38f6e76,48,35,41478,7735,33743,30,21,18387,7280,11107
4ff2034931efb15ddcec9988da937e5b,151,113,341235,53562,287673,109,95,269630,59559,210071
49c34ac8c7153f6d1ac4de4a1230e11f,147,103,782408,179741,602667,234,180,1290671,184922,1105749
3801e2094edc684170b681638a5cc559,82,69,195817,59394,136423,77,67,173780,51155,122625
ccf871e00f2fa3017688fbf6abe51fdf,170,113,461542,101829,359713,159,120,432573,88512,344061
658fcc6ed0e1895b5d80e1957c9f56dd,18,15,6018,1893,4125,19,15,3465,2387,1078
ce9c56434cd9d664a86e08abb4acff50,101,64,222440,68149,154291,119,97,260382,92486,167896
117e9bf78718922cbd255feb905a0eca,42,39,38429,18222,20207,73,51,100146,19467,80679
d887004133c685af41cf45a050bb0bba,90,75,131742,36983,94759,79,73,121271,41481,79790
7446f8d437495256a5fe955da76e0395,90,61,142993,38912,104081,89,78,127290,40882,86408
8064ab8daae909b7cbb5f048a5dba2ff,0,2,0,368,-368,2,0,368,0,368
8018ccc4902f4044081184dfb8b4b6c9,124,104,261593,64615,196978,159,104,380059,44503,335556
68f7af1422a07133744a0f66b139af46,260,184,1034882,121043,913839,155,108,699326,159436,539890
5c11e8556f23f10b6f1ca3b4eaaf4403,28,20,20370,5672,14698,29,20,20730,6999,13731
7c2dcbba14512acf3b8010ae2ba6fd14,172,126,1079928,155339,924589,178,136,644291,156077,488214
fc10ff1cc16d792dddfb74ca65832294,65,52,87772,34455,53317,74,54,91462,36553,54909
228a908305f22355a6a536b30c63b3f7,23,22,8776,5603,3173,24,20,9774,4104,5670
26c52605b5262f6b63d9b9d4f457bcf9,139,93,544752,96056,448696,183,109,565329,130131,435198
19b3da45bfc4c3999507097f935c914c,90,65,163194,32478,130716,67,58,118535,42222,76313
56f2b93262ebcbe7c245cb29661b72ac,36,27,32387,8899,23488,39,27,14075,10898,3177
8ea8b2e71495505b5133acc0623ec470,28,24,27033,7712,19321,34,22,23723,10804,12919
94ed3bbc94dd376c695c1a5232f0409f,81,81,114412,32332,82080,81,55,98149,27804,70345
384f2b2b371bdddc404a0e083b6aca3b,34,26,25256,9501,15755,44,33,49099,12784,36315
0c9abfc9abfcaa793cf6a006a770a0a3,72,51,145258,34709,110549,77,65,143426,30838,112588
459fb3af6e42733aebe8f22120ea005c,112,95,324943,77482,247461,105,86,279379,89617,189762
0859cb65e9e9c5b318c5fcae886be13d,14,10,2386,703,1683,15,9,2248,885,1363
06e09b28f2eaf6b26d5320d105c921cb,117,83,340568,123568,217000,148,101,659671,118024,541647
7b3466ec59e13dc6a6742d2525a7daa2,112,89,352675,56947,295728,153,116,319446,61692,257754
16b96ae41bf18645be0e0f61994160ce,57,32,47085,15661,31424,61,46,64237,15144,49093
b86ac62b3041fb0cb47cb87259e4510f,118,83,479638,100978,378660,160,104,358057,100338,257719
6cd356fff179697f5392e477f1fe16de,76,50,134138,24808,109330,115,79,298634,41755,256879
6d725bbd651be01772727e3bbf96df27,158,127,504721,95734,408987,139,81,388995,57908,331087
d09f68136462579e6673141e244fc936,19,19,12551,5781,6770,22,19,11726,5207,6519
d498ee7b8b7b2693de907dc4bcdda1a7,117,90,241567,37198,204369,95,78,178523,39143,139380
6e30ace30d0de355458534ddcffe54ee,162,118,418973,127499,291474,145,101,345221,119941,225280
a3aac2d6460268b7c78c395073181f1d,40,41,46616,21943,24673,47,31,36527,8296,28231
dcf6e77ac6d9efaa1930a5f006237297,73,64,90762,29298,61464,77,64,108080,32566,75514
936b9766b966239c1abf920a239b4c79,158,122,566457,198080,368377,199,106,623480,105291,518189
d515c0b18fedcf5f9a9a6c884db784bc,100,92,227005,76430,150575,166,104,321296,52371,268925
cb095a21d5de180f08fcbc156b3f9647,140,106,390973,53183,337790,126,100,307658,63464,244194
3044b43043674516d15ebc93c8a2aeed,27,20,9980,3929,6051,27,26,11216,5970,5246
30a4a22906d3c091cce324bf5b458758,62,46,72586,22247,50339,44,35,52647,25953,26694
b921cedd6ccfd322cf374ab3949b3115,161,89,417032,89984,327048,120,85,279622,126263,153359
ef62d72fe8b765e5863a8e81d0bdf76b,15,11,3582,1336,2246,14,11,2017,2231,-214
4c837a5f5ab3682348d4de4fff61fb44,81,58,137559,43649,93910,129,102,295053,44140,250913
9fc9836e5afbbba281de6c99f6527160,28,32,21023,7668,13355,34,24,18667,7294,11373
e27d954dda17d656dc2485af742de1a0,71,54,74214,35595,38619,95,72,130264,32225,98039
6c991a45e210d38e2af3e312992b9b0b,39,32,38111,14143,23968,38,36,30257,16136,14121
13e3c5dfe511b2e43afcd36f8a0805d7,141,105,386432,94005,292427,160,117,582943,81175,501768
3107a471daaaf9a27b14bdb8f53623a8,44,28,74098,17456,56642,50,49,65084,23659,41425
9320536e059c0090bdccaf9479833149,60,56,75974,24871,51103,57,44,55623,24099,31524
859324efe51cf4f9d5fa8f05a3706f94,84,64,184730,34183,150547,80,50,137234,31107,106127
51ac854df61e5ac01ee008c5a5bacf71,89,71,121416,26078,95338,74,60,112928,19335,93593
fd39fc22f8ce39c4b47b9acd14a47f6c,35,28,35377,17376,18001,45,27,48397,14519,33878
15963d9f57b30b193fd7d316fb8eb377,142,106,331440,80724,250716,131,93,271993,70055,201938
c29a21aaf797f9a91f92849c0e1dd431,152,126,421829,75363,346466,135,118,337890,79587,258303
9eb9589c250e484d2134ec5ee63f71a6,42,33,28366,9416,18950,45,36,38618,10761,27857
91ce6243ed7407594523790c305b744d,46,44,86151,28445,57706,68,47,93580,26061,67519
c087ea11c5eca836905e724a3dba50cb,55,37,50508,22312,28196,52,43,48054,23971,24083
d0a140ce3731d73d5ef19f12214d6e40,40,33,44544,17423,27121,55,46,79597,19506,60091
fa893b8af0670b9cd8170c8d6e4f2789,158,122,378489,136383,242106,197,120,491469,166673,324796
2d15d57654211af3dc4f81362c6d08c4,82,67,191588,30198,161390,103,88,177710,39293,138417
e1ba10054607653d7bf1c376752fee8d,106,85,211510,55857,155653,128,94,260594,73453,187141
56587e10b5a8b29d09426a8304cad442,175,112,612724,93074,519650,156,121,625065,86107,538958
6ea450f302d7483bc8cb17036f44adce,6,3,1073,435,638,3,2,550,242,308
db158959b053de8edfd3885c3c1b4d9b,184,141,696771,113910,582861,198,128,687186,117014,570172
c8ba3b91fcd49d6860d78e67977a940d,41,26,41199,5973,35226,39,32,18054,10261,7793
e0aa858fc0500e62497f3d15fe11a07d,58,47,68906,23407,45499,60,46,85372,19125,66247
c4264a6fa6af83dc071e81aa248278f5,39,33,38454,14433,24021,27,24,20894,13900,6994
a9788682430797510ced5c90e4d161da,118,86,204800,37563,167237,100,77,172884,42258,130626
2b4a087775f81ddb1780e2a1e7673ba3,68,49,137715,35394,102321,102,87,190676,51775,138901
d1a62b0edc04562d86ede4aa69351045,121,104,308010,139940,168070,116,79,260519,83240,177279
9fff6fe6afc217d7b7a8c46bd6c8ecad,0,2,0,46,-46,1,1,44,14,30
cd7d00a8232ecbaea4eff090f969b3b0,44,40,47507,16639,30868,40,32,28638,17200,11438
b8d6c5a9759de5b8545357841716e618,51,48,46534,15111,31423,68,64,69465,28046,41419
96b33fc0014038a2ddac12a922408249,68,48,117838,32859,84979,52,36,60990,25935,35055
87a80159f4310edbb7f3b434b1dfdad8,79,58,144674,55305,89369,122,103,260719,48148,212571
2a1339304a3c42ec8e579329dcaedfe7,7,3,1538,807,731,2,6,537,1268,-731
0a139b976b41a11035c15612830a0388,53,27,46280,15155,31125,49,40,53764,19510,34254
7c958dd6a8bcfbf51d6ea9a8f6fa296e,99,70,216330,63117,153213,60,49,119821,63905,55916
6055093eafac3436f9579129b1ef51e1,60,41,81326,18030,63296,67,55,80342,24490,55852
762bdab51f71b3fb29fbc411cab26cc0,116,83,364572,89088,275484,139,107,446776,106027,340749
38dc33324d1424dd39c459a1562a4d34,86,57,184787,65955,118832,93,72,244126,51449,192677
0aa19dc36e7993b00fe3248eaf8d5e68,17,14,4572,1091,3481,21,14,3498,1443,2055
78aa1d242e24d094ad458658386bacf0,146,107,419747,72002,347745,201,163,515393,126897,388496
318228962afe18dbeabf828b2c563b92,66,44,58106,21517,36589,48,53,84989,23967,61022
085bd7ecce6abaa1523e67bba2bb8c48,156,108,641113,128125,512988,176,144,710587,117641,592946
43627207b9c36c11494765f285ac7c7b,17,17,6304,3740,2564,18,15,5744,4158,1586
c460ec03942bbe8493841a034212abd3,11,10,1890,870,1020,13,11,1286,677,609
f5b0b7af5c2a7024e962178fb997944e,27,24,16343,8915,7428,28,22,18656,7257,11399
91f607d37fff353f1d82e9c49bab47f1,30,20,17037,6422,10615,21,17,14892,6126,8766
5703d3ac862f4a13be324e20a227678a,50,56,54587,27685,26902,67,55,94093,23628,70465
a0a251a15b85255838be228fda752fe3,49,35,44316,22963,21353,59,44,68240,23933,44307
9014526a6ab9635859d6d80c13ea1757,35,28,34642,16049,18593,45,44,56293,20182,36111
fdc458305db1eb47e8610f45eab72686,190,124,667371,112911,554460,172,135,523065,162608,360457
b1929f76b5f9d4e8f9923bd178340e21,77,62,108703,43250,65453,96,72,146610,36470,110140
193f212cd7f101be90c7e370ded0be0f,129,90,226471,63022,163449,110,90,204300,61128,143172
69e096b3526beb153f43350b8e1e5a92,40,28,37472,9302,28170,40,32,45754,14020,31734
f9f6e6e1f92cb7ca793bc9e29388fa42,94,78,150875,49490,101385,96,83,130765,43839,86926
00ecbe5e566cf09d9fa9a70580497570,60,43,58811,26253,32558,80,65,81235,22172,59063
1570a2e7e4caac051d5f6170d644333b,0,0,0,0,0,0,0,0,0,0
e33ab87aaf3375b025c316a26a604b65,128,97,399938,152116,247822,160,105,518869,168972,349897
976c7de73cf3f4adb6825310b5213b5a,45,40,59448,23182,36266,52,39,56282,25255,31027
56c3010c9045a19abaf1d6330a71fb23,121,95,369781,91345,278436,150,111,358367,57787,300580
e1d97a2eddfa205f216e875218ce189b,118,78,187597,40555,147042,96,80,173222,43642,129580
b8a21c16e9350fb13d34837e8686d0c4,99,83,218066,61698,156368,96,76,176656,71252,105404
2ca24bb50d99cf4fc770abd6d7728a0a,39,30,47182,13976,33206,45,31,34584,7968,26616
5ea0ecc9f9398f8d1b142dada3012224,25,11,8683,2430,6253,22,19,13172,2446,10726
743e2f48b2937deb38b6b275c955ff7a,32,29,35108,12406,22702,33,23,28987,13486,15501
cbb83e08c8b42e9942756462663a6d99,123,87,322791,74981,247810,133,110,283383,93334,190049
e8563a6f4bef2be1d2bb156baa59f474,66,50,114872,28279,86593,73,59,91608,37604,54004
3c8ad9d1c86311d4003eb62574fabb8c,35,34,26632,6953,19679,22,21,10470,3977,6493
f5792a67e1e5dc9d6ebc470a4bd364f5,60,53,92099,34484,57615,58,59,86438,40463,45975
af96afb750e60b7a585fadeb1dc326cc,86,72,128429,49985,78444,89,62,163388,36314,127074
75d6a2df21376cd5378fb1d68fa0fe15,45,35,35199,12697,22502,37,39,28691,12802,15889
4ad2f2348718a08aeccf8c1d0a06b829,76,52,103070,27968,75102,56,55,53425,37031,16394
80d82027a4f82adbfeb20ee3b68de1c9,38,29,42866,22176,20690,56,44,97951,18626,79325
4465f202594bc4e3dc20b8d0d5d716dc,61,53,101097,33349,67748,67,54,90188,27774,62414
45f47c6d536f6a9bfed604b59de56a87,57,40,81899,30974,50925,75,62,126891,33658,93233
5d303dac6262560e2ad824cc8724a4c4,139,99,308025,78511,229514,101,75,203195,108306,94889
1b09dff7f241f16ca73425a462f71fe8,33,26,20563,5726,14837,33,24,19108,6012,13096
3fffca3b32d59d3cdb9d3c3ec8d52ae7,20,16,7047,2857,4190,17,16,4866,3203,1663
230a047ba8c7ef98bb94dc9d0aed8919,124,81,212712,68131,144581,106,82,178959,53922,125037
305b2d609fa2d9beb78a8ac4d01afc92,90,79,120127,21685,98442,72,50,88467,19747,68720
821bb9cb1cca9be664c683881de2b542,31,25,27488,9125,18363,30,21,21575,9857,11718
3556863719b3092ec0b86620d0018fce,114,81,315688,36643,279045,104,80,204076,62461,141615
c414678daa2db058dcd481372847131c,164,108,400094,64573,335521,98,67,203229,74096,129133
82cfaf7332ed5ac780297abaed2fec2b,73,50,88647,18241,70406,59,44,74502,24601,49901
dce445eee0df1979b4afa87dd9e1f804,59,51,100690,28460,72230,41,38,42264,32858,9406
d9dd96d41833e15e9ae2b7c146954cee,117,86,240571,64637,175934,122,94,254017,62100,191917
40b14b86a7e243898a03913adb61a4c5,20,18,6876,3295,3581,22,18,5691,4310,1381
c61940782da7b7a283f0aca047292774,129,118,324038,88857,235181,199,129,442168,83124,359044
782c59d28597bd4db8c8a3e698f2f981,192,131,540324,112507,427817,172,126,651771,90996,560775
c8ee07ff3b0843a10101e8536701d918,136,118,311583,53853,257730,129,107,252455,68227,184228
bba8beaba5055a9e39c0f5c8a5f66657,96,75,137904,45440,92464,83,68,167045,38022,129023
18d21ccdfbbae32b36776c657670936c,156,116,659415,130106,529309,167,131,502936,128274,374662
d323f1f4fbb09679f74a07005a11e263,168,139,410578,75880,334698,140,107,369561,82142,287419
950b5ceae74168c146a04de43cf34956,54,42,64097,26132,37965,53,48,62570,28025,34545
12fd92fcd625bd75c460b8ab1770bf0e,119,97,248462,49365,199097,129,104,301224,46611,254613
c9b68aabaff922e6ba6e25d2bac92c70,44,30,37347,16528,20819,55,57,53396,18195,35201
91e243b21c88b4aa71412d4d41dc60d9,52,29,52717,14995,37722,49,52,75804,24193,51611
e557cf2f4fb6e6a160ea1466cbef635d,147,118,446228,109946,336282,199,141,558379,106341,452038
29fb2e0397a21c15855ced8b86a98fad,168,133,757772,127083,630689,196,152,776422,182804,593618
9b9da68669a77a29ee4a9417179bccc6,199,130,508775,112781,395994,153,139,477424,104899,372525
6aeace48cc0649788955a3edf39a7c38,37,26,28256,12884,15372,37,25,34910,11273,23637
4ce0d290672e048aada7e350a87b5e4a,99,84,221209,72006,149203,141,119,351597,90260,261337
b37ee6d65d55b92650e3d20969589c18,104,81,172626,42767,129859,70,59,140621,46163,94458
9eb1ff8c44f064be0a682f70fcace199,128,97,339644,79023,260621,118,93,279413,67945,211468
af285545495c48b209a3d261a2ce7aaa,84,64,132108,33138,98970,83,72,110770,35072,75698
bd0bacc194615b2e066e5111d4b4724f,31,24,21183,5916,15267,29,26,12007,9948,2059
cdca133af6834d924fbc0a6e6c92264c,146,118,530625,142580,388045,161,129,474342,140865,333477
7d2ebc2e5e8b272a6bbf7b78553d01d7,123,92,211996,44315,167681,85,67,122701,53195,69506
907b0b73e4856759335f192f58289f99,40,26,18788,7905,10883,29,32,11991,9801,2190
918e4e616308ba20fabd7a0ca1209b9d,117,81,279294,80124,199170,120,108,355417,65238,290179
5f2d1e8abdb154ad0feaa23b774d820e,10,7,1340,523,817,7,7,693,1031,-338
512af0e76301c9006ede07af9abff56c,58,36,51253,12765,38488,59,53,60351,16919,43432
c9370d538a4ecf75893845c06c2b0881,68,52,153856,41048,112808,64,48,89767,41275,48492
9bfabc4016c5244c8a0bca8783b1100d,203,101,787151,158623,628528,183,144,865468,215721,649747
4afa4a13e71f46ff61920c238033a5f0,10,8,1686,487,1199,11,4,3454,337,3117
5a9ce1b3f1e0635229cc3cab71ea5c29,140,118,373637,59680,313957,132,102,312918,53599,259319
a7251e31c688915a4c38d3b1a0891fd7,136,115,307256,63888,243368,141,115,361058,63072,297986
0d4058e7b9225e3ad80289ca84c0210b,163,90,512603,95349,417254,168,129,487420,109922,377498
c9d51cd1f6aa1686c44d548d017502ad,183,135,540666,125716,414950,155,98,470503,109250,361253
92c112c302d08f090fb49e39c4ac2928,109,99,373950,101882,272068,125,88,353755,100231,253524
24ac18cdaccd63852d57730e5e7d20e5,74,58,120864,27223,93641,54,38,76714,30383,46331
2581379521fd5a1b805daa49ae5421b7,67,44,58505,13090,45415,46,36,33503,16565,16938
2c062a5c55cf23d6e3a05c42c6382cbd,276,183,1690600,353989,1336611,209,153,2126665,334107,1792558
da1cf2790fe1970023d7ec297f0f9d72,128,86,315689,87067,228622,105,89,216254,60151,156103
ec080cbd7c02e475bc261176b3a6698c,202,157,695944,156766,539178,187,142,873986,135701,738285
445f4fde1c3c0db67767d24f13a68c1a,61,51,86433,35574,50859,74,57,120952,22008,98944
bd6523bf28d9e65767cc4f14d43f21a0,40,39,64095,28244,35851,55,45,69779,27162,42617
0889761cd5481ec6fbd99b45d5132632,78,65,148592,36401,112191,73,61,140304,41997,98307
10c2bd1ecea9f4439f6f97231cb9844c,78,58,134608,21901,112707,96,75,184495,41215,143280
97ceb5a7a8225f7b58e62ee60e4f70a2,35,27,25717,15011,10706,40,29,31974,10728,21246
ecc43b17cc954eade8634e0f9a495f9c,56,41,58186,17901,40285,51,43,45413,18845,26568
361069ce7d02f1017bd9ddbbe62f3bdd,111,87,221186,61940,159246,144,107,338793,60186,278607
cae069f895431b6df01ee928fb6c4f93,199,118,689332,139644,549688,210,152,858885,147290,711595
de74452a42caa7f5efeeb3b64c673cf7,70,45,100596,29093,71503,79,69,141275,29089,112186
cae0aa753fefbfc50f784c1050b2824a,163,100,714734,144679,570055,203,162,754654,140054,614600
dbb646502666c329c02d091821fdf852,110,86,265872,89831,176041,108,83,293659,88025,205634
5582e77c42b5297ca21617555b4c20a3,47,28,40371,12126,28245,52,45,48083,17285,30798
01ced69986598722dc3c7df4070513e3,131,110,259034,59678,199356,60,57,126004,59469,66535
ee51cfcbdbcf5dcebe81d6331bf5c4e3,43,29,39718,14391,25327,48,41,77556,15046,62510
c5a069a20f78784dbcc7556958ec8a3a,168,114,463614,102496,361118,167,132,474231,138171,336060
508fd462aa8793b86845eea3bcb5a4fb,159,117,599181,113382,485799,193,151,598169,152307,445862
9b21a976ec66f5ba1436c81b9f927302,84,45,94052,21519,72533,71,52,105359,19696,85663
ac56493c3401a08be3a7a1afdd0e454f,37,27,44689,11143,33546,44,43,61606,15435,46171
0203b30ff99282c5b693a8fbe10d84fb,70,58,123830,32432,91398,98,69,145927,33309,112618
77899079a45dbfb23436c3ac83f0d09b,103,84,190172,57670,132502,122,81,221222,50337,170885
78f659e0611c5774dbe63218ddea1747,125,101,294974,74076,220898,84,71,217298,87849,129449
472c486f76962fb5b3459623b4dcf00f,64,54,104158,27944,76214,99,59,142826,25058,117768
e3bdf3896410e3a2e6660097febb7e0a,167,109,619474,73633,545841,139,112,415483,112354,303129
46b7f0fb5fa94474017ccabac5b61b74,28,24,14526,5614,8912,30,30,22241,9536,12705
7cab6c5ecde1e07446ed416505989c10,84,63,133958,65712,68246,99,80,213983,55245,158738
872eb9889efbde0c89b54a66ede87b1a,82,77,158958,67191,91767,103,86,237529,54907,182622
17c632c7a9509bbab07f4291a4244d01,55,49,112208,38551,73657,77,58,123628,44518,79110
4f1563f8542abeb51601787974fe227d,218,144,1251112,225107,1026005,219,142,1428110,261257,1166853
29cb75f9c21b1f5fcc6f2009bbffe5ab,61,42,62447,19418,43029,56,56,48939,26544,22395
a8b4e8c0444d6b2e9237fe5804ba2c7a,77,65,153720,59266,94454,79,63,160146,65524,94622
aca9e97599d8ad4bc449fc3c9004ad78,44,34,55593,20152,35441,48,35,64777,25774,39003
c41435c1ae25485c9f6ba7f1c9e0acce,72,44,88548,29849,58699,59,40,92136,26796,65340
9e3873a825d931e391f506a7ebe09bc6,67,45,81652,23598,58054,56,44,82875,24188,58687
adad0f666d573619ae75c817b575229f,120,107,328249,57091,271158,127,116,278539,68902,209637
2fb00c1087429f7c6212b30e47c86e34,187,131,684161,119387,564774,178,145,565222,121473,443749
eb97fe9c48349b01411ac1076be35afc,57,46,50641,19704,30937,43,39,47616,19580,28036
1095a2bd1f04f64a4bd8d4f0e879ca67,58,46,63980,20234,43746,41,30,57805,20960,36845
4594c6b7284769c17076257ee70d48ea,38,25,12753,6609,6144,36,30,22679,5663,17016
9cf0e81d6ca4c93ef11228df68687c99,128,88,293732,59186,234546,134,95,316188,60220,255968
e660494337e9f2a187d88802d577c1aa,164,122,382806,72664,310142,174,120,445369,40255,405114
3c5c289bbc01c4ca1b19e2b366a0b763,96,76,217438,39469,177969,97,74,160344,47488,112856
0b4cfa132a78d04c288d079ce0da3478,111,80,220870,64449,156421,110,90,207076,63047,144029
1ba1de6e17ff03e4a1068e7638ed4947,136,103,340104,83789,256315,149,105,326882,58589,268293
6aad7561325d546c568d4223884ea13a,187,132,542110,168875,373235,193,145,768257,165698,602559
ce2beb4afe5cce87e5f90a1bf129b27b,120,99,363008,86944,276064,201,172,588237,134653,453584
ee4ad409d2ef4baf8f82ce3f8c48244d,73,45,102381,35917,66464,93,73,140907,36870,104037
52fb6339aeec9df5d509d6ff882f09ae,196,128,504347,89534,414813,104,72,276328,88761,187567
80a21768b393d8309f661a2a18989599,37,27,26978,12104,14874,36,30,43012,11381,31631
e68fe0ae13f2c134e50f423b5f4df3de,26,22,15953,7911,8042,26,21,14051,7535,6516
e96dda7ae25515e2816fd33113292367,42,35,28315,12200,16115,37,33,30971,11648,19323
c09cc5adcb824dbd2134f6b817ea7b6b,16,5,2735,456,2279,9,10,1789,769,1020
27c445bb206614078437b7e69422821f,112,74,360255,70100,290155,164,119,350651,84386,266265
06485a6bc4089f3bc2879fd1135de936,82,78,155894,58058,97836,162,105,254786,46748,208038
79be87e5b64b87c6b9e10623b5d4eb8f,55,47,65449,23497,41952,65,44,65211,17130,48081
b61293772869ed7f655607e823b881e5,14,10,2942,1595,1347,15,11,3046,1169,1877
f72b217ec96eabcebcd397733e66767d,95,75,233558,43566,189992,112,83,205824,56268,149556
ec9a4b64c0c8aae7464139502738052d,83,62,157025,41932,115093,58,48,113749,35002,78747
4077be8f74e92e50020a04727f712d00,113,81,166538,31837,134701,122,77,208709,36225,172484
43eb80e29ee6422ec7be424f0b15ba05,125,89,484621,153802,330819,172,144,526398,123334,403064
246468abdf3a4b8974e649f7fdf8fdbd,150,116,586940,126908,460032,213,143,656445,141133,515312
ba98dea6e5f7b942952f5121c46aaabf,144,108,353591,62147,291444,150,128,360520,86612,273908
687da41eb3a3de6f1f27d34659216726,69,52,123663,32837,90826,82,57,139115,36057,103058
c8aab452d49d56c39399a77a2c9621ed,36,24,30330,12602,17728,36,30,32885,11873,21012
edee7d2c42bb7eb811d0ee23e832cc0a,82,71,126363,34902,91461,94,73,176223,45473,130750
b1c5bda428fd4a9b02b94e7e472c6255,21,19,12004,5473,6531,22,17,7240,4486,2754
c6a4a54216028833b6cd4e0fc6085e60,165,134,517860,146545,371315,134,114,509274,110334,398940
839976aacc5396ef50966a41a7c577ae,116,97,217588,40483,177105,83,75,135187,49729,85458
7923dce8aee59d40ef6db5e12a3fef0c,46,28,51991,13135,38856,43,35,52232,10279,41953
8e250fe520e3151620b293fedd5281da,30,21,13764,7737,6027,28,25,14107,6440,7667
e35eade66810e9cea7d00a107fd220ec,31,34,16919,7643,9276,32,29,16589,7511,9078
d113220238e882c60d2e424ccbefbc63,99,71,137146,47186,89960,116,89,179481,42512,136969
fa9acb526cb4b6572eb78ed2ad7c79f6,68,54,114474,40062,74412,62,51,91216,36225,54991
058fdb7004a8f796cf6a6a96bc3f34a5,119,91,175270,35646,139624,101,88,193310,40977,152333
579f9fe58667191bcc0c2eef665a8672,119,93,305201,86802,218399,127,95,293196,86060,207136
87f8d8bdc860885a4a65680102d03606,150,125,436764,82286,354478,118,82,330897,73268,257629
0e62dace52116fa5ad1c2325bbe92dac,45,37,59366,20122,39244,43,36,44717,14775,29942
921e3e6a067624dc9f5cc8237985b30b,56,50,114410,34524,79886,49,39,83479,33254,50225
d46af08a0b9289fa59925bfe87db215a,9,8,1396,527,869,8,5,719,704,15
4c4ede8dd57490688cd36f78216045eb,126,68,231005,58559,172446,92,60,175672,63863,111809
1fc53df13455c3df757e8ba05ff59b4f,167,117,655057,124861,530196,200,149,791317,118138,673179
a35a02b5798f010b5be0ce62258039d5,63,50,77288,26890,50398,57,43,94931,27436,67495
344361558490f9c48299f6d6647a4652,57,37,59111,21588,37523,52,48,46482,24095,22387
caac4e201bb1dfea99f1704f61727953,188,141,580572,98667,481905,195,164,590266,135146,455120
eb761a24a8968a3f6f9273356b373ef1,68,64,92119,39583,52536,91,73,140932,51041,89891
7274908a0b8817969c26a7a8a9712211,150,117,372529,63160,309369,176,144,432150,78182,353968
c3d7da92993655d1015368672b0dc758,44,31,54568,14397,40171,30,30,40958,19519,21439
212f8e0e785aab6eb1d9e79448061a5d,177,109,389939,82156,307783,139,97,266327,88830,177497
9b76e2cf0b0bc1eea304f3a5abf6e5e2,143,113,452517,97925,354592,137,103,404051,109092,294959
d74ee857b575a7c61c6fbb1e09182c25,123,95,355939,71077,284862,120,101,328736,71071,257665
0439e697ae13b2d87c10fc16a062c63b,34,25,30274,10606,19668,28,21,29108,11706,17402
347fddb320c43b4ddd342bb52251edea,28,26,25096,5704,19392,25,25,19091,5313,13778
e4f364fc5d898d17059bc76a3b99e9f3,90,61,252488,40484,212004,97,85,183734,53632,130102
32c0ceeb1942efad7b6011d16afee45b,115,90,281964,97066,184898,115,94,277984,102869,175115
a128d9c6298477b15f26a824715113ba,161,120,678229,173705,504524,205,155,922139,128738,793401
c49354e7b1b3c5627c345387383e090a,40,29,22148,6358,15790,29,28,14729,7889,6840
225735757ae87b32bbb923b98bb63b26,97,75,150329,32654,117675,109,91,158909,42008,116901
0ac11293874f607abc55b34108ac1fe6,3,2,430,296,134,2,3,296,430,-134
80787dc8a027398a277add8c2f347ac9,181,150,497367,115629,381738,160,129,458973,88907,370066
3437d970a23be7747e4f8e562adcfe22,131,109,300314,83192,217122,176,131,473331,88332,384999
2340518c2d64b2bfe0d4b296adb2c367,28,29,22173,8972,13201,35,28,19313,8819,10494
b0f6cb8f0813c4c7d2d55c8d501f78f2,92,67,165434,37794,127640,109,86,199074,36959,162115
4f8ee1215668e89731903f0ec91ddd7b,15,17,7094,4379,2715,28,18,10133,2716,7417
90b4a7f29274c87a21d7b25472b96c0d,143,121,424821,118768,306053,169,127,452977,134351,318626
83e7df7e25ed38fb4f5b6d7e896dd193,12,11,1898,978,920,14,11,1941,843,1098
bae3fcdeca66724b2f8bb71da0790f17,63,51,67323,16405,50918,56,53,39234,16418,22816
501a890cb9bf329001588d0347c833ab,26,20,7138,3511,3627,25,17,8588,2853,5735
4df8bcc39bcb906c62fc3c21f3870c46,31,33,17506,14562,2944,37,26,26523,9441,17082
374f5800680ab380142dfe21a8ca4e61,46,39,60115,22546,37569,47,31,52214,20881,31333
7e4333e09250ae403cd8457f62dab5cd,94,60,180073,36520,143553,83,62,168224,30542,137682
20a43e35046fe5ed5f6f7cc17002140a,99,71,163372,58401,104971,109,86,218145,53371,164774
fd5551cfd5f5d15ea406dd3919614729,183,120,684171,106672,577499,158,137,550095,118200,431895
a9a6db9032f6f20d28b3192b18a8f139,24,15,5401,2818,2583,17,19,4243,2620,1623
07882c831b54862e8bcdb66fd24e375a,23,14,8220,3484,4736,15,17,6212,2729,3483
4863303324489f7f3df0f8dc20d9196d,38,30,55285,21953,33332,40,34,64481,18508,45973
5488252ee0c6e55612ca5c1d63db4a79,121,77,180056,35587,144469,114,86,183776,47054,136722
4cbce55e3190b9f95e881bbc59a4ffc2,108,89,269865,62816,207049,199,169,639661,74237,565424
954e7deb3e29b136810843ce71a462f4,132,116,319221,56745,262476,108,85,198840,47379,151461
a13aab6319a29cb6fd1c610ac8b6fbf4,46,40,71213,16965,54248,47,42,48107,23596,24511
3fabc9a47c7559496b47d094cdf4e532,144,108,294169,74400,219769,124,104,262931,78782,184149
2f4bfe03b80f9cbd8e633001198ccbbd,98,71,200768,32004,168764,100,93,172603,59965,112638
c3d11df2f59f099df0749cde0d5fe131,162,118,701346,198366,502980,192,119,948151,160480,787671
51e208e4e9beb7a586caf2969c392cb9,132,96,244154,53049,191105,119,106,275853,56536,219317
65be1ff791d04b8bdcd99834984c76e0,43,33,48038,13782,34256,48,42,36997,20098,16899
4b99bc87e7afc5f623f258a5b17c953e,42,39,47153,18513,28640,58,35,81060,20482,60578
68a33f7240289a09ab20e91a22eb3368,142,93,384915,96017,288898,150,129,458703,92438,366265
7f4e8bffeeba96917eeecd2c2550ba69,103,70,187763,31144,156619,55,39,85289,28631,56658
6b6d46202ab1dff1b5787623d1e03a2d,120,95,429411,77039,352372,167,139,489098,121753,367345
522107dd2f44b657225d6dfd23abd240,37,35,30919,14394,16525,36,27,25055,9947,15108
82b90e4bb78e097f6f9f042078d4391e,137,125,289793,55189,234604,113,91,222174,53799,168375
7b9e50bc3fa53908729c3b28533012e9,59,52,134215,51820,82395,81,68,245355,56809,188546
5c011473254302d0bf0c8d33141fd109,152,111,472742,111793,360949,125,106,407214,106814,300400
dfbeb1c4381c1a521ec826d492ae1508,134,106,279118,53532,225586,87,70,194568,35881,158687
e9be54fe9c6883c976efc52090c62815,59,43,86935,22836,64099,67,54,89637,27879,61758
b6a42f9b5daa04a283a4588ea891b99b,83,74,202702,79158,123544,106,70,226570,76559,150011
7b17f91aa6940fd658aa698d9054775e,81,67,172091,39579,132512,107,83,205268,60390,144878
620e340199c677ef969cb18dd97d3899,34,22,38298,15735,22563,33,24,34569,14018,20551
4ea7c43e06226d3faea0aadc1797dfbb,94,77,141294,43905,97389,101,70,193711,36030,157681
6f9f39ae9f1ce1907c4f82bb4aab5ce7,121,101,515821,92201,423620,199,130,562190,86907,475283
e8ed5ac216a3e9ac464458b9085fc9f7,25,20,15610,6816,8794,26,28,18110,6025,12085
0f440b3fea36d662e55b85162166e18d,150,121,426047,108352,317695,175,105,643774,92949,550825
c8405330dba9f5ee7818eaf43795303c,82,69,152463,46442,106021,65,55,110033,32670,77363
9ffd1636c8a700fbf70f81520a35418f,195,161,1265612,182803,1082809,169,101,548948,195325,353623
d4f893d742e69b66e84e9c099de6c55d,35,29,27994,9848,18146,34,27,27469,11633,15836
16f5cd59fd775ea420bf4e4180502e86,67,57,110124,40368,69756,77,55,85559,32627,52932
b8b80ce4f5ffe71c984b6a752f8aa190,140,98,275744,71558,204186,107,91,184274,76265,108009
01401f6427f01ae94c0340eb50e7f59b,53,51,69582,28880,40702,38,32,49865,20999,28866
045839dd1805fce1b2539068ae7001d0,112,85,291013,122751,168262,145,93,448396,117089,331307
538fcf7066f29a1d6b94120a47f5e63e,29,17,12527,5916,6611,26,22,17554,5215,12339
7b76e2433c04d6786db5107cdfa868d1,153,107,401592,91911,309681,121,96,304598,106323,198275
c993bf527353c5d246155d3c20842dac,1,1,148,83,65,1,1,83,148,-65
0e950a4f03c30ed14a0eb122aa4ab292,115,93,247651,59816,187835,134,113,330910,75706,255204
93c15798d9bdb64079017b9f617ca1a7,24,15,4743,1286,3457,15,22,3266,2883,383
616b373d8c49e3d7d3c0008acf67ba59,22,21,11033,3788,7245,25,19,9457,4065,5392
d8aff0465e42cd67879079de88409d5f,88,66,283292,66620,216672,119,82,262385,77292,185093
4f2c873ef6d62a7cea9e37d13e248a9b,101,82,203157,76371,126786,128,88,257095,76314,180781
cdab41b9935b8d5566a6fccbb56c834b,56,37,99069,36097,62972,63,51,143030,45664,97366
c3e07c27ae181c36ed2f0295e4b6bcec,13,11,2670,775,1895,10,10,1875,919,956
b2872158673a222e57898d8bc358176a,30,24,27135,6846,20289,25,21,17131,7485,9646
dbc1ff1308bbc2852bd7b3f6a7f3a4d4,38,30,30363,13177,17186,37,28,20091,11430,8661
56cdbd75cfad6ff99ab49ec898617c5a,98,86,214874,85943,128931,73,48,208210,69104,139106
7a7006e8e77b855471b66ee3dbef3502,132,93,267875,80384,187491,130,96,353198,109670,243528
1900744544c82174208cf29e460426bd,81,67,100398,35025,65373,92,77,122836,34674,88162
89440689b4a5ad873bfbf3464850f89f,62,53,100860,19031,81829,51,43,53290,26114,27176
a53c0c75e5569dc0e6ee654660a2ef16,26,21,18985,5361,13624,36,19,28480,4311,24169
719c35236349b4cfb1efdfe175b305d9,49,34,43583,11399,32184,48,36,37815,15689,22126
f5cc1c6011e2d119421c35bc42612283,127,89,307015,57818,249197,110,95,239581,65458,174123
955c0e3b0e6df269836fb2ecbb799970,60,38,55226,17440,37786,53,41,59377,16865,42512
be1fec6808d0a7459fe3968c92c73c0d,185,136,941589,101934,839655,169,119,916556,144155,772401
bdcbf95fc705a779de004c9b43a5dd66,26,19,15595,5827,9768,24,17,14939,6505,8434
943ff41895cf6a5dd666bd027e8cae52,35,22,21948,12403,9545,33,24,23236,9736,13500
9f4499a8d49520a602885ed5f4fd7c16,118,96,218546,37452,181094,124,97,188810,46426,142384
54b07d9a7496b25916ee6a293fb302a7,82,60,91028,31352,59676,98,80,119749,38651,81098
6b89b3b26ca505760da3afde7d0a9d3f,113,81,187786,28292,159494,87,77,133588,35508,98080
f8b8a16b93cf48eedc5bb7bb309506af,47,38,45355,15059,30296,36,27,32745,13689,19056
39a79a38fac61732ebe97667e7e8fc5d,74,58,103626,17000,86626,50,38,40968,21168,19800
8afd0e2293c37b30e9e3a00c1fbd2024,67,56,83056,28926,54130,67,49,92484,22460,70024
6af78885be29ace348c3de1684ca6c65,82,79,162895,47834,115061,114,86,187594,56855,130739
d2c07075565da7c00613d01043a47aab,183,132,439980,127270,312710,135,100,434243,113784,320459
4b92a8992bf3cb2203e93ab1b4f86fbb,27,23,22703,7253,15450,24,20,18484,8027,10457
dca73e7ba0d036ec62ea9f3fa9d19f40,83,65,137427,38389,99038,74,57,96853,47404,49449
55504db208760a4c9842b1d60087cb5a,199,135,462174,103294,358880,78,67,200727,106358,94369
0eaae0e72955a7d471383f1608d7b99a,26,28,18152,9732,8420,31,26,18602,7149,11453
9399f757f7b2ed9e1f5383ab9402cd96,56,45,101249,27158,74091,71,61,91886,28679,63207
110ca871702f1cf6ff3abe19aba0fe2d,178,128,481970,124417,357553,196,113,484563,122494,362069
10b3b95c53638d1e912dba08a5d21fb0,25,20,10914,5401,5513,24,21,10305,5346,4959
48b02003f6f5c71c27fabfeed1e0d910,171,101,450765,104322,346443,186,160,539177,90109,449068
0440087528a5c5597953ce3af6c141e6,49,39,56235,19317,36918,47,35,47512,15044,32468
b1b9a564d85424781ffa950e11afaeb7,20,16,8877,6011,2866,24,16,11416,4097,7319
b67aa84b6378b8cae21c725b4d8cbd9c,226,169,1459412,260400,1199012,224,168,1070944,218163,852781
a845eebf5c80b7ad3efd32f43ebe6c5d,115,103,290547,61870,228677,146,105,343164,65513,277651
ea6e926b857b7bbc6290c3bd54f96ba9,99,68,193936,43575,150361,86,64,154782,42450,112332
5f6e489e319de4edace82b04f2d05a40,95,71,180145,67380,112765,134,89,246603,49356,197247
4e7f13643682fa567b33aaccc9bc53be,19,14,4976,1930,3046,16,15,4025,2382,1643
8056fd16b65a6993736a2d6cf1ad8d43,143,109,409217,96379,312838,130,91,384998,75537,309461
9503c4385738886172651c02199f1b83,39,34,27066,9669,17397,43,29,23284,11872,11412
1e90115f3a55d018efb9f488ca0e917f,25,21,16701,5502,11199,23,19,14617,6098,8519
02ab0ee9e4252e784d98ca2a8fd40b05,40,30,26912,11631,15281,32,32,15591,9908,5683
61a763fdf79c7df50da4f97bd6f41385,23,19,28649,7633,21016,23,21,20633,9728,10905
6efc9806138e7dac67db11b79521ec02,100,68,149680,32647,117033,74,57,117258,35435,81823
94a414ceb76e950e664a53607d453247,44,40,44625,12383,32242,37,32,30141,15870,14271
1c83ca6e3539460de43376c410c7f16d,36,21,29034,9813,19221,31,21,22317,8476,13841
8f96d9be2b1f79be95362f42df25f1c8,124,89,232808,69478,163330,104,87,186026,48844,137182
7b5dce2f3d89383f9826481fff51ce0c,49,40,75400,15684,59716,47,33,64624,14414,50210
ff477818b6358234147be911ada9796c,123,108,230475,58992,171483,98,86,171529,67340,104189
d4286828ea733d7adf7130a1d0c287cc,50,34,32813,14345,18468,45,33,40973,13487,27486
9cd1658d7106b42b4821895bd9d25f4a,176,147,555142,152221,402921,182,133,640755,133143,507612
c45197eba92c54849df9c90f95921ccc,112,81,210220,51036,159184,74,59,134577,56763,77814
afae90220fd2e893f58dff711565f0b4,72,58,91565,27216,64349,52,42,65153,25178,39975
811547b1977ee4220b11fda76e89be81,82,74,159246,54989,104257,82,54,135955,37565,98390
539b6784a63a12414c6464dafeb8961f,129,111,338467,64354,274113,107,96,273364,55693,217671
02830264c6a9fc8a6dd20fa3a962209e,105,80,193430,54372,139058,87,65,161917,54839,107078
e57937cc5679d20ad6676c80d3b1ecbc,177,132,474396,123036,351360,167,118,556205,116896,439309
91904a8a6c191197bb02a42390fef8c4,65,54,126543,38704,87839,62,53,142986,33898,109088
eed1a0412a8043e5df17c98baa8d4f9e,73,60,71949,25213,46736,62,44,78000,16523,61477
e813df225cb1c84bf7dc7e34916c16a7,116,75,168310,64368,103942,113,103,253396,87973,165423
0c7aab74ccc03d5b31238490d7d7f04a,91,59,142511,27764,114747,86,75,127238,36181,91057
78636f3c83ac29d5bf4c665a785fc273,35,25,27032,4968,22064,26,19,16885,3811,13074
ce1901fab2634a0dc9cb245126a21b68,105,82,254793,38280,216513,120,108,265116,41120,223996
95b8b3d9da6523c5411eb288a7d11de0,123,100,300465,53122,247343,103,81,234566,51670,182896
1c5dd32d9be454f6fd7e237f6f81e2d9,97,56,106748,19057,87691,79,63,102445,35055,67390
57cdf2b40c56171fe95cbfa66fb90aef,196,140,634909,144863,490046,156,120,603445,122121,481324
8b30a1729fc71042394a265d7e3243d0,155,110,516635,94198,422437,131,89,394367,114004,280363
4c89606037ced84c8d9236ec20f51c0d,83,62,88778,28236,60542,85,62,121522,34910,86612
808d689b33d4a4beaab9f9e357fecf4a,120,83,214011,39237,174774,86,70,140825,51869,88956
2dc04b6e8272359d0bf935a971fafa59,141,107,326395,56896,269499,106,90,239140,50346,188794
b8c1bfbed18dd0c331061b207223451b,34,26,13436,6957,6479,28,23,17627,7229,10398
4c909c87b85a4221f7cfaac1551ced60,73,43,74770,35345,39425,79,60,86310,33488,52822
7615c16e20918237174eaba05c4d8224,35,24,25067,8817,16250,38,35,28986,10007,18979
37c7d4529f7710245be0a0f00132daad,51,38,87787,32083,55704,57,51,86167,37265,48902
17640d95b2868814a5a23d341ea564af,130,108,394810,76403,318407,201,140,665812,70728,595084
cf5e14a866f66903ede8388a9c440d23,187,128,718181,89016,629165,122,91,370732,79056,291676
4d67cf21e0b22f1ac0abfb6113f087ca,97,79,148659,59769,88890,156,98,260940,42863,218077
ccbda39f61f0003112d1ef34c29ef3c3,92,76,183099,64847,118252,136,85,347455,65737,281718
bdbb845df81fb42803024bbf3a302ec1,56,52,72043,23481,48562,60,54,49567,20733,28834
4b4ed9cc5ac4d6ad4ad14029f8423632,48,30,53583,21917,31666,58,41,81547,19906,61641
1e845a2362e1e3abaed2bef7538f6208,113,64,152742,41147,111595,107,77,165692,48013,117679
5eeb1e7b9b88e5bc82422ba89518b8d6,179,140,912952,160364,752588,186,143,678866,143344,535522
9bdaab212b95ee2c557254ac273014a3,145,109,398755,98437,300318,148,105,411550,79141,332409
d5f4fdb1c132b42aaafb147bdd0a2683,45,35,49358,10705,38653,45,42,51734,18909,32825
489bc667ad2ea043702df2cbab2aaadf,100,82,179920,48482,131438,101,80,227156,53295,173861
44273bc8dc28f284f0128ccb261ba38d,46,43,33816,18501,15315,48,36,42006,16978,25028
18de4d396101392ae4ddc51275e6a700,180,134,679859,164647,515212,188,140,776970,140989,635981
df0f5e0dd78cdbafff65cf1ed818d577,136,116,301469,84791,216678,131,95,286214,74642,211572
7ecda415d5d40b88df4f2ea3c70d3a83,142,105,380387,70069,310318,128,109,236388,86952,149436
0c6545f818c5813fd3fd0903f1a38683,96,72,166516,47754,118762,77,66,108172,63083,45089
929223f06d2b2f6f086785ae9e425aec,116,79,216349,61393,154956,140,104,348999,69616,279383
9eeb2dbb9bcf19bd9bf80411320400b4,62,42,69262,22507,46755,40,31,54862,20557,34305
da91e0a53838690491ce83bd9ee1fceb,119,88,236360,65681,170679,139,116,332012,77586,254426
8165c42b541d52d0cd3575815350e6a2,97,81,175616,52405,123211,125,101,321009,41806,279203
a2a77c4639e81d3df0263e3a93488248,18,12,8867,1115,7752,21,21,7277,3544,3733
21b93ce5a6e1ace414bfc56c88b62b3d,47,40,65311,18237,47074,64,50,66481,16620,49861
0a6c5218ac2033708a9bcbfe01b54e83,80,73,130307,40172,90135,105,74,105073,38294,66779
32d9393346e60d7976bee56fa0ca894a,33,28,10098,6275,3823,27,27,9529,6355,3174
0215f72dabcbaa2475a70c0d13be7602,101,71,218653,45231,173422,91,67,149177,40629,108548
498cb2d26b6a04aa4d38ecbab6fa5fcd,152,106,490221,86810,403411,182,139,567437,76989,490448
eee78d7eb9eb9662b085a00ba1c867a5,77,64,80355,31909,48446,64,38,85624,21069,64555
bdc6ea8cd0c3f66ffb36899c420e5245,146,117,391013,71632,319381,165,135,412205,98836,313369
089530585f3c514a1251830e0ce3b278,33,31,28664,12941,15723,39,35,28377,9998,18379
fc187e284e12e03b0f174799ac9af438,78,54,104005,21512,82493,70,55,68911,26353,42558
c6e9b5b26d376ea81e0faf8979b46383,120,97,265857,78594,187263,114,86,257059,55327,201732
d4804cb9493b4d8377cc76a0272fb1e0,129,114,270965,60681,210284,129,98,257281,52822,204459
6640503c1a49ab25753805c25e38a641,154,110,374488,101764,272724,144,126,420610,101584,319026
c5509f31242f0b41d75978e459e0fa97,121,93,205188,47496,157692,95,93,158148,52390,105758
4e1dfcf98d52aa3e292574293986a7ce,83,68,120901,39563,81338,87,71,125727,32722,93005
c496af491bb78f98b6ad9038605b6dae,157,144,385422,88705,296717,169,104,360137,72069,288068
468d67cfceb212f9b8bbd145c20e1fdb,91,68,280314,78773,201541,115,95,320879,83202,237677
ad2e23d0b3c82d7d9d587bc33a409bf8,143,97,336964,74604,262360,131,111,378787,72294,306493
cce8e87f43b8601bb7b1078688195cd1,223,179,1258155,188899,1069256,242,173,1112750,160081,952669
75210eb209289abcb80b9428a552402e,146,111,272722,51794,220928,114,91,200464,48746,151718
6b69625d48b149f36a75e645c9743f2e,61,45,95608,28626,66982,49,44,91862,34394,57468
1d1e28be6b24083079f82f1510841e75,31,19,9953,5215,4738,32,29,18716,5685,13031
fae107d3d08586ef28a9a2bc919855c0,39,29,25298,11382,13916,44,25,31503,10314,21189
e56537c9c6c329d06e4ef8f1de150788,57,49,66814,19103,47711,48,31,48152,11411,36741
fe56dc55f4c15021730797beaffad262,80,70,102054,32868,69186,69,62,130123,35024,95099
4051fd9690d823f0349d0cf657bb385a,69,48,104686,21061,83625,59,46,84910,27299,57611
94160697503d8d150bbd15ed0f570c4e,87,68,178828,67773,111055,124,105,295554,58782,236772
c7999b93d4ddc5809a269650e7d76315,18,14,4693,806,3887,10,11,2236,1105,1131
59a0ce7c22fd9c1f31bad1dcd39dd785,28,18,11355,7007,4348,27,20,14631,4934,9697
4b76129446c1114023ea8a5b155b2599,26,21,14581,5337,9244,30,21,12988,8085,4903
8f84bd293f45873e46cd584a62151560,43,32,35634,12397,23237,31,25,33330,13048,20282
2ac4072bd74a1e85c3231a81208f6d84,61,43,64808,16910,47898,57,39,57856,22101,35755
ed8ca2fc6a015d360273369fd37d3ccc,32,25,23941,10215,13726,28,23,26605,10357,16248
3934e975bd7d02232d52bbaa046eae36,101,80,182184,39710,142474,91,72,169515,39142,130373
4c719496d650488fef34e61e2e0f29e6,58,50,92675,43457,49218,58,40,111877,32666,79211
85be03d61259241d86348ce10a41f539,132,103,263747,63709,200038,123,104,217567,51476,166091
72fb178ff40c35994624b5dfbc3b8ba3,138,88,285416,58915,226501,106,79,296585,65684,230901
371e687af2f8d2d8d09022edec24a07b,115,87,219053,43837,175216,107,87,213280,43441,169839
34ad9000c39b9284ff986df0155c46a5,154,132,371061,59566,311495,127,104,299090,67980,231110
a832a980d6777e8e1734187ed9ea9f00,102,84,200074,58922,141152,116,89,340701,47379,293322
942eb0a21704fc54a0691533b675c2d0,29,23,19395,8431,10964,39,33,31123,8726,22397
917e2809c0dc67acc71d5b986a5440aa,157,130,652077,149014,503063,175,142,601282,148867,452415
c53f67de6557b7c3f5944f7f086dc60b,174,127,602974,134239,468735,192,115,550856,142177,408679
00caac8fdaa36c07d0137788f7534677,149,95,346192,72018,274174,77,63,169375,100504,68871
7d5a4cb52637884b519f69be686f1bc8,53,28,49446,18269,31177,63,46,102126,16859,85267
c76d8b28aa126f9d829e8fd3ee6eb114,132,104,283599,67548,216051,113,82,234669,70434,164235
fc3cf7c9a51696c7b2a84fed6cbf6028,18,9,7573,755,6818,12,14,1745,3970,-2225
aa2e76ae6f5906fb922dffd222353b79,126,106,499083,116780,382303,131,96,440412,93569,346843
7a543626f93274b835d307a7aecc62c4,26,20,18034,7668,10366,31,23,21257,6598,14659
d992c5a963595ed9c01eb73711fcc7a8,51,37,43495,15019,28476,70,47,65667,16463,49204
dda463c4b79ebdefa27376231f2142b8,114,85,275622,96665,178957,142,104,441012,75067,365945
47ef58a2c2c4bb59a49fe69e98af9ff3,31,23,18764,8580,10184,47,24,32350,6507,25843
502f0dd38c78312536e9d83802b474d3,46,34,49371,8316,41055,35,28,28141,12962,15179
0bb83e767dc821cf6336538090aba077,100,74,206486,49917,156569,120,96,187887,66364,121523
c703fdc38bcb1c7e17f44039eb11a796,15,12,1233,790,443,13,15,1590,1201,389
52e4cddb6a50557a08a050c8ea8461ae,25,21,21748,11753,9995,35,25,20919,8582,12337
fbd679074cc8e59ac19ad4906152e0cf,14,8,2957,2466,491,14,7,3485,2157,1328
29678cedb64dfe9b7de68e95445a16b2,98,70,174582,33792,140790,90,72,156606,36429,120177
55ff63cfbd77c057a3f4ee5316939100,65,50,116510,32318,84192,62,54,74342,39660,34682
392c490b6e109b364bae8a264096b36a,52,41,91955,20460,71495,80,66,89782,35058,54724
14babd26a0792fb681d6729c85033ddc,29,19,19500,3464,16036,33,25,26121,6087,20034
46ec31a9188c2db3d2478f1a5df3e0f9,100,84,200053,62977,137076,100,78,205389,39290,166099
ea2a77f80e927d8274cbb0db99bd5812,133,93,322048,66184,255864,76,57,168479,65468,103011
b0996b4db9f38c98b78d0fbdccb274ed,117,99,217557,65742,151815,126,99,311890,42120,269770
cc5c1de175c98d5147d2205a947732d9,20,18,8082,3644,4438,30,16,11165,3718,7447
74ef74a936f8a3e1671249137aad4985,14,13,1709,1375,334,18,11,2695,1388,1307
69161ead3661fd7132eeea2c9893cc49,119,100,247053,77117,169936,93,66,241718,72292,169426
8aeeb9196d913b1ab901b141f2063698,17,17,5074,4080,994,22,13,9692,1400,8292
6542b06f91f7b24831ce02a8c5b70bd4,25,17,6638,3326,3312,22,18,10753,1723,9030
42d8442a4c9abecb06fc58612e089f3f,145,100,311675,79078,232597,170,153,515431,96595,418836
44424ecb4ce0b808e239f211c14f7283,122,92,427582,107987,319595,152,94,393035,97938,295097
faa5096392b06301ceaff7faee9599ad,163,119,407172,101497,305675,114,95,254276,76761,177515
aa772088b98cfdc8473b4e57e10f6c5c,68,46,105218,16803,88415,73,48,85466,22971,62495
ffdd4da96437f2f14110b3e070cad822,66,56,130513,37649,92864,67,59,115171,43857,71314
a96626d7622483776a083f8302f0ee67,111,86,183903,38066,145837,94,72,148983,42166,106817
27b967bab00e9f2f2ab9ac3c8f9229ac,19,20,9967,4647,5320,20,17,7500,4186,3314
ba3d43817649bb6c9417d24c4fe47f57,118,93,308626,65088,243538,113,89,258738,67873,190865
ca7f5858d99b1ff83a1813033794f016,157,132,446958,98762,348196,143,102,350840,96775,254065
99396083207d31bd939a7195be2d003b,106,90,248157,89160,158997,132,114,358930,75652,283278
897ee53ee660ec12af8335a3fa801e31,40,33,58707,14408,44299,34,29,27579,18315,9264
a34941b187dfa2a26990b9f423568061,128,90,259204,98709,160495,162,99,341055,79752,261303
b64947acc9b3764bf174206df47928cb,149,89,313641,70250,243391,129,81,307149,76503,230646
50a8e2ce6beacdfd248c6b9edb694579,33,45,35844,9206,26638,44,29,23413,10254,13159
d201308ec22b7e64b86579ed6d172bdc,31,28,17987,6000,11987,25,22,11398,7257,4141
f85d07a8ee6b35028f472b929197319f,128,101,362154,107729,254425,138,112,441130,107885,333245
6201673ed96982111f33bd57c91ab489,143,104,279877,59066,220811,141,108,305850,64977,240873
be5a8de7c9760c318a59b06ec60704e3,27,21,14267,6405,7862,22,20,10123,8120,2003
008754ecf681c6d3b0d5093143acb20e,45,41,40104,15716,24388,64,42,41962,16034,25928
b5c0ca50fbbe565f6fef4550cdc8f747,25,21,14479,7202,7277,27,17,12910,5145,7765
99e8d1b027a3d2cb2573deaf9971f6da,84,63,165900,43837,122063,78,61,152933,57222,95711
a60c2fed117b27bf4e7b76cd04a3db65,95,79,251949,43306,208643,156,124,493195,62160,431035
e01cd2cf0f2dcef7895ddca1da41237a,50,35,78704,23614,55090,52,31,78740,22264,56476
9101e964ff1a51899509d0ba5db6346e,48,36,63862,17333,46529,35,30,34839,22221,12618
03eb2b4091481b738eb8262b595d91c0,40,32,31413,11860,19553,35,23,35164,10354,24810
cfe37395d49e5d23162a2b110968e2ec,105,76,241595,48840,192755,84,50,182754,36636,146118
3df9c61062be03e76f72f74e70550402,154,124,489570,118912,370658,187,129,641904,122755,519149
171888ccc14fc641d11e8005ff5e3ffb,41,40,54634,22833,31801,41,33,53810,18934,34876
c4afaf92b0abbed0a7f1400ddbdd500a,44,27,65711,15946,49765,40,41,54651,23184,31467
27035a06be2ee22edc4d26582cf3744a,133,104,339980,74553,265427,103,74,223991,78153,145838
ccf2df0bf56203eb2cf50224dcee0e23,104,90,218892,63481,155411,115,88,184905,48174,136731
e78733d24b88f37ab0edff89f4c62d26,89,58,128066,45689,82377,94,80,147940,48419,99521
264e4547199290a46df10596e778dd95,138,109,408325,133405,274920,130,113,523597,95623,427974
6c32886afdee28ed01ab617b6b5abbe8,33,25,37062,20290,16772,37,32,53336,21882,31454
3d2b9ee5ade92add28394223c0003559,30,23,24686,10113,14573,38,26,20977,10237,10740
b68f85f5b2c6ecc7fbda309063d2dd83,132,108,387260,106130,281130,145,115,394261,79481,314780
d4a09f7209e3cfb4309d2bb05a482b2f,160,119,656604,141691,514913,215,143,748481,200121,548360
794ce568e705f037eede9ab816521537,149,114,653350,123967,529383,170,148,581862,161676,420186
56c22ab4d44a8475a001a6984bf3b9c7,161,131,546005,111455,434550,177,145,620874,134766,486108
a1e6663d98c96097ee542b60a1bb85a7,23,17,13205,3430,9775,27,22,9565,5678,3887
1ca07232fb62cc8303f473a160e8e99f,161,128,750195,124131,626064,162,124,654354,132973,521381
2530193f1847fa7f7aee95e6e4f4b52b,170,109,339071,104999,234072,111,91,256290,63033,193257
d83f368e272a1b32e064ca2eab82354a,56,43,49961,15267,34694,52,43,39594,20463,19131
825c46f8e19463f9e90c13d13205d8ab,143,96,336603,74092,262511,180,134,487570,88945,398625
71cc4d3c719fdc6ed310160a8ff88540,61,49,60423,25613,34810,57,35,52517,22196,30321
30d8c349b4bf6687ac9bf9b73bfe1307,98,83,253326,101115,152211,94,70,186731,61363,125368
c46e1423b402266ac6390124c5b0cb67,113,87,194026,34852,159174,105,85,153647,39118,114529
43841b896d037e76c592914b9716d6c4,26,22,7229,5157,2072,27,18,7455,2823,4632
a3674dc93cfcb7f0513f19eb164e760f,204,145,902843,117805,785038,191,136,725801,148526,577275
18e8a5b8868a1a5bc229fc173076cb21,22,18,6603,2641,3962,20,15,4998,3128,1870
6ae77cd64d59d9fe6e60817cf39df2bd,193,151,766349,132981,633368,185,136,663938,148234,515704
0b65c1d55d116dde845c10608368d966,135,116,357120,79282,277838,165,116,499254,90749,408505
451ca32b87f4b1b910e9d641bee01572,42,27,36163,13683,22480,38,28,21540,11396,10144
bf4ce4bbbeb0efc0d1014d11a03aa8b5,118,92,211991,42554,169437,93,76,166301,47106,119195
71684fa1183241f6d1ca9c6b9d243c1f,94,80,139703,44764,94939,76,56,118579,32602,85977
beaff87d8ec0422f897357f099bd9501,38,33,33990,13668,20322,39,33,24151,13822,10329
633a533f066586682393e0757aba0e22,30,23,22259,7787,14472,27,22,22236,8054,14182
eabccbc8e105d133a1ed6ca752dc8de7,50,36,67768,24551,43217,88,64,145391,19932,125459
fe2e2f163d12515e49285c9393a2f538,181,142,729868,137546,592322,175,137,804528,135620,668908
0f11f525773ed11e89b799b6262f0f5e,142,107,363913,92136,271777,97,82,326043,108133,217910
7e8f8a8756be61cb5a1a58a3df153cf2,124,92,492858,139553,353305,112,80,434125,88057,346068
ff840845b1e8182ff97885312a52c7c9,113,88,232057,56554,175503,150,107,314962,45248,269714
325e3d7bbfc03d539f11509cce5d7dcc,93,71,149035,65581,83454,121,91,255104,53874,201230
43a9ca960ee730cf0307d73b6a79ae13,129,104,335806,120093,215713,112,73,271724,108064,163660
39cf4ed7d8d96ede84a36133c8ddb496,155,106,391750,38822,352928,128,106,291085,61097,229988
796e2804bae2640f3fc577a87198974b,69,50,75911,21446,54465,90,73,99210,27132,72078
810933e339a951f4082650a6f9bfe652,23,15,8303,2584,5719,21,18,8593,3100,5493
05a2d93b6be1212bd0ee242d8c358b52,76,47,77123,22908,54215,75,55,83500,25842,57658
1e6ec7f3ffde25756097cf5a67aa05f1,163,112,386324,71896,314428,138,127,374505,85794,288711
a4704c20153927bbf57cc6c7a4399291,27,17,24984,7832,17152,28,25,21941,12581,9360
9c1391eb449441c14f6127d035614370,33,23,19604,9227,10377,40,32,34451,9127,25324
61782f0d81f372bfe921701663747095,53,45,98923,48932,49991,89,73,146162,35515,110647
3d0f575200ec63feae78b87c919fab8b,54,42,75255,24995,50260,37,33,53144,30164,22980
50af88a22bc52bb83db026e1d829e9f5,34,21,16542,3254,13288,19,18,8776,4120,4656
aee1043f0b4ef40338b4510848aec4e7,27,20,11122,5491,5631,27,22,13087,5346,7741
f8e6099f5e282981b533628bafa61f0e,164,103,500079,107724,392355,167,136,585783,141884,443899
e17b58ae9778da36a1ced52c92a2187a,125,93,267528,72073,195455,148,121,334857,70182,264675
c81df1e3961638812f4fd511a6009566,50,38,71315,18868,52447,60,51,90486,29038,61448
73c860e49f208f31ffb6329593ef3562,85,60,118334,63870,54464,118,99,290885,37782,253103
bf4d272dcefdb4842d146a41406e27c1,8,7,581,311,270,7,2,633,200,433
fb324f87671b60838ef3b4da36e93861,258,176,1694607,299581,1395026,189,153,1701757,455997,1245760
9e8c88f25954ee32f3577f204d5c4c36,156,115,470614,111845,358769,154,116,481966,120335,361631
cc8bbc79e25d5e894819b21741350d0b,90,73,175747,32874,142873,40,29,59995,13036,46959
71ce317d2db014ca0c5b3cf6caebdfa3,48,34,44388,14730,29658,52,53,36144,15144,21000
84187c1ff19c331c2a68bfdbd68027bd,111,92,267957,53262,214695,129,102,297406,40289,257117
f72d756e848b754cf21222b0d883062e,24,17,6308,2264,4044,23,21,4456,2941,1515
cb76c9fb59806d049f32a9b586f14308,30,25,15856,8031,7825,31,25,18506,6308,12198
4749995b5ec44f28ed13f22aaef743c2,70,68,144964,43085,101879,75,52,163194,35922,127272
6eaef5aa50b666d68b1852fc68119644,128,103,362839,112766,250073,148,103,319974,99470,220504
99990f4f0f35ea73b78692b3ca201301,161,115,370028,86196,283832,172,135,538852,99790,439062
ac01069226843620f999a2b847599789,84,64,115883,48203,67680,93,67,154519,45950,108569
05a245e5c73c4fc5c5e451dc9dc5445f,44,41,43650,13524,30126,37,29,32997,7112,25885
e3bbef1c884daa8eb8b64879d35fbcae,200,127,758644,90068,668576,182,143,562768,171240,391528
f0c6e3deaab4235815332e6d02414cdd,55,38,85257,25342,59915,56,55,79470,32424,47046
9e65e6c7c507a3621f8c304478ced49e,150,130,471593,125321,346272,162,123,422233,110892,311341
b16eef4ece080775d87817d3bf22522f,200,166,571726,116423,455303,132,107,459015,90756,368259
0981b009f343055d94852e1f5d3eddcb,26,21,8858,3128,5730,24,22,7986,3282,4704
40feae90103abeb9f5ab12f50cec97ee,68,53,105758,26650,79108,96,73,139600,39599,100001
a16836a44c3f3e83efeefe04bd773c7b,57,43,74499,19156,55343,65,51,81734,23514,58220
b662c4ebb0f3029fe99f0d0b476eb4be,63,48,82784,21357,61427,62,48,79049,24622,54427
2f055ec0fdc4fdaa82d038e2b0f13ba9,69,58,122262,26050,96212,73,59,88373,29549,58824
d1910d66353a7c764065c4566a086380,54,36,37949,13064,24885,41,33,37519,12423,25096
54e72f7d766b446ece74ac2d8b6ed791,64,50,132132,26933,105199,56,53,85332,48108,37224
b3cd18174ac3df63e053116cd8ad4899,125,96,351327,96219,255108,114,77,330104,85896,244208
03deaccdf4216bd7658f2c6109aaa250,83,62,132090,41841,90249,85,57,144235,29446,114789
1e6c2a8b39f837453f1b60e7e0031f31,33,27,29699,14910,14789,42,33,39756,14503,25253
59c1d770f040bcf51094ed211c7bbb8d,99,74,214712,52565,162147,85,58,171747,47020,124727
82bbd70a723265272ca401e18ec86ec0,41,32,44584,10642,33942,39,33,31238,11772,19466
02be24d34dccb05dc3b7fe6cd577af22,64,36,69888,20570,49318,43,42,47093,27675,19418
1ce5a95cd3418daee93ec4b57ef5526a,64,45,93874,25975,67899,83,62,99137,26670,72467
7ba71106da5f428e89b14ae1adedfe6a,114,79,221004,40509,180495,95,60,222096,39603,182493
88598bb3f120dd467a8992af69004ff1,186,150,466840,87446,379394,163,140,510674,73383,437291
746cb4b8c00a5924526994eaa239773c,188,112,433457,119011,314446,131,82,343388,85594,257794
8059536e7639da202e5b219eb10e0ae6,137,109,345804,93220,252584,173,135,414941,78996,335945
b18997acad6e4593ac3808508eb027d2,157,127,626709,133097,493612,131,90,954707,200665,754042
d89ef8d12317d0d3268fe7dbca7f445a,129,121,341505,91902,249603,120,87,235530,82883,152647
aa17dee2f39e5b3b77547bf74102176d,113,83,294786,96799,197987,157,107,434318,83048,351270
390dca968bd5d21940bff45f20773bb9,145,103,350639,92015,258624,163,104,304299,79861,224438
4e53bf9fc0e8160c4f1aa86ccc86c107,134,107,462785,99131,363654,174,126,524405,104453,419952
8316d05f2df46ee41bc2482e7557d0af,93,75,189402,54909,134493,102,91,208557,60822,147735
321cd38ed6adb7ccba477fd91d80d210,133,102,473019,93362,379657,167,136,500602,99916,400686
877915872a2577c4f5fa4f4bd8bbc7e3,71,56,87989,25845,62144,65,43,78296,26976,51320
5d89dcc4ad80070ee8e66acba5189052,126,101,286960,89883,197077,144,102,376003,57753,318250
7437ea7f2b599bb73c84f9266527c03a,27,18,33015,7259,25756,19,19,24309,8354,15955
63f763bd8f11bcbd2c778df78e0ac1c2,27,24,18930,10550,8380,26,26,17983,10725,7258
f6887f5087c9a9c509e8b382fce8313e,104,93,206539,59669,146870,108,89,191262,50684,140578
911511b4b485fcfd9aa364b4b645efb6,22,21,9579,4109,5470,26,13,9039,2071,6968
56d037df318d34284de337f62469a23c,29,21,20106,13160,6946,30,24,30180,9683,20497
d3b387d674ce3632a27be6896ef56a34,122,101,322218,66196,256022,121,89,252576,71447,181129
94a154f02409d7a05625c1043939b7ea,155,112,367975,112184,255791,152,112,408974,130915,278059
57295f245a65f39db8bf5cf8f55e73d6,35,30,27218,13622,13596,43,24,36312,8631,27681
674db55b92bcb9bf9583d11a5b00c679,5,2,1059,324,735,2,5,324,1059,-735
996f17fd2092ac8a2ca86ce83adaab36,119,87,196957,46639,150318,117,89,258443,57368,201075
b330c7ea9f33fed1e0a546b90ea92b51,32,20,14378,3585,10793,21,21,7444,5368,2076
e95e92399615a2ae0067defca7429ac2,74,44,98319,31630,66689,88,77,156641,36928,119713
eecce7df13033c0bb19896b68db31a33,114,105,212190,77704,134486,109,94,192209,76328,115881
b19d6f6b26a98776bdf700a088dab792,65,48,72184,17559,54625,83,60,89641,21031,68610
2650b2ea3676f94de753868e1b0e31df,9,4,1542,832,710,12,5,1572,762,810
41913f2b4730e2257704153ed9078556,93,81,182314,49041,133273,97,64,192939,50555,142384
22a17353022e25cb5c1744d1fc680006,23,17,8157,4619,3538,25,17,9757,3603,6154
937a53d4c5af450a6a1dcda09ac91411,47,32,45831,12533,33298,40,36,31698,17222,14476
ea03da5012c83542e3012cf9fe7d74ac,130,102,348006,81968,266038,114,89,271297,62085,209212
c317d87507e9bd3739d8b6d76d7a124c,48,34,26447,12432,14015,39,31,30608,9357,21251
a6117ed2db30972e57be731ace5f7cea,68,55,100372,19717,80655,67,45,83263,15523,67740
0ebac2aee538b6af02dddcb6f3b028c3,149,92,539097,133982,405115,169,110,698299,160603,537696
d8f99851c14d0bd18dad2fc4a89f67d9,68,60,89287,34126,55161,71,54,90120,30727,59393
86ddaad0f9cc9b4b5331c2a5c87763de,144,98,259823,57901,201922,129,100,204295,64716,139579
50c8908ebccfd9513e697ca94015d604,154,124,510172,135604,374568,140,98,511309,129403,381906
96d375c2b6216b1310c3b1f1360cdc42,65,59,89073,37615,51458,71,55,120699,35331,85368
e682c66ea76a161f65e73b4dbd132d31,74,68,87690,34727,52963,69,55,119268,30111,89157
b7a1c432174d085cc2d14f6868133807,78,48,108016,25053,82963,81,54,107502,27148,80354
c873df71677c4650f07815a1387dfc1b,106,76,209021,65077,143944,152,111,271703,63080,208623
da7930792ebd1e60d08a04aa68322d01,146,121,427037,140609,286428,137,117,385306,113612,271694
05972a44d12a53b3c313f1130d9695c8,152,133,376998,118890,258108,146,102,436701,87554,349147
ca6f362e97375012525073e49734b229,127,92,306507,89754,216753,106,86,320696,77208,243488
b0ce01f0728b754c1c3f354a56e48907,73,45,123268,35884,87384,68,48,123044,41427,81617
b530e02537c9b2844b83f4efd25462fa,108,82,205273,81768,123505,101,73,188902,51609,137293
054387fe8cbab5baa470516fb7f3b216,132,118,359283,96887,262396,112,82,242552,83087,159465
24a5058da00420c6cc88787b43d04283,184,132,516062,96660,419402,157,146,485345,106047,379298
bce27f219e71bf6fa74271f280ef5404,177,121,636252,110115,526137,164,124,533588,123194,410394
0944c845db2dd6c91bd86fd70a9753dc,123,104,247216,60336,186880,135,110,290488,55778,234710
96779fae05883f487a5161cbd4e4eb7e,89,59,120003,47069,72934,83,69,130368,44441,85927
98c5068fabf2f5f5216c463f04cd0594,29,25,17349,7760,9589,30,22,17252,4422,12830
890c0e42c3d71be9b0a666a30c58f79f,71,48,101065,31005,70060,88,64,126620,41389,85231
61ba70c6ff4ecf5656c6ec0d24cd9008,138,127,377245,88373,288872,142,96,355122,46237,308885
171b5c32f9e5f2f71c37a876bdde325f,135,116,301744,49907,251837,122,106,247610,80397,167213
3816ab16ab2d80d61ff52612922deb7e,53,41,68767,25110,43657,68,63,86350,25553,60797
72993887090c6da1a11c593b883f31a7,53,44,78596,13618,64978,60,50,72461,18885,53576
d375c46a6279e3109cdb6940d07efc54,153,116,609358,153636,455722,151,126,494120,158381,335739
011eac0fa246e979ffff01f80c3260a9,46,41,65404,23683,41721,48,38,61481,22725,38756
fcdc87cbb6cd9d398dd104b9b0fd860f,170,130,618041,68028,550013,152,121,488989,89507,399482
1963baa4653c8da80f0087efeb49ccd7,76,46,96158,52502,43656,102,74,167157,37798,129359
db96cb15036909e51947502e2f78bd87,128,100,353794,90513,263281,131,92,369761,122367,247394
8b0b7043ec3e4a080c3be403d23ac071,20,19,6821,5022,1799,23,19,9856,4342,5514
b2f1ceb0015405f21bdd675a77762fd8,119,96,226704,49990,176714,149,109,430712,61955,368757
ac704fb678515d8d952511e053f1136c,62,46,83685,23146,60539,73,59,104669,28095,76574
7f4caa5fa473592f834daaf38a40792e,160,120,451143,89391,361752,144,99,379388,69497,309891
f322f8f8e4e78a4c2298f63c8c2648b3,129,110,297248,73156,224092,124,101,296528,63412,233116
552b3f498e3651da6d760c8ca32a5435,176,137,697697,161841,535856,227,153,875260,152408,722852
d0ca4cb59f679610f3b95bd63aca2473,67,51,116280,25367,90913,97,91,152584,40166,112418
bd44bfb5fb1ba361be230146ee46abcf,44,37,74856,23921,50935,40,29,59236,24321,34915
0e8f74668ba169d138e81ee92f3519bd,206,134,2033562,255683,1777879,269,195,1121068,306058,815010
1f8fec423e7ea127e55eeb6e9d9cd671,32,28,20842,8102,12740,38,27,24153,7690,16463
757b57f927e3f55f6c0e7a121a44d3d8,99,88,238852,71328,167524,157,127,375129,53033,322096
e40c1362c9157de76707f9f7277bb145,67,57,121069,36143,84926,73,66,101887,36874,65013
1d29344956d13e2c4442904cc99d7a2a,165,111,442070,129084,312986,157,115,389361,115838,273523
f96bea849eba991d5c18c1e10b80de91,137,114,319056,44572,274484,118,93,215535,41403,174132
b404fc15eb250104bf63abcb542c4bea,110,90,276852,50605,226247,123,98,232938,58038,174900
a37ede43bf535fcbc105e73443527312,33,27,26491,10207,16284,40,27,31220,11565,19655
46c3bfddeb2722cb8435f56470def389,65,55,83802,33008,50794,63,51,100341,37880,62461
0291405d5e248c698d6e3f1aa27f8094,96,85,150096,37440,112656,81,61,136988,18554,118434
b1d73c58e276f1a6bf25cb76be79e8a1,18,12,1953,790,1163,12,16,1170,889,281
474cf6d01fcc38060e3cef3567a55922,49,32,38776,10777,27999,40,38,26665,12416,14249
f97462f0edf61fa39c73b423140eeb2c,81,59,129177,28512,100665,88,77,118547,30268,88279
dfb979a885fb0e57c9a8cc7c5aa1ff0a,22,26,18045,5141,12904,25,21,12914,5895,7019
ce8c626741c432f548f7da997597f4c5,112,84,189737,44476,145261,89,74,156869,44516,112353
3e3bd064c92ab0abe84280d15f47c3ca,115,94,241274,52897,188377,114,94,282017,70217,211800
636844d996763956c66b814d2c04e6da,176,140,660452,160582,499870,183,142,500588,138335,362253
d7ca0d6c80d154ca59cd5f35ae0cc43d,48,33,40319,19750,20569,77,42,80583,17687,62896
37d93bbde4e719cb8547d47e55cd5913,25,18,11302,4017,7285,22,21,11596,6747,4849
ef8bc468cb86cbea1e94bc9547bbf489,176,121,740899,98714,642185,199,181,801703,199909,601794
eed32d816ae133a69aac973627121fd2,7,9,1019,457,562,10,10,1802,476,1326
8ac69cc0195e6123c60280b7ff33b3ad,77,60,77301,36132,41169,79,71,119922,41019,78903
9393deda5348aadc14bda988e7973399,64,64,71346,33794,37552,68,51,96130,20484,75646
7597cab01e7a6f390ace8ba867a82b54,103,72,224262,83976,140286,136,104,291468,85199,206269
464c25e8d7834856b76873601c094bd9,90,74,238807,72798,166009,130,93,217723,46543,171180
e9c1a413288b2dc511e6271b39ea2c70,107,88,163031,41941,121090,108,83,172234,39902,132332
3f3070494dea34027dd57d3889ba5063,64,55,77074,26715,50359,73,48,115344,24531,90813
0de865b9d68e1b42683856b6eee1cb32,108,91,292041,89542,202499,132,114,387135,97210,289925
3f49096457548badd6f2adda383f3ff6,6,6,808,273,535,6,3,444,501,-57
a631feb45f5d3b8bd6d1f8c4c8ebdfc7,151,108,555695,98562,457133,156,94,432008,79602,352406
edddd770ba8d4ad6817a789ad81dbeec,9,6,1636,873,763,6,11,1157,1472,-315
a4d8aa3d8a0efa84f9ffae9c5380fcb2,159,100,474074,177754,296320,204,152,674740,92579,582161
34de7b254e9e4ac871df4557f12d937b,48,41,81549,23830,57719,62,53,83471,25287,58184
1afc33162f6868025b51e799f1a841ae,30,22,15469,6998,8471,28,20,12786,3997,8789
71c5714f42bf98f9ea799b48365fe449,21,18,12123,3951,8172,27,19,16918,4016,12902
c1ca0d5d4d675ad754bcf7a24024a156,131,81,426411,64480,361931,137,92,349751,88351,261400
fb3da96e8c25594a70259a8f9ce8ec09,73,54,106783,33607,73176,67,49,114646,35477,79169
05808381c32a4995eef27a11871a7e1b,48,33,58081,21332,36749,54,46,93137,27492,65645
996836adcae1729a330f7d29856b78e1,146,106,621036,187704,433332,217,143,665197,169116,496081
a94ab3dcd7a23db72173a7a1add492e2,41,33,52346,17720,34626,40,33,66139,22037,44102
289bedf76b7c9a36d3863bad5c016afd,55,39,81915,35371,46544,55,46,88853,29142,59711
56bfc4e938a5bc343ccc881e16a76b7b,137,94,252849,44620,208229,111,88,189271,71724,117547
af481d2ecd5e8f14ad91c1f236e52ff9,133,100,242966,46004,196962,83,58,162303,48064,114239
df4a4aec09b288923123848db2032d29,159,120,438672,84029,354643,132,102,268511,81223,187288
5966e1d4b6fd393c31d26a59cdb28d9c,109,88,312926,88493,224433,117,85,301268,95702,205566
ded3f4b23b61299bee1694cdbe681f44,151,118,486153,111874,374279,162,123,429869,84109,345760
5595cdcb42075abffb83e7f9d1a8ede7,59,44,70890,17384,53506,60,53,51867,20426,31441
3f4b234bc72edb15c6e5483da853ee71,163,104,586133,138276,447857,202,138,607726,95751,511975
b95b3a7c2456d9633e73fae1114f9f97,92,74,224654,92434,132220,91,71,221482,69704,151778
b36ca2fc640ab25a9ec0f4fd64853ae6,36,27,48905,18301,30604,30,30,35947,13795,22152
e4e4c608f9a18ef290b9866ae31bae1c,51,40,59243,25633,33610,47,46,68581,25883,42698
9ccef5a0b0af25920affd3a2a40752b7,35,30,23714,6872,16842,40,29,32974,6485,26489
35c71fcad6083307ff9d8da4c792fc91,20,15,3408,1629,1779,16,13,3748,1441,2307
a54fa45baae51e97515b01df96029b24,72,56,121923,51839,70084,100,74,147127,44790,102337
108668064c0c98a1553a2a75f5509430,36,30,59183,26382,32801,46,35,66605,28571,38034
9446b69bb7aa44f8cf1a89ec8b1bbdc3,151,110,473064,267953,205111,189,146,714064,146352,567712
1cd758c9a8a2e8a13f2f8be55a6dd0e2,127,107,222333,41515,180818,123,86,196049,46011,150038
095293302feedf390c3567830cfeb44f,103,70,177013,32398,144615,66,48,98994,37104,61890
55e8bb5e13038b036984d398c2cea655,48,34,70756,29610,41146,44,36,82200,24941,57259
717d114f6c084871c0d5a0aeb3179e8e,25,19,7951,5741,2210,23,19,10202,4198,6004
79fffbd5c8d560ebf3074c05564a7afc,79,75,146137,42476,103661,63,57,97075,40598,56477
e122bcf08a9d78470d9c0fc01d605cdc,46,30,39520,11930,27590,39,30,30680,10643,20037
ce81dd4ecdb128afaac5817389c5faa5,76,63,90503,25834,64669,57,50,66099,14234,51865
43eda2813313023c825a5e2ea8201f18,55,38,94470,29662,64808,54,47,93799,38585,55214
1355a55a6110c6498c2d7da2f79a13fd,124,88,222890,60067,162823,97,75,164552,44755,119797
c28aacf85f8de86017974392faca0db5,134,72,283878,59021,224857,90,71,199103,60001,139102
edf33e80d3e82e10c985f7594258a931,117,93,248127,47563,200564,105,80,164837,40103,124734
bc4621c98782e3005373fbfe84db772f,54,44,76306,28006,48300,73,55,87707,23930,63777
f4661b2f548d16cce589cc9023f7b776,106,89,196554,47232,149322,112,108,279014,58761,220253
9461d808725496907cc3df824d9f0e7f,128,88,257275,50044,207231,145,106,265228,45636,219592
2000aecd7bca1a8deb2ee83e8de4d6be,131,100,379313,68865,310448,152,135,438113,86104,352009
c8a77cda065c939269f0f8605d4d3f97,78,59,164460,51355,113105,88,75,194973,64538,130435
199495ff210d9ae65bd5a1c6bce690d0,73,56,128832,23590,105242,67,62,117907,29208,88699
613c8aaa5ae9b520745919fc3d3a779c,77,63,121002,29461,91541,36,39,57691,39307,18384
8ecfe83d34548e08d3684ac97a5d6c3e,161,134,552537,109746,442791,166,125,522195,100935,421260
22c87a82e3e2fb0c88589a8437a6b3a7,146,109,438178,93900,344278,134,98,345605,105800,239805
3e4bc9d5d906472e6f2b01ee25b648da,22,21,14138,5490,8648,22,16,12976,4980,7996
a34a589515675705860f741aa209cecf,161,114,741561,261259,480302,190,150,882226,203279,678947
b64fc2bbe658aa80c789a9b0b0b6b236,179,133,668895,116066,552829,148,118,618189,115678,502511
f1523000815b530c503b6341d483758a,131,83,202491,50572,151919,115,70,166583,87583,79000
c3a51e04e1ff0790bd9e2e66a64e7762,163,108,498421,107368,391053,187,124,758313,147838,610475
44d0e3930e3fc6f0e773d67aa351c4ce,29,21,11235,3702,7533,30,18,11965,4161,7804
d4645a2d4a1084be2d88d715efb2f5fd,69,49,72305,25987,46318,76,61,116260,27281,88979
1ec89176831fbf0f447a461acaa51bc2,5,5,440,291,149,7,3,816,188,628
702cf2567ab8b90c37d1963bcd2c4d45,41,34,42815,16411,26404,40,27,47189,11363,35826
8f2f8741bde38d363b4d28ea2eb8e6fa,82,69,233083,62427,170656,88,76,223073,82630,140443
68c6149ab8f3f8543f7a8d7d5f466432,67,53,120907,28250,92657,84,65,93912,43619,50293
eb7ca58e1027042f3272aa9325d56344,155,109,571077,98380,472697,184,142,512836,91827,421009
24b0cfbc5bf094742cc37f496f2d9682,150,109,635512,107324,528188,161,134,505951,119538,386413
c704f6223cbd739a4645087714b1916c,40,34,64093,15069,49024,63,54,73727,23561,50166
580e4366c3dad1cc883b0ae524b21a1a,172,111,437243,106994,330249,208,142,601837,87672,514165
89c2633451d10ab5de5455a67d601155,50,24,42973,11532,31441,56,42,57145,15276,41869
32a5cb6d1030c2563c2dea200e9cbab4,32,24,28372,16054,12318,33,25,36784,11843,24941
2ba89248401e8efae84b765c86184c7b,99,74,221847,86392,135455,171,121,381859,100685,281174
7433722e62807c27e82e08e3af771400,111,92,204851,59330,145521,119,83,233630,60049,173581
2f774fb65af6cb345fe77db2f2058c32,113,87,317000,165139,151861,115,85,422405,136319,286086
5641ac4f0b0e5fdc96d9546822781321,76,58,105544,40121,65423,97,74,130311,30940,99371
8f5ed7eaff0e7f11ebc9507952faab1b,46,49,74622,28410,46212,88,74,110019,33723,76296
7295f51a58ace91b54d9a5ab3dcd12e8,107,91,245457,62872,182585,122,93,252885,60768,192117
e48225b56ee618c7a31131b328c60f50,29,16,14053,2436,11617,24,15,8707,3224,5483
b3905ccce1719b21077b2186cf7e3108,81,75,207312,56540,150772,92,81,215867,56589,159278
c81058d6ab370f9baa57dddfa2c43cdd,118,90,210118,81324,128794,134,118,377367,100129,277238
514f49ae5b7db7a60cfd67ed4f6e996d,149,116,345928,78065,267863,153,125,319624,62413,257211
183983c40c5cb655534b920c22440446,38,34,38708,12374,26334,30,30,18000,13720,4280
1249cf8054ed94444c84257f88b345e4,65,59,85996,23035,62961,62,45,80617,19362,61255
2897cc0c62aede70ec43728fea12d279,150,109,387104,59831,327273,135,112,425343,63091,362252
7a86ba8ebed6ff48630e791f5f4d864a,71,60,72045,35687,36358,85,62,119220,28741,90479
97b46c4e1f163e348bffc9d64211903f,92,65,118492,41579,76913,75,61,104771,35004,69767
ee50013adaac8b859ddf7995c03b5739,7,0,431,0,431,4,4,275,264,11
8e8b8a78af63aeb3323019c401a7ffd6,120,93,221226,56655,164571,146,119,363634,50400,313234
7267a99bbaa0787527c274fcdbd573d6,137,113,365364,71951,293413,91,80,231183,87443,143740
b88608cdcc3f7bc3c8a2e3ba8dfa3e5f,180,131,563847,86464,477383,144,114,435497,102664,332833
4af38f99f590fc352f81ba867852d4f4,71,56,97435,41448,55987,81,45,114840,29742,85098
5a2961bf79f3bdd1b516484bb28fe6ac,83,65,196383,72638,123745,90,75,204274,69832,134442
1b57f7d93bf59ca6489079bf875c0491,16,11,2829,1971,858,11,11,2136,1893,243
c2bd57f099fe5e2f91ee234128948c1b,83,57,135952,27335,108617,93,56,147013,31483,115530
d338e8b8d81d04c35d44ecacb3e7c725,162,135,707846,178859,528987,134,94,453266,146422,306844
3756e7e9622a48079ff734137154ac09,50,40,84342,21840,62502,79,59,147126,28961,118165
9e5057992323e2176df55066e9c85829,173,104,548640,82775,465865,181,149,419601,113918,305683
584d67b000750f5f8503ed3d13a3a30d,13,13,2456,1349,1107,18,16,6558,1761,4797
1098509831df96bf66014f7558f6b2dc,70,56,89353,28374,60979,94,63,128817,20282,108535
351dc7ca7180b6eb2cf72c04e84f852c,170,123,519742,109305,410437,123,90,325417,104697,220720
fda47cfaf0d0576315e3b890dbf8a430,162,121,422432,126207,296225,119,75,303788,98550,205238
335ae5c2d6098336d5a072df017e1a56,114,86,191512,52561,138951,118,101,279349,63849,215500
3b6600536631ef9e8c888129053d9ed8,100,87,220072,63064,157008,137,109,276941,59149,217792
eea278e7675b72a763dad1648fc250de,31,19,19976,9634,10342,28,22,19456,10453,9003
8ba6b2c055443dc54c3d674a043afee5,186,137,527063,141743,385320,138,116,549395,135281,414114
b3ed5f38c4c37ee45a28f382952cfa34,181,160,788765,98774,689991,159,125,559023,98406,460617
1f0d514884c2999004958e60592aebe7,47,30,44022,12607,31415,50,46,60438,16012,44426
38d1dce21ca4af8466abffee2f3ef972,148,104,294519,69773,224746,149,124,309412,73389,236023
5c7dcb43c53518463d1de9e4e104cc76,91,82,152470,62234,90236,83,64,184009,42486,141523
709077e48e07c3051f034b5244852c8d,27,27,18004,6092,11912,29,24,10260,6422,3838
5c7b3f4dd79d250a2d7134e82f420d40,58,33,60993,18185,42808,58,43,63866,17396,46470
0866154578d670bd4d4f2eb9e03dbb17,94,63,123775,36292,87483,77,54,115366,33444,81922
7010e838bc9a357fbf2703464d15dc0a,37,26,31819,11437,20382,44,35,33294,13069,20225
57e5ba27ab9206f67f6d24d4119c0db7,144,115,443923,105006,338917,149,118,522276,74303,447973
8d7a92822cd3cc28dc8097c7d4a39078,145,116,340139,61469,278670,156,113,317677,47470,270207
6ec5974e00994b66b07450a5fec848a2,146,112,757166,203951,553215,195,108,749882,155373,594509
dfa53914feb23a9d8fc01e368c5d4e2e,47,40,86500,26376,60124,43,37,56945,19828,37117
de1665fb1bda1d14fec9363f383a8e7a,101,84,118718,48212,70506,96,76,172869,39071,133798
e454b9df953870da323ae1e23861cf7a,192,145,709540,147208,562332,161,115,606895,125009,481886
b83d1425a342ec1fcee9d37e92882846,72,64,91871,37836,54035,106,82,178168,33933,144235
e8af80c3f05f0554781630c1ad45318b,35,25,29967,7646,22321,34,19,24621,7471,17150
22a1a2df0e965e9f69b858eb8237ce0a,153,99,608304,122681,485623,200,145,935746,144822,790924
58ffd3bfca6c4ecb51bcc0aedd30014b,26,16,5256,3090,2166,21,19,8947,2352,6595
1381b13b3257033a740eae300d68754a,34,35,30249,11764,18485,37,29,25892,11534,14358
22d504d76b939af807325aedb90bd222,20,15,7554,2104,5450,26,18,9077,3565,5512
9c561e691f20f03e335850c6e0653d62,23,18,9161,2033,7128,18,17,4031,2604,1427
4bd1bf52fced2091cc01bffb97907f86,144,111,582258,100217,482041,163,112,812281,97739,714542
08b1fcee88c4fc4b42e65bd48b0ed495,118,101,327721,103728,223993,155,123,449995,95270,354725
49a8bb756ed232625be88237a2669473,95,60,112809,34565,78244,91,64,140447,30395,110052
e49618a8befc17157be339f1486b4994,111,85,197518,80937,116581,121,100,212774,68570,144204
6ab0748082d86932b731cb38d16c0a2e,91,81,158105,47254,110851,154,94,309227,30581,278646
de2a8df197cd42da159e15c505cdca56,219,139,987366,110539,876827,193,131,826040,134926,691114
67e09c78b3dc15d22c631289b5c6e1ec,79,66,308463,37615,270848,127,78,315312,32321,282991
0c4a29f3cb385224c28064aa24ca8165,121,89,378049,86548,291501,130,104,326575,83697,242878
726159d7f2a8a57ca577ff9479d10ccb,136,110,215594,60077,155517,110,88,181079,30638,150441
e8268dbe902bbefe487da1e36702add2,52,44,80402,24620,55782,45,41,71623,18040,53583
ca95f6e1fd6e6559efc21939cf9c2195,134,79,230537,46526,184011,85,62,145902,55665,90237
e0392805e01cad734ddea225247c2923,135,105,408616,104877,303739,148,115,411467,91375,320092
c1dc92988152032827609b699dcbe890,169,105,462429,69798,392631,136,98,392389,82454,309935
4d3689f25ca88764da145e7703607ca4,111,74,229056,63393,165663,146,101,287969,75344,212625
da959620f4f00156f50ae73f75f8a7e9,143,118,515721,110383,405338,146,114,436602,96171,340431
52d4df98cb5f5afbeb3bdcd2220168e8,63,54,89535,39242,50293,63,49,79421,28938,50483
007910cac755fd10c7b8ba851f88fb5b,150,104,479832,119283,360549,125,95,389782,105112,284670
d4c98d0450d6bdbd813317f4d0002694,22,13,7705,1252,6453,16,14,7965,2878,5087
2aef11f14d073fac2cef0a3eb5dd581c,157,109,461230,129777,331453,130,100,427289,128423,298866
d1e71f446dfb397bac657bf6bcf003a8,203,126,538879,100422,438457,194,134,636680,122156,514524
1ae6ced5738fdcf312049f13c90c4903,157,119,553053,88044,465009,174,134,569311,90440,478871
789e524e5936dd4ed5f86b8243ce284c,22,15,2807,1681,1126,15,10,2575,1159,1416
bd827a186a302c5d914540d1fd868ae2,68,59,94575,31486,63089,86,73,122099,26597,95502
0dd27f6bc7048ead4e8c0c34589e8e7b,185,113,568367,99363,469004,143,91,413679,124933,288746
5d0c4d4e28f355987079c8eb6f55a085,89,65,160478,43643,116835,99,69,175219,42160,133059
3703a434a90bf0a3722e7f67f13ad143,24,19,6267,3665,2602,29,16,12633,3150,9483
8e063426b69fb34fe5fa8b6240f5f598,126,104,347433,86891,260542,171,123,506100,76960,429140
33b45578235f574d91e145aed8efde3d,27,24,14056,4247,9809,32,18,19516,4797,14719
dc547cf27c8b892f0508f164de543e83,233,183,2904638,267588,2637050,244,156,1156905,247653,909252
d8dfd704beea6d9a996a50a3d23e85fa,58,38,74429,24715,49714,51,41,86912,26996,59916
fd9dc19b6506578602f9483999c57428,89,76,179391,65677,113714,94,65,188574,56463,132111
3cd756dd6bb1e16317a93d3dfe63bcd4,95,77,163556,27730,135826,98,68,186923,33620,153303
a8af2629150cbbb96bcc1eeb8454f206,63,59,73343,21572,51771,75,68,104221,24910,79311
7f14f967cff192017922027ad4125841,28,23,14284,6686,7598,40,32,27414,8472,18942
f430d007c21c683173f3b049c2a9fb4a,24,21,10299,5329,4970,23,25,8871,5643,3228
ef4c25213d64857676f31aa85aac0b1e,67,59,78512,34631,43881,71,68,103845,36130,67715
55ef3cd26f08d52c8b465b92f203db46,21,15,13128,4614,8514,17,13,11683,3701,7982
c0aa4b52ca8e21c6e5e47dbf09127249,94,84,228097,59734,168363,96,73,190581,54355,136226
195b4dcdd3e36249db3363923ed8b862,165,143,375791,79321,296470,99,92,229023,72487,156536
f3d4cee5d7569b972cd6acbf9f6049a7,41,32,45816,19170,26646,79,68,122069,19352,102717
99909a94b6ca91d92e8164f71f8bf905,20,16,11268,4777,6491,24,18,12033,4713,7320
66473790ab00f723c6cfb79beb853e76,42,30,55612,18936,36676,55,44,72372,19864,52508
de69cb829f46ea1ff0d629904b1501bf,61,49,80653,26490,54163,56,46,76503,26034,50469
84095233392571ce0c4e7b6341b826f3,115,88,238210,52018,186192,86,69,180901,46769,134132
b2c69d1dc36409c57c506a71457eb7a8,62,51,66637,13460,53177,37,30,38018,15460,22558
a207c064635d3cbdb5eb3eb4bf4b66d7,6,6,936,1877,-941,6,8,1877,1565,312
9e5b9e8b81450ab6beb5d71e4c0467b8,99,70,190911,32617,158294,99,67,132500,39635,92865
d9a89eac055dfbedbbffe6cc83997816,85,67,180848,58500,122348,103,94,234037,60596,173441
b2c51c5e7fc4dc01a8b5ec48aab03f98,124,90,390164,73124,317040,157,131,414907,85989,328918
1b3ea1f106ed509ca3bdfddec7b54670,86,72,118841,21756,97085,71,71,117714,28768,88946
06522ad724b50650ff6ecbb4378e8410,45,38,39359,13280,26079,38,29,44939,12126,32813
f109151161cbeeb53ce633aa3758d590,201,180,757126,185977,571149,174,109,528274,89539,438735
406162cc03d74f85218c20b0a2223afd,24,20,18105,6688,11417,37,31,26500,10860,15640
cc5b47c9599a5e60d52f70712db51afc,24,18,9567,5026,4541,26,20,10758,5264,5494
3470a7b89f88059c2f24bac6ab5b42cf,184,133,501294,104040,397254,167,120,622361,94303,528058
32c4ec31e12ae0c4f00ca86d16971456,94,80,166750,56711,110039,100,79,169902,37542,132360
c275a0cf22bb5622c48376e4301106d6,125,99,196806,71033,125773,153,109,301722,64362,237360
b4757b7243403acdec39a8b94e12e003,125,87,375097,74998,300099,140,123,438442,72981,365461
2b64b95780f338d7018289161618708a,32,25,47725,14685,33040,28,24,48142,13585,34557
9611636fb3d6b05127b2bd4bd3bb103c,140,119,509567,141855,367712,145,122,387570,84551,303019
63ea987dc93047e28416111468588392,72,55,113885,42168,71717,123,103,187256,43136,144120
01d908c66fc83c541ce00ffba5dab9eb,28,21,15108,5161,9947,34,27,17866,7410,10456
88e854215ff8871fa93e3131b45a2785,30,25,13842,7892,5950,32,25,20192,8363,11829
dd26c0680f7f51074c9a6fe29ead970f,53,34,73647,13793,59854,61,34,58311,17940,40371
126c5daefd30fec31106d1d78152cc03,36,27,12568,3943,8625,35,25,14321,4454,9867
b43d0d3a2e0c93d53888f3c6fd81a75d,24,15,7799,1979,5820,22,15,5539,1982,3557
667d0d125da25d9fcce9eced08ac08ba,37,22,33563,12395,21168,40,32,29343,12278,17065
30ef5d19ebd419142a877c4bf83da2c4,38,25,32807,11721,21086,35,28,24374,12951,11423
169e07b46009b12145091e953d165241,42,32,36609,12044,24565,44,30,47831,11796,36035
3bb74d852aaa4c3eb212a3069196ccf1,166,129,571675,133701,437974,160,142,614469,148277,466192
9c4aaed9baaadf14598e3df536a16104,102,90,364719,98018,266701,174,125,547971,100043,447928
1b7bd4fcd127194598ca69bb50d1925d,106,80,140871,44290,96581,84,63,191608,28609,162999
f60e188d323e8fade58617d8052a8b75,130,97,244385,61322,183063,170,122,439515,80780,358735
0eb1c86db03b6753614a351a23ec542c,110,86,258589,49303,209286,120,98,244774,50347,194427
154b76e1407d8b4c9fc7763974712a36,20,20,7260,8520,-1260,22,16,10962,4596,6366
c2936f7bd3981d78fdf056079d1b3610,152,126,338805,59695,279110,105,92,248303,54014,194289
c530842f11532a423e8c865ad2e10d11,21,18,5222,3309,1913,24,17,5793,2988,2805
543d5e41ab77feab0fa40cb1fbf2969c,49,45,61155,20141,41014,68,49,70873,21595,49278
98d08920ca137ad86ad9fb60e1b00a8d,176,139,693878,123072,570806,211,131,758534,104894,653640
95a8bd05a4ca28dd2ae80a51833e49e5,110,74,221183,35997,185186,106,82,158139,34143,123996
40302a4768bc932a3a2cae0e653a29da,108,95,173700,47524,126176,82,50,132016,26530,105486
2772122128203581635b75010447e7fb,146,89,490562,114320,376242,193,121,570374,183354,387020
adf86cfca147efb32f4de93545b17ae9,40,31,78518,19129,59389,48,27,57061,24549,32512
89ce22d3979791665ed0e9c79b020839,36,23,32224,9563,22661,44,34,50731,12912,37819
ccae4a3f503d9fd32f6f73cecb1a9700,46,38,51861,16688,35173,40,30,45751,14777,30974
c9129cf9465f4e8c36ef0c80c5e62bbf,84,58,133969,32979,100990,98,73,208109,36687,171422
0a2df7aedd85b39233002bf9606697f5,45,42,43077,17296,25781,59,49,55812,19568,36244
d530c6694dd703f28f671d9a391ca24a,67,49,107008,35864,71144,74,51,112244,39354,72890
70cc0ed2f3d66d58695d954fef5aeaca,76,66,148742,60462,88280,116,92,238964,43469,195495
9aa007e26709236f9cd3b2aa22a71eca,63,41,75942,16594,59348,58,50,85342,24554,60788
35bec231e0f2c24e16ab36fad8bf54ea,86,74,105936,40620,65316,57,38,106696,21133,85563
dcd2de3a6033b0e595bf974a70216660,57,46,81179,23085,58094,70,59,62359,27197,35162
eceb5d36131b75b7f55e9aead729b30b,213,150,733391,136111,597280,228,145,631665,138243,493422
3a43d853dda66cd0bbbeade228f42cbd,119,98,290114,50427,239687,78,65,152137,31144,120993
2fb22a09643aead377e9af0d3caf36a9,82,56,154005,39933,114072,81,53,108226,34038,74188
9080bdfe93a74e0f86fcc2a42b359b16,17,11,3778,818,2960,19,14,6047,1105,4942
a432c1af70f8490ec4a8dc633f2149de,135,99,293264,70757,222507,123,104,315791,76888,238903
9223dd80452c35af9aac80150470deb2,57,57,103490,26054,77436,55,41,71939,25805,46134
903eddc5c9facd9c17a6d1eb6fa329ef,55,51,86063,20935,65128,45,33,62743,13579,49164
5291c7af9643a54133717873df1e88b6,104,95,179730,54458,125272,101,84,182223,45043,137180
52662ece245cafccb8495d23af203f04,56,46,62663,19818,42845,71,56,101543,19532,82011
e85ca13ac9d4058b56731373b3d74950,67,54,77739,25033,52706,53,43,78464,20960,57504
6ae5e307ecd5afd1ee7320703cc5e6b4,138,107,500923,149559,351364,196,145,701741,120574,581167
c840a60ce72ff27a871479fc0b11f402,24,18,13647,3315,10332,31,23,10756,5681,5075
392a82989bde8dedd964e52fb7acc69b,62,42,89341,44914,44427,92,67,181116,35591,145525
9086efe4ce502591cd1d5f9330bc84ff,112,95,274243,44979,229264,125,84,294919,43703,251216
a1098e8981836396618293439700412b,36,31,23529,16041,7488,37,39,33194,17641,15553
fe04be27554c62847313315dfe1e383c,38,26,19412,12441,6971,45,32,37530,8510,29020
388a5592d4b59c1dd024e5bcf0e892b5,138,111,259251,67961,191290,97,73,165912,63843,102069
5f540533046a14f1b69fb48a0e86d687,142,114,442530,138234,304296,192,143,645563,147136,498427
3397af290509251657e1b6ebb8b11106,81,72,179071,57736,121335,121,95,232241,44545,187696
71bc588ba458618a4622a19a418674ab,176,131,648604,122072,526532,122,100,435461,135945,299516
a09cf836a04607ee0e421053bfefd1b3,30,26,11933,6027,5906,28,23,13025,5324,7701
36f32d444f8078648e40607d096a4b9e,120,103,311271,57549,253722,105,89,197485,70449,127036
2d80489afa1589fa19898c450cc50f47,158,122,754125,109183,644942,175,151,629750,196255,433495
decb2cab0eb1bc49683bc0326d44aeef,160,117,415892,107638,308254,144,106,445380,93440,351940
5f87d65e87cb57458058b46643701fe2,127,121,326369,90700,235669,113,88,244569,43537,201032
a098f4cddc7ce3d8ca0145a28fca44fd,41,25,36557,12361,24196,64,51,76213,13808,62405
6dd6d1e2c960386adb2b30285ce9adb0,25,17,6852,2211,4641,24,25,8502,3866,4636
57620cd71499b8a00a77e2858fe0c91b,44,33,32168,11927,20241,40,36,32727,11884,20843
b47a7f0d83d0a0cb24763e6c5e299327,125,109,292348,71924,220424,165,114,378430,51647,326783
7b4fdfa517b568f965f80a4f6aa0ae8a,59,44,80916,32335,48581,59,46,78768,35703,43065
be3ba16b5bfc7621920c7466a7cd7fad,146,124,352700,84838,267862,130,104,287147,62695,224452
c89a1dd9dcc83abf3d204604f58ed845,125,87,227763,38952,188811,127,99,242855,53765,189090
8db8b4ae31e60e50eb1c9afac304c35a,138,86,252971,67910,185061,93,66,204984,56878,148106
cb5afd56a3958f01410383b1f067c37b,78,63,107045,31927,75118,89,86,121032,40700,80332
0b088bafcf3da8d1fdbd0c973ae73510,7,8,819,1203,-384,8,7,1203,819,384
478e787c14f14066457ac9386f1e62d7,97,74,157278,53593,103685,78,57,96784,51884,44900
073fc3609f82e9df86aabcbb416c3de4,164,120,346714,72088,274626,141,107,408071,100132,307939
72055c6727e31de0a8434706a5f55da7,42,32,29637,9035,20602,43,32,31028,7735,23293
12e7266be9c8a7ebb5c45bdfeb6808a4,42,35,33030,14577,18453,42,35,39375,15655,23720
461a9a90e5273317b3848ad8616da4f0,70,51,92648,26095,66553,57,49,91184,20353,70831
3ab9bc98c840d909c31a34a09fdad5fa,133,112,332157,143633,188524,140,114,367463,130161,237302
e47f041afcc7fe03a46aa3f8225c05af,66,60,254294,122959,131335,151,121,472154,120055,352099
54a0d32a0688129f104a3a2176f7c4d5,160,135,562062,73754,488308,156,123,342307,106874,235433
a0325d817374c2421cf5ccc1a2fc50fa,116,86,241452,70346,171106,147,119,337959,72910,265049
0d099bb64b40496b30ae929c73ff8718,143,117,327073,69506,257567,143,88,293305,68493,224812
5a7a2d2c65b501b47b405b4ccc5fee17,97,77,153560,38355,115205,90,72,142348,38117,104231
b16b9932eb5277c09a19a8151f7c81bb,67,54,110161,66835,43326,156,113,363175,71471,291704
e1aaf0ca37b25f52a55b599608989524,155,125,551707,94226,457481,133,101,628009,95022,532987
a931575c042bdf7ba325fef762415cf7,35,33,43025,10775,32250,35,25,23225,12076,11149
e6baec81795e471e1d433ce5049aca5f,35,29,27309,9875,17434,41,35,29384,11730,17654
b8a2dd755a3445f1e3432d5258a3dd71,168,105,603473,108941,494532,198,116,768955,90139,678816
2659dc35bd462d3e41342e87770b774e,31,26,22062,11774,10288,36,27,22058,8637,13421
be335012f3c121a043ec44d538b5c4d6,8,11,1574,1032,542,16,10,2706,1224,1482
aa87ec4d72a1bc85bc40c125091dbd2c,145,102,369647,91547,278100,170,120,443912,102351,341561
49f9f9a8ea3fb4688ecd70899d374b90,75,49,128537,60545,67992,114,94,249916,55906,194010
62628ba437b20c2460652c9b536b0fbc,140,100,357170,126673,230497,112,103,292419,121594,170825
4c79de862323f60e00be160913f56d37,94,78,272675,106898,165777,113,101,343787,83195,260592
7d47d6dc126bc26721489bc96094a46d,163,131,696128,100278,595850,209,161,627255,85045,542210
13350bf5f0db8c4f8c36e60957be7100,80,58,106930,41921,65009,65,58,75658,42955,32703
71f3ddd5fb20b62252e03942d7571a12,51,41,73878,16191,57687,56,42,77109,15510,61599
15a850e56cab73278b636cd26889374a,35,26,27286,11046,16240,40,31,25987,12049,13938
8cbd4aaef7e8f2195bf3e8e203b992de,36,26,33313,11332,21981,30,23,29135,10747,18388
894e359f4c6152ce350a01284f5d2b05,34,25,25485,9979,15506,29,25,21779,11721,10058
eb2d019b6ab607b7a1ce3bc40be89eb8,19,14,4436,2202,2234,16,17,3524,2531,993
1dc1830b3a627c000429eb6412d2cee0,53,34,72751,19743,53008,42,31,43842,22452,21390
885bb698740727f525636ea611b050d2,59,53,108022,32139,75883,63,51,102305,22739,79566
499f270b4bd6133d46192da5fbb3ed2c,207,142,644232,161805,482427,165,125,702573,137302,565271
b5aeefafcefa1d02dd82f3b453c7d0a0,94,68,199192,76610,122582,137,119,311475,82382,229093
bd2dc8733f2faac2a5254f32728cb5f4,82,67,140926,35709,105217,95,66,131388,43282,88106
66de4459f73da338c1fbb389229b2447,6,6,1430,899,531,5,6,589,1430,-841
028988d2b1d72d8c63181bd386e8c13b,91,75,200022,56316,143706,95,81,245582,65355,180227
5715bc957d4b748a2965e65519e9bfbb,157,110,435502,84333,351169,168,138,508668,91398,417270
2301e41bcce06601fd6fcaad8208aae7,51,44,57735,34263,23472,64,57,88024,29868,58156
4bce67de17d50a5df7eb4e98aab81d27,133,106,347921,120524,227397,172,108,413691,69445,344246
976162feb0abd87fad179fc18dd59a52,70,52,159973,29375,130598,49,41,93341,31186,62155
af186b6d942999f74130250d913784bc,147,124,516749,98536,418213,153,124,527432,106006,421426
ce7f373128ca07aaf27abb680216a79f,74,49,97958,29355,68603,72,55,115307,22276,93031
e18ac8c7ce7ec3b36ce67db453451864,142,77,313481,50366,263115,123,87,261881,58344,203537
269c72aa7b067b798a54f222c8f69266,71,55,82940,25646,57294,51,36,74754,21729,53025
572e1dfc325dec6552957a99f6b03b10,234,149,743299,173911,569388,176,132,989602,134651,854951
1a51ebe8f4c2be8f85b823c8e545c499,58,53,113532,47461,66071,104,77,172048,49096,122952
838981024de0004c4718bf84b190fc88,22,19,7867,2834,5033,22,18,5447,3377,2070
cce881c958f04e7aaf46a327b46a0e82,30,18,17131,5133,11998,23,21,14677,5257,9420
9c9d993d36889fcec520d639caf7e2e4,3,5,950,1151,-201,5,4,1151,1115,36
32b63b01ec15963e2f021f17547becda,39,35,29838,17565,12273,51,36,53789,15454,38335
9489aadfdf9743884d5fb834a77b96e2,122,109,260380,57974,202406,133,122,394168,89636,304532
a844745478706334101f0301291e6092,118,108,285495,79542,205953,87,68,213357,77107,136250
91dca70c49513eb821a7886ca1055237,59,44,73041,19779,53262,59,43,56023,21264,34759
677a4f88c6d9ec89d57b7f82c5eea4b8,58,50,72381,27942,44439,80,59,106597,20372,86225
d6be04a5faca3e83dfc03495df962ffe,169,123,462326,110443,351883,164,104,362718,110947,251771
0d2029694fa47fd89b92414f7ab5efca,229,151,705645,119478,586167,184,154,754417,161458,592959
5f33ec6dd11666f3108a093b7dcab979,39,30,76283,20077,56206,34,28,44387,23077,21310
c8c09197df17ff907c72cc9001518b92,104,90,196560,52140,144420,107,82,164850,61396,103454
e9441fce7f6da2066c9cb5787ef21d25,43,32,39188,15567,23621,55,46,62411,14448,47963
7bb3cada3529ead0721e444baae4f7ce,103,75,216644,40180,176464,89,82,133456,41312,92144
aa4785af71e864253725062efe7a44c2,103,85,143289,42870,100419,104,83,179437,35704,143733
54ec5dc49853445fb2458b4564b09cf1,117,100,272187,50631,221556,105,97,188181,75140,113041
9ff23985d16f38f0fe8397688ca4350d,67,52,99896,32541,67355,70,63,136826,27983,108843
c83aaa2ae5f0a5033d2be2aa1ca5cace,88,65,235475,67181,168294,139,110,321810,79706,242104
a3ff32ec682221250a751e5206973945,142,115,256613,89189,167424,121,97,296065,94204,201861
ea2e4b76fc360b4699de0aa9f31dc7c8,49,46,70067,45903,24164,73,58,127497,32491,95006
45d331a9a71fb045350242cdb40c7595,87,69,148207,31894,116313,101,70,203837,44117,159720
27a7ffabb91fdb1f8fa49afea96604ad,84,66,148129,41466,106663,78,56,121613,40337,81276
a0f26f45b89c48675209932ee6b93d0d,52,43,61399,35119,26280,76,55,120266,31835,88431
d0da4a21a366f3417cc67f5353c7be4c,73,47,100893,19428,81465,46,39,64221,22805,41416
e1b0c9f0bb22691fc8d4d5c359cc8661,61,56,64944,20633,44311,50,39,69862,16446,53416
e1c6160155a1105584d6f5e23781e630,99,71,175619,49103,126516,108,64,233483,52027,181456
45d29c107a8041420359d3926cfd6d0e,42,35,63295,22100,41195,54,33,53100,17448,35652
dbf8b706e9aa4fb48486e41b0596ed42,149,117,438161,60542,377619,134,109,375301,62201,313100
02f77f99f4ae11b0d3d72b9a2e546e34,35,23,36231,8375,27856,37,27,30158,15006,15152
11e4a2264adda25ffdcdd8f06094f4bc,2,4,389,810,-421,4,5,810,501,309
41af80ffdbce795a8fe362dbed14dbd3,150,117,483447,97747,385700,156,120,488887,91428,397459
6fc7d8b2f466b5dbfdcde635655ba91d,67,48,159908,36833,123075,87,78,191085,58379,132706
7e2b7d4884170157c7d33dcdaf8bb5e5,209,141,753019,163443,589576,180,128,760476,195893,564583
24f8c530d8c191e29a808ca72c32ccbc,31,23,11696,5074,6622,30,28,11794,5937,5857
4ad27dbd35d94065fa07fb83773722ef,38,31,41005,18501,22504,58,46,94513,18996,75517
bceac50b4ee98192b36abce15f83d032,152,120,534720,124440,410280,187,154,771507,156201,615306
5dbd1acedeec3c752eb092448361909b,152,113,539788,85072,454716,159,116,448307,83101,365206
4f4703adf428a404ca4d8375088b7ce0,94,61,132436,28917,103519,70,62,86707,38317,48390
a44af650b1648d1d821782f391ed28c1,72,60,150261,52163,98098,116,79,254273,68315,185958
335de6e269ebbca49ba72b7f83d7a078,112,85,295207,72517,222690,161,124,497255,83446,413809
1ac1e979cecf0a70649f2f33d417c52f,91,84,125405,51949,73456,76,60,145118,28991,116127
54c87c2ee46f797476e2f872ae5b231b,103,79,216032,58585,157447,109,85,161998,40030,121968
f80f51e1831a397356220021c4cbe51e,93,66,150192,33268,116924,98,83,161884,38185,123699
34e0e5b52afbd1a3e35bd9445f9ed6d7,110,82,159039,48987,110052,83,73,181613,34744,146869
0800b411d18c7ae2c52bd38c39363042,31,32,27244,9307,17937,35,22,20416,5981,14435
0c08c13fe2570fa0672344f3f12f9430,46,43,69004,19751,49253,52,35,60964,23005,37959
2779578d9b3633a3c954ada84f3fac26,17,10,3002,1817,1185,14,11,2855,1815,1040
f9349ef90566242da5d56317ea99e9d3,60,48,65219,35392,29827,59,43,87092,28430,58662
62e50824cde5efcaeb3ead84fe314a82,66,54,102391,33995,68396,67,45,139145,32089,107056
fef3d045e47b032a3b78ec64b3992082,163,132,448805,91613,357192,162,117,445292,111349,333943
0fd18c82cc4863ee647b7bac40efd7a6,8,6,1509,1287,222,7,9,1515,1737,-222
ed751ba5fa5bef4d7604a87f85dcf48f,136,104,473051,83990,389061,134,103,430422,78170,352252
283beb9e47281b44a50b305bb9f57ae4,51,41,50216,13816,36400,61,43,94933,13104,81829
3e52b4b8101dbc601029d60c29938a2b,101,80,247248,67580,179668,161,126,371131,75632,295499
877ca715b6f4e67904ce6dee6c9721ee,55,40,68498,18879,49619,50,35,37591,14171,23420
61d18a9c9d238798afd478cb14438749,88,60,214747,45085,169662,71,62,151116,55915,95201
69ef2772d2e24e07bc4dd603a5889734,118,85,293852,84535,209317,155,103,335080,58498,276582
fb52cad39fe2f169b675170e2f2e10b7,123,90,230188,60489,169699,164,124,315421,71790,243631
4f798d335c5d7361bab670a1658e6146,110,94,243978,44204,199774,137,111,249745,33199,216546
c3c4734e6dbc973bcc6bfbfbaf8b3eda,116,96,209168,55220,153948,70,69,148307,39717,108590
02e120860d67dfeb25b6737f522ceb6b,142,102,260418,67127,193291,134,106,213206,74103,139103
89a0870d798d560703ff815ea64edef0,95,62,147053,45867,101186,73,60,106815,49612,57203
ece9001d74f6aa016908aadb09b82aa9,11,12,1506,1775,-269,12,11,2943,933,2010
db7ce12607ac5bf0d2ebe5e5790a16f8,70,42,74997,25366,49631,70,55,120742,25661,95081
ca7743f79fb5a645d9530ebfe36cf5c0,36,36,31991,7145,24846,33,25,15656,7197,8459
a201f8b25d9c21a61fe37f7053fd3161,138,115,579231,172694,406537,179,139,558122,145578,412544
0106b6b7d17c731e4117541613d736d4,88,72,187654,46773,140881,72,63,138084,53038,85046
8d47cc6c1e5ebe1c7b5d0f89748b56ad,122,104,282945,97474,185471,136,106,350684,76290,274394
1c18653a3abc33eeb5008e66b1967f9a,55,43,57460,24034,33426,51,46,77441,24955,52486
420b2939f9c1b64a3a0f11e0fd618b4e,45,35,57007,21330,35677,55,43,51749,19581,32168
ec6d5006815ab9c8c6a54e624262ff6f,39,33,31743,13871,17872,41,30,32791,14813,17978
1d75b131adbc923c6a3b43ca25d6e851,102,86,165219,55360,109859,110,86,187270,49844,137426
f5ace5033df4d8819b7f4e533acb053e,11,11,1718,2156,-438,15,17,5422,1620,3802
48f450d2c2f3075fa019612c03e478a5,37,29,32076,13594,18482,48,38,37085,13706,23379
4a15702decd9737e31497d27ab5d59be,113,80,258337,57142,201195,117,100,266066,58851,207215
bfd84c5f7a342f66cb61405b6747840e,49,36,65449,30107,35342,76,59,130353,33871,96482
d29d097787e1290ca036898a6db24405,52,42,72621,36381,36240,62,43,109034,31467,77567
a526c14a978ef1c84a45249166104f08,171,100,422289,70522,351767,141,114,385353,96360,288993
44a4bcefde06d7ec8794739182810334,37,21,28704,9261,19443,34,28,43141,8807,34334
994116d3df268d1c3f3c91f8a09529e0,41,36,42383,15007,27376,38,29,35046,15625,19421
fa1fbf6a112f9f93528aa5cb0a4e2449,165,104,434576,63249,371327,157,112,347604,98730,248874
97bf06ce8d379a80278bff3c9e7b3d25,231,150,1320739,260355,1060384,197,144,1416173,157365,1258808
d9653d8cf04d23dccce86f3afb8afe80,76,67,89754,33154,56600,62,42,83346,26412,56934
d711454696e0378afd09a3ddc19141b3,23,17,15500,2970,12530,25,16,8715,6075,2640
8236fdd1906891830c0f705d483790d6,25,19,12456,3493,8963,27,19,8984,4828,4156
c6b291f368bafcc9aededc6445d73345,83,73,131847,53519,78328,83,54,151512,34366,117146
944ab46092cd6c8b00df15f6fb7291b9,122,96,304347,80714,223633,149,111,343502,89147,254355
b10f4bfb127caef0e706857e86cb3343,27,14,16004,2887,13117,32,26,24937,4798,20139
85df6e12df77030d2661e51bfcbf9c17,100,76,184894,54568,130326,104,83,212600,49034,163566
edab79c400188a1f1b928a77b971de94,152,121,397471,85004,312467,132,108,368675,81899,286776
ff56181406bf81feca56181f640cfd50,97,80,158934,28734,130200,56,47,77144,34284,42860
c159cc378b62f19801c6159a9a4d8095,73,47,131585,47605,83980,93,77,207146,55206,151940
fc820b5ab979a7cb155c55be40a2b602,145,112,557775,139286,418489,206,166,770558,99892,670666
c879dec81767b8c37e61c4db8672412f,47,24,48473,8910,39563,34,28,21426,13299,8127
1b6ba091edc7eceaf1e5e4404063d8c0,55,45,62752,28490,34262,50,39,77218,20780,56438
eb71e11ac1861f7134978f87a98ec525,5,7,550,1248,-698,4,3,1118,406,712
63b4a2eb1345818b774c26ab591b7918,33,27,25481,7869,17612,35,29,24152,4801,19351
4aaa85ee08833159ffafcc7f3c209f6d,118,90,342603,62840,279763,134,111,304753,71040,233713
1407640096a5ea4da481df14f5c52b44,62,50,90302,27198,63104,47,34,48087,29908,18179
f3044c7f4bf7aec9f3f7f46740564afb,195,126,705447,76118,629329,196,140,571014,115750,455264
6ba7ae70c502153692a0fe0c195fac6a,68,51,113168,22734,90434,63,52,87298,31507,55791
7e693f43fa0fe0898aa9c7e666daf740,75,62,172009,45640,126369,65,46,106188,46273,59915
02caf7dc6b252f0aa90c5b2db5d58248,87,77,135571,40877,94694,121,86,217516,42689,174827
70c374d77388ec26dae55be7bcf98d2e,135,104,332648,57845,274803,128,102,283346,48384,234962
8b17f07ac274107836b02687d16dfbb0,121,100,150277,38093,112184,84,69,126394,30243,96151
9af2e6eb4587f3f88c8d6d77f9d77376,114,105,250619,71333,179286,157,114,345358,71174,274184
62cb06f80708616309c9d2150f3792ea,9,7,1254,573,681,8,6,1393,413,980
98b317970a36a6382d406906dfe2941f,161,121,670068,235246,434822,182,139,939119,184608,754511
e812ec816fca1b0e873aa88026bac3f9,37,25,37074,11192,25882,47,34,45050,11494,33556
701496b3ee8f8c08984c117edcb73089,131,94,378172,77039,301133,151,131,372360,93070,279290
870491fac8b96508ce208e561aa282a8,86,71,170684,47440,123244,110,85,208902,54126,154776
3dff16a491dbb35f9656fb95ad14696a,143,115,395887,78037,317850,117,102,361329,72701,288628
7f9f041ec1ab7beda455aec26d6adf64,54,42,64483,17245,47238,51,33,61935,17044,44891
6be19f1bae2a0ee1179deccd6ba20eb9,41,32,40719,9609,31110,39,32,25361,12556,12805
2a43d4599478bc98449739c14a3953e7,25,23,8253,4830,3423,38,32,27408,5416,21992
56a08efe7d8a782e6f3b3dc5e8aff465,42,32,39415,21854,17561,59,43,85943,13988,71955
ca6e6adb80e610252ac2316ff632b8cb,160,122,472856,152014,320842,157,125,608845,103887,504958
7368c05425669287ce0052cca49a6345,23,21,11174,5029,6145,32,25,18361,4518,13843
0c789b619ac3bd492bee109c07c255cc,85,73,110609,48059,62550,64,48,117839,37427,80412
35c0053002fb4456885ef7b187419121,28,24,12177,4381,7796,29,24,11135,6227,4908
cdaf5ab88519479cff2779a19e87b211,34,25,20091,13587,6504,45,29,38947,13503,25444
cc5cca3ef64bfc0527413368f2f210fc,109,88,229533,47513,182020,90,71,186047,32035,154012
8a70b7da557e06e08ec33facd184b57c,171,128,373185,65629,307556,110,90,206416,55718,150698
39ac29df18ddddc61e0233ec0594d8c0,184,99,656533,146346,510187,174,111,517402,123365,394037
5ab23e928cc224952691b2f2bbf82745,135,94,439757,102497,337260,175,154,580461,163539,416922
1eab3420f4e7968ab8a9e4840409ffda,173,132,575276,129563,445713,156,118,416212,107037,309175
f57841c1b2d9e76175f1a5f1a0fa76e4,44,33,33174,12577,20597,40,34,25420,12962,12458
9d019ee5f2f9fe11b8aeaf2a2d3ed9de,77,56,193660,44897,148763,112,77,220825,51887,168938
659e22d4336be4a50c9e7b4d560a9e9b,42,27,28343,9093,19250,34,32,19079,11116,7963
33eaeb8c71569f8bd47cd386faa37d92,81,68,126244,37026,89218,71,57,125724,46690,79034
046f39fd4428e8eaaa81223e0327be0d,31,22,23780,9040,14740,31,28,29544,9268,20276
5123cbd256691d049db905510e3b1acf,7,6,1172,1382,-210,8,8,1580,1324,256
fb4097e965e078aaa643c51b012354b2,147,123,348559,67092,281467,108,85,219240,52322,166918
617eec773773f937875f359a001f1f1a,107,82,202846,41011,161835,110,86,185858,35151,150707
a3e879fcc67f349a758ef71c85ea5098,135,101,482296,112418,369878,201,156,609716,122122,487594
f01bbff721c301d4f9a6021f4f14c104,14,13,3241,3541,-300,21,12,5180,2616,2564
32123f11c56ddf2879bbf48a0cee00f5,51,38,53986,16873,37113,48,44,48032,25410,22622
a92a845ba7c22d79de292e3d73f8dd19,31,29,64375,17975,46400,35,25,51596,18028,33568
556cb88e2219166c9115421a46d3d402,111,71,210846,68075,142771,86,75,181702,75515,106187
214d9211fc1e351ec9ab0a94dacf771f,112,85,191167,39704,151463,88,63,135785,37987,97798
0b3722e691d01c95942ab8febf79955f,23,18,10426,4720,5706,28,19,13212,4561,8651
12d977da7c22de21fb816edbfbe4c87e,21,19,5713,3241,2472,19,16,6127,1936,4191
de9c03df53f785a44fd66712481da784,109,89,293882,86169,207713,141,104,375379,46245,329134
f47a285b5918df6bd8829b39c9ebd1f1,41,30,39050,11220,27830,31,24,24163,9180,14983
9a675e324c6f9d5b6068abacfde08ea5,58,42,80778,23603,57175,80,64,121174,26544,94630
c8537183e7432a478a2628055738f735,57,40,57466,16012,41454,57,47,47488,20154,27334
2819bb5286ea6089fff9c7301063ace4,57,31,45600,18342,27258,57,44,58274,17352,40922
2f38330c469da09a1c43fe455b56f977,95,76,149595,45956,103639,59,47,96818,59443,37375
cd73bfb998139f50fb85fb562f83b913,81,60,132526,41663,90863,124,100,240225,40727,199498
d734bc9822be0c23cc7ad7f645195582,63,52,79145,25513,53632,96,88,199337,35012,164325
601f39e517ae928f3f291ede6ee60108,220,163,1002989,226138,776851,191,139,1137098,224183,912915
883068a7181007b39599a34489817bb9,28,21,15975,8498,7477,30,24,19712,7919,11793
04a06083218bbc64657eaaad7f6baf35,34,27,29506,14809,14697,52,33,55752,11164,44588
f401fa4797dcb0dae6e0c925aaba34e0,103,77,233246,67410,165836,111,96,277419,62807,214612
fefb4b4cd36143e80b71f72bdd9a1075,103,76,212322,83929,128393,95,74,209233,71027,138206
82baff4bf8a0a3aec10d49f084bde2bd,66,52,83357,21632,61725,60,46,80945,20542,60403
59b8def329a975ec5111f8e1e5aa4586,84,69,96130,34408,61722,78,69,107264,31645,75619
47b5149e211b93709534997b2dd4ccd5,92,62,157292,44139,113153,104,67,190884,55434,135450
ed7eb8898032bf76330bf5c52afcf800,162,140,468485,102587,365898,172,108,477927,70077,407850
b38d866f28ba17abab6b66ede83b19ea,54,44,107497,28546,78951,45,41,67149,22135,45014
0c52e2223f25a92d076d0cc35c16aa45,52,43,49087,18655,30432,37,35,32441,19259,13182
b200ff07f6fcc09e20e0fc3e918278b7,29,29,11038,5057,5981,26,21,11652,2712,8940
ed99f7ed46c685f775d4c2fe075d662c,174,134,566922,155776,411146,181,98,569082,101695,467387
7e4eec905af22113f81eaf9bbbbdb75c,117,100,462421,121430,340991,176,144,581335,152116,429219
a7e20cf6d5cdd90a2791ba5b583de88b,163,140,483161,137098,346063,146,106,489077,101908,387169
24bedaaaadaa9d2086cc7cd2099d103a,40,31,53323,25042,28281,44,32,59208,21787,37421
1df9edead8bb45de49304384e608fe81,24,19,5692,2560,3132,20,18,5637,3070,2567
ad5e77157999689030bcaeca63b4a6e4,28,22,12680,6457,6223,27,19,12942,5555,7387
5aed5cc8ff1e4291cd0c595b2b235d25,113,86,251307,67616,183691,96,67,185139,62463,122676
5dff80dc0f195950ab9b81804fffaad9,88,64,137141,49884,87257,129,79,210739,35038,175701
a82a74e03c5a555bd2f55ecda3028f19,66,45,69358,35186,34172,65,52,69351,29670,39681
c8c8017b8fbca064cb7d7da0a6603b96,129,106,396655,72098,324557,156,132,396554,126007,270547
2096ba8fc77b13100a7b0d8649c38ab3,52,39,74000,17632,56368,38,35,43118,12846,30272
4917dbd328b9d3f765074b10888fc56c,187,136,694802,155902,538900,173,152,758484,180509,577975
cac01c8ccf163c833dbb249ae55924ca,70,40,155654,42240,113414,48,37,138560,20986,117574
dcdf711efdb90c685b5c66c947614e5d,35,33,36779,14344,22435,47,38,56558,20838,35720
9b7dd230bbbc2febac47456b8f612ca0,130,86,337031,56043,280988,137,106,332060,74869,257191
ed00bad21af44d47ea69d3cd69263166,102,82,209925,61194,148731,104,77,195503,79857,115646
4c62bcb5f289a9877ef857aae2641371,124,109,476493,113675,362818,193,158,557878,115032,442846
1dbcd5323082d65ee349a15c1b29a276,25,18,9077,4876,4201,24,21,12555,4633,7922
d9fd03f3f23f3960bdca492cb892035b,52,33,54084,15355,38729,41,30,42457,15429,27028
80a79e194cca5eb27063ada7ea962821,120,93,341060,77815,263245,113,69,297481,83203,214278
e85ffcd682793c3d4b544b28e9b6917a,94,79,147134,44753,102381,89,86,166643,41025,125618
126b2f1a177f50cf92c5245a32dc6a89,26,20,7913,4137,3776,23,19,8078,5115,2963
39fceba7b261c186aee33c7f4de77176,5,3,302,248,54,6,2,384,44,340
429008c7ad14c4f5b48af29da479a503,66,52,102619,27705,74914,80,50,98620,32114,66506
70a87cda8092a83c41d46ab02e77126f,97,81,220481,53538,166943,134,101,307043,50244,256799
8c47fa1331fafa249d0b66f467bc914a,207,144,921348,146800,774548,219,135,730770,148370,582400
d2cce3b22a241fb0c6f4b637d3bb88f8,148,100,424271,78527,345744,166,86,420733,66984,353749
7d94f4e028eba5407f6d903a0d4e417b,103,82,178388,53215,125173,111,79,199387,46924,152463
8db16a2a3f6bda5586b14d46c37b0576,20,21,9516,3737,5779,25,20,7696,4240,3456
5ac10c0fd43e078cda17ca2d6208acbc,149,108,412592,58469,354123,130,114,345039,100230,244809
4246febf8095e98b5143798e667e5287,102,81,208238,50132,158106,134,94,271497,49820,221677
f69e7780e000b2e176efe3ba2e45ceb1,1,2,65,147,-82,2,1,147,65,82
00f5f699e1477c10dd5d70bab9e62e13,122,87,359741,78998,280743,110,95,305139,73091,232048
1611f7eec234981e917e088c2d645304,44,38,44849,13810,31039,41,41,24906,15895,9011
30cd3d7505560a91d98823c754911828,88,57,142978,41320,101658,69,59,109249,54452,54797
9417c77f72b5ff63af7bf1efa6b3a319,111,106,284296,59133,225163,113,95,206425,57725,148700
d8d9287044135004cf3b26e5b58e0dd2,215,170,975673,190357,785316,249,151,959285,294344,664941
bf608fefa9693a7beac92be2dc54047d,42,26,46128,13552,32576,32,25,31769,11675,20094
b9e44ee1a6ce0075c96b5d0140149bb2,41,33,41027,13248,27779,55,38,52702,18066,34636
e941da38b3757ce43c8c7fafe9f24d09,100,79,264894,98380,166514,118,98,289614,86195,203419
bd6605b90970ae641ec1d113fcdc17cc,136,117,282554,53683,228871,120,78,197653,40406,157247
1d38c69ab7ed9a16124d667bf1b8d4b4,132,106,337590,76430,261160,110,88,312841,80715,232126
6a5132aad95cb011ed1a192c99206712,126,114,272059,43271,228788,85,71,125016,39038,85978
5ecb9888670bd2328eff951020f69e8b,121,100,255209,75553,179656,104,88,260810,72999,187811
1fb388f5cb01e7e9df24f7a6bb37ef5c,35,36,23993,10878,13115,43,35,51756,10710,41046
76b2a91664a68a3b72e4429f820c54f6,160,126,429617,136055,293562,159,127,380730,105521,275209
40fedbe42dc3a87cd349f64b716575d9,51,29,96759,22239,74520,35,26,60809,27171,33638
17bb6e49651ac8b66bf792be77fe0b6c,49,38,84139,23320,60819,54,44,68246,27289,40957
e73e2c21af5ed8f5faeeb3014e908914,125,97,296149,76413,219736,131,99,492766,87372,405394
5246cbf541e827534bb083e471e4e72d,71,62,125549,56017,69532,94,72,174734,45183,129551
ba81215f72c6bc09e38059ee5190d35d,49,39,50664,26297,24367,61,44,90849,30018,60831
13726fc3f86e66efbf12bc50f9859de5,78,74,135863,54098,81765,101,88,180719,35439,145280
468d78c782bf1c8e7e678b6a89a7a2a9,94,60,100371,20774,79597,80,75,148262,28504,119758
eb7c8a1d096851480a4a364e5f4a242c,54,40,59442,19389,40053,58,43,64221,23210,41011
8a3e6d7bbf29c4fefcbd63834efc6ca9,86,73,120430,31039,89391,81,64,120744,43600,77144
0349b56f81d4b7bb3545382b944a5fb3,38,24,21487,9130,12357,44,37,29204,11344,17860
78b238252a7eb638ce7f78760f23f582,54,41,69471,29711,39760,54,40,68020,23325,44695
9efdb37f65034d49228d8b04561f3df8,87,81,163588,50651,112937,69,48,142084,33714,108370
39e95ecce4328b93573f0d90a9af3919,47,29,42534,20918,21616,76,49,89346,17977,71369
881c0e2f889c5140d7e08ecac8de176d,24,25,15416,7163,8253,24,21,12323,5686,6637
77f3f3cfe2b717e907615b9d42786a18,41,34,59740,26158,33582,35,30,79413,25502,53911
229365398a0d3d33abcc297a1ece8798,4,4,879,350,529,3,3,254,783,-529
a24c071606fecd95c1230babd0e49bc3,116,83,272946,50200,222746,156,117,307137,51887,255250
f43db294350d3151b99d28b5c565f52e,21,19,7861,3226,4635,22,18,11064,3978,7086
ab017684aa65628306e94e33a181b565,81,60,190276,45828,144448,66,61,129104,54231,74873
1a976135c88bb2c6ee7e5cf04fb4c99e,84,66,175126,45416,129710,84,62,162163,61440,100723
ef45ae18ef7ea99f06cce34d517774f2,29,21,16469,5189,11280,27,24,11561,7832,3729
862e583cd4bafc62832adc9dbf111c49,40,35,33413,11844,21569,40,32,31826,8448,23378
d9bc70525e94572d095fc9e2a8851de8,160,106,535671,63038,472633,152,126,616520,82849,533671
b959515b3d123a110e565e80028612d1,132,101,243385,43507,199878,82,59,194452,51944,142508
1fc6d6deef0718d4bee67611aa2c45ef,63,48,72622,15614,57008,52,46,54800,16426,38374
e7cfd0f12ed28dff79e6eee45165176f,24,15,6091,1648,4443,26,14,7205,1718,5487
abdf0d38e6f064127b4ce32d3ba88283,41,40,52901,21151,31750,74,61,94044,27835,66209
e13e7725a1b032d81f2a64489b00c011,71,58,80172,30155,50017,69,68,110620,22339,88281
b7536a371c949f69cd821b5a278d5709,20,21,7943,2582,5361,20,15,8285,2199,6086
bcc00b57fcb84ddfc9cdb2c02cc29464,46,36,57208,18869,38339,51,38,67885,17133,50752
4ab448e0686fb79401892fb8e7a6dc6e,146,126,574895,98696,476199,146,110,519667,104607,415060
fbabc9ae06a380f105c245b3db1f38c5,96,81,131903,47973,83930,112,82,192295,41018,151277
c053740c449ee2497b37f514c08e7d01,163,146,403963,80716,323247,163,124,478703,59677,419026
628cbf05a75d67078ea0575e1c53eb5e,54,41,73684,30897,42787,71,44,104091,29252,74839
6ee1b5a7130d69013f8e1d90981d7b7a,160,106,507896,82486,425410,187,123,446040,88881,357159
aca9b84c71dad4936b7cce2bab8b1202,113,71,233646,38962,194684,94,81,166421,53996,112425
26bfa61ed733427976241d9fcc3c9efa,96,77,138092,28894,109198,68,59,94123,25802,68321
94620f34382cbafd76da112921117f8d,35,26,16848,7107,9741,26,22,13111,7337,5774
60200614eb82c4c15856e96ce5be0eda,134,107,332747,79281,253466,136,107,319498,63488,256010
2b021ee94e91b6c363dad0717f5d130b,46,34,42378,21934,20444,43,24,45774,13567,32207
1001b302c315042750fed4d73a154f63,72,57,104570,34341,70229,69,58,103727,35851,67876
8595ee72bb1eef4fc52472015f73942b,69,54,140388,39075,101313,84,60,131209,27051,104158
2294bbd5352fa1f8e153a5248df383d7,43,33,60360,17393,42967,55,46,47273,21410,25863
fc60d59df054782b88e030a2c6b75186,197,151,660472,154343,506129,195,112,618406,165824,452582
9d02397101a569ca5a772a63be916698,69,69,86018,27010,59008,52,38,40338,21759,18579
be7fb502eea78d7a1503d81b5814c584,176,110,535668,119451,416217,178,107,542175,98410,443765
b2bfc7b4cbb84bb24874a559c1ec14e1,5,5,686,699,-13,9,2,1425,456,969
eaff07421b515cdaaa500cc138138446,209,118,505423,121465,383958,133,89,393703,140449,253254
f1f924832e6c4a2934aff330a0eeec31,202,129,639672,153910,485762,180,136,748894,143396,605498
9cd430c792520770b15841ad24ee6acd,4,3,929,988,-59,3,4,988,929,59
08eab48f57d89825b1b8bc18f5c84c65,23,18,7634,5034,2600,25,20,8447,4376,4071
cb4d3d9a904205c2a25a51960fd2d8c6,64,48,82903,26202,56701,49,44,53342,32309,21033
5b64d22c837bcfb95ec59e98acee39ba,170,117,425924,69098,356826,162,125,410150,86560,323590
df9e9edfb38801ac05c432f21a619893,37,34,40790,18181,22609,43,28,51625,15592,36033
53ed89911b5c37fd5a147897b6a2073d,92,63,129958,25635,104323,87,62,123411,44820,78591
1927ca814157099d695fbf4cf839353b,94,60,148308,35015,113293,60,50,100254,30322,69932
b64b19cb91f105cc0c36c567282ffacd,65,53,87770,25136,62634,72,67,112297,29328,82969
13bf710d750ae9895d16a27472525abe,82,67,157069,38197,118872,108,93,243838,46562,197276
0887b0c4fbbf5617bd1685abba408660,135,104,483981,96866,387115,102,81,376845,107047,269798
0d753584826ecc3da8679a3d0295ef65,56,42,78279,23982,54297,48,35,72212,18009,54203
041bc419df0e524f64ecddfc91e91c7c,158,101,397488,76433,321055,137,111,460657,77865,382792
456fcbeb39bc73025da2b69d05e582b3,92,82,181201,41739,139462,92,70,141825,30249,111576
7612a2557d598fa22697c2b241e77bcf,55,45,91185,36931,54254,81,56,115482,38546,76936
8dafca2cc53dfe03853c2b1a31609098,112,70,371141,92565,278576,155,109,317645,90472,227173
1eec91d301ac8b0fd6fe8050641df457,23,12,6175,1263,4912,16,12,3898,1786,2112
98a0f76aa044640b7f1235bad5042f11,153,117,421234,86302,334932,126,96,281725,57681,224044
e01fd68cb87f5cd453b16a0e94e7b635,78,51,138341,42789,95552,83,70,106786,36322,70464
259a22a9b6a7cf37bcbb3831e4f4eacb,140,115,394843,70325,324518,135,110,411529,70573,340956
d8bdc27f6086d8bc446f0e696b75aafb,97,73,181771,39324,142447,116,86,198950,43640,155310
5395c358dee378364a2c192dad34baab,142,99,303951,78601,225350,128,107,391571,76776,314795
e75d7f3a05f493a750fff8f2711dac8c,23,23,11058,5320,5738,25,18,12845,4592,8253
a066ef9d73cdf0659d56db7795fc7b11,5,5,711,908,-197,5,5,908,711,197
b830c6fc905eb0a672cb22dd1cff5131,106,73,157984,35503,122481,100,79,186527,34277,152250
1c7b67b038c25e57b235cf9a3b601f4b,13,8,1556,690,866,12,8,1277,1184,93
afcd295ec849f57a0b6701090d9c284e,111,77,190675,35248,155427,102,71,209056,46999,162057
cd4c7a5027cdf839caf3ad8fc9a78962,37,33,33163,15805,17358,40,32,46430,20549,25881
96681eba954cfdab66a45adf1e477d58,37,28,14331,7898,6433,26,24,11960,5874,6086
de00a38904661a99915b8353bffe05ee,69,54,87367,37725,49642,60,46,92202,27403,64799
9409f488442286fc15a294894068dfb5,66,61,80697,18638,62059,57,46,58998,19904,39094
453509f51ba46209386ea1589fc823d5,68,50,116447,39566,76881,91,72,207388,34428,172960
b066a910915587f55c89946f1ba6fa59,88,69,175299,39894,135405,95,71,203937,53089,150848
b55f94d42d90b17fff7faf274e00783f,32,28,47416,16410,31006,40,32,41313,14117,27196
1d3f486cf21be49b3545a5f9cb34cd62,127,85,441762,73208,368554,176,135,500669,129485,371184
8a2971a1938900d4c1f98eb0f5bdece5,190,142,891705,129764,761941,186,160,756356,176949,579407
0c0840b6ddcb67a9d4b25362616fd71c,163,136,540808,140458,400350,158,135,486413,117211,369202
6125a6a9db6818a2e176eb0ea9ca75a0,53,39,25366,15688,9678,40,32,37013,10358,26655
012e511970c728bce9420b8aba6bf1e8,94,70,159496,30889,128607,77,64,126122,29028,97094
b60fa1688d2e8c24a9ee1a08563099ba,111,81,181923,61054,120869,119,104,231124,51380,179744
90742bb80baa53bc2f0dbf9f253afb7f,237,154,1062340,147902,914438,176,120,720457,187608,532849
22af684aa5a48613113297b4535d880f,135,119,294536,82653,211883,111,83,278985,67379,211606
1b10cebd09214d18f3ca5bf79256b3a3,20,20,8261,2002,6259,17,12,5107,2166,2941
17771fcf26ee047dd59268fc31694cf1,27,21,11480,5742,5738,27,20,8964,4456,4508
00e9b5bafc99c2ea02577e40857a8d88,40,28,20498,11992,8506,32,35,25656,9963,15693
616bcade6608df71d5e7562e6374ac0a,104,92,244796,64692,180104,93,76,184571,70855,113716
6ca479a2c1b913bcfcbc46c09143ba48,36,29,25170,7671,17499,30,27,19886,9271,10615
6362d83565acecd46fdfa8a9fb65bd50,115,86,275430,83484,191946,105,65,206122,61831,144291
01dc60d48c8b5f2c53d08a043f1bee77,155,103,276759,62744,214015,93,66,188484,62105,126379
6ca9cdb405d525c39d32d2b18523f457,43,30,49983,16107,33876,56,41,72681,21742,50939
2624f4186f12f1a522c70ee0e85b3a6c,32,27,21718,7829,13889,28,26,26060,9796,16264
431d9aa7708d9485b87db9cfadb2a0fc,56,36,75821,14076,61745,52,40,63941,16276,47665
0c564654b1c343f77bef85e598bd4a4e,121,87,296769,62085,234684,128,118,381711,71665,310046
2bf49f9ec44bef40d9a7c094ef5ab02e,100,71,273739,59077,214662,114,89,272319,70602,201717
1f454808e45a59d4a9dced60077ae749,1,0,96,0,96,1,2,51,105,-54
1f117b8a6820664f82660e6e5935a299,5,4,1026,543,483,3,4,311,794,-483
6d955b9b0348902212e38e84bdb9bb57,160,115,319764,52608,267156,92,68,169781,54177,115604
9faac3f4d340dba32b4986a720513c07,96,70,201947,49985,151962,113,85,210399,57966,152433
a70045d046216d682a061a2e94da4695,22,20,9438,5048,4390,28,19,12407,4677,7730
b6e79124eee5698c187e7664f5613869,46,42,38050,15801,22249,41,34,42153,11730,30423
e67557f032518df1aaca17a6a80aaf09,73,64,100204,29273,70931,86,57,112469,29739,82730
1e4ba857eb090b5d54cbd78a4329e42a,20,18,10704,5579,5125,31,22,16442,6666,9776
12bd457b0efa8de46b7d580feabdbd6b,42,34,26588,10366,16222,53,45,43995,11690,32305
3b3ea2e96283109a036c9085dd170ca5,114,92,314699,115932,198767,139,94,398758,77839,320919
deda71a2cb872774659bbb44dc0adfa7,35,23,31674,8955,22719,29,24,29347,9909,19438
42842ec70107082bd2d51c237531f3c4,86,62,151498,42643,108855,107,78,164486,40465,124021
d518067d646b2cc9a0a23e51777fd684,94,80,171189,48567,122622,86,65,176463,33892,142571
7340660420beb049e374c1c9feef9f38,53,39,65744,18457,47287,42,33,53675,20055,33620
45d134682e8595c6a9111ef84511fd8a,133,112,322802,65643,257159,138,108,319523,73239,246284
26c222f7dd3651494c6b0d000a3ac81d,44,28,39020,9790,29230,47,34,27451,15909,11542
39da225602a9bf52e8fdc059ea05aab5,62,47,108013,34193,73820,72,66,108834,46320,62514
812ba3e27f80cbc417a2ad06d65a475c,115,86,309825,60962,248863,100,92,262863,85006,177857
a2291e4a64a4795a5eb0afa12609a142,43,28,33850,9057,24793,33,24,25386,10747,14639
98d19d692731a8d521a6ae83666e3e8e,181,119,394034,96693,297341,144,111,327116,84833,242283
424c7e531c8d75dd5101a7ee80b66e4e,179,121,459462,99393,360069,113,88,288039,120726,167313
6822068a1338007aee1364de4c3953a7,84,61,128942,31111,97831,79,53,110768,33999,76769
fe3f13a6fd39feb5baa9a520b6f527e0,78,57,97596,32537,65059,75,74,121464,27777,93687
a0b884f06594fda07c4fa9a88fe59c77,97,78,184610,48174,136436,103,88,195236,43689,151547
b56442b25cd68675a18e8b877110d5e6,147,120,408436,92338,316098,194,144,576854,105306,471548
3a4661b4faae45826363cea1abec8e91,51,40,57977,30642,27335,76,52,138382,29531,108851
fc9b1c88d38d4c5b779e844413b3d618,168,126,380632,57638,322994,140,99,353661,54140,299521
0d9a1a334474536b46cf45526b7f6f83,56,34,59430,18424,41006,49,32,46946,21454,25492
b1fa5aba139c1308b0801e7177888fa9,81,62,97282,29027,68255,62,48,101839,21419,80420
7f38cc9daded0aac09ca974a0294a495,168,114,702180,170191,531989,145,133,674591,161518,513073
0c66454020296757be061881e721c741,52,44,72443,22045,50398,59,38,61510,20435,41075
5b9dedd77e42303341d36f647e2db9a4,65,56,94203,24249,69954,49,41,65999,22610,43389
4f066449315b3dd51f367535b7086ede,160,130,477410,77667,399743,165,107,414855,82734,332121
b6e2c29c88cc6cbff8723a5b34ff435a,21,18,10627,4685,5942,31,21,11517,5864,5653
e3d77b69714a8055dff62fc5cdde9696,26,22,21930,9158,12772,25,22,17255,8375,8880
25cd07555ba4fe8d6d9577a2f3026129,141,102,422890,95901,326989,196,162,602518,139464,463054
627993d21352a30f300710897bc07c5b,36,21,30130,7899,22231,46,27,57077,8100,48977
2f6a7737e60d3bdf9d316805af89c10d,108,75,257427,85279,172148,121,94,270299,98779,171520
3656227454f80152264535bc190a6af4,61,52,88213,32863,55350,94,64,154683,29419,125264
35aa1ec036584e2c8d25ec72bf89207b,47,35,71961,18936,53025,51,45,61083,20919,40164
bdee299a677a4e84313688ff6814a976,87,75,145056,38319,106737,93,80,127191,55150,72041
8cad12b10993b2876ccd94284e2749a1,36,29,22716,12939,9777,39,26,32278,11253,21025
c8e16f5e8f1aab29d35db2874c233e5d,102,68,195178,39646,155532,73,60,97367,65489,31878
938dec2aea245bade34646521b90c7d1,87,63,150269,26319,123950,79,54,86664,22989,63675
a51e2e20b45c2c1c17ad64efe533102b,83,79,143836,54989,88847,63,54,126125,55640,70485
fc253cab3101770e4b53650237d4655f,48,43,41241,9956,31285,37,32,24603,10170,14433
f24ad14d3c818b206f7baac0f024b56a,35,27,31514,14560,16954,42,27,33406,17085,16321
5b55f7cbd9ce256cc40873cd38378fde,38,25,28378,8703,19675,30,24,21736,8815,12921
afc7adf2bfb1574ecd4f437287f86cde,10,10,1426,894,532,10,13,1721,1035,686
7be941e8f5e795629a1745b3d0930624,57,52,79054,18780,60274,47,37,41349,14869,26480
42c0b5bc53909ceda0ee3232fa635f74,80,63,132431,32270,100161,92,79,138387,49304,89083
76e8cb1177e5544d90a2ced7eeb663c8,70,54,97496,31846,65650,66,57,126101,28583,97518
2c260a66c13d3d127be6a68d3823551b,45,36,62660,21927,40733,44,40,45835,24957,20878
5c876d9654ce6faddca6f83767b8060f,76,52,118896,21192,97704,70,65,83752,27164,56588
afab13c3b7638dd2c625dd12866ce41b,138,114,292257,61354,230903,84,65,169537,45534,124003
21d9b51d42e3822dfb06c5f1dd0b8ca8,36,24,18378,15317,3061,35,25,43626,8391,35235
c1f40ded777be7850258e8c37c6a0076,130,105,265606,64246,201360,122,96,259189,64651,194538
b74ce19eacafcf332eb1e3f8797aa238,113,85,237096,62502,174594,104,86,229696,54869,174827
5f3f328af53a5aa94ecae7071c63d354,104,81,158449,49668,108781,108,72,192067,30601,161466
e3889f5b86c05d0a63926311278c8565,106,76,200527,39512,161015,108,98,199289,58002,141287
8110c875581caf2bff20ea2f1d8f3640,72,60,127360,46717,80643,81,76,128885,49693,79192
0836e9e7d8fac3dafcfb6a821c6b4dfc,56,51,75016,22680,52336,57,46,62103,20983,41120
023cebefa0e4df372cc916cd7f873979,93,81,150166,33225,116941,91,68,131994,27418,104576
7f86abf7968a0f899ffe88e46261ff2b,78,59,122963,50211,72752,89,73,155902,47859,108043
a53cd724f3c7f1df0430dae23c25e56a,188,133,407001,144486,262515,134,101,346719,66423,280296
e16bf9428b5c6119aee99c0cc774a2e1,134,107,507672,80875,426797,156,135,447519,83991,363528
f31add2d5247a19862f2f4e11ef10241,17,12,6474,1181,5293,12,14,3609,2920,689
9796a7f80cadf858364649bfbb19a8f8,155,128,457786,155025,302761,167,122,566037,104055,461982
1e09217a462b48c7037ffc74a8c0cc61,84,72,170627,32724,137903,111,96,198459,46796,151663
245278d671869c6544dbd454b178574a,129,98,367228,80889,286339,156,90,370302,89001,281301
191d27affb9eba2ec191f2d13fa96b3d,181,133,564216,120164,444052,160,126,457910,151245,306665
3960b3568c8a266199e0b2f11ba71272,184,129,770552,180777,589775,187,119,627139,157631,469508
45e4f72c3a4339be3fc5db1472887c56,129,88,213311,40816,172495,128,103,241315,58018,183297
9dd5086277133ac249ab62ebc4252a93,65,58,97821,32367,65454,43,32,54433,18298,36135
b19ea7be99b9f7cdfb9ec1e9abe95bc9,110,93,276651,59094,217557,111,89,280833,72636,208197
e405efd0cb5ea7cc5493ff3199394c56,48,45,55927,17578,38349,61,53,78109,21118,56991
0ae51b9676b5eb56e7cb31203791866c,145,96,275937,68934,207003,136,121,266424,85353,181071
a5e9940cfe36ef18e7a59f8083f22faf,62,45,65439,26760,38679,70,57,89768,27672,62096
2cc989edfe75b743afddfa62ae7109a8,75,58,140012,43063,96949,91,69,165668,41817,123851
8c11a48786972f6045095fcfb002dfb2,51,45,77429,16984,60445,60,55,84718,28731,55987
4c0fbde0faee1ae9c0228d2c318281ba,53,45,55322,18161,37161,77,68,83906,23418,60488
b99ea499488b4a8957c4e959f48ec9bb,80,62,109496,29981,79515,57,39,52262,30041,22221
b98d3c88b7381149c25edd84305b3d0b,47,36,43263,13756,29507,38,35,41682,13407,28275
419f63615c5aa9c3329eaea432a33f50,54,37,63068,13603,49465,38,30,28771,15061,13710
2406f4f773bde328a99b94c23bcb58d8,117,90,258007,110215,147792,94,76,333247,84925,248322
2d557a1a02ffa6c357d252b93d637613,83,65,117130,28964,88166,85,69,141008,49065,91943
b3701a1717f9f7a6dde7ff737f5f0ff4,191,123,534595,96465,438130,175,142,619414,101635,517779
890eef50f60383f2b8c98cacde343cb1,146,110,318575,59986,258589,106,94,234456,66732,167724
b629033fc3c0f2841bb68270e01d6d05,117,89,197790,60718,137072,96,59,175474,51254,124220
593d2cf9b850d92cc7dd950a1632ee79,42,37,34765,14844,19921,45,39,34213,13225,20988
546bd18bf7c3b7ec39f2030f251cb201,13,16,4473,1766,2707,14,12,3823,2283,1540
83dc6f92d26b60524f6aea1c751be8f4,108,92,264813,116189,148624,173,149,525743,96537,429206
0582860d8ccb2f22fd9744b2373caae3,32,23,21204,7691,13513,30,21,23446,7195,16251
7a137ae8ad4fd80b5dfd19000e6b67f1,42,32,32043,11683,20360,33,33,29045,15863,13182
fab28b19de7c4df4974de9cd5114c578,60,53,77076,36430,40646,74,66,112347,35788,76559
5f2d0fe35c7dca8819b983ef5e73db11,50,43,64378,28170,36208,68,65,86207,33393,52814
679e11faa6b7906e96bc2a7375f19d04,135,105,307804,68402,239402,115,93,199441,68175,131266
b56f26879849a6f21e0485fa8c3eed2e,95,80,224293,70087,154206,125,95,327943,55108,272835
32f147b1ef3aac0f8becf5bb4b8ed655,194,149,771026,199810,571216,199,144,770814,153190,617624
537c228c00e0c9625a39e7b60a59e9fd,120,90,271414,65007,206407,144,110,279470,71060,208410
7ad5a934c50e494f046a549490c6fb4b,166,124,592359,193583,398776,188,129,610348,123015,487333
3ae7e439cfe46cb00e5239fbc065b8c8,68,46,128833,30444,98389,98,74,178781,38487,140294
8b766358358ce6fde31f620272771210,145,139,594139,172912,421227,145,94,607691,163023,444668
e7d6661d2ef1628b39851c5a577d158d,82,66,158459,81782,76677,123,91,218318,63889,154429
688689d6c6d45cfb93803eda414c7c3f,185,93,648233,138921,509312,156,109,606815,201991,404824
2eebba0fce26cb99e8474e75c70b862a,89,67,198805,66178,132627,131,114,391054,60023,331031
0b00f333b0219101585d850e38e4ded1,29,20,10074,3242,6832,30,22,10692,5639,5053
10a044d9b209b8a8b6708c865a1b46dc,116,85,245050,65944,179106,164,105,326101,116278,209823
56c8e627e99d55cb5c9159de523fa5ff,89,70,169829,43546,126283,101,83,166859,53373,113486
aad8e8e30a881eb0038c3835f49f2f9a,72,65,99275,29088,70187,67,49,92121,31973,60148
ee0758804bba1f727409b7911cdfb006,12,9,1835,1580,255,10,9,1761,1700,61
d2d4d3295016a99a15085f460220cd4c,162,128,509048,124190,384858,149,120,412628,157429,255199
c39236ac9bf44bd6bc620fa935fcf710,159,91,480534,112852,367682,165,125,616868,128668,488200
f839db6bff9ba798350c9aeacb236e64,216,161,873852,168675,705177,123,99,708663,184850,523813
b1412fcf45933094b8c2972c136b26e7,138,107,363959,60494,303465,143,112,337077,75485,261592
7056286966358985747dabf0421a8b27,73,63,112029,36062,75967,99,84,134993,36385,98608
93fe7be3232ccff7dbe500d3c5baadcf,70,38,108541,17423,91118,63,49,62905,25500,37405
c6fee008be0552f83cc5293c8f42e0a7,95,65,374915,169098,205817,149,101,406957,135481,271476
84a3496476b4e669df22ba2107e89c80,168,107,540755,75338,465417,155,97,365671,92062,273609
1b83f52554e9ce8381ecca71b358072d,99,73,144976,26332,118644,84,82,139282,40760,98522
eb63e2434314c500822f9ef01b2252ca,0,0,0,0,0,0,0,0,0,0
98b495f6396d87a8750d7a51c06479b0,105,86,225427,66807,158620,102,92,195459,65257,130202
59d289223f8c767fe97db208159d79bf,35,25,17466,7575,9891,34,33,20617,10009,10608
26845f2e6bf091da7aecbe7dc79780f6,53,39,65613,17276,48337,55,44,61275,22456,38819
bfc6dff278b98c68581bc87f3abe19a6,126,89,337972,82636,255336,122,90,316757,82210,234547
b46bbc67f4abbaf50e10c21c23332ed7,50,42,56546,16321,40225,55,48,64726,13562,51164
5b0a004936d7c2cada2f39a19836cbd8,35,30,43768,13234,30534,28,24,31431,10127,21304
f1094250172605bf2d36fdfdacad4848,93,73,173778,44925,128853,120,104,290884,42998,247886
6f50d3651ddc03b0422ae7c9bc4ae6a4,152,123,437932,113584,324348,227,158,652287,115750,536537
fde74b7e9d92aba757405093e833e291,73,50,149670,32222,117448,73,66,116605,31933,84672
c7d3c761b8012aecc6492bf28d6fe133,122,97,299527,76378,223149,152,118,532323,69253,463070
94644f647e86f3318d7f6a143a1d4d8a,55,36,51359,19072,32287,43,35,53828,22930,30898
40580f3022599f9091454e3b6b403800,177,122,599559,133810,465749,159,126,679217,105623,573594
5e21b067f8d960a59debedc0f73fc172,14,14,3320,1892,1428,18,15,2517,2478,39
0fd59aff22fb8f6775ee0a782d967ee5,136,99,302339,60072,242267,66,46,146923,64552,82371
ae4628d3d8a5404995931110f4f8ada4,80,53,134445,35442,99003,125,93,262982,28775,234207
441086f7d0a333dc0691d51c1b1bfacc,25,19,11509,6229,5280,21,18,13109,4024,9085
358b5b8e7a7be2e00abe7192d884568d,112,87,163446,35795,127651,90,66,169666,48997,120669
e3b11565ea6ee7938151c1c4386dbc93,66,55,81941,24208,57733,64,49,83358,21638,61720
f9b7213583b44d6830fc3e775252e9e1,147,109,318407,65985,252422,134,104,240955,71542,169413
fa38293862ef5532d65ac6db5f30d04c,70,50,166818,39777,127041,68,65,160451,58103,102348
bd22b88095f682c75d73ac1a307a60e9,122,97,288131,88631,199500,154,115,411704,95150,316554
17add418fec3b9afe4f35b01ccc575da,95,81,178693,57344,121349,103,82,192553,49950,142603
8468ff3cc36e838feb39a7dd906153c0,49,40,59112,11561,47551,49,39,46755,12220,34535
1e06f989083c3ce87bf46a025fc82633,114,91,266225,47269,218956,65,51,135213,46551,88662
520f90d2d82cb3c023c116a63006d4ef,122,104,299727,78552,221175,159,118,347972,85619,262353
aa25b2c33c6b4ceebdf9b3e5747b5df1,39,27,30391,5992,24399,26,19,16727,5520,11207
2823f2c6eb38785491e60cebdc1c8406,84,65,183076,35762,147314,96,79,197120,52172,144948
49aebde3fa27ddac822c57aeae39f6ee,102,83,266730,64017,202713,113,95,280423,74995,205428
ef8371d97df9aa91e857fb6cdc421735,17,13,5220,1699,3521,18,16,5140,2087,3053
5311d86104bcf62205e78ddc681dab93,136,124,358954,87754,271200,132,111,318989,74187,244802
5d5294fe6767efe4fe46fa6530add947,49,41,62344,20342,42002,96,65,103850,20045,83805
dddcd8c6757f3221a173eab0a91d023b,39,32,29583,12208,17375,50,36,30101,11090,19011
de639ef5ae680d3bed661564451d4a29,116,107,225351,55915,169436,79,68,160978,51599,109379
92f5d56cf382f95a6a8f0b18abc3c532,68,54,148184,39264,108920,103,68,167899,50086,117813
3cfa50d0c377f04436eeea9ae0d2fdc7,132,110,265386,60241,205145,120,88,234617,39548,195069
9953adc7b632d73e4a4c894c1209d79c,34,22,31364,10773,20591,37,30,28486,12806,15680
583f88cfa831f3aa80e9d9929bd2242e,137,94,475587,101288,374299,173,151,761199,170901,590298
2cae4815a9b8853a12b63a65314e5e04,121,114,342912,97099,245813,95,81,268308,84565,183743
3e2e0def9c033055d7562221b52eff43,14,13,2164,765,1399,16,8,2024,515,1509
ef59558e9bdf9eebe45cecb9b12b8e86,101,75,175525,49175,126350,124,101,245649,53859,191790
f05786a13d395709ede23d4acf44fe60,217,149,982920,251180,731740,189,137,1019125,197023,822102
5b43661d667f90385778d6ef4acf25ee,118,88,338850,96594,242256,145,113,309831,87120,222711
ee72148752f3dca66d18accceba1571c,164,125,388080,61686,326394,115,87,250086,114968,135118
28a919a6ec2c3356f1184f1fc53356e6,99,58,216194,33010,183184,102,68,187978,37280,150698
cfac09f67e943db7407629d8a4d81790,66,36,83122,16388,66734,80,72,109861,25208,84653
4700775569dc1790b4eabbb2af335a4e,107,87,233556,64642,168914,90,77,208036,82203,125833
6168ad90365d91cbc0b8175ada298326,127,90,320300,73593,246707,148,106,356863,92142,264721
1f899b549981432d71cdda11bff70775,67,60,126865,30969,95896,65,51,116354,32428,83926
aa4258bf3fab927e61a3602285eaed35,16,12,2873,3334,-461,15,13,4574,1791,2783
fb66a2b5321bb1c051459d61c2245087,16,8,2091,493,1598,12,12,1137,761,376
440e6c51a14bed52387f5aa9f64d1bac,91,75,106054,36987,69067,110,76,174078,35236,138842
0e054fb9e69feabe82ef6a3cf3c3f451,39,27,37774,9483,28291,35,27,24761,9778,14983
2e1e85ffd3019569a0f18517073eaab5,56,46,79441,24458,54983,58,39,53717,22591,31126
b1ccd4365e82f0e77989b45fd9c27eb0,103,77,360565,112162,248403,201,143,610859,124937,485922
1ebd686865d1fa5d80b567970e53cf7a,100,89,215669,60322,155347,68,54,152104,41558,110546
9fc3f4a211fcf45a7ef9e9142c0bf737,169,137,403980,69991,333989,140,111,393898,89149,304749
c63915210109bc4fb5f0edff889a9575,33,30,33434,14325,19109,38,26,25832,13479,12353
c9f942f420cb7cbbb2668b619379dd0e,27,21,11523,8358,3165,30,24,21863,5937,15926
cb0388f4477bcc32a29d7070fabf975d,122,95,410883,92584,318299,177,136,556020,95051,460969
ce7f973e8cbd2ec5ba6b41ec7a67a600,28,23,15919,6781,9138,27,19,11981,6687,5294
7b44601fb380bb7de2ed97a09efc1425,126,82,313980,82827,231153,121,93,293123,85811,207312
83c5f7fe74d3ee88ee701272fdd2f789,138,106,365164,80513,284651,166,129,453737,77467,376270
cc212a60ffad1f8df1b672afe360dfa9,146,99,414557,102791,311766,130,91,307262,96273,210989
4e9628a0a0ea5ecbd0cf787743e2a420,120,91,271016,62133,208883,127,107,278783,68480,210303
9a64865fc721f79e8b777f2044d149e4,122,97,281018,58108,222910,70,56,119368,76513,42855
033a796aa91b284c711b1f810900547e,157,118,393167,94865,298302,107,83,291630,90142,201488
de36e9defe12edd1e2eebab57e567afc,129,92,518148,113102,405046,175,123,442279,128764,313515
9b2a4b1fab267e55ccae365b05ce47e9,102,84,240265,69734,170531,103,76,253143,74361,178782
f4b30695a9e0ddb3b7af12cd98e8d016,36,29,34366,7274,27092,30,28,20948,8763,12185
04276a499eb6b2c481a52df19243d19d,26,18,12317,5593,6724,22,16,10765,4098,6667
24f8648f8590436dc61bd87bf0c839fd,115,97,191451,45785,145666,102,76,209699,39862,169837
04e85ce48dc1bdb5943c5b187927a9ed,65,56,71712,25688,46024,72,55,69548,27802,41746
e7fa4f1049149a9aaee182bd0f054f19,152,110,353833,111112,242721,161,125,517569,86279,431290
7e96c3e8af1bdcb9dc398b226e9b3808,80,62,156724,43620,113104,117,92,170382,33868,136514
dff9a9099198eec12974c5d1c0b1bdc5,50,34,78235,21390,56845,54,35,64372,25754,38618
166bfc5767e79ef7d43135236b3d5d1c,141,97,393409,87729,305680,186,132,527433,86170,441263
ec252d04bfa678f5637b9799c7c16ed3,20,15,3612,3264,348,17,16,5464,3081,2383
964fa389a95cc5d5c20ce48f1c875403,29,22,8199,3218,4981,25,22,7159,3929,3230
65ad79fbe504f286fa1c31e4d421a979,47,33,43008,16106,26902,52,50,52136,16026,36110
1cfcbc81cce5ba15e46a6137f494c623,33,22,38420,15442,22978,44,39,52978,18165,34813
99f1f62f2b93da186ce59a1ab4826e0f,44,31,43895,13533,30362,33,25,26905,10299,16606
90b8d3fc85f4bbfc18dff23fe5e43ff7,79,51,117495,29239,88256,68,52,115733,34208,81525
2283916e53c577dbba8c34e2df6251d8,103,83,208623,46098,162525,116,88,302005,58879,243126
0d3d0342b6a9bbe0e2f376fe699d26d0,75,64,162449,56371,106078,107,93,204866,72026,132840
a9fd5a49de19b9dd71b8a65cae87fe4f,185,120,498854,158947,339907,168,101,524791,114898,409893
5237faf9deded78c852e67f9768193d9,25,22,4969,3982,987,22,18,5053,2633,2420
bdf0bce6fb30bcabfe4c260c2aba570d,22,18,9445,4000,5445,24,20,12498,5617,6881
7f527416678d2a615e27ec6d580161a2,16,7,3581,1295,2286,12,11,3149,2182,967
b97926070a4e6194846965f3bce968a4,156,98,388452,139942,248510,141,100,485830,107188,378642
3976c98ced088a10f9a44fd7094850a3,136,97,293535,100148,193387,124,98,352851,98956,253895
4a7e56c1418f7a2d53e206b0069e3ca0,159,109,345225,95521,249704,162,128,489065,83945,405120
f0edc1daa031275d940f366c2c7a841e,118,102,308786,68063,240723,131,100,284499,60748,223751
90f594cb1a7abf67ab783f4b13fd94a6,129,85,281339,47500,233839,136,104,228297,63933,164364
00b18b67ba7554369cba57ad340f8668,143,113,336382,80801,255581,128,108,306886,69020,237866
c0414cd1df5d07dc6f2aa207fd6c6fbd,87,73,202518,44580,157938,94,70,169266,54666,114600
3de1942e3a914524e9148c349b0fb6e2,112,93,225195,76737,148458,131,109,345095,69169,275926
4e48a162a4429d14e3ffd48c48a04ce7,56,38,79183,21280,57903,75,57,102793,28348,74445
38585c7be4f607a2af8763cf2dc8a0a4,29,18,12287,2691,9596,27,17,7667,4775,2892
fa66de1124b3c4566ade83f167399d97,73,66,137380,32791,104589,75,58,122554,43438,79116
981b0831903acdbe493e7a2261564f17,137,114,370470,100395,270075,113,70,263920,55907,208013
1a08de18296faaede82bd790f9c100ad,37,32,35212,13142,22070,32,24,35590,11121,24469
62ddcffc80356bcc0d5a1de13a469e3d,170,145,662352,126860,535492,194,146,594355,156240,438115
293a8a17f42e25f036961243c958f682,80,62,113571,46520,67051,70,74,124281,38156,86125
25d05753a48183a50ccc4f2d45fdadad,111,72,180015,47636,132379,80,56,146367,46891,99476
dbd324be24e668c2da283ef17acdbc15,4,4,796,368,428,4,4,368,796,-428
3eeead35d831fea1377cab8005d41337,63,42,85094,32400,52694,66,48,110328,30368,79960
25f784383e06d405e6b7b7cf9d5c194f,145,96,439091,104547,334544,133,111,389024,140896,248128
e7e9372e9058c88bfc2f26436113b81a,32,28,21620,10127,11493,31,25,25338,7520,17818
95f52eafa43d915000a87e7b871324c9,23,16,8846,2173,6673,26,20,10601,3711,6890
e76f840b11ccf4af0704784768b09450,155,114,519084,118941,400143,176,125,566246,110013,456233
9e226a008e1a4f3fd775537572f810d7,261,170,1073524,157714,915810,213,185,1266089,145347,1120742
a21c5b8ba09f8ddac4a11dee9a17df4b,54,47,88799,21416,67383,38,21,67494,14644,52850
a97a59bd5712bfc7c44680166832ee5f,122,86,263448,56106,207342,115,88,246558,70476,176082
5524a3a5b88cd68a439b62406b9eb715,94,78,328310,85559,242751,168,118,453685,103245,350440
080f96366cce48b8f45b804c61de511a,28,21,32522,9388,23134,65,53,79015,15261,63754
9a0dcbc1767f94bc752c726d215e1e2a,45,35,25522,11092,14430,39,32,29248,10423,18825
cb330ab12a02c15ce206873a9519b812,21,13,3239,1785,1454,15,16,5668,1955,3713
b8cbbdc51c7ff18f0a22b664d36d23e2,145,96,504054,75337,428717,130,118,438482,133768,304714
4a482528950609d0b39fb494e2b1ef27,142,103,348052,74128,273924,121,102,317094,75540,241554
acd0a63de3f1e8714b7694a9a53a206b,11,6,2404,1100,1304,9,8,1748,1529,219
d5a08b32428bc6d6b8155a4897ae03ab,190,127,410589,80968,329621,92,79,168660,107549,61111
531b114510f32853df42a141031c20da,35,23,37481,11768,25713,44,35,34101,14889,19212
34d5b10be3b1275e547dc50ec739ecc2,99,76,272885,107991,164894,76,60,267071,125010,142061
b950fa51c314e7df0b3252907943213e,14,10,3960,1259,2701,19,14,7105,1357,5748
a8ef94823f3e2ad1cf76179a34dd54a9,131,75,223100,43503,179597,99,71,167422,49967,117455
d1d11da38c3521d5d3ff3bdcb00693e1,134,97,440780,130418,310362,158,127,607800,121904,485896
451267da6cbe3412a5205ea81e1635d3,107,78,280806,79801,201005,125,103,322897,101950,220947
84846ae059c6084b211a49a80df692b7,89,71,207669,59264,148405,68,59,155266,67763,87503
e7d18f9ab0046abf0e0c62126eba82a8,124,86,254249,65741,188508,176,120,376783,66817,309966
48ce6ff70c2bc803749742949748e576,77,48,148590,44234,104356,159,87,315988,64002,251986
b31b93e308231757921de3da0c68667e,64,67,143917,42728,101189,66,44,65264,42342,22922
1caf61d8f868cef384cf9473c0cba37e,154,105,441798,130556,311242,214,160,558146,173084,385062
8e05e16e0e7fe38da40a1f531af868c1,74,38,87066,16162,70904,48,36,102343,18393,83950
62af83f64e6f3eda90313e56512d4aa5,36,31,34726,9496,25230,31,23,23389,9260,14129
d604d9140f8f59980bf25d03ded5678b,174,118,421333,113752,307581,160,121,309241,108961,200280
60f8fbd476e89c232dcc2ca686742a19,139,106,356893,93561,263332,89,65,231534,99064,132470
0b47ce17279f0b60bae688dc8362ad72,27,23,16119,4195,11924,30,20,13366,5594,7772
6929e7f630fe30b1b173854664a4f520,40,34,37051,16096,20955,47,39,43814,16125,27689
ce037479a428827d0adf03bd4e1cc1f9,69,61,80797,45071,35726,105,85,155515,36779,118736
18da4c52fef066d1f92f63e1a1c4c833,42,33,57247,18476,38771,34,30,40678,18126,22552
ad83ddb09ed3c5d27ffc0408a7531676,84,75,115208,36875,78333,69,53,85284,28945,56339
88bfd7ed0f5b116e295b6a514ee4e270,49,37,49989,19367,30622,57,34,62841,15954,46887
c055114af2669a50e29f0a1a116c151d,115,85,232954,77554,155400,131,109,350569,94150,256419
add907a2d888ab521af2d0803e727cc2,70,69,124456,31491,92965,65,44,106112,32548,73564
dfbbc3377f966beac65c100abf3b4350,29,27,13627,4691,8936,24,21,7785,4219,3566
1dad3884d45d07b431d3cf76901cdc7a,137,100,296174,62261,233913,90,60,184761,56767,127994
cad8e9075d6aab32d24f958d2eecaea0,50,44,49508,19792,29716,49,36,53579,11531,42048
3214cfeb6aab0f6afa54b3e75da505e9,75,60,86767,31275,55492,85,62,156400,25938,130462
1df86d9d707a065ad0b6fb20ac1bd5c8,100,80,166876,40120,126756,70,54,86919,57174,29745
362cadf193243ef893c0ff39b724a04d,47,39,44318,20456,23862,45,33,54127,14791,39336
d85bb6197e8002b52d446f34e7506029,119,87,277114,50598,226516,133,113,340425,49539,290886
531e083e95d28aa1c935c681d64d4122,164,115,520295,72128,448167,159,134,490563,136978,353585
2bb4bb7a6b4550676f03230a7b2d2966,108,85,176292,53161,123131,113,77,228194,30440,197754
4038ea9451878e5839ea686eb8eef0d1,126,90,281267,58479,222788,143,116,332088,64847,267241
28d72ccbe356d35a22b20b008f8e8442,111,92,272511,79249,193262,132,86,285726,69943,215783
7e5849dd34bea1342881b7b15ac0c648,27,20,12436,6121,6315,29,20,14814,5955,8859
d1173b87ea120e12e3728848a1293907,52,46,91997,34909,57088,99,88,176085,39938,136147
cc68af0b291a7c9981495f701b891523,25,18,15246,6453,8793,25,22,11505,3547,7958
5781cc20555788c33961b9419d89a4fd,25,24,18804,8303,10501,30,31,27930,9361,18569
c389f41c87e1ad52bb8b9d6de5c66f24,78,58,110682,33072,77610,70,48,88963,35960,53003
125a2aec729046a2f9039bb0ce68cbf2,47,45,57232,19370,37862,71,49,85021,16943,68078
c264ada3348782bb7e2cea61eeda45c9,150,83,368543,73009,295534,161,78,311848,69780,242068
9cb6ec514cf16ef897e5845539ff50da,133,85,311004,44712,266292,133,101,302554,55493,247061
207811a9e54092ab2aded096bdfbb2da,99,78,214323,64915,149408,114,100,296617,73380,223237
e3448ca1eff37768810fe26dd3a539c2,92,72,204316,50829,153487,95,74,199409,50613,148796
8b64e37ecd24a049e68b424186389a63,41,39,49285,24061,25224,46,34,55461,16950,38511
0df38cd0f36653d7441eff27d2e45206,47,37,45170,12096,33074,31,29,32745,12173,20572
3a3457e56e21fbcf6d7a9ee6bf8219d7,19,14,4315,1713,2602,12,13,3347,2525,822
4839086dc5c99e0fddc47c8d54459d54,140,106,277773,57197,220576,154,108,310077,81086,228991
178c7a3ad07caa789fb0b57be9e99862,99,86,171366,59785,111581,121,104,254063,50241,203822
285b553cf51fcce29b5391f38bf8f3ec,21,17,13226,4783,8443,38,19,32879,3312,29567
b5793cd82fea1827159fbd2e711d1439,42,36,46567,22652,23915,40,33,48565,22038,26527
08de9d07ccd9313173ac79af286dfc60,108,83,282786,52473,230313,91,69,177385,49312,128073
d7fd17861f3263dc4577d10d6e494de5,43,31,39682,12590,27092,30,25,26285,12686,13599
4526ca5e5274239b65836c283963f53f,15,15,8101,3798,4303,23,19,16403,3710,12693
474272a50470c7b5417c5f6edb9a3dcc,114,96,385305,54659,330646,119,80,205933,74211,131722
4d0f1cd144798c8cf44965bf346783c5,155,102,521668,101544,420124,154,110,471607,87310,384297
43ab0a5b508f69159897963227f7834e,57,54,94146,31844,62302,81,52,91530,29619,61911
9d19a12d2af269202cb903180678f6e9,193,133,1076133,214973,861160,189,136,1073004,206418,866586
eda31c212f1d3cd42c7ccc1920c87eaf,85,73,136526,30534,105992,67,57,87928,32789,55139
50cbaa7b1c102ef68b9fa7d5949fdf53,203,134,903416,196453,706963,190,141,792182,196588,595594
1cb2551a8b2d028bb5584989251da73b,155,105,521855,148085,373770,210,165,701028,132070,568958
ce59c6372223d0eec72925b1c31fd822,33,25,31372,9482,21890,34,31,25492,14023,11469
c466a14bfc2288e24d3c9dbf75ebf303,130,98,383100,67149,315951,115,102,292194,79377,212817
a07021b8b2f99239c678e8dde9690ee8,42,29,42444,14341,28103,44,31,40903,12105,28798
8137494125206bf65a2cf538b714ccbd,37,30,25875,7867,18008,35,24,31427,8054,23373
25dfd09c1d2008ea1b74e0259f4cf24b,43,35,48097,21165,26932,36,36,43212,18435,24777
9276255117015701cbb149893e954387,32,22,17839,3630,14209,27,18,9585,3435,6150
f061bb92583c3c359028c52916b36ad6,92,68,123812,34672,89140,105,83,169225,37428,131797
c2ef36d5e03e60c9c1570206c9fc4f2b,112,91,186989,48079,138910,73,65,154565,45332,109233
56bcbc0622675b3263616552074ec037,123,88,281369,84282,197087,115,100,242003,85662,156341
874ce100d6c5de8559f8f9f87d05e5f4,107,79,219696,54069,165627,99,88,270577,55522,215055
29f24dd2e1aa87e93cad4de209df1127,70,60,124682,37334,87348,100,66,160605,37186,123419
14e99283177b086c41e2bae34bc1bf0c,75,66,167192,56965,110227,94,82,219611,59269,160342
6f1c2af27c82105ce0a8c431bb8785e4,59,44,84059,28212,55847,71,53,99230,23045,76185
0f2af05183f6e7a176ff01b73ae82008,134,102,406655,85364,321291,179,140,620255,82936,537319
8bcc8b9d96bc890ffa9f041f5cc65bb4,115,74,156119,31246,124873,69,58,113460,42442,71018
94d9ec34d262fb0a8983f9989d28fb21,45,28,32285,6495,25790,37,30,18315,9699,8616
a87c4d63bf21cf9c30036a0bb530086f,74,58,86464,32124,54340,67,55,100405,23325,77080
cac8b777ce8d96de12b3d3f87690d5e6,50,38,40765,20116,20649,60,42,51395,17182,34213
fa044630bec04be62a6061cadca92b50,124,89,235911,74283,161628,110,89,224486,89956,134530
a77f3eb635909d7a56bec12e774a91ea,85,74,124666,46724,77942,64,52,88760,22760,66000
f70b1ae1f8362754ac9b0b5e71affbec,95,91,149878,47451,102427,119,74,148955,38958,109997
874deb7521bf7f37c022af17554514e8,50,45,52976,28389,24587,62,46,75467,18361,57106
fe3324e119d1efba3b0b6a38e857088a,117,105,319641,149204,170437,131,98,381330,130304,251026
5e54d625fbf122821d15e49ce476e363,49,40,77219,25795,51424,60,47,80200,26782,53418
83540b0a0c2faf4e5d2c7a0f1710146b,99,81,138714,37068,101646,125,85,166325,43438,122887
1581ab2a91503e1ef7b5ee51a6ccee94,37,24,24221,10386,13835,55,46,56761,10249,46512
eacdf7fa85fa127e5f8f49a0a12c8822,103,78,258729,62623,196106,103,75,210807,65046,145761
01415f1688010ab1ddff282b3187cbfc,21,13,5939,3188,2751,23,17,6911,3185,3726
851884cda5888c9e9f0c072d62321cad,26,18,8760,3496,5264,20,18,7305,5051,2254
0e1eb7eb44a86f73ad8cadcbb6246237,92,79,170105,37529,132576,86,66,143141,38544,104597
04948f24329ce97b23d0008ce0d85f64,61,44,62067,21464,40603,66,47,60799,23926,36873
60296d593532603e84c6a3a203d4202e,41,33,43256,18188,25068,37,29,32040,18583,13457
6ededad16db5fcb822699a090baf386b,94,83,239274,94936,144338,120,86,259074,53884,205190
36983472ba489e9f4f92a00f278b338e,203,141,1265763,141797,1123966,212,162,964910,229381,735529
151887a9f272aa1daafee066e4346a0f,164,124,518174,71940,446234,143,108,372591,100399,272192
58c7ac54a4cc63c2e0bf81e9ee5f0dc2,26,21,19493,5841,13652,23,19,15737,6528,9209
a99437399d957545361435f597b8d48d,59,54,135261,39599,95662,48,36,83089,37098,45991
4a5dd1f7a9d4ef784efa4cb637a0485e,38,29,25825,10627,15198,37,34,33628,12213,21415
48325830e6f55b3d71e162ed8427aaab,89,70,121726,40765,80961,69,60,126053,39264,86789
9007dcc3e8882cd9e41fde573b75cc1c,33,24,37884,6757,31127,28,30,24038,13665,10373
fe379f8d09503fc25a1a5fdca48b6600,40,32,32136,14031,18105,38,32,44870,13106,31764
3fd8c937ddab4d2f9a4f1521bc99a4c6,134,100,441913,106731,335182,151,125,551454,95573,455881
5ddd0b96f077f9323839967f38679d3e,130,99,411395,73803,337592,161,119,521297,75706,445591
b6abd87bce070a303223371cb5b3a952,128,100,375573,114911,260662,145,121,508603,119436,389167
d10cb1a86ad98d58857bcdb942ac94c1,93,76,174450,35316,139134,79,70,138341,33023,105318
9b05ab52e53f6488f3a6aca29d6a2a4e,106,80,174916,33646,141270,97,84,179028,37275,141753
e751266d39c1e7c8bdb8a7ff49985e2e,89,78,183296,42078,141218,73,47,120365,38091,82274
772bc9f3fa8feb2751ed97f376d0f148,101,82,167235,39738,127497,84,71,134895,41852,93043
affbdfec800f4c8720e59574a94fa7ed,126,104,276458,92696,183762,129,93,277931,95223,182708
11f34c7469ca7ac92bc0f83ce253e5f3,43,33,38697,8629,30068,34,32,21468,11127,10341
2d7be01d71459cf0ae2ba5c88aa8c5da,45,30,68611,19238,49373,46,39,63914,25970,37944
e6419e0dfb746df811b86c0372fb025f,79,58,156015,45388,110627,86,61,215187,58758,156429
c86b689a03ff8d06359cfae3d027c459,15,14,2851,1587,1264,13,8,2907,1242,1665
e66ac5401fe02900d3508bb328648f9c,94,74,275079,67443,207636,126,105,358120,74208,283912
b87956efc36fae09a5f4d87710f297c6,140,118,459588,129798,329790,146,112,427348,99963,327385
15c0aabe3f7a808551a260d7bd1c024d,28,22,15122,6502,8620,26,19,13612,5061,8551
5e3f60a5b29bbe92828d292c612d441c,138,103,430370,99608,330762,150,116,584107,108899,475208
2dbec7a24659dbbe94902f39513d586b,185,154,885145,182054,703091,178,135,736986,153961,583025
0958adf1196986cb3684c7d944739cb6,47,37,49539,20226,29313,57,42,65748,23040,42708
2ab0c3b3d96b9b21e8bab161cc0d9dbe,80,68,175576,69675,105901,112,107,257673,63090,194583
ae5eef988c27fce9bd254c29d080b3f9,132,109,431484,87296,344188,165,139,478245,87261,390984
22fe09373e7c2e67fa04e254168a6f95,94,69,145685,44943,100742,91,75,172056,44966,127090
2b5d2ec7a46fffc42856228268ea8d97,17,17,4553,2488,2065,17,11,4026,2514,1512
45e86f9c05195cf3ae745b08eb4e10fd,144,135,501095,128828,372267,161,139,441319,115363,325956
c669dcd20a4167a37cc7dd13c4870704,50,42,30270,24875,5395,58,38,67718,18552,49166
fe2325e92ceca9e4a97025248f2c22e3,120,82,314205,67714,246491,140,128,287751,82782,204969
b5fff0f6837065c933976db859f3cab1,124,88,248145,42144,206001,80,62,106582,42320,64262
2409dfd27fe4793be9d9f80461123184,145,107,492454,100960,391494,183,131,676552,125995,550557
f166f3a6a865e9d45acdd104ed337ba2,126,83,262856,34263,228593,133,120,306799,63529,243270
ccc7b11009355524c9145f49f7617310,23,19,7238,3873,3365,23,14,7628,3017,4611
17997ab59f4f37b5ada39876cce7a23d,154,107,341495,67659,273836,131,102,341300,63376,277924
88bb0607ebf069014accb16c5d23ff4d,143,86,312627,47141,265486,131,106,309472,63306,246166
dc34d8d16f343b2bafaa4d183cea8540,40,29,39743,11182,28561,48,36,37863,8696,29167
3bc1a345181ba5784608b756b28e006a,138,119,422233,116912,305321,182,144,584065,96627,487438
315a99a4e7a24e7cd3b7acbd5228d85c,166,138,579685,118624,461061,177,150,1022553,183792,838761
ef61c74284742af76cf5a45b4b22b0d1,26,17,7670,3160,4510,21,19,7318,2502,4816
5bbce36c5b6cb7a046d8a4fb88f12825,206,155,1010406,127993,882413,202,160,1172304,191063,981241
8a9bf1317dcb5d30a1863b1da174823f,94,65,139854,35958,103896,81,69,154278,34043,120235
98ea37800cb7b11aba5ec637ed39e289,219,141,1447036,255319,1191717,235,155,1152028,256926,895102
ad82266d07671cd33aa7eea1c2b0506c,35,28,32069,14859,17210,36,31,32006,14738,17268
82c006b3efeb0c4f2570b0deaad85d02,79,61,106157,34359,71798,69,53,145533,29417,116116
7c0f390ce413d25e9d84c7bae288631b,47,43,47943,20860,27083,51,36,49034,14627,34407
c3f25b1fb51c1f02b8793efd135326c5,34,27,21015,12922,8093,31,23,26108,7915,18193
95d1296eb8226506670a400817ab9525,66,46,158463,59783,98680,82,62,152792,58827,93965
f28b449db129bef8ff96fa66550871bb,58,51,55210,25387,29823,75,59,93523,19709,73814
8a933bec72dabb2fd0d4cfbb521baf39,160,129,691748,179207,512541,162,140,832044,195046,636998
3da2db7f9ff7dec64a0af8d6d8ab8349,108,88,220349,52133,168216,128,111,250890,51735,199155
936bc5437a5b88fa8aaccc255d66a3a8,45,35,40627,16216,24411,49,38,50774,13560,37214
a6bc97a9588c126acb93475d25f34c45,125,91,233404,56416,176988,116,87,227084,59916,167168
4dd00def7dd9c0c9a53d5b0a3d55b8d9,82,57,92627,23094,69533,50,35,88938,24687,64251
b7d3a5dc3286b21f96edd85ff54bf82d,155,130,649322,99080,550242,184,146,657398,123736,533662
efeca91d6b59668de898785caa627c4e,164,123,541640,85446,456194,119,102,400687,70836,329851
c1f9cdfd8cd5beba713f9c13021dbbb8,46,37,42788,12591,30197,38,30,28542,10166,18376
998535176592b806cf344ad9b4e332d3,67,54,115353,33530,81823,50,39,83740,35805,47935
be71a96a0803c47cedcd02f0e421bf33,103,81,180976,39239,141737,108,79,279185,32831,246354
1c3c266e19162d2ab9c70ce0ba09b5e4,159,115,558351,122350,436001,137,98,501548,142759,358789
58cf7014c7a84ebacc3d83cf79192ce7,59,39,56306,21370,34936,48,36,69057,18860,50197
f8a2a6fd7fc13d16078afd8d151a2ae6,106,83,181518,30504,151014,119,95,154937,31599,123338
16f1240236959e24694845b83235f590,175,130,611205,133669,477536,174,137,627302,158725,468577
6b5632e788fa610b5ea2987f77be4af7,89,64,120618,31444,89174,77,61,154835,30301,124534
ef39be14e3c6fba0d1d4e768d1e57730,62,51,106467,32586,73881,47,35,95837,28766,67071
3367a83c6a2fa73ccc24f9f17e0a49de,106,94,213423,69404,144019,144,114,329162,59612,269550
66842998d5ba2f043b4a3ec8aec65988,65,52,63251,17675,45576,47,43,38943,17609,21334
d6301d8d770e7a7b1dda5ff3186ea277,147,105,343771,68300,275471,180,109,354602,42580,312022
bb2d62aede53d7dcb6c13a8ba4748f7e,18,12,2447,1504,943,12,13,2483,1698,785
8a4b7469cfa86a68cb924f589dd90102,22,20,12849,4079,8770,23,19,12399,3842,8557
cda3eb1cab7a0263b26019121dd8b87b,162,125,474213,111221,362992,165,141,537529,131905,405624
032d6ed643e6ee97786206148829d8bb,46,32,46973,19743,27230,48,36,46771,16669,30102
052ac710a4e382d5873bcb8593a810a8,160,119,332898,42451,290447,118,87,200308,43726,156582
acbd9d4fb68fcede9e757db140b1c3bd,190,139,531462,142497,388965,124,82,401595,101398,300197
44dcefb9b3e981334932f1b2190412cf,123,93,215138,33150,181988,120,84,220478,45448,175030
8b35dd448166335906bef1d0eb83f026,31,27,23620,9173,14447,27,24,21612,8885,12727
4aa3de5cc255030c2bb4ca5c4d954438,102,67,176575,43182,133393,78,65,115295,52375,62920
38fa53a49c0ab8a7d46f39c0dd5a86ac,188,147,598292,104108,494184,160,120,521836,97397,424439
19c7f3d7fe2b45a06fe76903702cafee,13,14,2334,2223,111,17,14,3091,1509,1582
ea796b5e633fc3963bc165c9cc609d52,51,31,55984,19109,36875,70,37,91660,17676,73984
3af3728db6eb70f63c72e4628e1e867a,137,106,366072,93868,272204,150,121,450663,104993,345670
cbcfcd80ae3c9991367ad69f398c2341,61,53,91610,25459,66151,88,70,130151,33333,96818
0aef6f2cdc7396931ee1e3c3bdd855d5,22,13,5112,1529,3583,16,15,4720,3183,1537
ec62067a110333da01ca3c4146bce6d8,137,125,425422,72946,352476,112,90,248179,65595,182584
35f33a016af8cdff4b2e0de7fa9f6ce9,61,44,126656,34789,91867,69,50,117258,33383,83875
05edc6b749079d89335edbbec44efc1f,76,57,125470,27990,97480,98,86,178656,45197,133459
8898e2b93acca76369c146ea1c33be4e,128,112,359977,76345,283632,133,109,280892,62875,218017
834cc89d533d575d418ba9bb18b8f254,37,30,64592,16491,48101,44,33,45645,22672,22973
fa337abc06b416075f8f77c369270398,77,64,172680,42497,130183,71,56,90189,37495,52694
ce2d6acc3fc60f3ba2020e36a729712c,25,22,13067,4901,8166,21,19,10557,2896,7661
108152dbe25fd8f44ed8c6df1bf74569,39,25,47188,19598,27590,35,26,56541,17664,38877
60fd4c79a70ff3869d0a6a901acd00f9,98,79,202062,56563,145499,103,82,205561,65372,140189
1fd925886249d0409a95473ef8d5a34a,120,95,251733,76764,174969,144,95,310160,84459,225701
a9d62771642b3ba34365ec195bf8ebfa,21,16,7623,2477,5146,21,17,5225,1775,3450
51d038aa641f6ed7dd1fb1a8581f6289,88,73,143232,35896,107336,88,74,139714,37842,101872
76a6428d05aca05de60be81562722ba0,27,18,7128,5167,1961,23,18,13899,3624,10275
aea9cfcb1fb2d4379e32be4c841c4f4f,104,90,188554,42398,146156,108,85,208991,39509,169482
7979712f5270adaa0728f94214bf8fe4,36,24,25207,8991,16216,34,27,23453,8799,14654
316772a10bff0874141679f3538fe929,50,37,61415,16310,45105,45,28,58870,18157,40713
92cb61f397f0ec8c4c1bcc48bf5f2952,94,54,132270,20634,111636,63,48,73244,35269,37975
bf4e28c7ab96fb7dcd3b13289e011f30,50,40,47566,11765,35801,51,38,52044,8968,43076
ff51261dec284c87561bcd2bf0346d40,190,131,423267,74376,348891,117,96,265491,52472,213019
70656dfc88ede1fb81053666b46627ea,154,97,230800,44201,186599,143,104,302673,54100,248573
d2d61c411da9902c880d8945b392e73b,96,68,169266,48523,120743,78,59,105046,49596,55450
458f978f1799e1111ca6f016c2aa0c7b,139,100,245021,62268,182753,102,69,238721,54647,184074
7caa323dc9599c238e8266ead3fd03ab,79,59,166573,63460,103113,100,82,155043,70954,84089
8749f92eed137b97e37b6f5ab0b213e0,185,133,769595,111956,657639,183,158,755538,177245,578293
22ca4da3fc046ca60f5464d9b5117fac,44,32,54726,11808,42918,31,23,29736,13083,16653
a651dd4872603e6976fd4dea6d5b3a9b,41,27,33179,7680,25499,42,38,37893,14325,23568
eb443adaf3727fd6e5966337abcb2736,74,52,62243,29024,33219,76,57,100557,26342,74215
5d152148639f8ab680ed38642aaa2f4b,113,89,225175,56155,169020,106,77,240531,68902,171629
431d5429a7b922c4a2a5bbda70814fec,174,131,625891,142309,483582,138,104,489607,102429,387178
d77acb21b72eb7381fb67a80159d5505,92,57,208498,80882,127616,128,103,244678,53100,191578
3f5d6a1a728019c9e5ec1ccf4feef36d,26,23,18296,16321,1975,33,25,35080,12963,22117
05272c2a94aa5386bcda48788b1b0a1b,67,48,126697,30418,96279,52,48,72247,37264,34983
6ef9c0b631aef816bdc44102460b706e,74,65,109129,32684,76445,84,73,120340,36906,83434
97823906506488b1c7ef8df831ec4f2f,23,20,10191,5393,4798,28,21,13569,5176,8393
8aa5582ca4e927dc0f07e0ce737cfe9b,112,70,191006,42752,148254,180,145,327909,68580,259329
78baffc00b8e324ba37aecd864d380e5,65,59,76963,26983,49980,62,43,66280,17757,48523
c72ebb3b9f8e389a9d2f76e8ac7602cc,142,102,314206,46064,268142,123,110,216698,85549,131149
e00ffeb50aa98df9f01febd7cdee9f5b,42,25,29096,11397,17699,65,51,61488,12431,49057
ad4db3c24917338ca3bb9d19511777d2,129,102,607512,140075,467437,187,120,564285,169242,395043
283340eb4c38aec6382956804d46b160,39,34,41860,14006,27854,41,36,32697,16100,16597
d287020170ffbb474be20b5a9b4304a5,108,88,192068,49827,142241,136,103,283406,58780,224626
9d73a7e752b0f3de8cf7ec6443077af7,42,24,30683,11406,19277,40,29,37511,15237,22274
872ea2db2952d048bb036bd77963e280,122,83,279364,48450,230914,114,95,181091,53312,127779
9ae0feb91cc9b79aeabaa91cfd3b168a,168,119,334342,57739,276603,124,98,321370,60713,260657
30d390436e3c20d7d40ecb8c5a8023b7,38,34,28948,11842,17106,53,29,36764,7026,29738
58fff8464a00e365f67f99f6b6af7849,186,138,859685,155696,703989,161,131,835746,142812,692934
5b053c4034b91bb347e8770a72347b54,134,103,280410,107583,172827,176,115,453033,61262,391771
170fb288cb720b543d6dd05557d8f5e9,173,122,800333,133520,666813,163,130,613276,157737,455539
9030cbafc7bedde197155e4157f107d8,42,35,53990,20749,33241,46,40,69792,20288,49504
9fa7337da30f6a4d263914127ce4315e,70,52,118838,36083,82755,67,58,91165,40725,50440
460e69a32ca7d5c4108e68fa93c74f23,173,126,405333,70299,335034,148,126,536874,103889,432985
88c2821aa125ecc1678f0d122960040d,159,117,605965,181544,424421,160,98,473123,106628,366495
def46444bc4b138d3b340c13b2712f54,112,97,186626,56852,129774,104,80,170271,49125,121146
b2763d3b977de1a9c8c272b5f81d46c8,165,97,595543,121223,474320,160,103,458744,132417,326327
c35e10fa3977a8b8ade1cc57f308fe62,72,57,104145,30224,73921,86,83,121411,31675,89736
af9d66985b9d64073dbc3af71ad0927f,83,66,108489,30424,78065,69,61,104009,32663,71346
bb0335027196a24a15eab9e553f2d04d,39,33,42733,16729,26004,49,36,54736,15832,38904
a6c1e42fc46debd88c397f993dc0f0c3,141,123,687956,135826,552130,229,187,1233791,189567,1044224
9bcb0ef23cafbe014ff3fbedafef3b8c,124,99,236993,67995,168998,105,74,209614,36465,173149
8c862b0ba74ef25dfd862850b98aa65e,61,53,101305,60502,40803,124,99,243054,59553,183501
f2c178e97674aa06ca38393cd254a0b7,53,39,49224,24925,24299,57,43,69380,18193,51187
f565c21b840084793af6bc1223dea53a,135,102,344321,66256,278065,127,112,294639,54990,239649
c944dc482a0f0536a0e421fb55245dd1,29,25,14277,6622,7655,34,25,27040,4717,22323
166665171f0eb155901863639e2a2efa,74,49,105702,38509,67193,52,48,93295,40256,53039
3720ee465bc34c94c85e166575437594,58,44,92887,32297,60590,78,65,104787,38107,66680
d229ec0246ebffd1d1b42051023ce441,125,82,251446,41268,210178,95,77,175091,40980,134111
2e61cebd7b784ca17169a5e071163edf,14,18,2187,1408,779,19,15,1949,1453,496
5ae5ec200f00e6377149f4d476125c47,38,24,16168,7860,8308,26,25,15511,5529,9982
bc4e7873e59aa450abb568c3148904c8,32,27,42014,11094,30920,43,29,38281,12844,25437
90976e58974f79c2b307837c96c7d425,70,55,100714,32465,68249,85,57,128597,26183,102414
ed51adfef75f962f2816f38a1846acfc,119,87,241737,41915,199822,97,80,156561,53633,102928
0384ba67523c7a812ace359b5f6c3d5e,47,40,64965,17622,47343,48,43,54462,26109,28353
98d4f9df98b514b083c162959a05426d,83,64,147677,28269,119408,58,52,93597,27133,66464
76167d4e179f816ebd8f9336df635cab,48,32,61667,19254,42413,62,53,91522,22860,68662
0c644153297e28a42cf1f15221944176,68,51,75244,27450,47794,88,63,108160,23077,85083
41f46f390581066ba0c463b219ec11b4,121,107,237190,80019,157171,143,106,318883,62109,256774
3ad05583fa1b84f7737620011c7e33c9,35,22,27462,16168,11294,43,30,43695,13274,30421
3710a690e0bc139029bd59494c877727,172,129,485007,73219,411788,165,137,507174,70357,436817
c67b7d4e36b734b0e992c3929455950c,81,69,97673,34284,63389,74,64,96691,32089,64602
f51510357770caaa0c717d34a04d3393,46,41,42943,16647,26296,34,30,34546,12788,21758
23222fdbaf56a13394160fa8a6aaa9e1,62,46,84188,17797,66391,48,38,49309,27446,21863
a8bc3b0f87d0d374dd14fd45ce12937b,125,98,442004,81545,360459,127,112,350580,105987,244593
a78dc1e87654fd410d0970a1342c3944,99,71,166402,51466,114936,76,63,126877,61815,65062
84488b20dafae29c84e38268e119c577,113,79,259564,46662,212902,164,129,359682,60249,299433
7cea098580d28016672337f2b0bebfe8,92,78,192633,38959,153674,82,65,137404,41675,95729
899ee25ee7632bdf639ae324bbf5615f,80,61,115222,32582,82640,82,50,116320,32715,83605
2d160bc112092f040c77aa7fc0db4990,140,86,363578,56794,306784,155,117,314113,69945,244168
4c86ac863a2aa2f744256b9dcf9f6c94,18,11,4504,1859,2645,22,19,4979,1858,3121
5d1624ceee494d75709ddf337dfb46db,27,21,14839,2932,11907,30,23,13188,6291,6897
42f6f32d4a175b02a6ddf8024402788d,130,87,515340,112663,402677,136,97,432526,110681,321845
e5a0e1fd503a732b7c10d3b209a294bf,89,73,115931,35630,80301,104,92,133322,26524,106798
8bf71701b8807fffa7bf0812f2ffacb4,48,31,66432,21432,45000,35,30,47650,19803,27847
52e465be3c77a044d7cd4043b7960695,134,89,459585,124388,335197,149,89,589952,110695,479257
5c25ccea45d2c3fd04c8c739db70f3db,39,32,33912,23054,10858,55,43,62618,21421,41197
3996157fafc9efdf488b8a1c947c0851,65,54,119861,48128,71733,61,47,112374,40220,72154
e68f067d3f6258e0bd5431b5e9edb392,26,16,8795,5521,3274,27,20,15339,5657,9682
009458053b4972828dc3a2b6aeef57ce,161,131,484494,193191,291303,179,110,581613,137084,444529
a0f263266db376ee3b2402c49d64229e,110,85,240533,58526,182007,100,92,214104,56690,157414
f5c4762ee6ed1d6945a215e21f843d12,56,44,65057,15680,49377,61,49,69480,14884,54596
64840b6f3e05ab5a257375e71c97a67b,19,16,7294,3842,3452,21,20,9514,4141,5373
0948debb147d162d1033a7807f9d18ba,128,79,340463,74529,265934,152,107,473029,97458,375571
621bcab9835f1dfb56ee8a8ae1cda899,14,15,3924,2113,1811,20,13,9541,2562,6979
991c0ac2d135d79130aba387be96f145,49,31,50568,12202,38366,43,36,57645,13153,44492
a4d7471bf41f133a4d0293d2851cde21,25,22,11822,6182,5640,34,26,12680,5885,6795
e8a47df356b1eb27c6f2da45aaec293b,33,26,23141,6501,16640,31,26,15404,5813,9591
e42620cca589bd70ded535a675a4084e,42,37,71059,20960,50099,65,61,87285,26691,60594
da63118d677fdc8f52c4e171a0133bea,87,63,152417,65100,87317,104,79,238776,54253,184523
50a54239dc07a2ec13c1dfb8a2fc3a6e,42,33,69479,19440,50039,32,24,35104,18937,16167
7b59226e00ced5d424189dd394ce0dfa,63,55,82457,28479,53978,55,51,87506,32360,55146
22707a25fd208b78dad2369eb375ee15,125,90,390890,88957,301933,144,118,498863,107466,391397
ef7a660c0f3d614b3fbbc9eb6efd57d6,84,72,102788,37050,65738,90,76,141150,34077,107073
8a6ff0bbcef8e70881c3996d0e4040b4,123,109,313897,68987,244910,152,107,336594,71176,265418
ab48911f9a9555813ee53b9ca8a8af0b,32,28,22021,7180,14841,45,40,37892,10769,27123
ce9fa73a29b491a8ab7a991bd6f0e9a5,153,123,362895,101037,261858,154,118,442883,76862,366021
4f48c0f9a059191a092f3e43b6b0ce9e,105,99,228462,56302,172160,94,77,184694,76506,108188
68ead0d67ef70e06b8a000b16e105fc3,34,22,19246,5798,13448,25,24,17587,6838,10749
e5a91a2d8fb18bdf05d4c10aa02d15d5,24,17,7012,3110,3902,19,13,5422,2767,2655
fc2d1b7a406b7da9b78db9349397abd7,165,147,404187,87883,316304,136,107,408089,89873,318216
9074c22e3ef7d18cdd78aec183974347,136,105,288360,80050,208310,148,113,459276,70994,388282
26e7cb3dd24eee6ee197e7642820616e,197,124,753665,213376,540289,239,143,815780,225517,590263
cf119e7bb2949b3f710922f6cd9fc8d0,131,91,312504,102834,209670,110,87,252703,82608,170095
0020c33f5ec4f7ad055f670cc6317783,40,33,28276,10660,17616,41,33,35072,10395,24677
836983a77b6a22755753abfd4909bda2,142,106,551461,99951,451510,183,140,564168,122463,441705
7d5698106892c7ba8aebb227a4c27f33,61,45,70461,32765,37696,70,51,107618,26196,81422
63314858d1de736ddc7bd24eb1a6b91f,110,94,193579,39022,154557,100,82,155882,42060,113822
2d83e6ade4ec7a7111277133a283b377,106,92,292566,108456,184110,108,93,337051,110691,226360
b1521fd582205e9c13f883f421c43e79,140,93,278429,73169,205260,144,122,283905,89868,194037
16d3c75a54ed0c9e13af782d6cd38c2b,125,88,250663,63129,187534,75,48,201395,56619,144776
4af5f83b5808056ee9ab20138d461259,76,57,156610,39275,117335,72,59,87565,41259,46306
8dc2a2d2aa3944dc487db0a5098b2cad,133,101,338299,64627,273672,160,117,467246,83435,383811
4e6d31b140b8373b25328578b8ff8bae,35,26,42270,11691,30579,36,27,23964,15537,8427
0012061041925a167e6feb9d1b8cb68f,36,27,25600,9850,15750,32,27,19788,8674,11114
d7db272325ab72ae817c6e93098ff939,35,22,32254,8480,23774,27,19,18893,7692,11201
f8fca1ab5da0ffca9f6a6419e8457e01,37,31,25865,14281,11584,43,32,25154,11754,13400
920d27618c5b5dd5dd90d91edbe28502,119,76,194791,33489,161302,109,72,187397,44347,143050
d0b2b796a37751ad3e723b0443edfb7d,54,45,39606,15410,24196,50,40,35242,16901,18341
809f8029d4bab9ab2a2da54f9b23a7bd,96,82,182300,67450,114850,166,141,338998,57240,281758
fdd80dbeb0a3dfcc9847ef34da35868e,98,77,162829,61516,101313,76,60,189496,51714,137782
14037516de5a49190178abea74aab1a0,22,17,7082,2217,4865,19,16,4939,3474,1465
1673bbb115878414fa81842ffafe42a6,54,37,65567,14761,50806,63,46,61846,19984,41862
a86aac40795b6627fe884ac6a2d9516b,94,69,154063,35509,118554,124,89,199020,51402,147618
2a01b8f68dcb3940694ea90d891b6028,104,81,136340,51142,85198,71,63,79949,48597,31352
f966a36a08c3ffa959fc2cf7128da56e,52,40,52081,14758,37323,48,41,41836,18001,23835
daa422f1b4c5f5fa53685677be1d73c5,11,13,4121,3443,678,18,14,5132,2886,2246
79cc9c40c807d7a5ee9d921e35fff6cc,16,16,6812,2365,4447,28,16,12330,2862,9468
f1e2b97963cf644530eb56f3e950d3f7,115,93,213442,45813,167629,98,87,149929,38960,110969
700b23cb9090321658a6d6249f0ecb1d,172,119,597279,130359,466920,202,144,795541,144090,651451
4107948826e730e4e019872b6ed3054f,25,18,11261,3482,7779,24,16,7209,3152,4057
12798d12cadb4e570315df33efec1007,39,30,33578,13600,19978,36,30,46618,14877,31741
62da8c30044dddc56a4be6a3cac710be,130,109,386630,92450,294180,96,74,292410,67322,225088
4e32c31c407d925eb0438b158f53e163,175,134,579430,125843,453587,151,127,692513,114597,577916
ce140e1842fcff5fb534e33cfb2c3895,48,48,77253,26842,50411,57,43,79555,32452,47103
ebd517a10bb8109187690b1e212f423a,115,91,200637,59807,140830,124,84,208550,58060,150490
9eb32041dcc9a2a63c50dc424b41cd26,115,95,264003,66040,197963,139,111,287613,69452,218161
75f9e03d581b88824e91b9c8b0ab4966,154,114,489009,118470,370539,134,111,439762,95235,344527
0250b8ce7c96fdd335faa972cdee4c77,18,15,3633,2420,1213,21,14,3914,1342,2572
456359d7c1ce8f4132d8cecf0d47ec6a,184,155,737970,198653,539317,198,154,699493,180476,519017
f293bbf0177a51ecbae8fb13bd5b4f81,30,19,14830,3419,11411,27,23,16629,4663,11966
b3d95d3f76005e32332c9560dc046ec8,95,75,300384,46531,253853,120,110,262882,79352,183530
edac0796f0fe9bba15d257340b027538,19,18,3688,1984,1704,19,12,3688,1226,2462
4eb2455bc0e127b5ca686cb25add6507,51,34,83664,12757,70907,42,33,54179,18906,35273
ae9fc1c6bcf630f9f6b00405cb35a19c,121,108,310652,71407,239245,104,77,226053,70785,155268
819ca0112bf44f5fc37ab91420cd185c,110,79,257475,50931,206544,127,90,306828,43957,262871
96b7883761cf9576f24697c3b45b6c3a,104,67,222971,29432,193539,97,91,204720,55089,149631
4b8d4712f9ee27a4c6b49368d527dc91,49,42,30907,18907,12000,52,36,46760,14771,31989
617667eae029f48bcf807b2b8bd538c0,106,62,193677,46908,146769,92,72,152505,55129,97376
dbf7527b5de1143db9872fc9ec0201cf,85,82,177748,68868,108880,93,77,193244,70971,122273
bfa1075cf56713c87c67ca4da8c2f42a,60,47,119344,44734,74610,85,53,119188,40715,78473
85d69bba93b9422f3bdbe08e30365650,111,65,131076,31092,99984,70,45,85321,24997,60324
ceb2fb91b9e15d180c671c32674d4588,57,55,62067,39262,22805,65,45,117624,27393,90231
b6009e4ecd8adb23f59257dcbae76307,32,24,22696,5311,17385,32,28,13317,6449,6868
9f6bf8cf0791e632c686ce571be1513b,142,111,329669,82077,247592,91,59,221150,88798,132352
1ff9d5fa4aef0a5d3e50ca41e2053c6b,148,105,375873,96691,279182,150,129,421840,111861,309979
fd6add95cdebf0f48a54d18abd5aa79e,91,66,157768,30641,127127,76,65,93989,33026,60963
dfca5addeb2d91dd98d0171085ed3a1f,31,23,6991,3620,3371,28,19,8880,3162,5718
6d51c30431e2cadb673a465d1fe038e9,97,87,306406,66740,239666,128,97,300620,89024,211596
9827dff4473d0ed55fc6afb7cdad5143,14,10,2453,1709,744,10,10,1935,1029,906
954a2f4656a7e7e1c719975560a900c5,161,110,477895,75019,402876,206,165,575055,88420,486635
839a9e139fa2e810eb5a9c41538e7457,117,105,260569,85784,174785,103,88,249823,51356,198467
639b1b40b2dd9f3b81d6fe58ef0a72ef,24,23,22650,5822,16828,25,17,15198,5100,10098
60bb27fd0597f8002838ac2c28abdb57,79,56,70148,19442,50706,50,50,43137,27312,15825
dd25205a9371eaa4e342b42b0068d61f,122,93,327021,59351,267670,112,105,285665,76425,209240
9e2b037bfdfa30d5671c73da01632b2e,158,121,371735,67523,304212,133,119,374018,78627,295391
7c7ab8b1af8324171295e3eb47652d46,82,81,161904,38794,123110,57,44,93287,22481,70806
4ca2d7b5f189ec740412fae1e288c4e5,54,35,65641,17493,48148,42,42,51793,23934,27859
fa8e3f7eed7aa679b21bcbc5923e8323,144,113,331736,54773,276963,144,116,300871,83133,217738
5c7b11dad9fd85fc187cbc4539372bf1,164,123,772987,141655,631332,140,104,617000,161065,455935
5ded034f323e8b4d6ea4d40e9712caf9,132,106,280915,64002,216913,91,74,211388,74400,136988
fb0b1154a956e0457821bc31912aca00,32,30,30655,12353,18302,33,23,25588,13451,12137
41dd745133f10807dc5ccd51409ae039,88,57,138085,44137,93948,91,66,183756,50533,133223
81d3d81097aa5af2078113ebc5d34c73,4,2,806,277,529,3,3,339,762,-423
d62edee10dc0cb30dfc586d611571e38,91,79,179752,40010,139742,65,49,125854,34959,90895
5653d3420521a507c0bceeb8edc50b4c,13,10,2523,990,1533,12,8,2124,1141,983
56d297b18dbf6f12091179c5a4842d35,57,46,87975,32553,55422,74,58,129562,39292,90270
8946c65c5d3eaa93f5e4e36962d26b89,32,21,21420,7821,13599,34,22,23939,4052,19887
9f8c5c91dfe3dd45382dfe9f5f20e88e,33,28,18686,8441,10245,29,29,20419,9676,10743
d228223c4e12f486fdbcd9259a13a0e2,62,51,76929,24651,52278,65,56,70968,36407,34561
8aad4a5c8d81df4cca0abaf72303a736,52,42,88316,28791,59525,45,38,54166,24021,30145
7fc86a30109b3480adc7bb180b7ba644,59,40,48227,14741,33486,45,31,28066,16365,11701
222dd6cfcc7bdf299dc28cddf200c27f,94,54,127129,28565,98564,79,71,103140,31016,72124
70e079a750b75d6ddf3fd281f496ae2f,97,85,174551,34189,140362,86,67,139906,26425,113481
472e6beb74b6d6891fa3aa65327b1256,73,52,68162,23452,44710,58,46,74771,17991,56780
722ea0ec759d9105b0c2f12726170e24,72,72,111933,32671,79262,89,75,142223,29726,112497
7557f607cdbe21ba7999bab3ac8bf064,95,73,166787,43197,123590,108,86,209921,42037,167884
a7789035ffaa6634cbd99fb3cc0723e1,18,16,4425,1748,2677,20,18,4880,2449,2431
a65e1610823b6d2e1f9937f7a4589782,112,87,238804,70442,168362,112,74,288941,68256,220685
e0ddcc3fe7d590c8685220a7410c8787,84,74,120517,34132,86385,76,58,112526,22004,90522
c03672359f7275a1a4a0e47501b998fe,27,22,16965,4804,12161,30,26,13082,8774,4308
e0c71995da86914c46c5c14af8548804,47,28,57310,13971,43339,33,31,37593,21118,16475
f997499a87f35c9d0d7048025426c8a7,171,115,671801,88360,583441,175,139,565155,91783,473372
67e94b4d1ced79d040b594e9e84e66d1,132,108,377829,96843,280986,153,118,457487,93693,363794
ba9d20db3f2b9de131ff9d9150515cdd,129,84,373950,98061,275889,177,137,477561,99575,377986
6f383d04756061c7fc7dbe67361ff812,108,87,325619,102563,223056,115,92,309139,98541,210598
b7d9a97829907b2b5aafc23a1c8d2dc5,190,154,714610,139159,575451,158,117,566628,157533,409095
dad134c65052fa98eceacf5d606095a7,163,127,571843,186768,385075,120,91,405888,146401,259487
492251898d744abc01b6cfbbb1982686,193,132,498239,121601,376638,138,116,478307,106172,372135
37f24b3d6505b169fb5d81083b3132e6,51,46,75452,26293,49159,73,51,98601,22911,75690
fe2940e4b4003f9eacf01b2d4c9ef9d8,55,49,73579,30532,43047,84,54,109596,34574,75022
f75f4ee2295b78a555e858d7c6940363,91,84,220546,60161,160385,133,101,314603,52908,261695
d300800bd41ed2d3dd101121dca9c6e2,84,73,145811,33413,112398,62,56,122320,40231,82089
84df816d483152db33d89e79e034fef6,52,43,45035,19290,25745,42,28,44654,13211,31443
876a086dba3ede2564f808e493778da0,79,53,113767,26034,87733,55,49,75553,16732,58821
1d7321fb8d966657693c4c51e28e0f67,60,51,109281,40540,68741,95,73,118850,34009,84841
7d06d887da79c19af911ab37c217a225,41,31,23636,6513,17123,31,26,22947,7706,15241
fbf5be655b35d7122bed0671c6e61e80,143,106,241578,59072,182506,119,93,213281,50920,162361
dd8c6541e68390bb9b56277460baaa7e,22,15,9374,2339,7035,21,17,4896,3117,1779
040b950fe176e77afcd8f30d0d298a8c,28,20,10379,4052,6327,23,18,10523,4446,6077
38bb48edaed4076e28563070ed81bca5,19,20,4279,3878,401,17,16,4058,2878,1180
ee70a74e7ea48a817ecc2226b3a3a13c,140,111,288783,60913,227870,101,78,207978,73556,134422
c945db704f208098cb6b61339c648bf7,86,57,167128,53582,113546,126,98,267714,60238,207476
ed718a66e99170248d7ed52035d8ebe9,92,86,125322,44404,80918,97,66,123125,29924,93201
c0c8663266466ddbe4e0671ae8e21f10,54,48,59904,22304,37600,62,54,85641,20249,65392
92d5569164243a76cccfd4745f1a2720,49,37,74342,18782,55560,54,37,64921,20835,44086
e70d578a5577801235159c1732655beb,151,103,486097,96584,389513,163,119,506680,127494,379186
7a8052f35b2aaac4e7bd3d844c2c419c,66,53,93176,32381,60795,96,82,155845,37200,118645
81fe45ad871b059023a44df5d4d4d8b7,190,123,661068,160564,500504,194,146,847724,173614,674110
23aa0d721db5855746b089da30da40e5,62,56,151290,38013,113277,76,61,149337,47297,102040
a66798fc63bd3b06f72d841c8d6c397b,89,70,133883,51591,82292,102,85,183359,54451,128908
40a1dea79c127c325ca4cdd80bda0f34,49,32,62808,25967,36841,48,41,66774,29782,36992
73ddcc052b4ac683a8874819054538b0,100,80,260724,50082,210642,91,68,161197,74567,86630
600de6948c13bc26fc7c062f8e380dbf,51,47,46298,15334,30964,41,30,44880,14316,30564
0b4bbe8a38a678d8c7213753f76b7289,23,18,10717,3632,7085,26,18,6498,4220,2278
1a37f99a9f689585f4f294340786fa1a,15,9,3078,639,2439,10,13,1500,1730,-230
9d63ad0e55fbf56297c6d69ff863d4e0,93,71,206752,75914,130838,127,111,333345,61066,272279
6f561fa1ddffedbd844fe5e99192833f,42,36,43200,24588,18612,37,36,45385,21129,24256
765de75581bca3c27764fbe731a0ddbf,116,92,318438,123142,195296,130,108,361838,120973,240865
9ee127647f166666f4d56d88d43a91db,76,70,226412,95912,130500,140,115,315005,75599,239406
b3f5ef7606de5ade5f9b41b03e9eed28,121,80,247727,48470,199257,112,91,177436,56515,120921
2863f17f27e9895e6d44af8a687d90c2,172,143,493505,119486,374019,116,81,268824,112345,156479
3abfe55474e821ceee2e629d1df13441,15,10,2230,735,1495,17,6,1911,853,1058
75597b5f1cb6ee9e336da2eaa4fe0506,32,33,19357,26729,-7372,50,37,74392,22820,51572
51c2d423b5377f96d7aa7e8637a6aaf8,114,88,303977,75712,228265,142,113,325753,69794,255959
51a1905c177bd251e876318a0a8c2219,24,20,9953,6386,3567,28,21,11226,6451,4775
d0d55df7b56982e4e7ccb2ea13c213fa,183,141,643839,147699,496140,158,102,500479,150499,349980
630aa76a625459e1100ec2fa28b17cc0,88,77,165843,39506,126337,127,107,249041,41648,207393
6ebcbfc8c00f1885c9be8e1bf520714a,176,95,635517,110973,524544,224,147,649747,124490,525257
4197d610de13c081723d6e63087d429b,57,44,62520,28040,34480,49,45,72235,27559,44676
98562abfb8d8b26ec76f1e7828c2291c,78,65,130462,44590,85872,111,78,176417,41627,134790
de2ba7644dd820b412aeaef98e9636da,157,93,329952,44204,285748,154,109,388246,64746,323500
d4f31c8cc01cdd1e812c478140dcdb8c,177,132,479542,148389,331153,119,95,408343,90705,317638
8f01088867f5715aed014f89e5879cb0,21,19,9945,3373,6572,25,15,10642,4003,6639
81f15e35d44cb9a484a108795bac79b6,124,102,336860,107319,229541,170,125,551664,90384,461280
96d3087441ec283d62f3484e48bd8a94,159,133,530120,83719,446401,158,121,357612,91479,266133
6e828f94846fbd2c1a327a2c4f59b7a0,53,42,53245,17260,35985,61,50,79506,16558,62948
b098b71f16a65beec8963c067f60227a,136,81,402397,85269,317128,188,143,569318,114778,454540
94a5c9ca21eed0752b176d42b91c12c5,79,62,136060,34215,101845,110,83,186613,38306,148307
40968cd038b608badae246a9e70666d1,80,71,174390,39779,134611,83,59,160070,34656,125414
b4f2535a6d061b4d2f577865c8385f08,168,131,451054,99635,351419,222,143,677037,71578,605459
9e33a65e1462c8637da93d959a605b04,150,106,623987,152186,471801,175,134,771564,160734,610830
39fc49ea372e7dd18afb2a6c54965b2b,171,112,911252,157529,753723,222,159,876694,318597,558097
d7397fb387304be5c027e92cc1c9e26c,26,20,18172,6035,12137,28,21,12784,5875,6909
1b9610bd8c20bd421926c5d26587c5ec,167,114,432922,87140,345782,168,130,378225,95674,282551
bb4f9bd694c4a2c3b7c034316c021516,39,31,27476,9032,18444,47,33,37490,10605,26885
93dc084f02306f78b681d24554931c93,60,49,77004,34384,42620,60,37,78601,21100,57501
22ca463ccf1c1b84fbeb60515671df8f,58,38,70962,23095,47867,51,47,63937,32530,31407
494d21b712d149b649650ac861b61b01,42,35,55052,15748,39304,37,30,46101,18011,28090
2fe8f33c35e54c5748c5d3f9973d6fe0,121,89,282552,65644,216908,103,71,240116,60741,179375
94a30d1c5bc951fbd2f5594a17bd7d75,138,105,481855,98671,383184,140,123,467807,106715,361092
52a030e10014af119e54f7e601659f97,160,91,438178,160552,277626,126,93,409640,147506,262134
fc395c8927004209e86759c7939944ee,32,25,22366,11520,10846,33,22,27662,8966,18696
9844bc04466ec029cf9a7133dc797042,175,115,563618,112284,451334,177,142,687303,149143,538160
528506dfb10eafb96627c053a9461b8b,158,121,482780,98680,384100,117,92,405306,85201,320105
b34f7da94d5367e48ab120a59e77c08b,116,96,275025,57332,217693,80,58,192915,44571,148344
981ea2162926b604a550539d40ec3b0f,96,72,140224,38370,101854,116,82,141256,41378,99878
96c7c7e73c5af831d76009dade68d7b2,89,70,135874,44611,91263,111,92,207294,47703,159591
b854370bab19362231bf6a5614887788,26,22,8049,5234,2815,25,20,10268,4599,5669
e4006509b411933c4f12837e3a60b805,54,47,77795,17237,60558,45,26,53327,15052,38275
11af23afbcfed4b912f1ea8c55863e29,131,100,499771,126222,373549,185,115,612734,123553,489181
f5480539b6ca8670af7fcbe4c38653fb,4,3,318,105,213,4,5,437,228,209
d73eabde425481d1710704517d3dba31,177,135,848690,247314,601376,199,141,726593,216903,509690
ef990f81dc1dfefd88fb6e50fa355d52,80,57,98585,23292,75293,69,56,84870,24203,60667
24b2f4d07c5665b02217a5dd49b107c6,67,56,91751,25377,66374,69,57,83519,21115,62404
46447ffe4d01621a106afc47b66bc5c9,21,21,7425,5093,2332,26,20,13055,3659,9396
5288e5b6b85ac8b26fe07cec86d92221,127,88,245825,71813,174012,138,85,269032,63218,205814
35c6cb8ed387492f79ff0408ad5378ab,129,89,576215,132176,444039,194,118,544579,126029,418550
f7c8d75ac9b9c23fea9c74bf8d2e8282,110,90,241581,72416,169165,132,99,327686,55106,272580
220fdd97a513ad13b1d125882280c6de,151,118,443379,102822,340557,164,116,476749,112556,364193
78b04a7f4724c37d22f272e3fbed6946,125,89,310635,70357,240278,137,108,305874,72894,232980
3cbebe6016c2c92f1138742edebc3488,154,97,349098,65800,283298,101,90,222876,66531,156345
44f4777fd7e769e1c6172a7c5a0531a3,53,25,53956,20028,33928,47,38,58333,15613,42720
f7746e4502dbc140562d2be18e73ed6f,191,163,814029,122906,691123,181,127,538772,113671,425101
7d1a956c0f25595fd8fe6bc3c9d2f32e,33,19,31856,5784,26072,25,21,15455,6703,8752
d801dbb6dc12feee83686441787fe02b,46,37,31754,10100,21654,34,29,26858,8076,18782
5c0ec5d6d80cc631291718630698e9e9,79,59,154788,36619,118169,102,76,159393,39872,119521
88551dec1847c867b8368af5edfce206,20,13,4760,987,3773,16,17,4596,2906,1690
cf6165aa4bdaf669d3396c7bb356b155,145,105,570377,118692,451685,159,126,562781,78856,483925
87a39f79f957bff003a3f340e7bb09c3,28,26,14330,7527,6803,28,26,12578,4856,7722
c2b6dfb4032dc4d9d6279c44caa3230d,162,126,536401,180393,356008,173,132,598842,147230,451612
4a0d52967d927d515ff95c7e155c1a41,15,8,2275,1513,762,13,10,2071,1410,661
b74ef4ccadc210de927b41b9a1e2b1e1,182,148,1083707,125527,958180,221,165,789540,136260,653280
793b68b573889a305369690db41f4e07,115,99,380667,92571,288096,177,152,578691,84286,494405
c765b85f6b1f9658da641b86bfad0105,54,50,94635,24020,70615,53,44,70459,36210,34249
ea79c1b1a5c19f67acee806bb906b1f2,73,64,101427,32512,68915,61,47,75632,34281,41351
c7b847da544e323fe8409a84bc6876f9,9,8,570,819,-249,8,6,915,471,444
6392befc076bd50a94b00d1f442061de,26,19,9617,4070,5547,27,20,8800,4747,4053
19c468f70a82683b4a79c127e0d58591,48,38,59641,14021,45620,34,25,25978,14698,11280
83b7cddd827b0d6eb1277af985bcea4b,33,28,28730,6983,21747,44,31,39443,8601,30842
480ec232109f7160ee4198202e1f2e96,105,72,189378,50207,139171,141,102,226879,56686,170193
7b7c8400bd1fdd799a24760176b85883,121,78,187225,41911,145314,96,58,109347,36846,72501
e14ca2fe21a27603361d3780ea3c8dfd,35,22,22107,3379,18728,25,14,12667,4382,8285
77332edf9ab4cd708a652fb040849c01,112,87,177142,34527,142615,78,61,123991,64473,59518
b721b97748604ecc24ef1d2ae007c92b,48,42,34530,13948,20582,57,47,68474,18349,50125
122e480a351220ddb6d772058aee44f7,44,32,45750,13360,32390,51,40,43901,16596,27305
9529ea256a200f802447fe862c944e25,16,9,5508,2248,3260,14,16,7823,2851,4972
475dd6727c2d901d72f014de1087952f,28,23,9344,5375,3969,30,18,10706,3197,7509
f72c98779678addaa5d07f5b5b502e6e,118,100,247980,50530,197450,130,94,240620,59220,181400
20c3a31959c831d644be876c40c86cad,23,20,11357,5808,5549,26,22,14380,6448,7932
f0816557d1b9295e737452e3698250e5,87,73,160636,53940,106696,133,120,317524,60022,257502
3c98829ed0b92a533c1791a18f33c908,25,26,21507,8872,12635,36,30,38851,7861,30990
9d77d38117254b496a9347ccab710281,79,61,182789,40053,142736,63,55,134218,47022,87196
9e1009ef1e656cd74374f07f4274456e,168,125,1075143,274955,800188,240,171,1102320,316501,785819
1a49eb6a4b75814ddd466bd94018babb,34,32,24293,12045,12248,38,23,22251,7640,14611
7f7329f72fb0abeceb0f87637c088852,95,82,243658,55607,188051,110,79,236611,57066,179545
d1c24510f6e89ac2a5a1e4d763d20a0c,16,12,2828,1131,1697,15,9,2102,1107,995
6454cd44689e99c433591bd9c2385d17,186,144,566978,109581,457397,174,145,573066,136916,436150
e50dab5e196ed939144d74675f3ed249,81,63,111802,33098,78704,79,64,99584,30169,69415
65c14452275cb065689e87428157c179,43,29,44287,12660,31627,47,35,64270,18684,45586
60c7338b4c5f9daafcfde0e77f0403de,2,3,150,696,-546,3,2,696,150,546
e62450a2e5fdfa0007c9bba920573e1a,50,38,118280,28504,89776,38,30,63306,35046,28260
c260c7b6e6a2bdb345126858188cbed7,33,31,31596,16051,15545,34,25,33079,11441,21638
b22cc12e60c9d5fc702d9cfc2da07ebe,98,75,175455,58469,116986,79,56,183703,36378,147325
d1199e2780eff39ed1151bb0088c337d,132,100,427559,118184,309375,167,123,501861,149846,352015
6aa83470ef1105600585af52944bad7e,142,115,414562,92841,321721,121,98,424955,95623,329332
393b34b9ded10477a18431208434958f,28,21,14829,3228,11601,22,22,8464,6602,1862
e026027b50c0f40918e42b1784074f5e,163,111,391931,109363,282568,162,107,690991,139520,551471
9eeef2f26be00239f8272fc447668c6e,11,9,1711,1404,307,16,11,2975,1062,1913
c08f3bf091d310f44f54dcd5e98ef1c8,81,58,107265,21361,85904,61,44,87230,19937,67293
ffc1d26c8f355120c80355aee5f36945,90,76,166014,38388,127626,99,89,172410,46014,126396
8c2813c6004a005493b42e30ef4bdbe9,162,124,468041,79467,388574,140,105,396084,74424,321660
fac803787a54ce14cf201acad4d65f77,24,15,5514,2060,3454,21,19,5830,1033,4797
bea35f0fb26a1d6a2d976688235e9dd2,129,96,367277,50109,317168,168,162,514585,63064,451521
c5257a9e108c8ab25754644feb9bca23,67,56,78993,25741,53252,48,37,61228,22205,39023
28eb098b7e214eec41b558a432ff803f,49,37,65936,16222,49714,50,42,51187,25405,25782
aacc7c36aee22bf34c834fa31087b7e9,158,113,457453,73675,383778,166,121,595878,104307,491571
23ae4a0547aacb7b692fd22025a77e27,141,99,387878,91938,295940,126,96,409028,95263,313765
6dc505bb3e3c482c794471d3e5eb9b5c,117,97,326011,85359,240652,175,124,442703,89046,353657
c0092a823d35776823e0f8c95ccdf224,142,102,363536,60817,302719,151,111,275106,63087,212019
d439f653f3aed283d0a46bdc2680ac0f,16,9,2408,2234,174,16,11,3152,1807,1345
47f00d834a194af505ab70b5abcf2ea3,69,51,78835,20833,58002,69,51,71317,21144,50173
ac397093bc89e57f63c98c1d979979fc,23,20,10225,6470,3755,27,25,12326,4865,7461
4df73ddf5324b9756f731b33bad0081f,35,25,29488,10651,18837,25,16,18858,3931,14927
15a43304b18c7609ba2e1608f4ec2e54,74,40,99576,22380,77196,97,80,129976,27993,101983
02124d9770dea1249ac19f3940d0c00e,64,56,128087,50933,77154,89,72,180560,50894,129666
78f24b6c60352f20c0b477a272b6c345,27,26,26899,11143,15756,38,26,31901,9304,22597
df0f2a5ba209f2eee0b5ad2d8a790132,147,104,535540,104780,430760,180,131,627352,107781,519571
70d8a2304069df666f8a1812f407f496,18,16,4333,1125,3208,24,12,3639,2454,1185
5cfb074b4e0f6f9c505edd2fcc7d1ffb,150,123,667254,129019,538235,153,121,587382,153492,433890
6deef06f9b00c3eff6bd51d7a94c3d8e,81,67,125031,34793,90238,92,70,177655,37250,140405
bbb25b199643229febb1744c8bb2cf74,71,56,107193,22449,84744,62,47,86906,22244,64662
c823f3b3e86201057e3cb6d6175a630b,53,46,59150,18960,40190,83,64,112821,19182,93639
860cdee682b0be7f35ce47772e83d872,104,76,162386,49651,112735,89,61,145181,37121,108060
e22f75d86fba5083613909fb8dd672eb,88,67,147960,35353,112607,64,54,84750,41087,43663
389c072a631169d39e38c938b89238d4,142,97,396654,77791,318863,150,131,420964,118459,302505
f9100a49d35b9cf5e732cc44aeb4db9a,89,80,112827,32773,80054,84,70,120332,29326,91006
42146f291918f02361557314a36a260b,123,88,353455,72322,281133,192,145,513533,105671,407862
e7eceba0ea91a2192f6b7032b5421794,31,28,27518,16568,10950,34,28,27461,12773,14688
12134fc654b2d5890ca29d61aeedbfbd,46,35,51370,17624,33746,45,38,39942,18935,21007
447573ed16aec91abb2ffd7a5d67cd4e,166,123,364118,62100,302018,149,131,336651,89299,247352
8e69b016235382df45f6d5cd8c480901,32,26,18885,7781,11104,30,20,17503,6501,11002
381f98bfdd2b247ccb4194fa12debc86,49,40,56505,26623,29882,63,47,94112,18739,75373
d2b43dd197d318974e5bdaf17e5b62c6,26,19,10608,3022,7586,24,20,8021,4386,3635
a3f3dcb87059f2acec4da29e5872c14d,91,76,195887,56402,139485,98,85,195624,48270,147354
31c27e40ce49972714135f9980cde486,77,54,121888,32696,89192,68,44,104854,30177,74677
dc9a3f7404f6c934dc506acaf4c0bdb1,23,19,13181,4703,8478,27,21,14551,6045,8506
c4eaae6df116e00b2d8c83d454c2b1eb,88,79,126366,46071,80295,78,61,125925,40381,85544
99b59eaa61ba388065d6ac7928fc6a74,45,29,34977,19552,15425,44,39,55795,16673,39122
be66aef962bced96b2a20d9c91015935,184,149,441163,149427,291736,135,101,390974,104733,286241
a4839b3e0a673d641cea1d73c6cf1234,146,121,404557,81241,323316,129,110,340526,52921,287605
6e3f0a92326eba6e364d93b65d204948,63,48,66365,20255,46110,51,49,60819,21486,39333
8a44a6d4df7db7c931786bd91ec269ae,63,55,100840,32424,68416,78,56,99189,36611,62578
e9fae332a6cf22720804793c586b25f1,134,96,315594,90666,224928,85,68,205807,56183,149624
e3a5efa04b207ea1e0c6d0d6e9618722,48,39,46786,15884,30902,43,33,46217,18137,28080
b91cb6f78b5a5c05442a4e44be337cd8,29,18,15235,7102,8133,27,20,16813,5160,11653
404297d22aea63bfe5533048296e27bf,141,115,484995,108097,376898,195,146,550608,135385,415223
340f64b9f81cf6a803619fd1e04abe0f,57,45,59856,18763,41093,53,36,65301,17234,48067
5b938eae0a3ad2038b4525485f918e12,72,64,171414,47149,124265,97,82,229038,86490,142548
800ae4c654831560ef06be3d8805e3df,59,50,80822,31911,48911,72,57,131203,26213,104990
c5a97ba8a3f13f4a6f65fd9522e1ec34,90,79,131132,47323,83809,120,73,149632,32756,116876
e99a2da75301c4c1d9d85e936efc0cb8,28,29,21936,10729,11207,29,22,17051,10974,6077
c7186b7a496d958007658aa5274bd24c,56,50,68932,30306,38626,62,44,80963,27060,53903
635d82c0867c9cfb04ee5587f1258263,26,18,10028,1754,8274,20,17,4139,1502,2637
71aa1b3585ead73ef3d09e435e454df5,53,38,26650,9782,16868,59,50,55306,10235,45071
8d1a9d95c64bf8a5484189978f0fbebb,28,16,15443,2264,13179,21,22,8613,4387,4226
03f683fed8cf6f03b735e2ee2a942698,43,38,65599,17115,48484,53,34,63427,14730,48697
c2911c082180c432b0c62922a73dbbc9,50,35,89691,33182,56509,62,39,81325,34427,46898
7a8c2cf093d9bd43b5f51f7a890df1e7,21,24,12390,6780,5610,32,23,23397,6191,17206
54a122e9c4441dfd976862cd67d17be8,65,56,51527,21771,29756,69,40,95955,12398,83557
06e2b42495855647830ccc6d466f913c,109,99,502568,138982,363586,123,97,524181,135446,388735
b794aa55646841a03c7783226e6f6bc8,178,140,743032,129635,613397,191,129,689823,174766,515057
308faee28efee2e66b39f9f2ba6ea9cf,189,143,655061,92628,562433,144,110,625665,126319,499346
6066cc7417b43c749d551e123d00f0c8,65,59,97574,42604,54970,82,64,151348,27495,123853
defd0caeed6ea83d7d5fbdec013fe7d1,104,80,251186,78991,172195,130,98,299117,79933,219184
bc7a87ed5f9c2bca55f9f7a93da0b0c5,36,30,17897,8605,9292,43,30,29480,8619,20861
e2ca68ac1a6847f4a37f6c9c8ee8695b,38,28,47293,26720,20573,50,32,74711,16139,58572
47ad6454ede66c1c78fdaa9391dfc556,187,125,838824,133441,705383,189,135,632201,130893,501308
9928dfde50efcbdb2055da23dcdbc101,118,97,323248,63237,260011,132,112,347560,75824,271736
